Rank,Release Group,Worldwide,Domestic,Foreign,filename,year,Domestic %,Foreign %
1,Avengers: Endgame,2797800564,858373000,1939427564,2019_boxofficemojo_rankings.csv,2019,0.306802783245132,0.693197216754868
2,Avatar,2744336793,749766139,1994570654,2009_boxofficemojo_rankings.csv,2009,0.27320485623792023,0.7267951437620798
3,Star Wars: Episode VII - The Force Awakens,2068223624,936662225,1131561399,2015_boxofficemojo_rankings.csv,2015,0.4528824707980417,0.5471175292019583
4,Avengers: Infinity War,2048359754,678815482,1369544272,2018_boxofficemojo_rankings.csv,2018,0.3313946589091205,0.6686053410908794
5,Titanic,1850906470,600788188,1250118282,1997_boxofficemojo_rankings.csv,1997,0.32459132740510654,0.6754086725948935
6,Jurassic World,1670400637,652270625,1018130012,2015_boxofficemojo_rankings.csv,2015,0.39048753368022093,0.6095124663197791
7,The Lion King,1656943394,543638043,1113305351,2019_boxofficemojo_rankings.csv,2019,0.32809693135479556,0.6719030686452044
8,The Avengers,1518812988,623357910,895455078,2012_boxofficemojo_rankings.csv,2012,0.41042440045291473,0.5895755995470853
9,Furious 7,1515047671,353007020,1162040651,2015_boxofficemojo_rankings.csv,2015,0.23300060239490641,0.7669993976050936
10,Frozen II,1450026933,477373578,972653355,2019_boxofficemojo_rankings.csv,2019,0.329217042205105,0.6707829577948949
11,Avengers: Age of Ultron,1402805868,459005868,943800000,2015_boxofficemojo_rankings.csv,2015,0.3272055517235689,0.6727944482764311
12,Black Panther,1346913161,700059566,646853595,2018_boxofficemojo_rankings.csv,2018,0.5197510769589992,0.4802489230410007
13,Harry Potter and the Deathly Hallows: Part 2,1341511219,381011219,960500000,2011_boxofficemojo_rankings.csv,2011,0.2840164238686102,0.7159835761313897
14,Star Wars: Episode VIII - The Last Jedi,1332539889,620181382,712358507,2017_boxofficemojo_rankings.csv,2017,0.465412995978239,0.5345870040217611
15,Jurassic World: Fallen Kingdom,1308467944,417719760,890748184,2018_boxofficemojo_rankings.csv,2018,0.3192434036427567,0.6807565963572433
16,Frozen,1280802282,400738009,880064273,2013_boxofficemojo_rankings.csv,2013,0.31288046143565507,0.6871195385643449
17,Beauty and the Beast,1263521126,504014165,759506961,2017_boxofficemojo_rankings.csv,2017,0.3988965080430321,0.6011034919569679
18,Incredibles 2,1242805359,608581744,634223615,2018_boxofficemojo_rankings.csv,2018,0.48968387494698595,0.510316125053014
19,The Fate of the Furious,1236005118,226008385,1009996733,2017_boxofficemojo_rankings.csv,2017,0.1828539232634472,0.8171460767365528
20,Iron Man 3,1214811252,409013994,805797258,2013_boxofficemojo_rankings.csv,2013,0.33668933616363966,0.6633106638363603
21,Minions,1159398397,336045770,823352627,2015_boxofficemojo_rankings.csv,2015,0.28984494964762314,0.7101550503523768
22,Captain America: Civil War,1153296293,408084349,745211944,2016_boxofficemojo_rankings.csv,2016,0.35384172434862754,0.6461582756513724
23,Aquaman,1148461807,335061807,813400000,2018_boxofficemojo_rankings.csv,2018,0.2917483236776023,0.7082516763223977
24,The Lord of the Rings: The Return of the King,1140682011,377027325,763654686,2003_boxofficemojo_rankings.csv,2003,0.3305279835784138,0.6694720164215863
25,Spider-Man: Far from Home,1131927996,390532085,741395911,2019_boxofficemojo_rankings.csv,2019,0.345014953583673,0.654985046416327
26,Captain Marvel,1128274794,426829839,701444955,2019_boxofficemojo_rankings.csv,2019,0.3783030882811692,0.6216969117188308
27,Transformers: Dark of the Moon,1123794079,352390543,771403536,2011_boxofficemojo_rankings.csv,2011,0.3135721655639725,0.6864278344360275
28,Skyfall,1108561013,304360277,804200736,2012_boxofficemojo_rankings.csv,2012,0.2745543758356943,0.7254456241643057
29,Transformers: Age of Extinction,1104054072,245439076,858614996,2014_boxofficemojo_rankings.csv,2014,0.22230711540729683,0.7776928845927031
30,The Dark Knight Rises,1081041287,448139099,632902188,2012_boxofficemojo_rankings.csv,2012,0.4145439257399981,0.5854560742600019
31,Joker,1074251311,335451311,738800000,2019_boxofficemojo_rankings.csv,2019,0.3122652097931673,0.6877347902068327
32,Star Wars: Episode IX - The Rise of Skywalker,1074144248,515202542,558941706,2019_boxofficemojo_rankings.csv,2019,0.4796399952420543,0.5203600047579457
33,Toy Story 4,1073394593,434038008,639356585,2019_boxofficemojo_rankings.csv,2019,0.4043601587249657,0.5956398412750342
34,Toy Story 3,1066969703,415004880,651964823,2010_boxofficemojo_rankings.csv,2010,0.3889565737744289,0.6110434262255711
35,Pirates of the Caribbean: Dead Man's Chest,1066179725,423315812,642863913,2006_boxofficemojo_rankings.csv,2006,0.3970398255322291,0.602960174467771
36,Rogue One: A Star Wars Story,1056057273,532177324,523879949,2016_boxofficemojo_rankings.csv,2016,0.5039284682810948,0.49607153171890517
37,Aladdin,1050693953,355559216,695134737,2019_boxofficemojo_rankings.csv,2019,0.3384041708670612,0.6615958291329388
38,Pirates of the Caribbean: On Stranger Tides,1045713802,241071802,804642000,2011_boxofficemojo_rankings.csv,2011,0.23053325062644625,0.7694667493735537
39,Despicable Me 3,1034799409,264624300,770175109,2017_boxofficemojo_rankings.csv,2017,0.2557252136969475,0.7442747863030524
40,Finding Dory,1028570889,486295561,542275328,2016_boxofficemojo_rankings.csv,2016,0.47278759898871686,0.5272124010112832
41,Alice in Wonderland,1025467110,334191110,691276000,2010_boxofficemojo_rankings.csv,2010,0.32589159295416115,0.6741084070458389
42,Zootopia,1023784195,341268248,682515947,2016_boxofficemojo_rankings.csv,2016,0.3333400238709487,0.6666599761290513
43,The Hobbit: An Unexpected Journey,1017003568,303003568,714000000,2012_boxofficemojo_rankings.csv,2012,0.29793756633113405,0.7020624336688659
44,The Dark Knight,1003045358,533345358,469700000,2008_boxofficemojo_rankings.csv,2008,0.5317260617839378,0.4682739382160622
45,Harry Potter and the Deathly Hallows: Part 1,976536918,295983305,680553613,2010_boxofficemojo_rankings.csv,2010,0.30309484418283916,0.6969051558171608
46,Harry Potter and the Sorcerer's Stone,974755371,317575550,657179821,2001_boxofficemojo_rankings.csv,2001,0.32580025660612644,0.6741997433938736
47,Despicable Me 2,970766005,368065385,602700620,2013_boxofficemojo_rankings.csv,2013,0.3791494377679614,0.6208505622320386
48,The Jungle Book,966550600,364001123,602549477,2016_boxofficemojo_rankings.csv,2016,0.3765981036067848,0.6234018963932152
49,Jumanji: Welcome to the Jungle,962077546,404515480,557562066,2017_boxofficemojo_rankings.csv,2017,0.42046036900231326,0.5795396309976868
50,Pirates of the Caribbean: At World's End,960996492,309420425,651576067,2007_boxofficemojo_rankings.csv,2007,0.32197872476729084,0.6780212752327092
51,The Hobbit: The Desolation of Smaug,958366855,258366855,700000000,2013_boxofficemojo_rankings.csv,2013,0.2695907664711547,0.7304092335288452
52,The Hobbit: The Battle of the Five Armies,956019788,255119788,700900000,2014_boxofficemojo_rankings.csv,2014,0.26685617934092387,0.7331438206590761
53,Harry Potter and the Order of the Phoenix,941676843,292004738,649672105,2007_boxofficemojo_rankings.csv,2007,0.31009017602018274,0.6899098239798173
54,The Lord of the Rings: The Two Towers,936689735,339789881,596899854,2002_boxofficemojo_rankings.csv,2002,0.36275606351125433,0.6372439364887457
55,Harry Potter and the Half-Blood Prince,933959197,301959197,632000000,2009_boxofficemojo_rankings.csv,2009,0.32331090905248616,0.6766890909475138
56,Shrek 2,928760770,441226247,487534523,2004_boxofficemojo_rankings.csv,2004,0.47506985787093486,0.5249301421290652
57,Star Wars: Episode I - The Phantom Menace,924305084,431088295,493216789,1999_boxofficemojo_rankings.csv,1999,0.4663917817420552,0.5336082182579448
58,Jurassic Park,912667947,357067947,555600000,1993_boxofficemojo_rankings.csv,1993,0.39123533172574537,0.6087646682742546
59,Bohemian Rhapsody,903655259,216428042,687227217,2018_boxofficemojo_rankings.csv,2018,0.23950288546929155,0.7604971145307085
60,Harry Potter and the Goblet of Fire,895921036,290013036,605908000,2005_boxofficemojo_rankings.csv,2005,0.3237037912345659,0.6762962087654341
61,Spider-Man 3,894983373,336530303,558453070,2007_boxofficemojo_rankings.csv,2007,0.3760184972732449,0.6239815027267551
62,Ice Age: Dawn of the Dinosaurs,886686817,196573705,690113112,2009_boxofficemojo_rankings.csv,2009,0.22169462907442775,0.7783053709255723
63,The Lord of the Rings: The Fellowship of the Ring,883726270,313364114,570362156,2001_boxofficemojo_rankings.csv,2001,0.35459409167501604,0.6454059083249839
64,Spectre,880674609,200074609,680600000,2015_boxofficemojo_rankings.csv,2015,0.22718335121207064,0.7728166487879293
65,Spider-Man: Homecoming,880166924,334201140,545965784,2017_boxofficemojo_rankings.csv,2017,0.37970199843592395,0.620298001564076
66,Harry Potter and the Chamber of Secrets,878979634,261988482,616991152,2002_boxofficemojo_rankings.csv,2002,0.2980597864455185,0.7019402135544816
67,Ice Age: Continental Drift,877244782,161321843,715922939,2012_boxofficemojo_rankings.csv,2012,0.18389604168657225,0.8161039583134277
68,The Secret Life of Pets,875457937,368384330,507073607,2016_boxofficemojo_rankings.csv,2016,0.42079043941548044,0.5792095605845196
69,Batman v Superman: Dawn of Justice,873634919,330360194,543274725,2016_boxofficemojo_rankings.csv,2016,0.3781444477724682,0.6218555522275317
70,Finding Nemo,871014978,339714978,531300000,2003_boxofficemojo_rankings.csv,2003,0.3900219704373442,0.6099780295626558
71,Wolf Warrior 2,870325439,2721100,867604339,2017_boxofficemojo_rankings.csv,2017,0.003126531614572282,0.9968734683854277
72,Star Wars: Episode III - Revenge of the Sith,868352530,380270577,488081953,2005_boxofficemojo_rankings.csv,2005,0.437921885250913,0.562078114749087
73,The Hunger Games: Catching Fire,865011746,424668047,440343699,2013_boxofficemojo_rankings.csv,2013,0.490939052520103,0.5090609474798969
74,Guardians of the Galaxy Vol. 2,863756051,389813101,473942950,2017_boxofficemojo_rankings.csv,2017,0.4512999944240043,0.5487000055759956
75,Inside Out,857611174,356461711,501149463,2015_boxofficemojo_rankings.csv,2015,0.4156449004009829,0.5843550995990171
76,Venom,856085151,213515506,642569645,2018_boxofficemojo_rankings.csv,2018,0.24940919224050412,0.7505908077594958
77,Thor: Ragnarok,853977126,315058289,538918837,2017_boxofficemojo_rankings.csv,2017,0.36893059475225337,0.6310694052477467
78,Transformers: Revenge of the Fallen,836303693,402111870,434191823,2009_boxofficemojo_rankings.csv,2009,0.4808203925986968,0.5191796074013032
79,The Twilight Saga: Breaking Dawn - Part 2,829746820,292324737,537422083,2012_boxofficemojo_rankings.csv,2012,0.35230594436023266,0.6476940556397673
80,Inception,826137188,292576195,533560993,2010_boxofficemojo_rankings.csv,2010,0.3541496488111125,0.6458503511888876
81,Wonder Woman,821847012,412563408,409283604,2017_boxofficemojo_rankings.csv,2017,0.501995385973369,0.49800461402663104
82,Spider-Man,821708551,403706375,418002176,2002_boxofficemojo_rankings.csv,2002,0.4913011730359856,0.5086988269640144
83,Independence Day,817400891,306169268,511231623,1996_boxofficemojo_rankings.csv,1996,0.37456439229646005,0.6254356077035399
84,Fantastic Beasts and Where to Find Them,814037575,234037575,580000000,2016_boxofficemojo_rankings.csv,2016,0.287502177034027,0.7124978229659731
85,Shrek the Third,813367380,322719944,490647436,2007_boxofficemojo_rankings.csv,2007,0.3967702073323865,0.6032297926676135
86,Coco,807292196,209936015,597356181,2017_boxofficemojo_rankings.csv,2017,0.2600496029073468,0.7399503970926532
87,Jumanji: The Next Level,800059707,320314960,479744747,2019_boxofficemojo_rankings.csv,2019,0.4003638193467978,0.5996361806532021
88,Harry Potter and the Prisoner of Azkaban,795634069,249541069,546093000,2004_boxofficemojo_rankings.csv,2004,0.31363798852107727,0.6863620114789227
89,Pirates of the Caribbean: Dead Men Tell No Tales,794861794,172558876,622302918,2017_boxofficemojo_rankings.csv,2017,0.21709293024593404,0.782907069754066
90,Mission: Impossible - Fallout,791115104,220159104,570956000,2018_boxofficemojo_rankings.csv,2018,0.27828959766643513,0.7217104023335649
91,Indiana Jones and the Kingdom of the Crystal Skull,790653942,317101119,473552823,2008_boxofficemojo_rankings.csv,2008,0.40106183268735285,0.5989381673126472
92,Spider-Man 2,788976453,373585825,415390628,2004_boxofficemojo_rankings.csv,2004,0.47350693874256855,0.5264930612574314
93,Fast & Furious 6,788679850,238679850,550000000,2013_boxofficemojo_rankings.csv,2013,0.30263211365169274,0.6973678863483073
94,Deadpool,782612155,363070709,419541446,2016_boxofficemojo_rankings.csv,2016,0.463921633059737,0.536078366940263
95,Guardians of the Galaxy,772776600,333176600,439600000,2014_boxofficemojo_rankings.csv,2014,0.4311421955581988,0.5688578044418011
96,2012,769679473,166112167,603567306,2009_boxofficemojo_rankings.csv,2009,0.21581992612137652,0.7841800738786235
97,The Lion King,763455561,312855561,450600000,1994_boxofficemojo_rankings.csv,1994,0.4097888298700859,0.5902111701299141
98,The Da Vinci Code,760006945,217536138,542470807,2006_boxofficemojo_rankings.csv,2006,0.28622914491919543,0.7137708550808045
99,Fast & Furious Presents: Hobbs & Shaw,759056935,173956935,585100000,2019_boxofficemojo_rankings.csv,2019,0.22917508157671992,0.77082491842328
100,Maleficent,758410378,241410378,517000000,2014_boxofficemojo_rankings.csv,2014,0.31831101604466705,0.681688983955333
101,The Amazing Spider-Man,757930663,262030663,495900000,2012_boxofficemojo_rankings.csv,2012,0.34571851462354675,0.6542814853764533
102,The Hunger Games: Mockingjay - Part 1,755356711,337135885,418220826,2014_boxofficemojo_rankings.csv,2014,0.44632672231596815,0.5536732776840319
103,Shrek Forever After,752600867,238736787,513864080,2010_boxofficemojo_rankings.csv,2010,0.31721566831519477,0.6827843316848052
104,Madagascar 3: Europe's Most Wanted,746921274,216391482,530529792,2012_boxofficemojo_rankings.csv,2012,0.2897112313338661,0.7102887686661339
105,Suicide Squad,746846894,325100054,421746840,2016_boxofficemojo_rankings.csv,2016,0.43529678788488074,0.5647032121151193
106,X-Men: Days of Future Past,746045700,233921534,512124166,2014_boxofficemojo_rankings.csv,2014,0.3135485319465014,0.6864514680534985
107,"The Chronicles of Narnia: The Lion, the Witch and the Wardrobe",745013115,291710957,453302158,2005_boxofficemojo_rankings.csv,2005,0.39155143866158654,0.6084485613384135
108,Monsters University,743559607,268492764,475066843,2013_boxofficemojo_rankings.csv,2013,0.3610911102114238,0.6389088897885762
109,The Matrix Reloaded,739412035,281576461,457835574,2003_boxofficemojo_rankings.csv,2003,0.3808113036731949,0.6191886963268052
110,Up,735099082,293004164,442094918,2009_boxofficemojo_rankings.csv,2009,0.3985913888000203,0.6014086111999797
111,Deadpool 2,734546611,318491426,416055185,2018_boxofficemojo_rankings.csv,2018,0.43358912998919275,0.5664108700108073
112,Ne Zha,726063471,3695533,722367938,2019_boxofficemojo_rankings.csv,2019,0.005089820859476899,0.9949101791405232
113,Gravity,723192705,274092705,449100000,2013_boxofficemojo_rankings.csv,2013,0.37900369169238235,0.6209963083076177
114,Captain America: The Winter Soldier,714421503,259766572,454654931,2014_boxofficemojo_rankings.csv,2014,0.3636040781376089,0.6363959218623911
115,The Twilight Saga: Breaking Dawn - Part 1,712205856,281287133,430918723,2011_boxofficemojo_rankings.csv,2011,0.394952008089077,0.6050479919109231
116,Dawn of the Planet of the Apes,710644566,208545589,502098977,2014_boxofficemojo_rankings.csv,2014,0.29345976734028806,0.7065402326597119
117,The Twilight Saga: New Moon,709827462,296623634,413203828,2009_boxofficemojo_rankings.csv,2009,0.4178813160655089,0.5821186839344911
118,Transformers,709709780,319246193,390463587,2007_boxofficemojo_rankings.csv,2007,0.44982639664342794,0.5501736033565721
119,The Amazing Spider-Man 2,708982323,202853933,506128390,2014_boxofficemojo_rankings.csv,2014,0.28611987410580336,0.7138801258941967
120,It,700381748,327481748,372900000,2017_boxofficemojo_rankings.csv,2017,0.4675760739555994,0.5324239260444006
121,The Wandering Earth,699856699,5971413,693885286,2019_boxofficemojo_rankings.csv,2019,0.008532336703402763,0.9914676632965972
122,The Twilight Saga: Eclipse,698491347,300531751,397959596,2010_boxofficemojo_rankings.csv,2010,0.4302583736946422,0.5697416263053579
123,Mission: Impossible - Ghost Protocol,694713380,209397903,485315477,2011_boxofficemojo_rankings.csv,2011,0.3014162516921727,0.6985837483078273
124,The Hunger Games,694394724,408010692,286384032,2012_boxofficemojo_rankings.csv,2012,0.5875774655223331,0.4124225344776669
125,Mission: Impossible - Rogue Nation,682714267,195042377,487671890,2015_boxofficemojo_rankings.csv,2015,0.2856866868434727,0.7143133131565274
126,Interstellar,677896797,188020017,489876780,2014_boxofficemojo_rankings.csv,2014,0.2773578778245798,0.7226421221754201
127,Doctor Strange,677718395,232641920,445076475,2016_boxofficemojo_rankings.csv,2016,0.3432722524817996,0.6567277475182004
128,Forrest Gump,677387716,329694499,347693217,1994_boxofficemojo_rankings.csv,1994,0.4867146114589418,0.5132853885410582
129,The Sixth Sense,672806292,293506292,379300000,1999_boxofficemojo_rankings.csv,1999,0.43624189531212054,0.5637581046878795
130,Man of Steel,668045518,291045518,377000000,2013_boxofficemojo_rankings.csv,2013,0.4356671965577052,0.5643328034422948
131,Kung Fu Panda 2,665692281,165249063,500443218,2011_boxofficemojo_rankings.csv,2011,0.24823641150196843,0.7517635884980316
132,E.T. the Extra-Terrestrial,663400925,359197037,304203888,1982_boxofficemojo_rankings.csv,1982,0.541447898945875,0.458552101054125
133,Ice Age: The Meltdown,660998756,195330621,465668135,2006_boxofficemojo_rankings.csv,2006,0.29550830349822926,0.7044916965017707
134,The Hunger Games: Mockingjay - Part 2,658344137,281723902,376620235,2015_boxofficemojo_rankings.csv,2015,0.4279280184430351,0.5720719815569649
135,Justice League,657924295,229024295,428900000,2017_boxofficemojo_rankings.csv,2017,0.3481012887660578,0.6518987112339422
136,Big Hero 6,657827828,222527828,435300000,2014_boxofficemojo_rankings.csv,2014,0.33827670178769026,0.6617232982123098
137,Fantastic Beasts: The Crimes of Grindelwald,654855901,159555901,495300000,2018_boxofficemojo_rankings.csv,2018,0.24365039813545178,0.7563496018645482
138,Pirates of the Caribbean: The Curse of the Black Pearl,654264015,305413918,348850097,2003_boxofficemojo_rankings.csv,2003,0.4668053125312111,0.5331946874687888
139,Star Wars: Episode II - Attack of the Clones,645256452,302191252,343065200,2002_boxofficemojo_rankings.csv,2002,0.4683273620331037,0.5316726379668963
140,Thor: The Dark World,644783140,206362140,438421000,2013_boxofficemojo_rankings.csv,2013,0.32004890822672566,0.6799510917732744
141,Moana,643331111,248757044,394574067,2016_boxofficemojo_rankings.csv,2016,0.38667031602642327,0.6133296839735767
142,Sing,634151679,270395425,363756254,2016_boxofficemojo_rankings.csv,2016,0.42638919670825315,0.5736108032917469
143,Kung Fu Panda,631744560,215434591,416309969,2008_boxofficemojo_rankings.csv,2008,0.3410153480387706,0.6589846519612294
144,The Incredibles,631442092,261441092,370001000,2004_boxofficemojo_rankings.csv,2004,0.4140381126192012,0.5859618873807988
145,The Martian,630161890,228433663,401728227,2015_boxofficemojo_rankings.csv,2015,0.36249996488997455,0.6375000351100255
146,Hancock,629443428,227946274,401497154,2008_boxofficemojo_rankings.csv,2008,0.3621394137425167,0.6378605862574833
147,Fast Five,626137675,209837675,416300000,2011_boxofficemojo_rankings.csv,2011,0.33513024911014977,0.6648697508898502
148,Men in Black 3,624026776,179020854,445005922,2012_boxofficemojo_rankings.csv,2012,0.2868800841328001,0.7131199158671999
149,Iron Man 2,623933331,312433331,311500000,2010_boxofficemojo_rankings.csv,2010,0.5007479412892594,0.4992520587107407
150,Ratatouille,623726085,206445654,417280431,2007_boxofficemojo_rankings.csv,2007,0.3309876866862158,0.6690123133137842
151,Ant-Man and the Wasp,622674139,216648740,406025399,2018_boxofficemojo_rankings.csv,2018,0.3479327732285988,0.6520672267714012
152,How to Train Your Dragon 2,621537519,177002924,444534595,2014_boxofficemojo_rankings.csv,2014,0.2847823640393944,0.7152176359606056
153,Logan,619021436,226277068,392744368,2017_boxofficemojo_rankings.csv,2017,0.36553995522701094,0.6344600447729891
154,The Lost World: Jurassic Park,618638999,229086679,389552320,1997_boxofficemojo_rankings.csv,1997,0.37030752889861057,0.6296924711013895
155,The Passion of the Christ,611486736,370274604,241212132,2004_boxofficemojo_rankings.csv,2004,0.6055317019991747,0.39446829800082533
156,Mamma Mia!,609841637,144130063,465711574,2008_boxofficemojo_rankings.csv,2008,0.23634014841790804,0.7636598515820919
157,Life of Pi,609016565,124987023,484029542,2012_boxofficemojo_rankings.csv,2012,0.20522762463776334,0.7947723753622367
158,Casino Royale,606099584,167445960,438653624,2006_boxofficemojo_rankings.csv,2006,0.27626806620609723,0.7237319337939028
159,Transformers: The Last Knight,605425157,130168683,475256474,2017_boxofficemojo_rankings.csv,2017,0.21500375644284633,0.7849962435571537
160,Madagascar: Escape 2 Africa,603900354,180010950,423889404,2008_boxofficemojo_rankings.csv,2008,0.298080550553875,0.701919449446125
161,War of the Worlds,603873119,234280354,369592765,2005_boxofficemojo_rankings.csv,2005,0.38796287933459084,0.6120371206654092
162,Tangled,592461732,200821936,391639796,2010_boxofficemojo_rankings.csv,2010,0.33896186901738995,0.66103813098261
163,Quantum of Solace,589580482,168368427,421212055,2008_boxofficemojo_rankings.csv,2008,0.2855732714028345,0.7144267285971655
164,Men in Black,589390539,250690539,338700000,1997_boxofficemojo_rankings.csv,1997,0.4253385869161364,0.5746614130838635
165,The Croods,587204668,187168425,400036243,2013_boxofficemojo_rankings.csv,2013,0.3187447838885368,0.6812552161114632
166,The Hangover Part II,586764305,254464305,332300000,2011_boxofficemojo_rankings.csv,2011,0.43367379854505633,0.5663262014549436
167,I Am Legend,585410052,256393010,329017042,2007_boxofficemojo_rankings.csv,2007,0.4379716561477834,0.5620283438522166
168,Iron Man,585366247,318604126,266762121,2008_boxofficemojo_rankings.csv,2008,0.5442816828487209,0.45571831715127914
169,Ready Player One,582890172,137690172,445200000,2018_boxofficemojo_rankings.csv,2018,0.23621975221774713,0.7637802477822528
170,Operation Red Sea,579330426,1543547,577786879,2018_boxofficemojo_rankings.csv,2018,0.0026643637736368433,0.9973356362263631
171,Night at the Museum,574480841,250863268,323617573,2006_boxofficemojo_rankings.csv,2006,0.43667821465259277,0.5633217853474073
172,Fifty Shades of Grey,569651467,166167230,403484237,2015_boxofficemojo_rankings.csv,2015,0.2916998193212763,0.7083001806787237
173,Kong: Skull Island,566652812,168052812,398600000,2017_boxofficemojo_rankings.csv,2017,0.29657103686975084,0.7034289631302492
174,The Smurfs,563749323,142614158,421135165,2011_boxofficemojo_rankings.csv,2011,0.2529744199799243,0.7470255800200757
175,King Kong,562363449,218080025,344283424,2005_boxofficemojo_rankings.csv,2005,0.38779196156469975,0.6122080384353003
176,Cars 2,559852396,191452396,368400000,2011_boxofficemojo_rankings.csv,2011,0.3419694143811434,0.6580305856188566
177,Puss in Boots,554987477,149260504,405726973,2011_boxofficemojo_rankings.csv,2011,0.26894391348581725,0.7310560865141827
178,The Mermaid,553810228,3232685,550577543,2016_boxofficemojo_rankings.csv,2016,0.005837170995693492,0.9941628290043065
179,Armageddon,553709788,201578182,352131606,1998_boxofficemojo_rankings.csv,1998,0.3640502414235813,0.6359497585764188
180,The Day After Tomorrow,552639571,186740799,365898772,2004_boxofficemojo_rankings.csv,2004,0.3379070352528194,0.6620929647471806
181,Ted,549368315,218815487,330552828,2012_boxofficemojo_rankings.csv,2012,0.398303799155217,0.6016962008447829
182,American Sniper,547426372,350126372,197300000,2014_boxofficemojo_rankings.csv,2014,0.639586234621521,0.3604137653784791
183,Mission: Impossible II,546388108,215409889,330978219,2000_boxofficemojo_rankings.csv,2000,0.3942433699527004,0.6057566300472996
184,Detective Chinatown 2,544185156,1983984,542201172,2018_boxofficemojo_rankings.csv,2018,0.0036457885301083076,0.9963542114698917
185,X-Men: Apocalypse,543934105,155442489,388491616,2016_boxofficemojo_rankings.csv,2016,0.285774485495812,0.7142255145041879
186,Sherlock Holmes: A Game of Shadows,543848418,186848418,357000000,2011_boxofficemojo_rankings.csv,2011,0.3435670893134785,0.6564329106865214
187,Despicable Me,543113985,251513985,291600000,2010_boxofficemojo_rankings.csv,2010,0.4630961307321151,0.5369038692678849
188,Cinderella,542351353,201151353,341200000,2015_boxofficemojo_rankings.csv,2015,0.3708875286976559,0.6291124713023442
189,Madagascar,542063846,193595521,348468325,2005_boxofficemojo_rankings.csv,2005,0.35714523746341126,0.6428547625365887
190,World War Z,540007876,202359711,337648165,2013_boxofficemojo_rankings.csv,2013,0.37473473997997764,0.6252652600200224
191,Brave,538983207,237283207,301700000,2012_boxofficemojo_rankings.csv,2012,0.4402423005360907,0.5597576994639093
192,The Simpsons Movie,536414270,183135014,353279256,2007_boxofficemojo_rankings.csv,2007,0.34140593239624295,0.658594067603757
193,The Revenant,532950503,183637894,349312609,2015_boxofficemojo_rankings.csv,2015,0.34456838480552104,0.6554316151944789
194,The Meg,530243742,145443742,384800000,2016_boxofficemojo_rankings.csv,2016,0.2742960085703378,0.7257039914296621
195,Ralph Breaks the Internet,529323962,201091711,328232251,2018_boxofficemojo_rankings.csv,2018,0.3799029052835511,0.6200970947164489
196,"Monsters, Inc.",528773250,255873250,272900000,2001_boxofficemojo_rankings.csv,2001,0.48389976232723575,0.5161002376727643
197,Hotel Transylvania 3: Summer Vacation,528583774,167510016,361073758,2018_boxofficemojo_rankings.csv,2018,0.31690343941583043,0.6830965605841696
198,The Boss Baby,527965936,175003033,352962903,2017_boxofficemojo_rankings.csv,2017,0.331466522870521,0.6685334771294791
199,Dunkirk,525245546,188045546,337200000,2017_boxofficemojo_rankings.csv,2017,0.3580145465907482,0.6419854534092517
200,Godzilla,524976069,200676069,324300000,2014_boxofficemojo_rankings.csv,2014,0.38225755582013016,0.6177424441798699
201,Sherlock Holmes,524028679,209028679,315000000,2009_boxofficemojo_rankings.csv,2009,0.39888786125005193,0.6011121387499481
202,Meet the Fockers,522657936,279261160,243396776,2004_boxofficemojo_rankings.csv,2004,0.5343096139269183,0.46569038607308166
203,How to Train Your Dragon: The Hidden World,521799505,160799505,361000000,2019_boxofficemojo_rankings.csv,2019,0.3081633912243746,0.6918366087756255
204,WALL·E,521311860,223808164,297503696,2008_boxofficemojo_rankings.csv,2008,0.4293172305728859,0.5706827694271142
205,Kung Fu Panda 3,521170825,143528619,377642206,2016_boxofficemojo_rankings.csv,2016,0.2753964959569638,0.7246035040430362
206,Ant-Man,519311965,180202163,339109802,2015_boxofficemojo_rankings.csv,2015,0.3470017545234106,0.6529982454765894
207,Terminator 2: Judgment Day,516950043,204843345,312106698,1991_boxofficemojo_rankings.csv,1991,0.3962536569515287,0.6037463430484713
208,Dr. Seuss' the Grinch,511595957,270620950,240975007,2018_boxofficemojo_rankings.csv,2018,0.5289739809261237,0.4710260190738763
209,Ghost,505702588,217631306,288071282,1990_boxofficemojo_rankings.csv,1990,0.43035434495344127,0.5696456550465587
210,Aladdin,504050219,217350219,286700000,1992_boxofficemojo_rankings.csv,1992,0.4312074686351838,0.5687925313648162
211,Star Wars: Episode IV - A New Hope,503015849,307263857,195751992,1977_boxofficemojo_rankings.csv,1977,0.6108432917389051,0.389156708261095
212,Rio 2,498781117,131538435,367242682,2014_boxofficemojo_rankings.csv,2014,0.2637197570572825,0.7362802429427175
213,Troy,497409852,133378256,364031596,2004_boxofficemojo_rankings.csv,2004,0.268145585504004,0.731854414495996
214,How to Train Your Dragon,494878759,217581231,277297528,2010_boxofficemojo_rankings.csv,2010,0.4396657303289107,0.5603342696710892
215,Twister,494471524,241721524,252750000,1996_boxofficemojo_rankings.csv,1996,0.48884821929604183,0.5111517807039582
216,Oz the Great and Powerful,493311825,234911825,258400000,2013_boxofficemojo_rankings.csv,2013,0.47619337930932426,0.5238066206906757
217,Clash of the Titans,493214993,163214888,330000105,2010_boxofficemojo_rankings.csv,2010,0.33092037005452507,0.6690796299454749
218,Maleficent: Mistress of Evil,491730089,113929605,377800484,2019_boxofficemojo_rankings.csv,2019,0.23169134358178353,0.7683086564182164
219,War for the Planet of the Apes,490719763,146880162,343839601,2017_boxofficemojo_rankings.csv,2017,0.2993157665019495,0.7006842334980505
220,Mr. & Mrs. Smith,487287646,186336279,300951367,2005_boxofficemojo_rankings.csv,2005,0.38239483502112015,0.6176051649788799
221,Toy Story 2,487059677,245852179,241207498,1999_boxofficemojo_rankings.csv,1999,0.5047680820434659,0.4952319179565341
222,Angels & Demons,485930816,133375846,352554970,2009_boxofficemojo_rankings.csv,2009,0.2744749697043293,0.7255250302956707
223,Teenage Mutant Ninja Turtles,485004754,191204754,293800000,2014_boxofficemojo_rankings.csv,2014,0.39423274189184543,0.6057672581081546
224,Bruce Almighty,484592874,242829261,241763613,2003_boxofficemojo_rankings.csv,2003,0.5010995291688916,0.49890047083110844
225,Shrek,484409218,267665011,216744207,2001_boxofficemojo_rankings.csv,2001,0.5525596975737155,0.4474403024262845
226,Rio,483866518,143619809,340246709,2011_boxofficemojo_rankings.csv,2011,0.29681700150205476,0.7031829984979453
227,Saving Private Ryan,481840909,216540909,265300000,1998_boxofficemojo_rankings.csv,1998,0.44940332992772103,0.550596670072279
228,Rise of the Planet of the Apes,481800873,176760185,305040688,2011_boxofficemojo_rankings.csv,2011,0.3668739408863628,0.6331260591136372
229,Home Alone,476684675,285761243,190923432,1990_boxofficemojo_rankings.csv,1990,0.5994764631357197,0.4005235368642803
230,Charlie and the Chocolate Factory,474968763,206459076,268509687,2005_boxofficemojo_rankings.csv,2005,0.43467927173981336,0.5653207282601866
231,Hotel Transylvania 2,474800000,169700110,305099890,2015_boxofficemojo_rankings.csv,2015,0.3574138795282224,0.6425861204717775
232,Indiana Jones and the Last Crusade,474171806,197171806,277000000,1989_boxofficemojo_rankings.csv,1989,0.41582355489098816,0.5841764451090118
233,San Andreas,473990832,155190832,318800000,2015_boxofficemojo_rankings.csv,2015,0.32741315131597315,0.6725868486840269
234,It Chapter Two,473093228,211593228,261500000,2019_boxofficemojo_rankings.csv,2019,0.44725482310222375,0.5527451768977762
235,Wreck-It Ralph,471222889,189422889,281800000,2012_boxofficemojo_rankings.csv,2012,0.40198151113156133,0.5980184888684387
236,The Hangover,468812793,277322503,191490290,2009_boxofficemojo_rankings.csv,2009,0.5915420977003928,0.40845790229960727
237,The Lego Movie,468060692,257760692,210300000,2014_boxofficemojo_rankings.csv,2014,0.5506992926464331,0.44930070735356686
238,Bumblebee,467989645,127195589,340794056,2018_boxofficemojo_rankings.csv,2018,0.2717914602576303,0.7282085397423698
239,Star Trek Into Darkness,467365246,228778661,238586585,2013_boxofficemojo_rankings.csv,2013,0.4895072172311246,0.5104927827688753
240,The Matrix,463517383,171479930,292037453,1999_boxofficemojo_rankings.csv,1999,0.3699536118583928,0.6300463881416072
241,Pretty Woman,463406268,178406268,285000000,1990_boxofficemojo_rankings.csv,1990,0.3849888970427133,0.6150111029572867
242,Cars,461983149,244082982,217900167,2006_boxofficemojo_rankings.csv,2006,0.5283374134496841,0.47166258655031595
243,Gladiator,460583960,187705427,272878533,2000_boxofficemojo_rankings.csv,2000,0.4075379155626696,0.5924620844373304
244,X-Men: The Last Stand,460435291,234362462,226072829,2006_boxofficemojo_rankings.csv,2006,0.5090019522417538,0.49099804775824624
245,National Treasure: Book of Secrets,459242249,219964115,239278134,2007_boxofficemojo_rankings.csv,2007,0.47897186175481865,0.5210281382451813
246,Lucy,458863600,126663600,332200000,2014_boxofficemojo_rankings.csv,2014,0.27603758502526676,0.7239624149747332
247,Mission: Impossible,457696391,180981856,276714535,1996_boxofficemojo_rankings.csv,1996,0.39541901478528374,0.6045809852147163
248,300,456068181,210614939,245453242,2007_boxofficemojo_rankings.csv,2007,0.4618058171438187,0.5381941828561814
249,The Last Samurai,454627263,111127263,343500000,2003_boxofficemojo_rankings.csv,2003,0.24443598535356645,0.7555640146464335
250,Ocean's Eleven,450717150,183417150,267300000,2001_boxofficemojo_rankings.csv,2001,0.4069451317749946,0.5930548682250054
251,"My People, My Country",450064993,2356683,447708310,2019_boxofficemojo_rankings.csv,2019,0.005236317057878794,0.9947636829421213
252,Thor,449326618,181030624,268295994,2011_boxofficemojo_rankings.csv,2011,0.40289316668081304,0.597106833319187
253,Pearl Harbor,449220945,198542554,250678391,2001_boxofficemojo_rankings.csv,2001,0.44197083018914,0.55802916981086
254,Tarzan,448191819,171091819,277100000,1999_boxofficemojo_rankings.csv,1999,0.3817379339536762,0.6182620660463238
255,La La Land,447403498,151101803,296301695,2016_boxofficemojo_rankings.csv,2016,0.33773049087783397,0.6622695091221661
256,The Bourne Ultimatum,444100035,227471070,216628965,2007_boxofficemojo_rankings.csv,2007,0.5122068274549899,0.48779317254501003
257,Alvin and the Chipmunks: The Squeakquel,443140005,219614612,223525393,2009_boxofficemojo_rankings.csv,2009,0.4955874205038202,0.5044125794961798
258,Men in Black II,441818803,190418803,251400000,2002_boxofficemojo_rankings.csv,2002,0.43098845433248795,0.569011545667512
259,Les Misérables,441809770,148809770,293000000,2012_boxofficemojo_rankings.csv,2012,0.33681864934765926,0.6631813506523407
260,The Eight Hundred,441656664,331279,441325385,2020_boxofficemojo_rankings.csv,2020,0.0007500826479095083,0.9992499173520905
261,Mrs. Doubtfire,441286195,219195243,222090952,1993_boxofficemojo_rankings.csv,1993,0.4967190124766989,0.5032809875233011
262,Terminator Genisys,440603537,89760956,350842581,2015_boxofficemojo_rankings.csv,2015,0.20372273134974855,0.7962772686502514
263,Warcraft,439048914,47365290,391683624,2016_boxofficemojo_rankings.csv,2016,0.10788157877097038,0.8921184212290296
264,A Star Is Born,436188866,215288866,220900000,2018_boxofficemojo_rankings.csv,2018,0.4935679995096436,0.5064320004903564
265,The Greatest Showman,434993183,174340174,260653009,2017_boxofficemojo_rankings.csv,2017,0.4007882900546513,0.5992117099453488
266,Terminator 3: Rise of the Machines,433371112,150371112,283000000,2003_boxofficemojo_rankings.csv,2003,0.34698000821060726,0.6530199917893927
267,The Mummy Returns,433013274,202019785,230993489,2001_boxofficemojo_rankings.csv,2001,0.46654409259518453,0.5334559074048155
268,Pokémon Detective Pikachu,433005346,144105346,288900000,2019_boxofficemojo_rankings.csv,2019,0.3328026947731957,0.6671973052268043
269,Die Another Day,431971116,160942139,271028977,2002_boxofficemojo_rankings.csv,2002,0.37257615854111875,0.6274238414588812
270,The Secret Life of Pets 2,430051293,158874395,271176898,2019_boxofficemojo_rankings.csv,2019,0.36943126921374003,0.63056873078626
271,Cast Away,429632142,233632142,196000000,2000_boxofficemojo_rankings.csv,2000,0.5437957712204875,0.4562042287795125
272,Rampage,428028233,101028233,327000000,2018_boxofficemojo_rankings.csv,2018,0.2360317035441912,0.7639682964558088
273,The Matrix Revolutions,427343298,139313948,288029350,2003_boxofficemojo_rankings.csv,2003,0.32600007687496246,0.6739999231250375
274,The Intouchables,426588510,10198820,416389690,2011_boxofficemojo_rankings.csv,2011,0.023907863810021513,0.9760921361899785
275,Bad Boys for Life,426505244,206305244,220200000,2020_boxofficemojo_rankings.csv,2020,0.4837109200936343,0.5162890799063657
276,Django Unchained,425368238,162805434,262562804,2012_boxofficemojo_rankings.csv,2012,0.38273998727662406,0.6172600127233759
277,Dances with Wolves,424208848,184208848,240000000,1990_boxofficemojo_rankings.csv,1990,0.43424093785049955,0.5657590621495004
278,The King's Speech,423999102,135453143,288545959,2010_boxofficemojo_rankings.csv,2010,0.3194656365097679,0.6805343634902321
279,The Chronicles of Narnia: Prince Caspian,419665568,141621490,278044078,2008_boxofficemojo_rankings.csv,2008,0.33746273413595845,0.6625372658640415
280,Sex and the City,418765321,152647258,266118063,2008_boxofficemojo_rankings.csv,2008,0.3645174286053166,0.6354825713946833
281,The Captain,416953262,706572,416246690,2019_boxofficemojo_rankings.csv,2019,0.001694607200362903,0.9983053927996371
282,The Mummy,415933406,155385488,260547918,1999_boxofficemojo_rankings.csv,1999,0.3735826114433328,0.6264173885566672
283,The Chronicles of Narnia: The Voyage of the Dawn Treader,415686217,104386950,311299267,2010_boxofficemojo_rankings.csv,2010,0.25111958427045944,0.7488804157295406
284,Jason Bourne,415484914,162434410,253050504,2016_boxofficemojo_rankings.csv,2016,0.39095140287091146,0.6090485971290885
285,The Wolverine,414828246,132556852,282271394,2013_boxofficemojo_rankings.csv,2013,0.3195463502743253,0.6804536497256747
286,Kingsman: The Secret Service,414351546,128261724,286089822,2015_boxofficemojo_rankings.csv,2015,0.3095480763573644,0.6904519236426355
287,Night at the Museum: Battle of the Smithsonian,413106170,177243721,235862449,2009_boxofficemojo_rankings.csv,2009,0.4290512557582957,0.5709487442417043
288,Batman,411348924,251188924,160160000,1989_boxofficemojo_rankings.csv,1989,0.6106468483189712,0.38935315168102885
289,Pacific Rim,411002906,101802906,309200000,2013_boxofficemojo_rankings.csv,2013,0.24769388370212642,0.7523061162978736
290,The Bodyguard,410945720,121945720,289000000,1992_boxofficemojo_rankings.csv,1992,0.29674410527988954,0.7032558947201105
291,Kingsman: The Golden Circle,410902662,100234838,310667824,2017_boxofficemojo_rankings.csv,2017,0.24393815681826855,0.7560618431817314
292,The Mummy,409231607,80227895,329003712,2017_boxofficemojo_rankings.csv,2017,0.196045206742792,0.803954793257208
293,Ice Age: Collision Course,408579038,64063008,344516030,2016_boxofficemojo_rankings.csv,2016,0.15679465180981703,0.843205348190183
294,Signs,408247917,227966634,180281283,2002_boxofficemojo_rankings.csv,2002,0.5584024425040728,0.44159755749592716
295,X2: X-Men United,407711549,214949694,192761855,2003_boxofficemojo_rankings.csv,2003,0.5272102164562427,0.4727897835437573
296,Twilight,407187715,192769854,214417861,2008_boxofficemojo_rankings.csv,2008,0.47341765701354716,0.5265823429864528
297,Alita: Battle Angel,404852543,85710210,319142333,2019_boxofficemojo_rankings.csv,2019,0.21170722892062951,0.7882927710793705
298,The Mummy: Tomb of the Dragon Emperor,403449830,102491776,300958054,2008_boxofficemojo_rankings.csv,2008,0.2540384661954127,0.7459615338045873
299,Prometheus,403354469,126477084,276877385,2012_boxofficemojo_rankings.csv,2012,0.3135631156227502,0.6864368843772498
300,Star Wars: Episode V - The Empire Strikes Back,400083259,209398025,190685234,1980_boxofficemojo_rankings.csv,1980,0.5233861209873818,0.4766138790126182
301,TRON: Legacy,400062763,172062763,228000000,2010_boxofficemojo_rankings.csv,2010,0.4300894232438224,0.5699105767561776
302,Mission: Impossible III,398479497,134029801,264449696,2006_boxofficemojo_rankings.csv,2006,0.33635306711903423,0.6636469328809658
303,Snow White and the Huntsman,396592829,155332381,241260448,2012_boxofficemojo_rankings.csv,2012,0.39166714484391246,0.6083328551560876
304,Mamma Mia! Here We Go Again,395044706,120634935,274409771,2018_boxofficemojo_rankings.csv,2018,0.3053703369967449,0.6946296630032551
305,Solo: A Star Wars Story,392924807,213767512,179157295,2018_boxofficemojo_rankings.csv,2018,0.5440417815106289,0.4559582184893712
306,The Wolf of Wall Street,392000694,116900694,275100000,2013_boxofficemojo_rankings.csv,2013,0.2982155281592435,0.7017844718407565
307,Superman Returns,391081192,200081192,191000000,2006_boxofficemojo_rankings.csv,2006,0.5116103665757468,0.48838963342425323
308,Robin Hood: Prince of Thieves,390493908,165493908,225000000,1991_boxofficemojo_rankings.csv,1991,0.4238066320870747,0.5761933679129253
309,Independence Day: Resurgence,389681935,103144286,286537649,2016_boxofficemojo_rankings.csv,2016,0.26468839516514925,0.7353116048348508
310,Live Free or Die Hard,388156011,134529403,253626608,2007_boxofficemojo_rankings.csv,2007,0.34658590666524547,0.6534140933347545
311,Monster Hunt,387053506,32766,387020740,2015_boxofficemojo_rankings.csv,2015,8.465496240718718e-05,0.9999153450375928
312,Godzilla: King of the Monsters,386600138,110500138,276100000,2019_boxofficemojo_rankings.csv,2019,0.2858253971963145,0.7141746028036855
313,Home,386041607,177397510,208644097,2015_boxofficemojo_rankings.csv,2015,0.45952950869360565,0.5404704913063944
314,Star Trek,385680446,257730019,127950427,2009_boxofficemojo_rankings.csv,2009,0.6682475652395403,0.3317524347604597
315,1917,384792488,159227644,225564844,2019_boxofficemojo_rankings.csv,2019,0.4138013317973089,0.5861986682026911
316,Happy Feet,384335608,198000317,186335291,2006_boxofficemojo_rankings.csv,2006,0.515175572803028,0.48482442719697205
317,Cars 3,383930656,152901115,231029541,2017_boxofficemojo_rankings.csv,2017,0.3982519046356121,0.6017480953643879
318,Ice Age,383257136,176387405,206869731,2002_boxofficemojo_rankings.csv,2002,0.4602325395449388,0.5397674604550612
319,Fifty Shades Darker,381545846,114581250,266964596,2017_boxofficemojo_rankings.csv,2017,0.3003079477898444,0.6996920522101556
320,Monsters vs. Aliens,381509870,198351526,183158344,2009_boxofficemojo_rankings.csv,2009,0.5199119121085911,0.48008808789140894
321,Back to the Future,381109762,210609762,170500000,1985_boxofficemojo_rankings.csv,1985,0.552622323014649,0.447377676985351
322,Godzilla,379014294,136314294,242700000,1998_boxofficemojo_rankings.csv,1998,0.3596547575063224,0.6403452424936775
323,True Lies,378882411,146282411,232600000,1994_boxofficemojo_rankings.csv,1994,0.3860892106706954,0.6139107893293047
324,Slumdog Millionaire,378410113,141319928,237090185,2008_boxofficemojo_rankings.csv,2008,0.37345705927262046,0.6265429407273796
325,Taken 2,376141306,139854287,236287019,2012_boxofficemojo_rankings.csv,2012,0.3718131584304118,0.6281868415695883
326,G.I. Joe: Retaliation,375740705,122523060,253217645,2013_boxofficemojo_rankings.csv,2013,0.3260840743884802,0.6739159256115198
327,Spider-Man: Into the Spider-Verse,375540831,190241310,185299521,2018_boxofficemojo_rankings.csv,2018,0.5065795628491859,0.49342043715081413
328,Mad Max: Fury Road,374736354,153636354,221100000,2015_boxofficemojo_rankings.csv,2015,0.4099851865453118,0.5900148134546882
329,Star Wars: Episode VI - Return of the Jedi,374593074,252583617,122009457,1983_boxofficemojo_rankings.csv,1983,0.6742880061898848,0.3257119938101151
330,Shark Tale,374583879,160861908,213721971,2004_boxofficemojo_rankings.csv,2004,0.42944162047080514,0.5705583795291949
331,Once Upon a Time... In Hollywood,374343626,142502728,231840898,2019_boxofficemojo_rankings.csv,2019,0.38067357930651663,0.6193264206934834
332,What Women Want,374111707,182811707,191300000,2000_boxofficemojo_rankings.csv,2000,0.4886554031307018,0.5113445968692982
333,The Adventures of Tintin,373993951,77591831,296402120,2011_boxofficemojo_rankings.csv,2011,0.20746814431766036,0.7925318556823396
334,Penguins of Madagascar,373515621,83850911,289664710,2014_boxofficemojo_rankings.csv,2014,0.22449104210289508,0.775508957897105
335,X-Men Origins: Wolverine,373062864,179883157,193179707,2009_boxofficemojo_rankings.csv,2009,0.48217920988243956,0.5178207901175604
336,The Golden Compass,372234864,70107728,302127136,2007_boxofficemojo_rankings.csv,2007,0.188342723318899,0.811657276681101
337,Fifty Shades Freed,371985018,100407760,271577258,2018_boxofficemojo_rankings.csv,2018,0.26992420431298125,0.7300757956870187
338,Batman Begins,371853783,205343774,166510009,2005_boxofficemojo_rankings.csv,2005,0.552216444709398,0.44778355529060193
339,Hitch,371594210,179495555,192098655,2005_boxofficemojo_rankings.csv,2005,0.48304185094810814,0.5169581490518919
340,Terminator Salvation,371353001,125322469,246030532,2009_boxofficemojo_rankings.csv,2009,0.33747530964479805,0.6625246903552019
341,Captain America: The First Avenger,370569774,176654505,193915269,2011_boxofficemojo_rankings.csv,2011,0.4767105074252494,0.5232894925747505
342,Edge of Tomorrow,370541256,100206256,270335000,2014_boxofficemojo_rankings.csv,2014,0.2704321162013873,0.7295678837986127
343,There's Something About Mary,369884651,176484651,193400000,1998_boxofficemojo_rankings.csv,1998,0.47713429179303796,0.5228657082069621
344,Gone Girl,369330363,167767189,201563174,2014_boxofficemojo_rankings.csv,2014,0.4542469447604014,0.5457530552395986
345,The Fugitive,368875760,183875760,185000000,1993_boxofficemojo_rankings.csv,1993,0.49847612648768247,0.5015238735123175
346,Jurassic Park III,368780809,181171875,187608934,2001_boxofficemojo_rankings.csv,2001,0.49127251358679025,0.5087274864132098
347,My Big Fat Greek Wedding,368744044,241438208,127305836,2002_boxofficemojo_rankings.csv,2002,0.6547582582784713,0.34524174172152866
348,Grease,366178870,159978870,206200000,1978_boxofficemojo_rankings.csv,1978,0.43688722399520213,0.5631127760047979
349,Die Hard with a Vengeance,366101666,100012499,266089167,1995_boxofficemojo_rankings.csv,1995,0.2731823105115288,0.7268176894884713
350,Shazam!,365971656,140371656,225600000,2019_boxofficemojo_rankings.csv,2019,0.3835588185550632,0.6164411814449369
351,The Nun,365550119,117450119,248100000,2018_boxofficemojo_rankings.csv,2018,0.32129689718415877,0.6787031028158412
352,Alvin and the Chipmunks,365352546,217326974,148025572,2007_boxofficemojo_rankings.csv,2007,0.5948418216305519,0.4051581783694481
353,Notting Hill,363889678,116089678,247800000,1999_boxofficemojo_rankings.csv,1999,0.31902437749278506,0.680975622507215
354,A Bug's Life,363258859,162798565,200460294,1998_boxofficemojo_rankings.csv,1998,0.4481613069208038,0.5518386930791962
355,Night at the Museum: Secret of the Tomb,363204635,113746621,249458014,2014_boxofficemojo_rankings.csv,2014,0.313175025973994,0.6868249740260061
356,Toy Story,363007140,191796233,171210907,1995_boxofficemojo_rankings.csv,1995,0.5283538858216398,0.4716461141783602
357,Ocean's Twelve,362744280,125544280,237200000,2004_boxofficemojo_rankings.csv,2004,0.34609582265501193,0.6539041773449881
358,Planet of the Apes,362211740,180011740,182200000,2001_boxofficemojo_rankings.csv,2001,0.4969793082907804,0.5030206917092196
359,The Hangover Part III,362000072,112200072,249800000,2013_boxofficemojo_rankings.csv,2013,0.3099448886297459,0.6900551113702541
360,The World Is Not Enough,361832400,126943684,234888716,1999_boxofficemojo_rankings.csv,1999,0.3508355912848048,0.6491644087151952
361,Monster Hunt 2,361682618,706153,360976465,2018_boxofficemojo_rankings.csv,2018,0.0019524106629862981,0.9980475893370137
362,Fast & Furious,360364265,155064265,205300000,2009_boxofficemojo_rankings.csv,2009,0.43029867292751683,0.5697013270724832
363,Noah,359200044,101200044,258000000,2014_boxofficemojo_rankings.csv,2014,0.28173728174710355,0.7182627182528964
364,The Karate Kid,359126022,176591618,182534404,2010_boxofficemojo_rankings.csv,2010,0.4917260437340294,0.5082739562659706
365,Home Alone 2: Lost in New York,358994850,173585516,185409334,1992_boxofficemojo_rankings.csv,1992,0.4835320506686934,0.5164679493313066
366,Hotel Transylvania,358375603,148313048,210062555,2012_boxofficemojo_rankings.csv,2012,0.4138480598524448,0.5861519401475552
367,Minority Report,358372926,132072926,226300000,2002_boxofficemojo_rankings.csv,2002,0.3685348875936013,0.6314651124063987
368,Your Name.,357986087,5017246,352968841,2016_boxofficemojo_rankings.csv,2016,0.014015198305737508,0.9859848016942625
369,The Legend of Tarzan,356700357,126643061,230057296,2016_boxofficemojo_rankings.csv,2016,0.3550404660794887,0.6449595339205113
370,American Beauty,356296601,130096601,226200000,1999_boxofficemojo_rankings.csv,1999,0.3651356780695194,0.6348643219304806
371,Rain Man,354825435,172825435,182000000,1988_boxofficemojo_rankings.csv,1988,0.48707172021081296,0.5129282797891871
372,Raiders of the Lost Ark,353988025,212222025,141766000,1981_boxofficemojo_rankings.csv,1981,0.5995175260519053,0.4004824739480947
373,Top Gun,353811728,176781728,177030000,1986_boxofficemojo_rankings.csv,1986,0.4996491467348985,0.5003508532651015
374,The Great Gatsby,353641895,144840419,208801476,2013_boxofficemojo_rankings.csv,2013,0.40956804340164504,0.5904319565983549
375,Dumbo,353284621,114766307,238518314,2019_boxofficemojo_rankings.csv,2019,0.32485508900768145,0.6751449109923185
376,Apollo 13,353148882,172071312,181077570,1995_boxofficemojo_rankings.csv,1995,0.48724863866339524,0.5127513613366048
377,"I, Robot",353133898,144801023,208332875,2004_boxofficemojo_rankings.csv,2004,0.4100456620564928,0.5899543379435072
378,Basic Instinct,352927224,117727224,235200000,1992_boxofficemojo_rankings.csv,1992,0.33357365483372287,0.6664263451662771
379,Murder on the Orient Express,352789811,102826543,249963268,2017_boxofficemojo_rankings.csv,2017,0.29146687289106543,0.7085331271089346
380,X-Men: First Class,352616690,146408305,206208385,2011_boxofficemojo_rankings.csv,2011,0.41520526155469273,0.5847947384453073
381,The Angry Birds Movie,352333929,107509366,244824563,2016_boxofficemojo_rankings.csv,2016,0.3051348653964007,0.6948651346035993
382,GoldenEye,352194034,106429941,245764093,1995_boxofficemojo_rankings.csv,1995,0.3021912091787449,0.6978087908212551
383,Catch Me If You Can,352114312,164615351,187498961,2002_boxofficemojo_rankings.csv,2002,0.4675054247723961,0.5324945752276039
384,Now You See Me,351723989,117723989,234000000,2013_boxofficemojo_rankings.csv,2013,0.3347056006464205,0.6652943993535795
385,Hannibal,351692268,165092268,186600000,2001_boxofficemojo_rankings.csv,2001,0.46942251229702897,0.5305774877029711
386,The Mask,351583407,119938730,231644677,1994_boxofficemojo_rankings.csv,1994,0.3411387671091088,0.6588612328908913
387,Peter Rabbit,351266433,115253424,236013009,2018_boxofficemojo_rankings.csv,2018,0.3281082767165515,0.6718917232834485
388,Speed,350448145,121248145,229200000,1994_boxofficemojo_rankings.csv,1994,0.34598027334400644,0.6540197266559936
389,Dinosaur,349822765,137748063,212074702,2000_boxofficemojo_rankings.csv,2000,0.39376529140406286,0.6062347085959372
390,Mary Poppins Returns,349537494,171958438,177579056,2018_boxofficemojo_rankings.csv,2018,0.4919599211865952,0.5080400788134047
391,Deep Impact,349464664,140464664,209000000,1998_boxofficemojo_rankings.csv,1998,0.40194239495412903,0.5980576050458709
392,The Lorax,348840316,214030500,134809816,2012_boxofficemojo_rankings.csv,2012,0.6135486358176558,0.3864513641823441
393,The Maze Runner,348319861,102427862,245891999,2014_boxofficemojo_rankings.csv,2014,0.2940626517992323,0.7059373482007677
394,The Smurfs 2,347545360,71017784,276527576,2013_boxofficemojo_rankings.csv,2013,0.2043410506185437,0.7956589493814563
395,National Treasure,347512318,173008894,174503424,2004_boxofficemojo_rankings.csv,2004,0.4978496733459675,0.5021503266540325
396,Rush Hour 2,347325802,226164286,121161516,2001_boxofficemojo_rankings.csv,2001,0.6511588966258257,0.3488411033741743
397,Trolls,346864462,153707064,193157398,2016_boxofficemojo_rankings.csv,2016,0.44313292608223437,0.5568670739177656
398,xXx: Return of Xander Cage,346118277,44898413,301219864,2017_boxofficemojo_rankings.csv,2017,0.12971985585147242,0.8702801441485276
399,Pocahontas,346079773,141579773,204500000,1995_boxofficemojo_rankings.csv,1995,0.40909577515239526,0.5909042248476047
400,How the Grinch Stole Christmas,345141403,260044825,85096578,2000_boxofficemojo_rankings.csv,2000,0.7534443064195344,0.24655569358046564
401,Titanic 2012 3D Release,343550770,57884114,285666656,2012_boxofficemojo_rankings.csv,2012,0.1684878016719334,0.8315121983280667
402,Star Trek Beyond,343471816,158848340,184623476,2016_boxofficemojo_rankings.csv,2016,0.462478528369268,0.537521471630732
403,Alvin and the Chipmunks: Chipwrecked,342695435,133110742,209584693,2011_boxofficemojo_rankings.csv,2011,0.3884228630007867,0.6115771369992133
404,Wanted,342463063,134508551,207954512,2008_boxofficemojo_rankings.csv,2008,0.39276805452154706,0.6072319454784529
405,The Flintstones,341631208,130531208,211100000,1994_boxofficemojo_rankings.csv,1994,0.38208221305121515,0.6179177869487849
406,A Quiet Place,340939361,188024361,152915000,2018_boxofficemojo_rankings.csv,2018,0.5514891576276522,0.44851084237234784
407,Enchanted,340487652,127807262,212680390,2007_boxofficemojo_rankings.csv,2007,0.37536533630300345,0.6246346636969966
408,Over the Hedge,339795890,155019340,184776550,2006_boxofficemojo_rankings.csv,2006,0.4562131107589324,0.5437868892410677
409,300: Rise of an Empire,337580051,106580051,231000000,2014_boxofficemojo_rankings.csv,2014,0.31571785916935,0.68428214083065
410,Batman Forever,336529144,184031112,152498032,1995_boxofficemojo_rankings.csv,1995,0.5468504445487193,0.4531495554512806
411,Prince of Persia: The Sands of Time,336365676,90759676,245606000,2009_boxofficemojo_rankings.csv,2009,0.2698244276267951,0.730175572373205
412,The Curious Case of Benjamin Button,335802786,127509326,208293460,2008_boxofficemojo_rankings.csv,2008,0.3797149139793021,0.6202850860206979
413,Journey 2: The Mysterious Island,335260290,103860290,231400000,2012_boxofficemojo_rankings.csv,2012,0.30979001420060814,0.6902099857993919
414,The Rock,335062621,134069511,200993110,1996_boxofficemojo_rankings.csv,1996,0.4001326993738284,0.5998673006261717
415,The Great Wall,334933831,45540830,289393001,2016_boxofficemojo_rankings.csv,2016,0.13596963276008986,0.8640303672399101
416,Now You See Me 2,334897606,65075540,269822066,2016_boxofficemojo_rankings.csv,2016,0.19431473630778956,0.8056852636922105
417,Fantastic Four,333535934,154696080,178839854,2005_boxofficemojo_rankings.csv,2005,0.46380633758040596,0.5361936624195941
418,Indiana Jones and the Temple of Doom,333107271,179870271,153237000,1984_boxofficemojo_rankings.csv,1984,0.5399770183941737,0.46002298160582633
419,Tomorrow Never Dies,333011068,125304276,207706792,1997_boxofficemojo_rankings.csv,1997,0.37627661072213975,0.6237233892778603
420,The Good Dinosaur,332207671,123087120,209120551,2015_boxofficemojo_rankings.csv,2015,0.3705125761530052,0.6294874238469947
421,Back to the Future Part II,331950002,118450002,213500000,1989_boxofficemojo_rankings.csv,1989,0.3568308518943766,0.6431691481056234
422,Beauty and the Beast,331907151,145863363,186043788,1991_boxofficemojo_rankings.csv,1991,0.43947038369173314,0.5605296163082669
423,22 Jump Street,331333876,191719337,139614539,2014_boxofficemojo_rankings.csv,2014,0.5786288420445123,0.4213711579554878
424,Meet the Parents,330444045,166244045,164200000,2000_boxofficemojo_rankings.csv,2000,0.5030928761327806,0.49690712386721936
425,Who Framed Roger Rabbit,329803958,156452370,173351588,1988_boxofficemojo_rankings.csv,1988,0.4743799041975112,0.5256200958024888
426,Black Swan,329398046,106954678,222443368,2010_boxofficemojo_rankings.csv,2010,0.32469736629828094,0.6753026337017191
427,The Perfect Storm,328718434,182618434,146100000,2000_boxofficemojo_rankings.csv,2000,0.5555466779815579,0.44445332201844207
428,Crocodile Dundee,328203506,174803506,153400000,1986_boxofficemojo_rankings.csv,1986,0.5326070648373878,0.4673929351626122
429,Se7en,327333559,100125643,227207916,1995_boxofficemojo_rankings.csv,1995,0.30588260887726454,0.6941173911227354
430,John Wick: Chapter 3 - Parabellum,326709727,171015687,155694040,2019_boxofficemojo_rankings.csv,2019,0.5234484096030603,0.47655159039693973
431,The Devil Wears Prada,326705902,124740460,201965442,2006_boxofficemojo_rankings.csv,2006,0.38181269219923675,0.6181873078007633
432,Taken 3,326479141,89256424,237222717,2015_boxofficemojo_rankings.csv,2015,0.27339089329446625,0.7266091067055338
433,The Hunchback of Notre Dame,325338851,100138851,225200000,1996_boxofficemojo_rankings.csv,1996,0.3077986250095904,0.6922013749904096
434,A Christmas Carol,325286646,137855863,187430783,2009_boxofficemojo_rankings.csv,2009,0.4237981014443489,0.5762018985556512
435,The SpongeBob Movie: Sponge Out of Water,325186032,162994032,162192000,2015_boxofficemojo_rankings.csv,2015,0.5012331894993571,0.4987668105006429
436,Tenet,323300000,48300000,275000000,2020_boxofficemojo_rankings.csv,2020,0.14939684503557069,0.8506031549644293
437,Megamind,321885765,148415853,173469912,2010_boxofficemojo_rankings.csv,2010,0.4610823749848024,0.5389176250151976
438,Green Book,321752656,85080171,236672485,2018_boxofficemojo_rankings.csv,2018,0.26442725308847176,0.7355727469115282
439,Lethal Weapon 3,321731527,144731527,177000000,1992_boxofficemojo_rankings.csv,1992,0.4498518636005479,0.550148136399452
440,Robin Hood,321669741,105269730,216400011,2010_boxofficemojo_rankings.csv,2010,0.327260281532045,0.672739718467955
441,Inglourious Basterds,321455689,120540719,200914970,2009_boxofficemojo_rankings.csv,2009,0.37498393441094147,0.6250160655890585
442,Schindler's List,321306305,96065768,225240537,1993_boxofficemojo_rankings.csv,1993,0.29898500746818524,0.7010149925318148
443,101 Dalmatians,320689294,136189294,184500000,1996_boxofficemojo_rankings.csv,1996,0.4246767714047853,0.5753232285952147
444,The Conjuring 2,320392818,102470008,217922810,2016_boxofficemojo_rankings.csv,2016,0.31982617038562955,0.6801738296143705
445,Fatal Attraction,320145693,156645693,163500000,1987_boxofficemojo_rankings.csv,1987,0.48929501918990365,0.5107049808100964
446,The Last Airbender,319713881,131772187,187941694,2010_boxofficemojo_rankings.csv,2010,0.4121566026093187,0.5878433973906814
447,The Conjuring,319494638,137400141,182094497,2013_boxofficemojo_rankings.csv,2013,0.4300546070510266,0.5699453929489734
448,The Proposal,317375031,163958031,153417000,2009_boxofficemojo_rankings.csv,2009,0.5166065852231456,0.4833934147768543
449,Beverly Hills Cop,316360478,234760478,81600000,1984_boxofficemojo_rankings.csv,1984,0.7420663904800396,0.2579336095199603
450,Air Force One,315156409,172956409,142200000,1997_boxofficemojo_rankings.csv,1997,0.5487954680940663,0.45120453190593374
451,The Expendables 2,314975955,85028192,229947763,2012_boxofficemojo_rankings.csv,2012,0.26995137454222495,0.730048625457775
452,Chicken Little,314432837,135386665,179046172,2005_boxofficemojo_rankings.csv,2005,0.4305741928601433,0.5694258071398567
453,As Good as It Gets,314178011,148478011,165700000,1997_boxofficemojo_rankings.csv,1997,0.4725919886226538,0.5274080113773462
454,A Beautiful Mind,313542341,170742341,142800000,2001_boxofficemojo_rankings.csv,2001,0.5445591190505272,0.45544088094947277
455,Maze Runner: The Scorch Trials,312296056,81697192,230598864,2015_boxofficemojo_rankings.csv,2015,0.2616017411375826,0.7383982588624174
456,Resident Evil: The Final Chapter,312242626,26830068,285412558,2016_boxofficemojo_rankings.csv,2016,0.085926986791355,0.914073013208645
457,Austin Powers: The Spy Who Shagged Me,312016928,206040086,105976842,1999_boxofficemojo_rankings.csv,1999,0.6603490628559743,0.3396509371440257
458,The Lego Batman Movie,311950384,175750384,136200000,2017_boxofficemojo_rankings.csv,2017,0.5633921066114155,0.4366078933885845
459,Knives Out,311390805,165363234,146027571,2019_boxofficemojo_rankings.csv,2019,0.5310472606922353,0.4689527393077647
460,Ocean's Thirteen,311312624,117154724,194157900,2007_boxofficemojo_rankings.csv,2007,0.376325002483677,0.623674997516323
461,Little Fockers,310650585,148438600,162211985,2010_boxofficemojo_rankings.csv,2010,0.47783138731253316,0.5221686126874668
462,Bolt,309979994,114053579,195926415,2008_boxofficemojo_rankings.csv,2008,0.3679385160579105,0.6320614839420895
463,Ransom,309492681,136492681,173000000,1996_boxofficemojo_rankings.csv,1996,0.4410207070454115,0.5589792929545885
464,Runaway Bride,309460292,152257509,157202783,1999_boxofficemojo_rankings.csv,1999,0.4920098407972807,0.5079901592027193
465,The Blind Side,309208309,255959475,53248834,2009_boxofficemojo_rankings.csv,2009,0.8277897700349314,0.17221022996506863
466,The Ex-File 3: The Return of The Exes,307592427,838959,306753468,2017_boxofficemojo_rankings.csv,2017,0.002727502130603495,0.9972724978693965
467,The Fault in Our Stars,307166834,124872350,182294484,2014_boxofficemojo_rankings.csv,2014,0.40652940414784494,0.593470595852155
468,The Pursuit of Happyness,307127625,163566459,143561166,2006_boxofficemojo_rankings.csv,2006,0.5325683712105025,0.4674316287894975
469,Rise of the Guardians,306941670,103412758,203528912,2012_boxofficemojo_rankings.csv,2012,0.33691338813657984,0.6630866118634202
470,Chicago,306776732,170687518,136089214,2002_boxofficemojo_rankings.csv,2002,0.556390039385386,0.443609960614614
471,Sonic the Hedgehog,306766470,146066470,160700000,2020_boxofficemojo_rankings.csv,2020,0.47614874598257106,0.5238512540174289
472,Annabelle: Creation,306515884,102092201,204423683,2017_boxofficemojo_rankings.csv,2017,0.33307311734617967,0.6669268826538203
473,Wonder,305937718,132422809,173514909,2017_boxofficemojo_rankings.csv,2017,0.43284237676114196,0.5671576232388581
474,Skyscraper,304868961,68420120,236448841,2018_boxofficemojo_rankings.csv,2018,0.22442468323300382,0.7755753167669962
475,A Good Day to Die Hard,304654182,67349198,237304984,2013_boxofficemojo_rankings.csv,2013,0.22106769569964413,0.7789323043003559
476,Mulan,304320254,120620254,183700000,1998_boxofficemojo_rankings.csv,1998,0.39635959951584426,0.6036404004841558
477,Dangal,303723636,12391761,291331875,2016_boxofficemojo_rankings.csv,2016,0.04079946217949267,0.9592005378205073
478,Passengers,303144152,100014699,203129453,2016_boxofficemojo_rankings.csv,2016,0.3299245535173642,0.6700754464826357
479,Battleship,303025485,65422625,237602860,2012_boxofficemojo_rankings.csv,2012,0.21589809517176417,0.7841019048282358
480,Liar Liar,302710615,181410615,121300000,1997_boxofficemojo_rankings.csv,1997,0.5992872598801995,0.40071274011980057
481,G.I. Joe: The Rise of Cobra,302469017,150201498,152267519,2009_boxofficemojo_rankings.csv,2009,0.49658473945448767,0.5034152605455123
482,Wrath of the Titans,301970083,83670083,218300000,2012_boxofficemojo_rankings.csv,2012,0.27708070338875257,0.7229192966112474
483,Fantastic 4: Rise of the Silver Surfer,301913131,131921738,169991393,2007_boxofficemojo_rankings.csv,2007,0.436952634564278,0.563047365435722
484,Hook,300854823,119654823,181200000,1991_boxofficemojo_rankings.csv,1991,0.3977161536147287,0.6022838463852713
485,Rocky IV,300473716,127873716,172600000,1985_boxofficemojo_rankings.csv,1985,0.42557371640453234,0.5744262835954677
486,Rambo: First Blood Part II,300400432,150415432,149985000,1985_boxofficemojo_rankings.csv,1985,0.5007164303944809,0.49928356960551906
487,Resident Evil: Afterlife,300228084,60128566,240099518,2010_boxofficemojo_rankings.csv,2010,0.20027628727764188,0.7997237127223581
488,Superman,300218018,134218018,166000000,1978_boxofficemojo_rankings.csv,1978,0.4470684967349295,0.5529315032650706
489,Van Helsing,300157638,120177084,179980554,2004_boxofficemojo_rankings.csv,2004,0.4003798963796483,0.5996201036203517
490,Stuart Little,300135367,140035367,160100000,1999_boxofficemojo_rankings.csv,1999,0.46657402757869587,0.5334259724213042
491,Beverly Hills Cop II,299965036,153665036,146300000,1987_boxofficemojo_rankings.csv,1987,0.5122764907840792,0.4877235092159207
492,Alice Through the Looking Glass,299457024,77041381,222415643,2016_boxofficemojo_rankings.csv,2016,0.257270241889534,0.7427297581104659
493,My Best Friend's Wedding,299288605,127120029,172168576,1997_boxofficemojo_rankings.csv,1997,0.4247406245219393,0.5752593754780607
494,Real Steel,299268508,85468508,213800000,2011_boxofficemojo_rankings.csv,2011,0.28559138604720813,0.7144086139527919
495,Horton Hears a Who!,298572799,154529439,144043360,2008_boxofficemojo_rankings.csv,2008,0.5175603387768757,0.48243966122312437
496,Ocean's 8,297718711,140218711,157500000,2018_boxofficemojo_rankings.csv,2018,0.47097715333048046,0.5290228466695195
497,The Divergent Series: Insurgent,297002527,130179072,166823455,2015_boxofficemojo_rankings.csv,2015,0.4383096444159211,0.5616903555840789
498,Look Who's Talking,296999813,140088813,156911000,1989_boxofficemojo_rankings.csv,1989,0.4716798020340841,0.5283201979659159
499,Austin Powers in Goldmember,296938801,213307889,83630912,2002_boxofficemojo_rankings.csv,2002,0.7183564030084435,0.2816435969915565
500,Miss Peregrine's Home for Peculiar Children,296482446,87242834,209239612,2016_boxofficemojo_rankings.csv,2016,0.29425969455203427,0.7057403054479657
501,X-Men,296339528,157299718,139039810,2000_boxofficemojo_rankings.csv,2000,0.5308090994867212,0.46919090051327883
502,Ferdinand,296069199,84410380,211658819,2017_boxofficemojo_rankings.csv,2017,0.28510355107894897,0.7148964489210511
503,Shutter Island,294804195,128012934,166791261,2010_boxofficemojo_rankings.csv,2010,0.4342303677191568,0.5657696322808432
504,Doctor Dolittle,294456605,144156605,150300000,1998_boxofficemojo_rankings.csv,1998,0.4895682506425692,0.5104317493574307
505,Bee Movie,293514336,126631277,166883059,2007_boxofficemojo_rankings.csv,2007,0.431431318571097,0.568568681428903
506,Salt,293503354,118311368,175191986,2010_boxofficemojo_rankings.csv,2010,0.4031005655901295,0.5968994344098705
507,G-Force,292817841,119436770,173381071,2009_boxofficemojo_rankings.csv,2009,0.4078876122852091,0.5921123877147909
508,The Departed,291465034,132384315,159080719,2006_boxofficemojo_rankings.csv,2006,0.45420307603690124,0.5457969239630988
509,What Lies Beneath,291420351,155464351,135956000,2000_boxofficemojo_rankings.csv,2000,0.533471154181679,0.46652884581832105
510,Pacific Rim: Uprising,290930148,59874525,231055623,2018_boxofficemojo_rankings.csv,2018,0.20580378283793402,0.794196217162066
511,Sex and the City 2,290745055,95347692,195397363,2010_boxofficemojo_rankings.csv,2010,0.3279426093764518,0.6720573906235482
512,The Bourne Supremacy,290633422,176241941,114391481,2004_boxofficemojo_rankings.csv,2004,0.6064063100079384,0.39359368999206157
513,Shakespeare in Love,289317794,100317794,189000000,1998_boxofficemojo_rankings.csv,1998,0.3467391086218499,0.65326089137815
514,Divergent,288885818,150947895,137937923,2014_boxofficemojo_rankings.csv,2014,0.5225174985917792,0.47748250140822074
515,Coming to America,288752301,128152301,160600000,1988_boxofficemojo_rankings.csv,1988,0.4438139559622072,0.5561860440377928
516,Wedding Crashers,288467645,209255921,79211724,2005_boxofficemojo_rankings.csv,2005,0.7254051697894923,0.2745948302105077
517,Bridesmaids,288383523,169106725,119276798,2011_boxofficemojo_rankings.csv,2011,0.5863952393701772,0.4136047606298228
518,Maze Runner: The Death Cure,288175335,58032443,230142892,2018_boxofficemojo_rankings.csv,2018,0.2013789382772818,0.7986210617227182
519,Close Encounters of the Third Kind,288095460,116395460,171700000,1977_boxofficemojo_rankings.csv,1977,0.4040169879803035,0.5959830120196965
520,Casper,287928194,100328194,187600000,1995_boxofficemojo_rankings.csv,1995,0.34844866216887393,0.6515513378311261
521,American Pie 2,287553595,145103595,142450000,2001_boxofficemojo_rankings.csv,2001,0.5046140876798985,0.4953859123201016
522,Pitch Perfect 2,287144079,184296230,102847849,2015_boxofficemojo_rankings.csv,2015,0.6418249355578737,0.35817506444212627
523,The Green Mile,286801374,136801374,150000000,1999_boxofficemojo_rankings.csv,1999,0.4769899533326504,0.5230100466673496
524,Oblivion,286168572,89107235,197061337,2013_boxofficemojo_rankings.csv,2013,0.3113802273158074,0.6886197726841926
525,Elysium,286140700,93050117,193090583,2013_boxofficemojo_rankings.csv,2013,0.3251900795657521,0.6748099204342479
526,The Polar Express,286000505,162775358,123225147,2004_boxofficemojo_rankings.csv,2004,0.5691436034352457,0.43085639656475433
527,Lethal Weapon 4,285444603,130444603,155000000,1998_boxofficemojo_rankings.csv,1998,0.45698745616150255,0.5430125438384974
528,John Carter,284139100,73078100,211061000,2012_boxofficemojo_rankings.csv,2012,0.2571912841280908,0.7428087158719092
529,Turbo,282570682,83028128,199542554,2013_boxofficemojo_rankings.csv,2013,0.29383136074959115,0.7061686392504088
530,Paddington,282370135,76271832,206098303,2014_boxofficemojo_rankings.csv,2014,0.2701129565277858,0.7298870434722142
531,Ghostbusters,282242989,229242989,53000000,1984_boxofficemojo_rankings.csv,1984,0.8122185419457841,0.18778145805421584
532,Bridget Jones's Diary,281929795,71543427,210386368,2001_boxofficemojo_rankings.csv,2001,0.25376327110087815,0.7462367288991218
533,The Tourist,278780441,67631157,211149284,2010_boxofficemojo_rankings.csv,2010,0.24259649191099458,0.7574035080890055
534,Split,278454358,138291365,140162993,2017_boxofficemojo_rankings.csv,2017,0.4966392553281569,0.5033607446718431
535,Scary Movie,278019771,157019771,121000000,2000_boxofficemojo_rankings.csv,2000,0.5647791537818366,0.43522084621816337
536,xXx,277448382,142109382,135339000,2002_boxofficemojo_rankings.csv,2002,0.5122011560334131,0.4877988439665869
537,The Bourne Legacy,276144750,113203870,162940880,2012_boxofficemojo_rankings.csv,2012,0.4099439514964525,0.5900560485035475
538,Mr. Peabody & Sherman,275698039,111506430,164191609,2014_boxofficemojo_rankings.csv,2014,0.4044512989807664,0.5955487010192336
539,Scooby-Doo,275650703,153294164,122356539,2002_boxofficemojo_rankings.csv,2002,0.556117442588202,0.44388255741179805
540,Lincoln,275293450,182207973,93085477,2012_boxofficemojo_rankings.csv,2012,0.6618681737614898,0.33813182623851024
541,Spirited Away,274925095,10055859,264869236,2001_boxofficemojo_rankings.csv,2001,0.03657672283426873,0.9634232771657313
542,Lara Croft: Tomb Raider,274703340,131168070,143535270,2001_boxofficemojo_rankings.csv,2001,0.4774898987394911,0.5225101012605089
543,Tomb Raider,274650803,58250803,216400000,2018_boxofficemojo_rankings.csv,2018,0.21209041577060309,0.7879095842293969
544,The Expendables,274470394,103068524,171401870,2010_boxofficemojo_rankings.csv,2010,0.3755178199656754,0.6244821800343245
545,Cloudy With a Chance of Meatballs 2,274325949,119793567,154532382,2013_boxofficemojo_rankings.csv,2013,0.43668332302023677,0.5633166769797632
546,The Nutty Professor,273961019,128814019,145147000,1996_boxofficemojo_rankings.csv,1996,0.47019104933319,0.52980895066681
547,Jerry Maguire,273552592,153952592,119600000,1996_boxofficemojo_rankings.csv,1996,0.5627897395320605,0.43721026046793954
548,Bad Boys II,273339556,138608444,134731112,2003_boxofficemojo_rankings.csv,2003,0.5070925190205547,0.4929074809794452
549,Lilo & Stitch,273144151,145794338,127349813,2002_boxofficemojo_rankings.csv,2002,0.5337633534023578,0.46623664659764213
550,The Silence of the Lambs,272742922,130742922,142000000,1991_boxofficemojo_rankings.csv,1991,0.4793632078195598,0.5206367921804401
551,Grown Ups,271430189,162001186,109429003,2010_boxofficemojo_rankings.csv,2010,0.5968429178671795,0.40315708213282053
552,Neighbors,270665134,150157400,120507734,2014_boxofficemojo_rankings.csv,2014,0.5547718606416444,0.44522813935835565
553,The Firm,270248367,158348367,111900000,1993_boxofficemojo_rankings.csv,1993,0.5859364434198413,0.4140635565801587
554,We're the Millers,269994119,150394119,119600000,2012_boxofficemojo_rankings.csv,2012,0.5570273884373015,0.4429726115626985
555,Gran Torino,269958228,148095302,121862926,2008_boxofficemojo_rankings.csv,2008,0.5485859908667055,0.4514140091332945
556,"10,000 BC",269784201,94784201,175000000,2008_boxofficemojo_rankings.csv,2008,0.35133340146927283,0.6486665985307272
557,American Gangster,269755430,130164645,139590785,2007_boxofficemojo_rankings.csv,2007,0.4825283591140315,0.5174716408859684
558,Epic,268426634,107518682,160907952,2013_boxofficemojo_rankings.csv,2013,0.4005514668861064,0.5994485331138936
559,Exodus: Gods and Kings,268175631,65014513,203161118,2014_boxofficemojo_rankings.csv,2014,0.24243259075243864,0.7575674092475614
560,The Princess and the Frog,267045765,104400899,162644866,2009_boxofficemojo_rankings.csv,2009,0.3909475928217772,0.6090524071782228
561,Batman Returns,266822354,162831698,103990656,1992_boxofficemojo_rankings.csv,1992,0.6102625794239114,0.3897374205760886
562,Indecent Proposal,266614059,106614059,160000000,1993_boxofficemojo_rankings.csv,1993,0.39988160939404926,0.6001183906059507
563,Something's Gotta Give,265328738,124728738,140600000,2003_boxofficemojo_rankings.csv,2003,0.4700913249736257,0.5299086750263743
564,Bridget Jones: The Edge of Reason,265126918,40226215,224900703,2004_boxofficemojo_rankings.csv,2004,0.15172437149516443,0.8482756285048355
565,The Incredible Hulk,264770996,134806913,129964083,2008_boxofficemojo_rankings.csv,2008,0.5091453181677045,0.4908546818322956
566,Waterworld,264218220,88246220,175972000,1995_boxofficemojo_rankings.csv,1995,0.33398991182364335,0.6660100881763567
567,The Truman Show,264118201,125618201,138500000,1998_boxofficemojo_rankings.csv,1998,0.475613571970377,0.524386428029623
568,Charlie's Angels,264105545,125305545,138800000,2000_boxofficemojo_rankings.csv,2000,0.47445253373987284,0.5255474662601272
569,The Fifth Element,263920180,63820180,200100000,1997_boxofficemojo_rankings.csv,1997,0.2418162188279805,0.7581837811720195
570,Jumanji,262797249,100475249,162322000,1995_boxofficemojo_rankings.csv,1995,0.38232991168031594,0.6176700883196841
571,Borat: Cultural Learnings of America for Make Benefit Glorious Nation of Kazakhstan,262552893,128505958,134046935,2006_boxofficemojo_rankings.csv,2006,0.48944788431639946,0.5105521156836006
572,Robots,262511490,128200012,134311478,2005_boxofficemojo_rankings.csv,2005,0.48835962189693105,0.511640378103069
573,Knight and Day 2010 Re-release,261930436,76423035,185507401,2010_boxofficemojo_rankings.csv,2010,0.2917684411444266,0.7082315588555734
574,Total Recall,261299840,119394840,141905000,1990_boxofficemojo_rankings.csv,1990,0.4569265714054781,0.5430734285945219
575,This Is It,261183588,72091016,189092572,2009_boxofficemojo_rankings.csv,2009,0.27601663853396485,0.7239833614660351
576,Terminator: Dark Fate,261119292,62253077,198866215,2019_boxofficemojo_rankings.csv,2019,0.23840856998034446,0.7615914300196556
577,The Lone Ranger,260502115,89302115,171200000,2013_boxofficemojo_rankings.csv,2013,0.34280763900899613,0.6571923609910039
578,Super 8,260095986,127004179,133091807,2011_boxofficemojo_rankings.csv,2011,0.4882973434276683,0.5117026565723317
579,Mojin: The Lost Legend,259368448,1243810,258124638,2015_boxofficemojo_rankings.csv,2015,0.004795533186827721,0.9952044668131723
580,Blade Runner 2049,259239658,92054159,167185499,2017_boxofficemojo_rankings.csv,2017,0.35509288860425825,0.6449071113957418
581,Charlie's Angels: Full Throttle,259175788,100830111,158345677,2003_boxofficemojo_rankings.csv,2003,0.38904139841951596,0.6109586015804841
582,Rush Hour 3,258097122,140125968,117971154,2007_boxofficemojo_rankings.csv,2007,0.542919529339037,0.457080470660963
583,The Full Monty,257938649,45950122,211988527,1997_boxofficemojo_rankings.csv,1997,0.17814360964571851,0.8218563903542815
584,Kung Fu Yoga,257743016,362657,257380359,2017_boxofficemojo_rankings.csv,2017,0.0014070487946800467,0.99859295120532
585,Parasite,257500210,53369749,204130461,2019_boxofficemojo_rankings.csv,2019,0.2072609921366666,0.7927390078633334
586,Annabelle,257047661,84273813,172773848,2014_boxofficemojo_rankings.csv,2014,0.3278528684997449,0.6721471315002551
587,Star Wars: Episode IV - A New Hope 1997 Special Edition,256905873,138257865,118648008,1997_boxofficemojo_rankings.csv,1997,0.5381654509704417,0.4618345490295584
588,The Village,256697520,114197520,142500000,2003_boxofficemojo_rankings.csv,2003,0.44487192552541993,0.55512807447458
589,Lost in Hong Kong,256283912,1302281,254981631,2015_boxofficemojo_rankings.csv,2015,0.005081399725161055,0.9949186002748389
590,Erin Brockovich,256271286,125595205,130676081,2000_boxofficemojo_rankings.csv,2000,0.4900869190627935,0.5099130809372066
591,Marley & Me,255743093,143153751,112589342,2008_boxofficemojo_rankings.csv,2008,0.5597560791211671,0.4402439208788329
592,Halloween,255485178,159342015,96143163,2018_boxofficemojo_rankings.csv,2018,0.6236839892136522,0.37631601078634785
593,Get Out,255407969,176040665,79367304,2017_boxofficemojo_rankings.csv,2017,0.6892528282858708,0.31074717171412924
594,Us,255184580,175084580,80100000,2019_boxofficemojo_rankings.csv,2019,0.6861095603817441,0.3138904396182559
595,Cliffhanger,255000211,84049211,170951000,1993_boxofficemojo_rankings.csv,1993,0.3296044762880608,0.6703955237119392
596,Baahubali 2: The Conclusion,254158390,20186659,233971731,2017_boxofficemojo_rankings.csv,2017,0.07942550706274147,0.9205744929372586
597,Babe,254134910,63658910,190476000,1995_boxofficemojo_rankings.csv,1995,0.2504925828568771,0.749507417143123
598,Men in Black: International,253890701,80001807,173888894,2019_boxofficemojo_rankings.csv,2019,0.31510333653377876,0.6848966634662212
599,Wild Hogs,253625427,168273550,85351877,2007_boxofficemojo_rankings.csv,2007,0.6634727124579666,0.33652728754203337
600,High School Musical 3,252909177,90559416,162349761,2008_boxofficemojo_rankings.csv,2008,0.3580708975222358,0.6419291024777641
601,Hercules,252712101,99112101,153600000,1997_boxofficemojo_rankings.csv,1997,0.39219372799247154,0.6078062720075285
602,X-Men: Dark Phoenix,252442974,65845974,186597000,2019_boxofficemojo_rankings.csv,2019,0.26083504308580996,0.73916495691419
603,True Grit,252276927,171243005,81033922,2010_boxofficemojo_rankings.csv,2010,0.6787898007018296,0.32121019929817046
604,Bean,251212670,45319423,205893247,1997_boxofficemojo_rankings.csv,1997,0.18040261663553833,0.8195973833644616
605,American Hustle,251171807,150117807,101054000,2013_boxofficemojo_rankings.csv,2013,0.5976698133162692,0.4023301866837308
606,Enemy of the State,250849789,111549836,139299953,1998_boxofficemojo_rankings.csv,1998,0.44468778086155775,0.5553122191384422
607,You've Got Mail,250821495,115821495,135000000,1998_boxofficemojo_rankings.csv,1998,0.4617686175580765,0.5382313824419235
608,Eragon,250425512,75030163,175395349,2006_boxofficemojo_rankings.csv,2006,0.2996107002069342,0.7003892997930659
609,Brother Bear,250397798,85336277,165061521,2003_boxofficemojo_rankings.csv,2003,0.34080282527085165,0.6591971747291484
610,The Mask of Zorro,250288523,94095523,156193000,1998_boxofficemojo_rankings.csv,1998,0.37594821317476074,0.6240517868252393
611,The Ring,249348933,129128133,120220800,2002_boxofficemojo_rankings.csv,2002,0.5178611813029094,0.48213881869709063
612,The Blair Witch Project,248639099,140539099,108100000,1999_boxofficemojo_rankings.csv,1999,0.5652333022651438,0.43476669773485627
613,Unbreakable,248118121,95011339,153106782,2000_boxofficemojo_rankings.csv,2000,0.3829278515292319,0.6170721484707681
614,Journey to the West: The Demons Strike Back,247585244,880346,246704898,2017_boxofficemojo_rankings.csv,2017,0.0035557288704976295,0.9964442711295024
615,Dumb and Dumber,247275374,127175374,120100000,1994_boxofficemojo_rankings.csv,1994,0.5143066692925111,0.4856933307074889
616,Glass,246999039,111048468,135950571,2019_boxofficemojo_rankings.csv,2019,0.44959068848846817,0.5504093115115318
617,Grown Ups 2,246984278,133668525,113315753,2013_boxofficemojo_rankings.csv,2013,0.5412025659382255,0.4587974340617746
618,The Peanuts Movie,246233113,130178411,116054702,2015_boxofficemojo_rankings.csv,2015,0.5286795484732388,0.47132045152676116
619,Rango,245724603,123477607,122246996,2011_boxofficemojo_rankings.csv,2011,0.5025040451484624,0.4974959548515376
620,Four Weddings and a Funeral,245700832,52700832,193000000,1994_boxofficemojo_rankings.csv,1994,0.2144918744109096,0.7855081255890904
621,Face/Off,245676146,112276146,133400000,1997_boxofficemojo_rankings.csv,1997,0.45700874027875704,0.542991259721243
622,Teenage Mutant Ninja Turtles: Out of the Shadows,245623848,82051601,163572247,2016_boxofficemojo_rankings.csv,2016,0.3340538863311025,0.6659461136688974
623,Dark Shadows,245527149,79727149,165800000,2012_boxofficemojo_rankings.csv,2012,0.3247182616045446,0.6752817383954554
624,Dolittle,245516662,77047065,168469597,2020_boxofficemojo_rankings.csv,2020,0.3138160333900271,0.6861839666099729
625,Hulk,245285165,132177234,113107931,2003_boxofficemojo_rankings.csv,2003,0.5388717006183394,0.4611282993816605
626,The Bravest,245179562,290217,244889345,2019_boxofficemojo_rankings.csv,2019,0.0011836916488169597,0.9988163083511831
627,Welcome to the Sticks,245144417,0,245144417,2008_boxofficemojo_rankings.csv,2008,0.0,1.0
628,Love Actually,244931766,59696144,185235622,2003_boxofficemojo_rankings.csv,2003,0.24372560968674026,0.7562743903132597
629,Pixels,244874809,78747585,166127224,2015_boxofficemojo_rankings.csv,2015,0.3215830379677805,0.6784169620322195
630,Hercules,244819862,72688614,172131248,2014_boxofficemojo_rankings.csv,2014,0.29690652304999665,0.7030934769500033
631,Back to the Future Part III,244527583,87727583,156800000,1990_boxofficemojo_rankings.csv,1990,0.3587635469328628,0.6412364530671372
632,Rush Hour,244386864,141186864,103200000,1998_boxofficemojo_rankings.csv,1998,0.5777187107732599,0.42228128922674013
633,Journey to the Center of the Earth,244232688,101704370,142528318,2008_boxofficemojo_rankings.csv,2008,0.41642407014739974,0.5835759298526002
634,After Earth,243611982,60522097,183089885,2013_boxofficemojo_rankings.csv,2013,0.24843645416422908,0.7515635458357709
635,A Few Good Men,243240178,141340178,101900000,1992_boxofficemojo_rankings.csv,1992,0.5810724986395956,0.41892750136040435
636,Cloudy with a Chance of Meatballs,243006126,124870275,118135851,2009_boxofficemojo_rankings.csv,2009,0.513856490185766,0.48614350981423404
637,8 Mile,242875078,116750901,126124177,2002_boxofficemojo_rankings.csv,2002,0.48070350388111865,0.5192964961188813
638,Daddy's Home,242786137,150357137,92429000,2015_boxofficemojo_rankings.csv,2015,0.6192986916711806,0.38070130832881943
639,RoboCop,242688965,58607007,184081958,2014_boxofficemojo_rankings.csv,2014,0.24149020125410317,0.7585097987458969
640,Eraser,242295562,101295562,141000000,1996_boxofficemojo_rankings.csv,1996,0.4180661055607779,0.5819338944392222
641,Alien: Covenant,240891763,74262031,166629732,2017_boxofficemojo_rankings.csv,2017,0.3082796608533269,0.6917203391466731
642,Sully,240797623,125070033,115727590,2016_boxofficemojo_rankings.csv,2016,0.5193989518742052,0.48060104812579485
643,Assassin's Creed,240697856,54647948,186049908,2016_boxofficemojo_rankings.csv,2016,0.2270396126835463,0.7729603873164537
644,Click,240685326,137355633,103329693,2006_boxofficemojo_rankings.csv,2006,0.570685530699948,0.42931446930005196
645,Resident Evil: Retribution,240159255,42345531,197813724,2012_boxofficemojo_rankings.csv,2012,0.17632271136084263,0.8236772886391573
646,Die Hard 2,240031094,117540947,122490147,1990_boxofficemojo_rankings.csv,1990,0.489690502348,0.5103094976520001
647,Crocodile Dundee II,239606210,109306210,130300000,1988_boxofficemojo_rankings.csv,1988,0.45619105615000544,0.5438089438499946
648,Planes,239258712,90288712,148970000,2013_boxofficemojo_rankings.csv,2013,0.37736854489127236,0.6226314551087276
649,Crazy Rich Asians,238532921,174532921,64000000,2018_boxofficemojo_rankings.csv,2018,0.7316932198218459,0.2683067801781541
650,Batman & Robin,238207122,107325195,130881927,1997_boxofficemojo_rankings.csv,1997,0.45055409804245905,0.549445901957541
651,Gulliver's Travels,237382724,42779261,194603463,2010_boxofficemojo_rankings.csv,2010,0.1802121918526809,0.8197878081473191
652,Gone in 60 Seconds,237202299,101648571,135553728,2000_boxofficemojo_rankings.csv,2000,0.4285311374659147,0.5714688625340854
653,Saturday Night Fever,237113184,94213184,142900000,1977_boxofficemojo_rankings.csv,1977,0.3973342283658086,0.6026657716341913
654,Silver Linings Playbook,236412453,132092958,104319495,2012_boxofficemojo_rankings.csv,2012,0.5587394247797937,0.44126057522020634
655,2 Fast 2 Furious,236350661,127154901,109195760,2003_boxofficemojo_rankings.csv,2003,0.5379925762086191,0.4620074237913809
656,Hidden Figures,235956898,169607287,66349611,2016_boxofficemojo_rankings.csv,2016,0.7188062245164792,0.2811937754835207
657,A.I. Artificial Intelligence,235926552,78616689,157309863,2001_boxofficemojo_rankings.csv,2001,0.33322527004082186,0.6667747299591782
658,Dead Poets Society,235860116,95860116,140000000,1989_boxofficemojo_rankings.csv,1989,0.406427833691051,0.5935721663089489
659,Spy,235666219,110825712,124840507,2015_boxofficemojo_rankings.csv,2015,0.47026558354551445,0.5297344164544856
660,American Pie,235483004,102561004,132922000,1999_boxofficemojo_rankings.csv,1999,0.4355346341683326,0.5644653658316674
661,Howl's Moving Castle,235347345,4711096,230636249,2004_boxofficemojo_rankings.csv,2004,0.020017629686878344,0.9799823703131216
662,American Reunion,234989584,57011521,177978063,2012_boxofficemojo_rankings.csv,2012,0.24261297045404362,0.7573870295459564
663,Big Daddy,234801895,163479795,71322100,1999_boxofficemojo_rankings.csv,1999,0.696245637199819,0.303754362800181
664,Alvin and the Chipmunks: The Road Chip,234798636,85886987,148911649,2015_boxofficemojo_rankings.csv,2015,0.3657899741802589,0.6342100258197412
665,The Imitation Game,233555708,91125683,142430025,2014_boxofficemojo_rankings.csv,2014,0.39016679909188945,0.6098332009081106
666,The Day the Earth Stood Still,233093859,79366978,153726881,2008_boxofficemojo_rankings.csv,2008,0.34049364638130597,0.659506353618694
667,American Wedding,232722935,104565114,128157821,2003_boxofficemojo_rankings.csv,2003,0.4493115987902095,0.5506884012097906
668,The Girl with the Dragon Tattoo,232617430,102515793,130101637,2011_boxofficemojo_rankings.csv,2011,0.44070555246010584,0.5592944475398941
669,Juno,232372681,143495265,88877416,2007_boxofficemojo_rankings.csv,2007,0.6175220958956015,0.3824779041043986
670,Argo,232325503,136025503,96300000,2012_boxofficemojo_rankings.csv,2012,0.5854953556261105,0.4145046443738895
671,Mr. Bean's Holiday,232225908,33302167,198923741,2007_boxofficemojo_rankings.csv,2007,0.14340418468726582,0.8565958153127342
672,The English Patient,231976425,78676425,153300000,1996_boxofficemojo_rankings.csv,1996,0.33915698545660405,0.660843014543396
673,Sister Act,231605150,139605150,92000000,1992_boxofficemojo_rankings.csv,1992,0.6027722181479989,0.39722778185200114
674,Annabelle Comes Home,231252591,74152591,157100000,2019_boxofficemojo_rankings.csv,2019,0.32065626023623667,0.6793437397637634
675,Constantine,230884728,75976178,154908550,2005_boxofficemojo_rankings.csv,2005,0.32906541137705736,0.6709345886229426
676,Get Smart,230685453,130319208,100366245,2008_boxofficemojo_rankings.csv,2008,0.5649216554630343,0.43507834453696564
677,Space Jam,230418342,90418342,140000000,1996_boxofficemojo_rankings.csv,1996,0.3924094810125836,0.6075905189874163
678,The Heat,229930771,159582188,70348583,1996_boxofficemojo_rankings.csv,1996,0.6940445043782331,0.30595549562176694
679,Ghostbusters,229147509,128350574,100796935,2016_boxofficemojo_rankings.csv,2016,0.5601220565744837,0.43987794342551634
680,Life Is Beautiful,228847384,57247384,171600000,1998_boxofficemojo_rankings.csv,1998,0.250155291266078,0.749844708733922
681,Ghost Rider,228738393,115802596,112935797,2007_boxofficemojo_rankings.csv,2007,0.5062665452930764,0.49373345470692365
682,Goodbye Mr. Loser,228122928,1293626,226829302,2015_boxofficemojo_rankings.csv,2015,0.005670740820931423,0.9943292591790686
683,Paddington 2,227978523,40891591,187086932,2017_boxofficemojo_rankings.csv,2017,0.17936597913655225,0.8206340208634477
684,Lethal Weapon 2,227853986,147253986,80600000,1989_boxofficemojo_rankings.csv,1989,0.6462646916345804,0.3537353083654196
685,The Green Hornet,227817248,98780042,129037206,2011_boxofficemojo_rankings.csv,2011,0.4335933423267408,0.5664066576732593
686,Sleepless in Seattle,227799884,126680884,101119000,1993_boxofficemojo_rankings.csv,1993,0.5561060074991083,0.4438939925008917
687,Out of Africa,227514205,87071205,140443000,1985_boxofficemojo_rankings.csv,1985,0.38270667539198266,0.6172933246080173
688,Youth,227091290,1891956,225199334,2017_boxofficemojo_rankings.csv,2017,0.00833125744276674,0.9916687425572333
689,Baby Driver,226945087,107825862,119119225,2017_boxofficemojo_rankings.csv,2017,0.47511873213628986,0.5248812678637101
690,Immortals,226904017,83504017,143400000,2011_boxofficemojo_rankings.csv,2011,0.3680147143450528,0.6319852856549473
691,Taken,226837760,145000989,81836771,2008_boxofficemojo_rankings.csv,2008,0.6392277414483374,0.3607722585516627
692,Percy Jackson & the Olympians: The Lightning Thief,226497209,88768303,137728906,2010_boxofficemojo_rankings.csv,2010,0.39191786685548075,0.6080821331445192
693,Hansel & Gretel: Witch Hunters,226349749,55703475,170646274,2013_boxofficemojo_rankings.csv,2013,0.2460947062945495,0.7539052937054505
694,Good Will Hunting,225933435,138433435,87500000,1997_boxofficemojo_rankings.csv,1997,0.6127177900871555,0.38728220991284446
695,Valerian and the City of a Thousand Planets,225874228,41189488,184684740,2017_boxofficemojo_rankings.csv,2017,0.18235585513545174,0.8176441448645483
696,Better Days,225820914,1921657,223899257,2019_boxofficemojo_rankings.csv,2019,0.00850965026206563,0.9914903497379344
697,Ford v Ferrari,225508210,117624357,107883853,2019_boxofficemojo_rankings.csv,2019,0.521596783549477,0.47840321645052303
698,Jumper,225132113,80172128,144959985,2008_boxofficemojo_rankings.csv,2008,0.3561114713119581,0.6438885286880419
699,The Social Network,224920315,96962694,127957621,2010_boxofficemojo_rankings.csv,2010,0.4310979824121267,0.5689020175878733
700,Chicken Run,224834564,106834564,118000000,2000_boxofficemojo_rankings.csv,2000,0.47516966297050306,0.524830337029497
701,Con Air,224012234,101117573,122894661,1997_boxofficemojo_rankings.csv,1997,0.4513930832902635,0.5486069167097365
702,Interview with the Vampire: The Vampire Chronicles,223664608,105264608,118400000,1994_boxofficemojo_rankings.csv,1994,0.47063596221714254,0.5293640377828575
703,Flightplan,223387299,89707299,133680000,2005_boxofficemojo_rankings.csv,2005,0.40157743704130644,0.5984225629586936
704,Yes Man,223241637,97690976,125550661,2008_boxofficemojo_rankings.csv,2008,0.43760195146750336,0.5623980485324966
705,Non-Stop,222809600,92168600,130641000,2014_boxofficemojo_rankings.csv,2014,0.4136652998793589,0.5863347001206412
706,"Honey, I Shrunk the Kids",222724172,130724172,92000000,1989_boxofficemojo_rankings.csv,1989,0.5869330249435162,0.41306697505648377
707,Fahrenheit 9/11,222446882,119194771,103252111,2004_boxofficemojo_rankings.csv,2004,0.5358347571713772,0.4641652428286228
708,Wild Wild West,222104681,113804681,108300000,1999_boxofficemojo_rankings.csv,1999,0.5123920868646618,0.4876079131353382
709,Geostorm,221600160,33700160,187900000,2017_boxofficemojo_rankings.csv,2017,0.15207642449355632,0.8479235755064437
710,Presumed Innocent,221303188,86303188,135000000,1990_boxofficemojo_rankings.csv,1990,0.38997715658754994,0.61002284341245
711,Collateral,220926695,101005703,119920992,2004_boxofficemojo_rankings.csv,2004,0.4571910289066697,0.5428089710933303
712,Scary Movie 3,220673217,110003217,110670000,2003_boxofficemojo_rankings.csv,2003,0.4984892072335176,0.5015107927664824
713,Elf,220443451,173398518,47044933,2003_boxofficemojo_rankings.csv,2003,0.7865895639603283,0.2134104360396717
714,Inferno,220021259,34343574,185677685,2016_boxofficemojo_rankings.csv,2016,0.15609207108482184,0.8439079289151782
715,Knocked Up,219922417,148768917,71153500,2007_boxofficemojo_rankings.csv,2007,0.6764609039377737,0.32353909606222636
716,Green Lantern,219851172,116601172,103250000,2011_boxofficemojo_rankings.csv,2011,0.5303641137742036,0.46963588622579644
717,What Happens in Vegas,219375562,80277646,139097916,2008_boxofficemojo_rankings.csv,2008,0.36593704999830384,0.6340629500016962
718,It's Complicated,219103655,112735375,106368280,2009_boxofficemojo_rankings.csv,2009,0.5145298694355418,0.4854701305644582
719,The Terminal,219100084,77872883,141227201,2004_boxofficemojo_rankings.csv,2004,0.3554215113856369,0.6445784886143631
720,Captain Phillips,218791811,107100855,111690956,2013_boxofficemojo_rankings.csv,2013,0.4895103455220269,0.5104896544779731
721,The Prince of Egypt,218613188,101413188,117200000,1998_boxofficemojo_rankings.csv,1998,0.46389327619155346,0.5361067238084466
722,Jack Reacher,218340595,80070736,138269859,2012_boxofficemojo_rankings.csv,2012,0.3667239983476275,0.6332760016523725
723,Kingdom of Heaven,218122627,47398413,170724214,2005_boxofficemojo_rankings.csv,2005,0.2173016786561992,0.7826983213438008
724,The Emoji Movie,217776646,86089513,131687133,2017_boxofficemojo_rankings.csv,2017,0.39531104267259215,0.6046889573274078
725,Dracula Untold,217124280,56280355,160843925,2014_boxofficemojo_rankings.csv,2014,0.2592080213230874,0.7407919786769126
726,Central Intelligence,216972543,127440871,89531672,2016_boxofficemojo_rankings.csv,2016,0.5873594383783389,0.412640561621661
727,Million Dollar Baby,216763646,100492203,116271443,2004_boxofficemojo_rankings.csv,2004,0.4636026605679072,0.5363973394320928
728,The Help,216639112,169708112,46931000,2011_boxofficemojo_rankings.csv,2011,0.7833678343363962,0.21663216566360372
729,Twins,216614388,111938388,104676000,1988_boxofficemojo_rankings.csv,1988,0.5167634016997984,0.48323659830020155
730,Little Women,216601214,108101214,108500000,2019_boxofficemojo_rankings.csv,2019,0.4990794465260938,0.5009205534739062
731,Valentine's Day,216485654,110485654,106000000,2010_boxofficemojo_rankings.csv,2010,0.5103601645585254,0.48963983544147455
732,Bad Teacher,216197492,100292856,115904636,2011_boxofficemojo_rankings.csv,2011,0.46389463204318765,0.5361053679568124
733,Clear and Present Danger,215887717,122187717,93700000,1994_boxofficemojo_rankings.csv,1994,0.5659780866551106,0.4340219133448894
734,Ted 2,215863606,81476385,134387221,2015_boxofficemojo_rankings.csv,2015,0.37744382441197616,0.6225561755880239
735,Bram Stoker's Dracula,215862692,82522790,133339902,1992_boxofficemojo_rankings.csv,1992,0.3822929716822025,0.6177070283177974
736,Vertical Limit,215663859,69243859,146420000,2000_boxofficemojo_rankings.csv,2000,0.3210730778957266,0.6789269221042734
737,Ghostbusters II,215394738,112494738,102900000,1989_boxofficemojo_rankings.csv,1989,0.5222724521710461,0.47772754782895394
738,The Patriot,215294342,113330342,101964000,2000_boxofficemojo_rankings.csv,2000,0.5263972148418095,0.47360278515819054
739,The Sorcerer's Apprentice,215283742,63150991,152132751,2010_boxofficemojo_rankings.csv,2010,0.29333841196424393,0.7066615880357561
740,Just Go with It,214945591,103028109,111917482,2011_boxofficemojo_rankings.csv,2011,0.4793218066054679,0.5206781933945321
741,The Expendables 3,214657577,39322544,175335033,2014_boxofficemojo_rankings.csv,2014,0.18318730952599918,0.8168126904740008
742,Creed II,214215889,115715889,98500000,2018_boxofficemojo_rankings.csv,2018,0.5401835015142131,0.45981649848578693
743,Public Enemies,214104620,97104620,117000000,2009_boxofficemojo_rankings.csv,2009,0.453538181474085,0.546461818525915
744,Smallfoot,214040103,83240103,130800000,2018_boxofficemojo_rankings.csv,2018,0.3888995652370808,0.6111004347629192
745,The Bourne Identity,214034224,121661683,92372541,2002_boxofficemojo_rankings.csv,2002,0.5684216324208039,0.4315783675791961
746,Disclosure,214015089,83015089,131000000,1994_boxofficemojo_rankings.csv,1994,0.387893626509671,0.612106373490329
747,Pulp Fiction,213928762,107928762,106000000,1994_boxofficemojo_rankings.csv,1994,0.5045079539141165,0.4954920460858835
748,The Aviator,213719942,102610330,111109612,2004_boxofficemojo_rankings.csv,2004,0.4801158424420684,0.5198841575579316
749,"Crouching Tiger, Hidden Dragon",213525736,128078872,85446864,2000_boxofficemojo_rankings.csv,2000,0.5998287344622477,0.40017126553775234
750,Dirty Dancing,213446382,63446382,150000000,1987_boxofficemojo_rankings.csv,1987,0.2972473995834701,0.7027526004165299
751,Braveheart,213216216,75609945,137606271,1995_boxofficemojo_rankings.csv,1995,0.35461629710190523,0.6453837028980948
752,Into the Woods,212902372,128002372,84900000,2014_boxofficemojo_rankings.csv,2014,0.6012256735213829,0.39877432647861716
753,Bedtime Stories,212874864,110101975,102772889,2008_boxofficemojo_rankings.csv,2008,0.5172145406514506,0.4827854593485495
754,Miss Congeniality,212742720,106807667,105935053,2000_boxofficemojo_rankings.csv,2000,0.502050866887478,0.49794913311252204
755,Entrapment,212404396,87704396,124700000,1999_boxofficemojo_rankings.csv,1999,0.41291233915893155,0.5870876608410684
756,Ace Ventura: When Nature Calls,212385533,108385533,104000000,1995_boxofficemojo_rankings.csv,1995,0.5103244626365394,0.48967553736346064
757,End of Days,211989043,66889043,145100000,1999_boxofficemojo_rankings.csv,1999,0.3155306616483947,0.6844693383516053
758,Bridget Jones's Baby,211952420,24252420,187700000,2016_boxofficemojo_rankings.csv,2016,0.11442388815376583,0.8855761118462342
759,Battle Los Angeles,211819354,83552429,128266925,2011_boxofficemojo_rankings.csv,2011,0.3944513446113144,0.6055486553886856
760,Fury,211817906,85817906,126000000,2014_boxofficemojo_rankings.csv,2014,0.4051494400100433,0.5948505599899566
761,Australia,211787511,49554002,162233509,2008_boxofficemojo_rankings.csv,2008,0.23397981196351092,0.7660201880364891
762,Due Date,211780824,100539043,111241781,2010_boxofficemojo_rankings.csv,2010,0.47473156965335067,0.5252684303466493
763,Master and Commander: The Far Side of the World,211622535,93927920,117694615,2003_boxofficemojo_rankings.csv,2003,0.44384649300226936,0.5561535069977307
764,A Series of Unfortunate Events,211468235,118634549,92833686,2004_boxofficemojo_rankings.csv,2004,0.5610041101444858,0.43899588985551424
765,District 9,210888950,115646235,95242715,2009_boxofficemojo_rankings.csv,2009,0.5483750334002802,0.4516249665997199
766,Moonraker,210308099,70308099,140000000,1979_boxofficemojo_rankings.csv,1979,0.33430999250295157,0.6656900074970484
767,The Others,209947037,96522687,113424350,2001_boxofficemojo_rankings.csv,2001,0.4597477934399236,0.5402522065600764
768,Horrible Bosses,209838559,117538559,92300000,2011_boxofficemojo_rankings.csv,2011,0.5601380392628411,0.4398619607371589
769,Red Dragon,209196298,93149898,116046400,2002_boxofficemojo_rankings.csv,2002,0.44527507843374936,0.5547249215662506
770,Tomorrowland,209035668,93436322,115599346,2015_boxofficemojo_rankings.csv,2015,0.44698745861878464,0.5530125413812154
771,Me Before You,208314186,56245075,152069111,2016_boxofficemojo_rankings.csv,2016,0.2700011750519957,0.7299988249480043
772,Safe House,208076205,126373434,81702771,2012_boxofficemojo_rankings.csv,2012,0.6073420745058283,0.3926579254941717
773,S.W.A.T.,207725639,116934650,90790989,2003_boxofficemojo_rankings.csv,2003,0.562928344151104,0.43707165584889596
774,Traffic,207515725,124115725,83400000,2000_boxofficemojo_rankings.csv,2000,0.5981027461894756,0.4018972538105245
775,The Fast and the Furious,207283925,144533925,62750000,2001_boxofficemojo_rankings.csv,2001,0.697275126375574,0.302724873624426
776,Paranormal Activity 3,207039844,104028807,103011037,2011_boxofficemojo_rankings.csv,2011,0.5024579085366776,0.4975420914633224
777,Philadelphia,206678440,77446440,129232000,1993_boxofficemojo_rankings.csv,1993,0.37471949178637115,0.6252805082136289
778,Sleepy Hollow,206071502,101071502,105000000,1999_boxofficemojo_rankings.csv,1999,0.4904681191676858,0.5095318808323143
779,The Holiday,205841885,63224849,142617036,2006_boxofficemojo_rankings.csv,2006,0.3071524971703402,0.6928475028296598
780,London Has Fallen,205754447,62524260,143230187,2016_boxofficemojo_rankings.csv,2016,0.30387804935268303,0.696121950647317
781,The Break-Up,205668210,118703275,86964935,2006_boxofficemojo_rankings.csv,2006,0.5771590806376931,0.4228409193623069
782,Journey to the West,205637183,18058,205619125,2013_boxofficemojo_rankings.csv,2013,8.781485788005567e-05,0.99991218514212
783,JFK,205405498,70405498,135000000,1991_boxofficemojo_rankings.csv,1991,0.34276345417005344,0.6572365458299466
784,White House Down,205366737,73103784,132262953,2013_boxofficemojo_rankings.csv,2013,0.35596701329485503,0.644032986705145
785,The Ugly Truth,205298907,88915214,116383693,2009_boxofficemojo_rankings.csv,2009,0.43310125367593894,0.566898746324061
786,A Dog's Purpose,205035819,64508620,140527199,2017_boxofficemojo_rankings.csv,2017,0.3146212223533489,0.6853787776466511
787,Fun with Dick and Jane,204681899,110332737,94349162,2005_boxofficemojo_rankings.csv,2005,0.5390449157402043,0.46095508425979576
788,Eat Pray Love,204594016,80574010,124020006,2010_boxofficemojo_rankings.csv,2010,0.39382388388133505,0.606176116118665
789,You Don't Mess with the Zohan,204313400,100018837,104294563,2008_boxofficemojo_rankings.csv,2008,0.48953635444371246,0.5104636455562875
790,King Arthur,203567857,51882244,151685613,2004_boxofficemojo_rankings.csv,2004,0.2548646174528428,0.7451353825471573
791,Hairspray,203552922,118871849,84681073,2007_boxofficemojo_rankings.csv,2007,0.5839849795916956,0.4160150204083044
792,Yogi Bear,203509374,100246011,103263363,2010_boxofficemojo_rankings.csv,2010,0.49258670020772605,0.5074132997922739
793,Everest,203427584,43482270,159945314,2015_boxofficemojo_rankings.csv,2015,0.2137481512831613,0.7862518487168387
794,Vanilla Sky,203388341,100618344,102769997,2001_boxofficemojo_rankings.csv,2001,0.4947104809709815,0.5052895190290185
795,Arrival,203388186,100546139,102842047,2016_boxofficemojo_rankings.csv,2016,0.49435584719753584,0.5056441528024641
796,Need for Speed,203277636,43577636,159700000,2014_boxofficemojo_rankings.csv,2014,0.2143749644943726,0.7856250355056273
797,Garfield,203172417,75369589,127802828,2004_boxofficemojo_rankings.csv,2004,0.3709636874576336,0.6290363125423665
798,The Addams Family,203044905,100044905,103000000,2019_boxofficemojo_rankings.csv,2019,0.49272305059809307,0.5072769494019069
799,Ponyo,202551810,15090399,187461411,2008_boxofficemojo_rankings.csv,2008,0.07450142756068188,0.9254985724393181
800,Patch Adams,202292902,135026902,67266000,1998_boxofficemojo_rankings.csv,1998,0.6674821541687113,0.33251784583128874
801,Teenage Mutant Ninja Turtles,201965915,135265915,66700000,1990_boxofficemojo_rankings.csv,1990,0.6697462539656753,0.33025374603432467
802,Kindergarten Cop,201957688,91457688,110500000,1990_boxofficemojo_rankings.csv,1990,0.4528556892570487,0.5471443107429512
803,Harley Quinn: Birds of Prey,201858461,84158461,117700000,2020_boxofficemojo_rankings.csv,2020,0.41691817416561006,0.5830818258343899
804,Straight Outta Compton,201634991,161197785,40437206,2015_boxofficemojo_rankings.csv,2015,0.7994534291917617,0.20054657080823834
805,21 Jump Street,201585328,138447667,63137661,2012_boxofficemojo_rankings.csv,2012,0.6867943633278708,0.31320563667212925
806,Valkyrie,201545517,83077833,118467684,2008_boxofficemojo_rankings.csv,2008,0.41220382490571594,0.5877961750942841
807,Open Season,200811689,85105259,115706430,2006_boxofficemojo_rankings.csv,2006,0.4238063004390148,0.5761936995609852
808,Cats & Dogs,200687492,93385515,107301977,2001_boxofficemojo_rankings.csv,2001,0.46532802851510047,0.5346719714848995
809,The Hunt for Red October,200512643,122012643,78500000,1990_boxofficemojo_rankings.csv,1990,0.608503489727578,0.39149651027242205
810,Percy Jackson: Sea of Monsters,199850315,68559554,131290761,2013_boxofficemojo_rankings.csv,2013,0.34305452057956476,0.6569454794204352
811,Two Weeks Notice,199043242,93354851,105688391,2002_boxofficemojo_rankings.csv,2002,0.469017938323171,0.530982061676829
812,RED,199006387,90380162,108626225,2010_boxofficemojo_rankings.csv,2010,0.45415709195303366,0.5458429080469663
813,City of Angels,198685114,78685114,120000000,1998_boxofficemojo_rankings.csv,1998,0.3960292364932785,0.6039707635067215
814,The Pacifier,198636868,113086868,85550000,2005_boxofficemojo_rankings.csv,2005,0.5693145947105851,0.43068540528941485
815,50 First Dates,198520934,120908074,77612860,2004_boxofficemojo_rankings.csv,2004,0.609044454727379,0.390955545272621
816,Total Recall,198467168,58877969,139589199,2012_boxofficemojo_rankings.csv,2012,0.296663521696445,0.703336478303555
817,The Island,198326350,670883,197655467,2018_boxofficemojo_rankings.csv,2018,0.0033827224672868736,0.9966172775327131
818,The Impossible,198087212,19019882,179067330,2012_boxofficemojo_rankings.csv,2012,0.09601771769093302,0.903982282309067
819,Lost in Thailand,197757387,57387,197700000,2012_boxofficemojo_rankings.csv,2012,0.00029018890707733716,0.9997098110929227
820,Christopher Robin,197744377,99215042,98529335,2018_boxofficemojo_rankings.csv,2018,0.5017338217409844,0.4982661782590157
821,Jack the Giant Slayer,197687603,65187603,132500000,2013_boxofficemojo_rankings.csv,2013,0.3297505863329225,0.6702494136670776
822,Smurfs: The Lost Village,197183546,45020282,152163264,2017_boxofficemojo_rankings.csv,2017,0.22831662637814618,0.7716833736218538
823,Spy Kids 3-D: Game Over,197011982,111761982,85250000,2003_boxofficemojo_rankings.csv,2003,0.567285201973147,0.43271479802685303
824,The Other Woman,196710396,83911193,112799203,2014_boxofficemojo_rankings.csv,2014,0.4265722336301941,0.5734277663698059
825,Stargate,196567262,71567262,125000000,1994_boxofficemojo_rankings.csv,1994,0.36408535822206245,0.6359146417779376
826,Panic Room,196397415,96397334,100000081,2002_boxofficemojo_rankings.csv,2002,0.49082791644686363,0.5091720835531364
827,Beowulf,196393745,82280579,114113166,2007_boxofficemojo_rankings.csv,2007,0.41895722799114604,0.5810427720088539
828,The Vow,196114570,125014030,71100540,2012_boxofficemojo_rankings.csv,2012,0.6374540657535032,0.36254593424649684
829,Anger Management,195745823,135645823,60100000,2003_boxofficemojo_rankings.csv,2003,0.6929691827957933,0.3070308172042067
830,Tropic Thunder,195702811,110515313,85187498,2008_boxofficemojo_rankings.csv,2008,0.564709890651494,0.435290109348506
831,The Shape of Water,195333312,63859435,131473877,2017_boxofficemojo_rankings.csv,2017,0.3269254708587545,0.6730745291412455
832,The Pelican Brief,195268056,100768056,94500000,1993_boxofficemojo_rankings.csv,1993,0.5160498755618277,0.4839501244381723
833,The BFG,195243411,55483770,139759641,2016_boxofficemojo_rankings.csv,2016,0.28417742609506036,0.7158225739049396
834,Rocketman,195179299,96368160,98811139,2019_boxofficemojo_rankings.csv,2019,0.4937417056713581,0.5062582943286419
835,The Intern,194564672,75764672,118800000,2015_boxofficemojo_rankings.csv,2015,0.38940610965591943,0.6105938903440805
836,Wallace & Gromit: The Curse of the Were-Rabbit,194111171,56110897,138000274,2005_boxofficemojo_rankings.csv,2005,0.2890657797329964,0.7109342202670036
837,Gnomeo & Juliet,193967670,99967670,94000000,2011_boxofficemojo_rankings.csv,2011,0.5153831563785862,0.48461684362141383
838,The Sum of All Fears,193921372,118907036,75014336,2002_boxofficemojo_rankings.csv,2002,0.6131713837090633,0.38682861629093673
839,Downton Abbey,193820755,96854135,96966620,2019_boxofficemojo_rankings.csv,2019,0.49970982209825776,0.5002901779017422
840,Gangs of New York,193772504,77812000,115960504,2002_boxofficemojo_rankings.csv,2002,0.4015636810886234,0.5984363189113766
841,The Monkey King 2,193678298,709982,192968316,2016_boxofficemojo_rankings.csv,2016,0.003665779838689,0.996334220161311
842,Paranormal Activity,193355800,107918810,85436990,2009_boxofficemojo_rankings.csv,2009,0.5581358821405926,0.4418641178594074
843,Weathering with You,193186879,7798743,185388136,2019_boxofficemojo_rankings.csv,2019,0.040368906213345886,0.9596310937866541
844,The Equalizer,192330738,101530738,90800000,2014_boxofficemojo_rankings.csv,2014,0.527896575741315,0.47210342425868507
845,The LEGO Movie 2: The Second Part,192306508,105806508,86500000,2019_boxofficemojo_rankings.csv,2019,0.5501972299346208,0.44980277006537916
846,The Addams Family,191502426,113502426,78000000,1991_boxofficemojo_rankings.csv,1991,0.592694454951709,0.4073055450482909
847,The Longest Yard,191466556,158119460,33347096,2005_boxofficemojo_rankings.csv,2005,0.8258333115888918,0.17416668841110822
848,The Equalizer 2,190400157,102084362,88315795,2018_boxofficemojo_rankings.csv,2018,0.5361569213411941,0.4638430786588059
849,Hollow Man,190213455,73209340,117004115,2000_boxofficemojo_rankings.csv,2000,0.3848799234523131,0.615120076547687
850,Cheaper by the Dozen,190212113,138614544,51597569,2003_boxofficemojo_rankings.csv,2003,0.7287366814541406,0.2712633185458594
851,Outbreak,189859560,67659560,122200000,1995_boxofficemojo_rankings.csv,1995,0.356366358375633,0.643633641624367
852,The Santa Clause,189833357,144833357,45000000,1994_boxofficemojo_rankings.csv,1994,0.7629499856550501,0.23705001434494993
853,The White Storm 2: Drug Lords,189396380,609461,188786919,2019_boxofficemojo_rankings.csv,2019,0.003217912612690908,0.9967820873873091
854,The X Files,189176423,83898313,105278110,1998_boxofficemojo_rankings.csv,1998,0.4434924377442109,0.5565075622557891
855,Breakup Buddies,189017596,777896,188239700,2014_boxofficemojo_rankings.csv,2014,0.004115468699538428,0.9958845313004616
856,Rambo III,189015611,53715611,135300000,1988_boxofficemojo_rankings.csv,1988,0.28418610883944395,0.715813891160556
857,The Secret Life of Walter Mitty,188133322,58236838,129896484,2013_boxofficemojo_rankings.csv,2013,0.30955089391341317,0.6904491060865868
858,12 Years a Slave,187733202,56671993,131061209,2013_boxofficemojo_rankings.csv,2013,0.30187517389704993,0.6981248261029501
859,Heat,187436818,67436818,120000000,1995_boxofficemojo_rankings.csv,1995,0.3597842660773296,0.6402157339226704
860,Mr. Popper's Penguins,187361754,68224452,119137302,2011_boxofficemojo_rankings.csv,2011,0.3641322230576471,0.635867776942353
861,The Grudge,187281115,110359362,76921753,2004_boxofficemojo_rankings.csv,2004,0.5892711713084365,0.41072882869156346
862,I Now Pronounce You Chuck & Larry,187134117,120059556,67074561,2007_boxofficemojo_rankings.csv,2007,0.6415695754719061,0.3584304245280939
863,The Horse Whisperer,186883563,75383563,111500000,1998_boxofficemojo_rankings.csv,1998,0.40337182034569835,0.5966281796543016
864,Walk the Line,186797986,119519402,67278584,2005_boxofficemojo_rankings.csv,2005,0.6398323909123945,0.3601676090876055
865,The Final Destination,186167139,66477700,119689439,2009_boxofficemojo_rankings.csv,2009,0.35708611281822406,0.6429138871817759
866,Atlantis: The Lost Empire,186053725,84056472,101997253,2001_boxofficemojo_rankings.csv,2001,0.45178602040888993,0.5482139795911101
867,Inside Man,186003591,88513495,97490096,2006_boxofficemojo_rankings.csv,2006,0.47586981801872846,0.5241301819812715
868,The Waterboy,185991646,161491646,24500000,1998_boxofficemojo_rankings.csv,1998,0.868273653538181,0.13172634646181905
869,Hugo,185770160,73864507,111905653,2011_boxofficemojo_rankings.csv,2011,0.39761233451055866,0.6023876654894413
870,The Lion King 2011 3D Release,185542001,94242001,91300000,2011_boxofficemojo_rankings.csv,2011,0.5079281267425805,0.49207187325741947
871,Pitch Perfect 3,185400345,104897530,80502815,2017_boxofficemojo_rankings.csv,2017,0.5657892923554161,0.4342107076445839
872,Watchmen,185382813,107509799,77873014,2009_boxofficemojo_rankings.csv,2009,0.5799340147028624,0.42006598529713757
873,The Birdcage,185260553,124060553,61200000,1996_boxofficemojo_rankings.csv,1996,0.6696544460816761,0.3303455539183239
874,The Little Mermaid,184155863,84355863,99800000,1989_boxofficemojo_rankings.csv,1989,0.45806775644172676,0.5419322435582733
875,Hop,183953723,108085305,75868418,2011_boxofficemojo_rankings.csv,2011,0.5875679123928359,0.4124320876071641
876,Bad Moms,183936074,113257297,70678777,2016_boxofficemojo_rankings.csv,2016,0.615742711785835,0.3842572882141651
877,Jupiter Ascending,183887723,47387723,136500000,2015_boxofficemojo_rankings.csv,2015,0.25769922117095334,0.7423007788290467
878,Jaws 2,183855272,77737272,106118000,1978_boxofficemojo_rankings.csv,1978,0.42281774764663804,0.577182252353362
879,Knowing,183658498,79957634,103700864,2007_boxofficemojo_rankings.csv,2007,0.435360382834014,0.564639617165986
880,102 Dalmatians,183611771,66957026,116654745,2000_boxofficemojo_rankings.csv,2000,0.36466630453665194,0.6353336954633481
881,Storks,183388953,72679278,110709675,2016_boxofficemojo_rankings.csv,2016,0.3963121922616571,0.6036878077383429
882,Paul Blart: Mall Cop,183348429,146336178,37012251,2009_boxofficemojo_rankings.csv,2009,0.7981316163881611,0.20186838361183884
883,Wayne's World,183097323,121697323,61400000,1992_boxofficemojo_rankings.csv,1992,0.6646592151431946,0.33534078485680535
884,Maverick,183031272,101631272,81400000,1994_boxofficemojo_rankings.csv,1994,0.5552672550950747,0.4447327449049253
885,Mirror Mirror,183018522,64935167,118083355,2012_boxofficemojo_rankings.csv,2012,0.3548010676209045,0.6451989323790955
886,The Man in the Iron Mask,182968902,56968902,126000000,1998_boxofficemojo_rankings.csv,1998,0.31135838591849885,0.6886416140815012
887,Cape Fear,182291969,79091969,103200000,1991_boxofficemojo_rankings.csv,1991,0.43387522464031314,0.5661247753596869
888,The Haunted Mansion,182290266,75847266,106443000,2003_boxofficemojo_rankings.csv,2003,0.41607962764177436,0.5839203723582257
889,While You Were Sleeping,182057016,81057016,101000000,1995_boxofficemojo_rankings.csv,1995,0.4452287408687397,0.5547712591312602
890,The Bridges of Madison County,182016617,71516617,110500000,1995_boxofficemojo_rankings.csv,1995,0.39291257127364365,0.6070874287263563
891,Poseidon,181674817,60674817,121000000,2006_boxofficemojo_rankings.csv,2006,0.33397483482809837,0.6660251651719016
892,The First Wives Club,181489203,105489203,76000000,1996_boxofficemojo_rankings.csv,1996,0.5812423067393161,0.41875769326068396
893,Scooby-Doo 2: Monsters Unleashed,181216833,84216833,97000000,2004_boxofficemojo_rankings.csv,2004,0.46472963689857666,0.5352703631014234
894,Hot Shots!,181096164,69467617,111628547,1991_boxofficemojo_rankings.csv,1991,0.3835951875822174,0.6164048124177827
895,Road to Perdition,181001478,104454762,76546716,2002_boxofficemojo_rankings.csv,2002,0.5770934201984804,0.42290657980151963
896,Kill Bill: Vol. 1,180899045,70099045,110800000,2003_boxofficemojo_rankings.csv,2003,0.38750367642902706,0.612496323570973
897,Sweet Home Alabama,180622424,127223418,53399006,2002_boxofficemojo_rankings.csv,2002,0.7043611484252918,0.29563885157470815
898,Daddy's Home 2,180613180,104029443,76583737,2017_boxofficemojo_rankings.csv,2017,0.5759792447040687,0.42402075529593136
899,Deja Vu,180557550,64038616,116518934,2006_boxofficemojo_rankings.csv,2006,0.35467149393642083,0.6453285060635792
900,Hacksaw Ridge,180450918,67209615,113241303,2016_boxofficemojo_rankings.csv,2016,0.3724537161955585,0.6275462838044414
901,The Post,179769457,81903458,97865999,2017_boxofficemojo_rankings.csv,2017,0.4556027445752367,0.5443972554247632
902,Dangerous Minds,179519401,84919401,94600000,1995_boxofficemojo_rankings.csv,1995,0.47303745738322733,0.5269625426167727
903,The Dictator,179379533,59650222,119729311,2012_boxofficemojo_rankings.csv,2012,0.3325363880839181,0.6674636119160818
904,The League of Extraordinary Gentlemen,179265204,66465204,112800000,2003_boxofficemojo_rankings.csv,2003,0.37076466886457227,0.6292353311354277
905,Allegiant,179246868,66184051,113062817,2016_boxofficemojo_rankings.csv,2016,0.36923407219589466,0.6307659278041053
906,Moulin Rouge!,179213434,57386607,121826827,2001_boxofficemojo_rankings.csv,2001,0.320213756966456,0.6797862430335441
907,Daredevil,179179718,102543518,76636200,2003_boxofficemojo_rankings.csv,2003,0.5722942258453605,0.4277057741546395
908,Abominable,179057149,60716390,118340759,2019_boxofficemojo_rankings.csv,2019,0.3390894490339506,0.6609105509660493
909,City Slickers,179033791,124033791,55000000,1991_boxofficemojo_rankings.csv,1991,0.6927954231835486,0.30720457681645136
910,He's Just Not That Into You,178866158,93953653,84912505,2009_boxofficemojo_rankings.csv,2009,0.5252735008709697,0.4747264991290303
911,The Scorpion King,178799308,91047077,87752231,2002_boxofficemojo_rankings.csv,2002,0.5092138108275005,0.4907861891724995
912,Eagle Eye,178767383,101440743,77326640,2008_boxofficemojo_rankings.csv,2008,0.5674454774560301,0.43255452254396987
913,Along Came Polly,178311729,88097164,90214565,2004_boxofficemojo_rankings.csv,2004,0.4940626423963395,0.5059373576036605
914,Flushed Away,178281554,64665672,113615882,2006_boxofficemojo_rankings.csv,2006,0.36271656012152553,0.6372834398784745
915,Scary Movie 4,178262620,90710620,87552000,2006_boxofficemojo_rankings.csv,2006,0.5088594569068939,0.4911405430931061
916,Dante's Peak,178127760,67127760,111000000,1997_boxofficemojo_rankings.csv,1997,0.3768517607811382,0.6231482392188618
917,Brokeback Mountain,178062759,83043761,95018998,2005_boxofficemojo_rankings.csv,2005,0.46637354978870116,0.5336264502112988
918,Patriot Games,178051587,83351587,94700000,1992_boxofficemojo_rankings.csv,1992,0.468131671300408,0.531868328699592
919,Flubber,177977226,92977226,85000000,1997_boxofficemojo_rankings.csv,1997,0.5224108055263206,0.4775891944736795
920,Baywatch,177856751,58060186,119796565,2017_boxofficemojo_rankings.csv,2017,0.32644353207599075,0.6735564679240093
921,Double Jeopardy,177841558,116741558,61100000,1999_boxofficemojo_rankings.csv,1999,0.6564357583956839,0.34356424160431615
922,War Horse,177584879,79884879,97700000,2011_boxofficemojo_rankings.csv,2011,0.44984054639021376,0.5501594536097862
923,Paranormal Activity 2,177512032,84752907,92759125,2010_boxofficemojo_rankings.csv,2010,0.4774488018930458,0.5225511981069543
924,How to Lose a Guy in 10 Days,177502387,105813373,71689014,2003_boxofficemojo_rankings.csv,2003,0.5961236622693981,0.4038763377306019
925,Alien vs. Predator,177427090,80282231,97144859,2004_boxofficemojo_rankings.csv,2004,0.4524801201439983,0.5475198798560017
926,Hero,177395557,53710019,123685538,2002_boxofficemojo_rankings.csv,2002,0.302769809505432,0.697230190494568
927,The 40-Year-Old Virgin,177378645,109449237,67929408,2005_boxofficemojo_rankings.csv,2005,0.6170372820245639,0.38296271797543613
928,Lee Daniels' The Butler,177313795,116632095,60681700,2013_boxofficemojo_rankings.csv,2013,0.6577722562421046,0.34222774375789544
929,The Haunting,177311151,91411151,85900000,1999_boxofficemojo_rankings.csv,1999,0.5155409035723872,0.4844590964276127
930,The Descendants,177243185,82584160,94659025,2011_boxofficemojo_rankings.csv,2011,0.4659370119082435,0.5340629880917566
931,The A-Team,177238796,77222099,100016697,2010_boxofficemojo_rankings.csv,2010,0.4356952357090036,0.5643047642909964
932,Tootsie,177200000,177200000,0,1982_boxofficemojo_rankings.csv,1982,1.0,0.0
933,In the Line of Fire,176997168,102314823,74682345,1993_boxofficemojo_rankings.csv,1993,0.5780590964031695,0.42194090359683045
934,Analyze This,176885658,106885658,70000000,1999_boxofficemojo_rankings.csv,1999,0.6042641286383998,0.39573587136160016
935,The Hitman's Bodyguard,176586701,75468583,101118118,2017_boxofficemojo_rankings.csv,2017,0.4273741033306919,0.5726258966693081
936,Looper,176506819,66486205,110020614,2012_boxofficemojo_rankings.csv,2012,0.37667782682095696,0.623322173179043
937,Ip Man 4: The Finale,176345966,3956031,172389935,2019_boxofficemojo_rankings.csv,2019,0.02243335126815433,0.9775666487318456
938,Dr. Dolittle 2,176104344,112952899,63151445,2001_boxofficemojo_rankings.csv,2001,0.6413975739292382,0.35860242607076176
939,The Italian Job,176070171,106128601,69941570,2003_boxofficemojo_rankings.csv,2003,0.6027630938121824,0.3972369061878176
940,The Bucket List,175372502,93466502,81906000,2007_boxofficemojo_rankings.csv,2007,0.5329598479469717,0.46704015205302823
941,Sleeping with the Enemy,174999005,101599005,73400000,1991_boxofficemojo_rankings.csv,1991,0.580569043806849,0.4194309561931509
942,Cowboys & Aliens,174822325,100240551,74581774,2011_boxofficemojo_rankings.csv,2011,0.5733852984737504,0.4266147015262496
943,The Mule,174804407,103804407,71000000,2018_boxofficemojo_rankings.csv,2018,0.5938317504775494,0.40616824952245056
944,George of the Jungle,174463257,105263257,69200000,1997_boxofficemojo_rankings.csv,1997,0.6033548771819616,0.39664512281803843
945,Evan Almighty,174440724,100462298,73978426,2007_boxofficemojo_rankings.csv,2007,0.5759108062404052,0.4240891937595948
946,Identity Thief,173965010,134506920,39458090,2013_boxofficemojo_rankings.csv,2013,0.7731837568945618,0.22681624310543827
947,The Nutcracker and the Four Realms,173961069,54858851,119102218,2018_boxofficemojo_rankings.csv,2018,0.3153513100106323,0.6846486899893677
948,Big Momma's House,173959438,117559438,56400000,2000_boxofficemojo_rankings.csv,2000,0.6757864899517553,0.32421351004824467
949,In Time,173930596,37520095,136410501,2011_boxofficemojo_rankings.csv,2011,0.215718774401256,0.784281225598744
950,Amélie,173921954,33225499,140696455,2001_boxofficemojo_rankings.csv,2001,0.1910368313824257,0.8089631686175743
951,Operation Mekong,173839072,800012,173039060,2016_boxofficemojo_rankings.csv,2016,0.004602026407504062,0.9953979735924959
952,Creed,173567581,109767581,63800000,2015_boxofficemojo_rankings.csv,2015,0.6324198353608442,0.3675801646391557
953,Gemini Man,173469516,48546770,124922746,2019_boxofficemojo_rankings.csv,2019,0.27985764369112553,0.7201423563088745
954,The Girl on the Train,173185859,75395035,97790824,2016_boxofficemojo_rankings.csv,2016,0.435341750390833,0.564658249609167
955,Scream,173046663,103046663,70000000,1996_boxofficemojo_rankings.csv,1996,0.5954848317415979,0.40451516825840206
956,Cold Mountain,173013509,95636509,77377000,2003_boxofficemojo_rankings.csv,2003,0.5527690268394013,0.4472309731605987
957,Black Hawk Down,172989651,108638745,64350906,2001_boxofficemojo_rankings.csv,2001,0.6280071921759065,0.3719928078240935
958,The Grand Budapest Hotel,172936941,59301324,113635617,2014_boxofficemojo_rankings.csv,2014,0.342907210322403,0.657092789677597
959,The Santa Clause 2,172855065,139236327,33618738,2002_boxofficemojo_rankings.csv,2002,0.8055090951485859,0.1944909048514141
960,Cloverfield,172394180,80048433,92345747,2008_boxofficemojo_rankings.csv,2008,0.46433373214803425,0.5356662678519658
961,Scream 2,172363301,101363301,71000000,1997_boxofficemojo_rankings.csv,1997,0.5880793673126509,0.41192063268734913
962,Couples Retreat,171844840,109204945,62639895,2009_boxofficemojo_rankings.csv,2009,0.6354857381810243,0.3645142618189758
963,Antz,171757863,90757863,81000000,1998_boxofficemojo_rankings.csv,1998,0.5284058698378193,0.4715941301621807
964,Blood Diamond,171720398,57377916,114342482,2006_boxofficemojo_rankings.csv,2006,0.3341357035522361,0.6658642964477639
965,Jackass 3D,171685792,117229692,54456100,2010_boxofficemojo_rankings.csv,2010,0.6828153374508708,0.3171846625491293
966,No Country for Old Men,171627166,74283625,97343541,2007_boxofficemojo_rankings.csv,2007,0.43281973787296585,0.5671802621270341
967,Spies in Disguise,171616764,66757013,104859751,2019_boxofficemojo_rankings.csv,2019,0.3889888810629246,0.6110111189370754
968,John Wick: Chapter 2,171539887,92029184,79510703,2017_boxofficemojo_rankings.csv,2017,0.5364885427492441,0.46351145725075593
969,Cocktail,171504781,78222753,93282028,1988_boxofficemojo_rankings.csv,1988,0.4560966320816444,0.5439033679183556
970,Anchorman 2: The Legend Continues,171464676,125168368,46296308,2013_boxofficemojo_rankings.csv,2013,0.7299950690718361,0.2700049309281639
971,Mr. Deeds,171269535,126293452,44976083,2002_boxofficemojo_rankings.csv,2002,0.7373958947223159,0.2626041052776841
972,Contact,171120329,100920329,70200000,1997_boxofficemojo_rankings.csv,1997,0.5897623595616158,0.4102376404383842
973,Superbad,170812526,121463226,49349300,2007_boxofficemojo_rankings.csv,2007,0.7110908599290897,0.28890914007091023
974,The Other Guys,170458922,119219978,51238944,2010_boxofficemojo_rankings.csv,2010,0.6994059131736149,0.30059408682638505
975,The Specialist,170362582,57362582,113000000,1994_boxofficemojo_rankings.csv,1994,0.33670880851054485,0.6632911914894551
976,Olympus Has Fallen,170270201,98925640,71344561,2013_boxofficemojo_rankings.csv,2013,0.5809920903305916,0.4190079096694083
977,Starsky & Hutch,170268750,88237754,82030996,2004_boxofficemojo_rankings.csv,2004,0.5182263568623132,0.4817736431376867
978,Shall We Dance,170128460,57890460,112238000,2004_boxofficemojo_rankings.csv,2004,0.3402749898517861,0.6597250101482138
979,Stuart Little 2,169956806,64956806,105000000,2002_boxofficemojo_rankings.csv,2002,0.3821959680743824,0.6178040319256176
980,Zookeeper,169852759,80360843,89491916,2011_boxofficemojo_rankings.csv,2011,0.47312062207950356,0.5268793779204964
981,Dumb and Dumber To,169837010,86208010,83629000,2014_boxofficemojo_rankings.csv,2014,0.5075926030492411,0.49240739695075886
982,Ghost in the Shell,169801921,40563557,129238364,2017_boxofficemojo_rankings.csv,2017,0.23888750351652382,0.7611124964834762
983,Seven Pounds,169748929,69951824,99797105,2008_boxofficemojo_rankings.csv,2008,0.412089928414217,0.587910071585783
984,Meet the Robinsons,169333034,97822171,71510863,2007_boxofficemojo_rankings.csv,2007,0.5776910074144186,0.42230899258558136
985,The Emperor's New Groove,169327687,89302687,80025000,2000_boxofficemojo_rankings.csv,2000,0.5273956585729539,0.4726043414270461
986,12 Monkeys,168839459,57141459,111698000,1995_boxofficemojo_rankings.csv,1995,0.338436638795437,0.6615633612045629
987,Dodgeball,168423227,114326736,54096491,2004_boxofficemojo_rankings.csv,2004,0.6788062313994256,0.3211937686005743
988,Hellboy II: The Golden Army,168319243,75986503,92332740,2008_boxofficemojo_rankings.csv,2008,0.4514427563104,0.5485572436896
989,Insidious: The Last Key,167885588,67745330,100140258,2018_boxofficemojo_rankings.csv,2018,0.40352081919026905,0.596479180809731
990,Fantastic Four,167882881,56117548,111765333,2015_boxofficemojo_rankings.csv,2015,0.3342660530110869,0.6657339469889131
991,Unstoppable,167805466,81562942,86242524,2010_boxofficemojo_rankings.csv,2010,0.48605652690717477,0.5139434730928253
992,Three Men and a Baby,167780960,167780960,0,1987_boxofficemojo_rankings.csv,1987,1.0,0.0
993,Magic Mike,167739368,113721571,54017797,2012_boxofficemojo_rankings.csv,2012,0.6779658964733908,0.3220341035266092
994,Alexander,167298192,34297191,133001001,2004_boxofficemojo_rankings.csv,2004,0.20500634579481888,0.7949936542051811
995,Up in the Air,166842739,83823381,83019358,2009_boxofficemojo_rankings.csv,2009,0.5024095234974535,0.4975904765025465
996,Nutty Professor II: The Klumps,166339890,123309890,43030000,2000_boxofficemojo_rankings.csv,2000,0.7413128023590734,0.2586871976409267
997,Sleepers,165615285,53315285,112300000,1996_boxofficemojo_rankings.csv,1996,0.3219224904271366,0.6780775095728634
998,Bridge of Spies,165478348,72313754,93164594,2015_boxofficemojo_rankings.csv,2015,0.4369982833041094,0.5630017166958906
999,The Princess Diaries,165335153,108248956,57086197,2001_boxofficemojo_rankings.csv,2001,0.6547243827814403,0.3452756172185597
1000,The Muppets,165184237,88631237,76553000,2011_boxofficemojo_rankings.csv,2011,0.5365598958452676,0.4634401041547324
1001,The Huntsman: Winter's War,164989338,48390190,116599148,2016_boxofficemojo_rankings.csv,2016,0.2932928308373478,0.7067071691626522
1002,Saw III,164874275,80238724,84635551,2006_boxofficemojo_rankings.csv,2006,0.4866661218070557,0.5133338781929443
1003,Six Days Seven Nights,164839294,74339294,90500000,1998_boxofficemojo_rankings.csv,1998,0.45098041975355707,0.5490195802464429
1004,Bringing Down the House,164729679,132716677,32013002,2003_boxofficemojo_rankings.csv,2003,0.8056634226792854,0.19433657732071463
1005,Deep Blue Sea,164648142,73648142,91000000,1999_boxofficemojo_rankings.csv,1999,0.4473062441239088,0.5526937558760913
1006,Speed 2: Cruise Control,164508066,48608066,115900000,1997_boxofficemojo_rankings.csv,1997,0.29547527475035784,0.7045247252496422
1007,Daddy Day Care,164433867,104297061,60136806,2003_boxofficemojo_rankings.csv,2003,0.6342796827857853,0.3657203172142148
1008,Miami Vice,164231296,63450470,100780826,2006_boxofficemojo_rankings.csv,2006,0.386348226832479,0.613651773167521
1009,The Spiderwick Chronicles,164170327,71195053,92975274,2008_boxofficemojo_rankings.csv,2008,0.43366578054023125,0.5663342194597688
1010,The Pink Panther,164115897,82226474,81889423,2006_boxofficemojo_rankings.csv,2006,0.5010268688352597,0.49897313116474024
1011,Four Christmases,164112721,120146040,43966681,2008_boxofficemojo_rankings.csv,2008,0.7320946192830475,0.26790538071695247
1012,The Ring Two,163995949,76231249,87764700,2005_boxofficemojo_rankings.csv,2005,0.46483617104468844,0.5351638289553116
1013,Burn After Reading,163728902,60355347,103373555,2008_boxofficemojo_rankings.csv,2008,0.3686297670279374,0.6313702329720625
1014,Pokémon: The First Movie - Mewtwo Strikes Back,163644662,85744662,77900000,1999_boxofficemojo_rankings.csv,1999,0.5239685850553438,0.4760314149446561
1015,Legend of Deification,163422610,143937,163278673,2020_boxofficemojo_rankings.csv,2020,0.0008807655195324564,0.9991192344804676
1016,The Happening,163403799,64506874,98896925,2008_boxofficemojo_rankings.csv,2008,0.3947697323732357,0.6052302676267644
1017,Talladega Nights: The Ballad of Ricky Bobby,163362095,148213377,15148718,2006_boxofficemojo_rankings.csv,2006,0.9072690760974876,0.09273092390251239
1018,World Trade Center,163247198,70278893,92968305,2006_boxofficemojo_rankings.csv,2006,0.43050596801055047,0.5694940319894495
1019,The Island,162949164,35818913,127130251,2005_boxofficemojo_rankings.csv,2005,0.21981648828833514,0.7801835117116649
1020,The Interpreter,162944923,72708161,90236762,2005_boxofficemojo_rankings.csv,2005,0.4462131109172392,0.5537868890827609
1021,Dick Tracy,162738726,103738726,59000000,1990_boxofficemojo_rankings.csv,1990,0.6374556846414049,0.3625443153585951
1022,27 Dresses,162655351,76808654,85846697,2008_boxofficemojo_rankings.csv,2008,0.47221719745328267,0.5277828025467173
1023,The Magnificent Seven,162360636,93432655,68927981,2016_boxofficemojo_rankings.csv,2016,0.5754637164638847,0.4245362835361152
1024,Memoirs of a Geisha,162242962,57490508,104752454,2005_boxofficemojo_rankings.csv,2005,0.35434823977141144,0.6456517602285885
1025,Jack Reacher: Never Go Back,162146076,58697076,103449000,2016_boxofficemojo_rankings.csv,2016,0.36200121179620776,0.6379987882037922
1026,Eyes Wide Shut,162091208,55691208,106400000,1999_boxofficemojo_rankings.csv,1999,0.3435794494171454,0.6564205505828545
1027,Insidious: Chapter 2,161919318,83586447,78332871,2013_boxofficemojo_rankings.csv,2013,0.5162228203060983,0.4837771796939016
1028,Limitless,161849455,79249455,82600000,2011_boxofficemojo_rankings.csv,2011,0.489649192825518,0.510350807174482
1029,Scream 3,161834276,89143175,72691101,2000_boxofficemojo_rankings.csv,2000,0.5508300046400554,0.4491699953599446
1030,Flight,161772375,93772375,68000000,2012_boxofficemojo_rankings.csv,2012,0.5796562917494411,0.42034370825055883
1031,Payback,161626121,81526121,80100000,1999_boxofficemojo_rankings.csv,1999,0.5044117899729834,0.4955882100270166
1032,Into the Storm,161502194,47602194,113900000,2014_boxofficemojo_rankings.csv,2014,0.29474642307336085,0.7052535769266391
1033,Unbroken,161459297,115637895,45821402,2014_boxofficemojo_rankings.csv,2014,0.7162046233856698,0.28379537661433024
1034,Alien: Resurrection,161376069,47795658,113580411,1997_boxofficemojo_rankings.csv,1997,0.2961756244043843,0.7038243755956157
1035,Born on the Fourth of July,161001698,70001698,91000000,1989_boxofficemojo_rankings.csv,1989,0.43478856974539487,0.5652114302546052
1036,Freaky Friday,160846332,110230332,50616000,2003_boxofficemojo_rankings.csv,2003,0.6853145522771387,0.31468544772286133
1037,Legends of the Fall,160638883,66638883,94000000,1994_boxofficemojo_rankings.csv,1994,0.4148365685535799,0.5851634314464201
1038,The Predator,160542134,51024708,109517426,2018_boxofficemojo_rankings.csv,2018,0.3178275181018835,0.6821724818981165
1039,Johnny English,160466000,28082366,132383634,2003_boxofficemojo_rankings.csv,2003,0.1750050851893859,0.824994914810614
1040,"Three Billboards Outside Ebbing, Missouri",160192031,54513740,105678291,2017_boxofficemojo_rankings.csv,2017,0.3403024461310438,0.6596975538689562
1041,The War of the Roses,160188546,86888546,73300000,1989_boxofficemojo_rankings.csv,1989,0.542414224797321,0.45758577520267896
1042,Underworld Awakening,160112671,62321039,97791632,2012_boxofficemojo_rankings.csv,2012,0.3892323987275186,0.6107676012724814
1043,Lara Croft Tomb Raider: The Cradle of Life,160099222,65660196,94439026,2003_boxofficemojo_rankings.csv,2003,0.41012189303455826,0.5898781069654417
1044,Johnny English Reborn,160078586,8305970,151772616,2011_boxofficemojo_rankings.csv,2011,0.051886827636021225,0.9481131723639787
1045,Alien³,159814498,55473545,104340953,1992_boxofficemojo_rankings.csv,1992,0.34711209367250273,0.6528879063274973
1046,Norbit,159814490,95673607,64140883,2007_boxofficemojo_rankings.csv,2007,0.5986541458161898,0.40134585418381025
1047,21,159808370,81159365,78649005,2008_boxofficemojo_rankings.csv,2008,0.5078542819753433,0.4921457180246567
1048,Stepmom,159710793,91137662,68573131,1998_boxofficemojo_rankings.csv,1998,0.5706418476051272,0.4293581523948729
1049,Princess Mononoke,159414369,2375308,157039061,1999_boxofficemojo_rankings.csv,1999,0.014900212665271096,0.9850997873347289
1050,The Jackal,159330280,54930280,104400000,1997_boxofficemojo_rankings.csv,1997,0.34475731794358233,0.6552426820564177
1051,Step Up 3D,159291809,42400223,116891586,2010_boxofficemojo_rankings.csv,2010,0.26617955603731014,0.7338204439626899
1052,Daylight,159212469,33023469,126189000,1996_boxofficemojo_rankings.csv,1996,0.20741760496158124,0.7925823950384188
1053,Happy Feet Two,159196259,64006466,95189793,2011_boxofficemojo_rankings.csv,2011,0.4020601137367179,0.5979398862632821
1054,Unforgiven,159157447,101157447,58000000,1992_boxofficemojo_rankings.csv,1992,0.6355809854125142,0.3644190145874858
1055,Johnny English Strikes Again,158970776,4412170,154558606,2018_boxofficemojo_rankings.csv,2018,0.02775459811556811,0.9722454018844319
1056,The Fast and the Furious: Tokyo Drift,158964610,62514415,96450195,2006_boxofficemojo_rankings.csv,2006,0.3932599526397731,0.6067400473602269
1057,Focus,158762963,53862963,104900000,2015_boxofficemojo_rankings.csv,2015,0.3392665517334795,0.6607334482665205
1058,Sin City,158733820,74103820,84630000,2005_boxofficemojo_rankings.csv,2005,0.4668432977924931,0.5331567022075069
1059,Goosebumps,158260952,80080379,78180573,2015_boxofficemojo_rankings.csv,2015,0.5060021312142745,0.4939978687857255
1060,Days of Thunder,157920733,82670733,75250000,1990_boxofficemojo_rankings.csv,1990,0.52349511954203,0.47650488045797
1061,Final Destination 5,157887643,42587643,115300000,2011_boxofficemojo_rankings.csv,2011,0.26973385751283907,0.7302661424871609
1062,Don't Breathe,157830487,89217875,68612612,2016_boxofficemojo_rankings.csv,2016,0.565276561555563,0.4347234384444369
1063,Hustlers,157563598,104963598,52600000,2019_boxofficemojo_rankings.csv,2019,0.6661665469203109,0.33383345307968915
1064,Crimson Tide,157387195,91387195,66000000,1995_boxofficemojo_rankings.csv,1995,0.5806520346207327,0.41934796537926733
1065,The Book of Eli,157107755,94835059,62272696,2010_boxofficemojo_rankings.csv,2010,0.6036306673722122,0.39636933262778784
1066,Ip Man 3,156954938,2679437,154275501,2015_boxofficemojo_rankings.csv,2015,0.01707137751855886,0.9829286224814411
1067,The Climbers,156892866,487157,156405709,2019_boxofficemojo_rankings.csv,2019,0.0031050296448788183,0.9968949703551212
1068,P.S. I Love You,156835339,53695808,103139531,2007_boxofficemojo_rankings.csv,2007,0.3423705928929704,0.6576294071070297
1069,Mystic River,156595191,90135191,66460000,2003_boxofficemojo_rankings.csv,2003,0.5755936081076717,0.4244063918923283
1070,Under Siege,156563139,83563139,73000000,1992_boxofficemojo_rankings.csv,1992,0.5337344379637151,0.46626556203628494
1071,This Means War,156491279,54760791,101730488,2012_boxofficemojo_rankings.csv,2012,0.3499287075288074,0.6500712924711926
1072,Licence to Kill,156167015,34667015,121500000,1989_boxofficemojo_rankings.csv,1989,0.22198679407428,0.77801320592572
1073,Rocky Balboa,155929020,70270943,85658077,2006_boxofficemojo_rankings.csv,2006,0.45065981303544395,0.549340186964556
1074,The Hateful Eight,155760117,54117416,101642701,2015_boxofficemojo_rankings.csv,2015,0.3474407765114866,0.6525592234885135
1075,Escape Room,155712077,57005601,98706476,2019_boxofficemojo_rankings.csv,2019,0.36609620845273294,0.6339037915472671
1076,The Monuments Men,155641650,78031620,77610030,2014_boxofficemojo_rankings.csv,2014,0.5013543611237737,0.49864563887622626
1077,Hannah Montana: The Movie,155545279,79576189,75969090,2009_boxofficemojo_rankings.csv,2009,0.5115950127936701,0.4884049872063298
1078,Monster-in-Law,155457327,82931301,72526026,2005_boxofficemojo_rankings.csv,2005,0.5334666599535705,0.4665333400464296
1079,Dreamgirls,155430335,103365956,52064379,2006_boxofficemojo_rankings.csv,2006,0.6650307740763732,0.3349692259236268
1080,The Accountant,155160045,86260045,68900000,2016_boxofficemojo_rankings.csv,2016,0.5559423819450426,0.44405761805495736
1081,Blade II,155010032,82348319,72661713,2002_boxofficemojo_rankings.csv,2002,0.5312450938659248,0.4687549061340752
1082,Maid in Manhattan,154906693,94011225,60895468,2002_boxofficemojo_rankings.csv,2002,0.6068893679113013,0.39311063208869873
1083,Cool Runnings,154856263,68856263,86000000,1993_boxofficemojo_rankings.csv,1993,0.44464629112223897,0.555353708877761
1084,Lone Survivor,154802912,125095601,29707311,2013_boxofficemojo_rankings.csv,2013,0.8080959161801814,0.19190408381981858
1085,The Phantom of the Opera,154648887,51268815,103380072,2004_boxofficemojo_rankings.csv,2004,0.331517516837997,0.668482483162003
1086,Ride Along,154468902,134938200,19530702,2014_boxofficemojo_rankings.csv,2014,0.8735622397315933,0.12643776026840664
1087,Kill Bill: Vol. 2,154116796,66208183,87908613,2004_boxofficemojo_rankings.csv,2004,0.4295974528305143,0.5704025471694857
1088,The Town,154026136,92186262,61839874,2010_boxofficemojo_rankings.csv,2010,0.598510515124524,0.4014894848754759
1089,Midnight in Paris,153959590,56817045,97142545,2011_boxofficemojo_rankings.csv,2011,0.36903868735945583,0.6309613126405442
1090,Free Willy,153698625,77698625,76000000,1993_boxofficemojo_rankings.csv,1993,0.5055258301757741,0.4944741698242258
1091,Another 48 Hrs.,153518974,80818974,72700000,1990_boxofficemojo_rankings.csv,1990,0.5264429007973959,0.4735570992026041
1092,Sweeney Todd: The Demon Barber of Fleet Street,153383627,52898073,100485554,2007_boxofficemojo_rankings.csv,2007,0.34487431308427724,0.6551256869157227
1093,Yesterday,153178301,73286650,79891651,2019_boxofficemojo_rankings.csv,2019,0.47844015452293076,0.5215598454770692
1094,The Devil's Advocate,152944660,60944660,92000000,1997_boxofficemojo_rankings.csv,1997,0.3984752393447408,0.6015247606552593
1095,Tower Heist,152930623,78046570,74884053,2011_boxofficemojo_rankings.csv,2011,0.5103397113604906,0.48966028863950944
1096,Duckweed,152894264,471575,152422689,2017_boxofficemojo_rankings.csv,2017,0.0030843210704098096,0.9969156789295902
1097,Chocolat,152699946,71509363,81190583,2000_boxofficemojo_rankings.csv,2000,0.4682998578139641,0.5317001421860359
1098,Backdraft,152368585,77868585,74500000,1991_boxofficemojo_rankings.csv,1991,0.5110540666896657,0.48894593331033426
1099,A Time to Kill,152266007,108766007,43500000,1996_boxofficemojo_rankings.csv,1996,0.7143157500675774,0.28568424993242253
1100,Date Night,152263880,98711404,53552476,2010_boxofficemojo_rankings.csv,2010,0.6482916631311378,0.35170833686886216
1101,Vantage Point,152039882,72266306,79773576,2008_boxofficemojo_rankings.csv,2008,0.4753115106995413,0.5246884893004586
1102,Phenomenon,152036382,104636382,47400000,1996_boxofficemojo_rankings.csv,1996,0.6882325179245583,0.31176748207544164
1103,Congo,152022101,81022101,71000000,1995_boxofficemojo_rankings.csv,1995,0.5329626446880904,0.46703735531190954
1104,Surf's Up,152005713,58867694,93138019,2007_boxofficemojo_rankings.csv,2007,0.3872729046703659,0.6127270953296341
1105,Jackass Presents: Bad Grandpa,151826547,102003019,49823528,2013_boxofficemojo_rankings.csv,2013,0.6718391547164674,0.3281608452835327
1106,47 Ronin,151783839,38362475,113421364,2013_boxofficemojo_rankings.csv,2013,0.25274413437388416,0.7472558656261158
1107,Big,151668774,114968774,36700000,1988_boxofficemojo_rankings.csv,1988,0.7580253401402189,0.24197465985978103
1108,Red Sparrow,151572634,46874505,104698129,2018_boxofficemojo_rankings.csv,2018,0.30925440670246584,0.6907455932975342
1109,The Bone Collector,151493655,66518655,84975000,1999_boxofficemojo_rankings.csv,1999,0.43908541912200877,0.5609145808779912
1110,Darkest Hour,150847207,56468410,94378797,2017_boxofficemojo_rankings.csv,2017,0.37434176689794463,0.6256582331020554
1111,Step Up 2: The Streets,150816700,58017783,92798917,2008_boxofficemojo_rankings.csv,2008,0.3846907073288303,0.6153092926711697
1112,Gods of Egypt,150680864,31153464,119527400,2015_boxofficemojo_rankings.csv,2015,0.20675129656808977,0.7932487034319102
1113,Broken Arrow,150270147,70770147,79500000,1996_boxofficemojo_rankings.csv,1996,0.4709528034200965,0.5290471965799035
1114,The Taking of Pelham 123,150166126,65452312,84713814,2009_boxofficemojo_rankings.csv,2009,0.4358660221413716,0.5641339778586284
1115,I Am Number Four,149878437,55100437,94778000,2011_boxofficemojo_rankings.csv,2011,0.36763418476268206,0.6323658152373179
1116,The General's Daughter,149705852,102705852,47000000,1999_boxofficemojo_rankings.csv,1999,0.6860510168967877,0.3139489831032123
1117,Jack and Jill,149673788,74158157,75515631,2011_boxofficemojo_rankings.csv,2011,0.49546522467915355,0.5045347753208465
1118,Friends with Benefits,149542245,55802754,93739491,2011_boxofficemojo_rankings.csv,2011,0.37315712359407205,0.626842876405928
1119,Beverly Hills Chihuahua,149292488,94514402,54778086,2008_boxofficemojo_rankings.csv,2008,0.633082101224008,0.366917898775992
1120,"Me, Myself & Irene",149270999,90570999,58700000,2000_boxofficemojo_rankings.csv,2000,0.606755495754403,0.393244504245597
1121,No Strings Attached,149228077,70662220,78565857,2011_boxofficemojo_rankings.csv,2011,0.473518264260686,0.526481735739314
1122,Death Becomes Her,149022650,58422650,90600000,1992_boxofficemojo_rankings.csv,1992,0.39203872699888237,0.6079612730011176
1123,Charlotte's Web,148963822,82985708,65978114,2006_boxofficemojo_rankings.csv,2006,0.5570863239532079,0.4429136760467921
1124,Lights Out,148868835,67268835,81600000,2016_boxofficemojo_rankings.csv,2016,0.4518664702387172,0.5481335297612828
1125,The Secret World of Arrietty,148800274,19202743,129597531,2010_boxofficemojo_rankings.csv,2010,0.12905045457107156,0.8709495454289284
1126,King Arthur: Legend of the Sword,148675066,39175066,109500000,2017_boxofficemojo_rankings.csv,2017,0.2634945257061463,0.7365054742938537
1127,Seabiscuit,148336445,120277854,28058591,2003_boxofficemojo_rankings.csv,2003,0.8108449275564074,0.18915507244359267
1128,Gremlins,148168459,148168459,0,1984_boxofficemojo_rankings.csv,1984,1.0,0.0
1129,RED 2,148075565,53262560,94813005,2013_boxofficemojo_rankings.csv,2013,0.35969850933879605,0.640301490661204
1130,Spy Kids,147934180,112719001,35215179,2001_boxofficemojo_rankings.csv,2001,0.7619537351002993,0.23804626489970065
1131,The Game Plan,147880543,90648202,57232341,2007_boxofficemojo_rankings.csv,2007,0.6129826152991608,0.38701738470083924
1132,The Mexican,147845033,66845033,81000000,2001_boxofficemojo_rankings.csv,2001,0.4521290410885836,0.5478709589114164
1133,The Angry Birds Movie 2,147792047,41667116,106124931,2019_boxofficemojo_rankings.csv,2019,0.2819307049722371,0.7180692950277628
1134,Saw II,147748505,87039965,60708540,2005_boxofficemojo_rankings.csv,2005,0.5891089388687892,0.41089106113121077
1135,Resident Evil: Extinction,147717833,50648679,97069154,2007_boxofficemojo_rankings.csv,2007,0.3428745058831184,0.6571254941168816
1136,Romeo + Juliet,147554998,46351345,101203653,1996_boxofficemojo_rankings.csv,1996,0.31412927808788965,0.6858707219121104
1137,Arthur Christmas,147419472,46462469,100957003,2011_boxofficemojo_rankings.csv,2011,0.31517185870805453,0.6848281412919455
1138,Source Code,147332697,54712227,92620470,2011_boxofficemojo_rankings.csv,2011,0.3713515608826464,0.6286484391173536
1139,Beethoven,147214049,57114049,90100000,1992_boxofficemojo_rankings.csv,1992,0.38796602218311377,0.6120339778168862
1140,Swordfish,147080413,69772969,77307444,2001_boxofficemojo_rankings.csv,2001,0.4743865452703073,0.5256134547296927
1141,Planes: Fire & Rescue,146965787,59165787,87800000,2014_boxofficemojo_rankings.csv,2014,0.402582044486313,0.597417955513687
1142,The Last Witch Hunter,146936910,27367660,119569250,2015_boxofficemojo_rankings.csv,2015,0.18625449521158435,0.8137455047884157
1143,Angel Has Fallen,146661977,69030436,77631541,2019_boxofficemojo_rankings.csv,2019,0.470677113537069,0.529322886462931
1144,Mama,146428180,71628180,74800000,2013_boxofficemojo_rankings.csv,2013,0.4891693661698179,0.5108306338301821
1145,Star Trek: First Contact,146027888,92027888,54000000,1996_boxofficemojo_rankings.csv,1996,0.630207621711272,0.36979237828872796
1146,Music and Lyrics,145896422,50572589,95323833,2007_boxofficemojo_rankings.csv,2007,0.3466335109986453,0.6533664890013546
1147,Driving Miss Daisy,145793296,106593296,39200000,1989_boxofficemojo_rankings.csv,1989,0.7311261829213327,0.2688738170786673
1148,Blades of Glory,145710347,118594548,27115799,2007_boxofficemojo_rankings.csv,2007,0.8139061531436749,0.18609384685632518
1149,The Foreigner,145374099,34393507,110980592,2017_boxofficemojo_rankings.csv,2017,0.23658620921186244,0.7634137907881375
1150,Home on the Range,145358062,50030461,95327601,2004_boxofficemojo_rankings.csv,2004,0.344187727268956,0.655812272731044
1151,The Exorcism of Emily Rose,145166804,75072454,70094350,2005_boxofficemojo_rankings.csv,2005,0.5171461514024929,0.4828538485975072
1152,"Crazy, Stupid, Love",145051197,84351197,60700000,2011_boxofficemojo_rankings.csv,2011,0.5815270659227997,0.4184729340772003
1153,Herbie Fully Loaded,144146816,66023816,78123000,2005_boxofficemojo_rankings.csv,2005,0.4580317334237893,0.5419682665762108
1154,The Beach,144056873,39785027,104271846,2000_boxofficemojo_rankings.csv,2000,0.2761758336931276,0.7238241663068724
1155,Pete's Dragon,143695338,76233151,67462187,2016_boxofficemojo_rankings.csv,2016,0.5305193060612725,0.4694806939387275
1156,Garfield: A Tail of Two Kitties,143325970,28426747,114899223,2006_boxofficemojo_rankings.csv,2006,0.19833633081290153,0.8016636691870985
1157,Spy Game,143049560,62362560,80687000,2001_boxofficemojo_rankings.csv,2001,0.435950729243767,0.564049270756233
1158,More Than Blue,142958164,722669,142235495,2018_boxofficemojo_rankings.csv,2018,0.005055108290282743,0.9949448917097172
1159,Meet Joe Black,142940100,44619100,98321000,1998_boxofficemojo_rankings.csv,1998,0.3121524330821092,0.6878475669178907
1160,Paranormal Activity 4,142802657,53885000,88917657,2012_boxofficemojo_rankings.csv,2012,0.3773389174404507,0.6226610825595493
1161,The Legend of Zorro,142400065,46464023,95936042,2005_boxofficemojo_rankings.csv,2005,0.32629214740878104,0.673707852591219
1162,Power Rangers,142337240,85364450,56972790,2017_boxofficemojo_rankings.csv,2017,0.5997337731151735,0.4002662268848265
1163,New Year's Eve,142044638,54544638,87500000,2011_boxofficemojo_rankings.csv,2011,0.3839964589159641,0.6160035410840359
1164,Monster House,141861243,73661010,68200233,2006_boxofficemojo_rankings.csv,2006,0.519246895362393,0.48075310463760706
1165,Legally Blonde,141774679,96520674,45254005,2001_boxofficemojo_rankings.csv,2001,0.6808033330126602,0.31919666698733984
1166,The Taking of Tiger Mountain,141654055,228984,141425071,2014_boxofficemojo_rankings.csv,2014,0.0016165015537324364,0.9983834984462676
1167,Gothika,141591324,59694580,81896744,2003_boxofficemojo_rankings.csv,2003,0.42159772444814486,0.5784022755518552
1168,Big Momma's House 2,141522961,70165972,71356989,2006_boxofficemojo_rankings.csv,2006,0.495792142166952,0.504207857833048
1169,Bad Boys,141407024,65807024,75600000,1995_boxofficemojo_rankings.csv,1995,0.46537309207497357,0.5346269079250264
1170,Mona Lisa Smile,141337989,63860942,77477047,2003_boxofficemojo_rankings.csv,2003,0.4518314039405216,0.5481685960594784
1171,Scary Movie 2,141220678,71308997,69911681,2001_boxofficemojo_rankings.csv,2001,0.5049472783298774,0.49505272167012254
1172,Shallow Hal,141069860,70839203,70230657,2001_boxofficemojo_rankings.csv,2001,0.5021568958812321,0.4978431041187678
1173,Evita,141047179,50047179,91000000,1996_boxofficemojo_rankings.csv,1996,0.3548258061935432,0.6451741938064568
1174,The Rugrats Movie,140894675,100494675,40400000,1998_boxofficemojo_rankings.csv,1998,0.7132609873297199,0.2867390126702801
1175,The Devil's Own,140807547,42868348,97939199,1997_boxofficemojo_rankings.csv,1997,0.3044463802781821,0.6955536197218178
1176,Trainwreck,140795793,110212700,30583093,2015_boxofficemojo_rankings.csv,2015,0.7827840424180856,0.2172159575819144
1177,Die Hard,140767956,83008852,57759104,1988_boxofficemojo_rankings.csv,1988,0.5896857094380201,0.4103142905619799
1178,Sausage Party,140705322,97685686,43019636,2016_boxofficemojo_rankings.csv,2016,0.6942572221966131,0.3057427778033869
1179,Girls Trip,140552359,115171585,25380774,2017_boxofficemojo_rankings.csv,2017,0.8194212165446473,0.18057878345535275
1180,Step Up Revolution,140470746,35074677,105396069,2012_boxofficemojo_rankings.csv,2012,0.24969381881121355,0.7503061811887864
1181,Lion,140312928,51738905,88574023,2016_boxofficemojo_rankings.csv,2016,0.3687394008341127,0.6312605991658873
1182,Onward,140245673,61555145,78690528,2020_boxofficemojo_rankings.csv,2020,0.4389094057825228,0.5610905942174772
1183,The SpongeBob SquarePants Movie,140192993,85417988,54775005,2004_boxofficemojo_rankings.csv,2004,0.6092885683666087,0.3907114316333913
1184,Sommersby,140081992,50081992,90000000,1993_boxofficemojo_rankings.csv,1993,0.35751913065313917,0.6424808693468608
1185,Legend of the Guardians: The Owls of Ga'Hoole,140073390,55675313,84398077,2010_boxofficemojo_rankings.csv,2010,0.3974724464082721,0.6025275535917278
1186,Anastasia,139804348,58406347,81398001,1997_boxofficemojo_rankings.csv,1997,0.4177720352445691,0.5822279647554309
1187,The Wolfman,139789765,61979680,77810085,2010_boxofficemojo_rankings.csv,2010,0.4433778109577622,0.5566221890422378
1188,Saw IV,139352633,63300095,76052538,2007_boxofficemojo_rankings.csv,2007,0.4542439826020367,0.5457560173979633
1189,Mr. Six,139191345,1415450,137775895,2015_boxofficemojo_rankings.csv,2015,0.010169094924688026,0.989830905075312
1190,Brüno,138805831,60054530,78751301,2009_boxofficemojo_rankings.csv,2009,0.4326513487751102,0.5673486512248899
1191,Bird on a Wire,138697012,70978012,67719000,1990_boxofficemojo_rankings.csv,1990,0.5117486741531245,0.4882513258468755
1192,Platoon,138545632,138530565,15067,1986_boxofficemojo_rankings.csv,1986,0.9998912488269569,0.00010875117304311695
1193,Nine Months,138510230,69684532,68825698,1995_boxofficemojo_rankings.csv,1995,0.503100254760966,0.49689974523903396
1194,The Admiral: Roaring Currents,138342258,2589811,135752447,2014_boxofficemojo_rankings.csv,2014,0.018720317547513212,0.9812796824524868
1195,America's Sweethearts,138307673,93607673,44700000,2001_boxofficemojo_rankings.csv,2001,0.676807518842429,0.32319248115757104
1196,Let's Be Cops,138224951,82390774,55834177,2014_boxofficemojo_rankings.csv,2014,0.5960629640592168,0.40393703594078323
1197,Far and Away,137783840,58883840,78900000,1992_boxofficemojo_rankings.csv,1992,0.4273639056655701,0.57263609433443
1198,Bridge to Terabithia,137587063,82272442,55314621,2007_boxofficemojo_rankings.csv,2007,0.5979664090947272,0.40203359090527285
1199,Stardust,137515140,38634938,98880202,2007_boxofficemojo_rankings.csv,2007,0.28095043207606085,0.7190495679239391
1200,Escape Plan,137328301,25135965,112192336,2013_boxofficemojo_rankings.csv,2013,0.18303557836923942,0.8169644216307606
1201,Last Action Hero,137298489,50016394,87282095,1993_boxofficemojo_rankings.csv,1993,0.36428947153234875,0.6357105284676512
1202,The First Purge,137056262,69488745,67567517,2018_boxofficemojo_rankings.csv,2018,0.5070089026650968,0.49299109733490326
1203,Conspiracy Theory,136982834,75982834,61000000,1997_boxofficemojo_rankings.csv,1997,0.5546887283701547,0.44531127162984524
1204,Anaconda,136885767,65885767,71000000,1997_boxofficemojo_rankings.csv,1997,0.4813193397966642,0.5186806602033358
1205,Annie,136853506,85911262,50942244,2014_boxofficemojo_rankings.csv,2014,0.6277607677804031,0.3722392322195969
1206,The Best Exotic Marigold Hotel,136836156,46412041,90424115,2012_boxofficemojo_rankings.csv,2012,0.3391796609662142,0.6608203390337858
1207,How Long Will I Love U,136796719,746933,136049786,2018_boxofficemojo_rankings.csv,2018,0.005460167505918033,0.994539832494082
1208,The Godfather: Part III,136766062,66666062,70100000,1990_boxofficemojo_rankings.csv,1990,0.4874459425467701,0.5125540574532299
1209,Remember the Titans,136706683,115654751,21051932,2000_boxofficemojo_rankings.csv,2000,0.8460065628247304,0.15399343717526962
1210,Contagion,136515867,75658097,60857770,2011_boxofficemojo_rankings.csv,2011,0.5542073508568788,0.4457926491431212
1211,The Wind Rises,136454220,5209580,131244640,2012_boxofficemojo_rankings.csv,2012,0.03817822563494189,0.9618217743650581
1212,The Bounty Hunter,136333522,67061228,69272294,2010_boxofficemojo_rankings.csv,2010,0.49189096721201114,0.5081090327879888
1213,17 Again,136316880,64167069,72149811,2009_boxofficemojo_rankings.csv,2009,0.4707199064415207,0.5292800935584794
1214,Lost in Space,136159423,69117629,67041794,1998_boxofficemojo_rankings.csv,1998,0.507622810651893,0.49237718934810704
1215,Saw: The Final Chapter,136150434,45710178,90440256,2010_boxofficemojo_rankings.csv,2010,0.3357328849939619,0.6642671150060381
1216,Unknown,135710029,63686397,72023632,2011_boxofficemojo_rankings.csv,2011,0.4692829076029451,0.5307170923970549
1217,The Jungle Book 2,135703599,47901582,87802017,2003_boxofficemojo_rankings.csv,2003,0.35298682093169836,0.6470131790683017
1218,Jack Ryan: Shadow Recruit,135503748,50577412,84926336,2014_boxofficemojo_rankings.csv,2014,0.3732547087922616,0.6267452912077384
1219,Babel,135330182,34302837,101027345,2006_boxofficemojo_rankings.csv,2006,0.2534751412659742,0.7465248587340257
1220,A Perfect World,135130999,31130999,104000000,1993_boxofficemojo_rankings.csv,1993,0.2303764438239667,0.7696235561760333
1221,Perfume: The Story of a Murderer,135039924,2223293,132816631,2006_boxofficemojo_rankings.csv,2006,0.016463968092873038,0.983536031907127
1222,American Made,134866593,51342000,83524593,2017_boxofficemojo_rankings.csv,2017,0.3806873063072039,0.6193126936927961
1223,Wall Street: Money Never Sleeps,134748021,52474616,82273405,2010_boxofficemojo_rankings.csv,2010,0.38942773044510987,0.6105722695548902
1224,The Princess Diaries 2: Royal Engagement,134734481,95170481,39564000,2004_boxofficemojo_rankings.csv,2004,0.7063557917293644,0.29364420827063564
1225,Sense and Sensibility,134582776,43182776,91400000,1995_boxofficemojo_rankings.csv,1995,0.3208640606432431,0.6791359393567569
1226,Inspector Gadget,134403112,97403112,37000000,1999_boxofficemojo_rankings.csv,1999,0.7247087552556075,0.27529124474439254
1227,Last Vegas,134402450,63914167,70488283,2012_boxofficemojo_rankings.csv,2012,0.4755431690419334,0.5244568309580666
1228,Black Rain,134212055,46212055,88000000,1989_boxofficemojo_rankings.csv,1989,0.3443211938003632,0.6556788061996368
1229,Scent of a Woman,134095253,63095253,71000000,1992_boxofficemojo_rankings.csv,1992,0.47052562703319556,0.5294743729668044
1230,The Cat in the Hat,133960541,101149285,32811256,2003_boxofficemojo_rankings.csv,2003,0.7550677553623795,0.24493224463762056
1231,Pokémon the Movie 2000,133949270,43758684,90190586,2000_boxofficemojo_rankings.csv,2000,0.32668101886632156,0.6733189811336785
1232,Hot Shots! Part Deux,133752825,38922972,94829853,1993_boxofficemojo_rankings.csv,1993,0.29100672826910384,0.7089932717308961
1233,Point Break,133718711,28782481,104936230,2015_boxofficemojo_rankings.csv,2015,0.21524647362178057,0.7847535263782194
1234,The Big Short,133440870,70259870,63181000,2015_boxofficemojo_rankings.csv,2015,0.5265243699325401,0.47347563006745985
1235,The Artist,133432856,44671682,88761174,2011_boxofficemojo_rankings.csv,2011,0.33478772274798646,0.6652122772520136
1236,1408,132963417,71985628,60977789,2007_boxofficemojo_rankings.csv,2007,0.5413942392891422,0.4586057607108578
1237,Zero Dark Thirty,132820716,95720716,37100000,2012_boxofficemojo_rankings.csv,2012,0.7206761029657452,0.2793238970342548
1238,A Wrinkle in Time,132675864,100478608,32197256,2018_boxofficemojo_rankings.csv,2018,0.7573239394921144,0.2426760605078856
1239,Ghost Rider: Spirit of Vengeance,132563930,51774002,80789928,2012_boxofficemojo_rankings.csv,2012,0.39055874399619867,0.6094412560038014
1240,V for Vendetta,132511035,70511035,62000000,2006_boxofficemojo_rankings.csv,2006,0.5321144386201496,0.4678855613798504
1241,A League of Their Own,132440069,107533928,24906141,1992_boxofficemojo_rankings.csv,1992,0.8119440650548135,0.1880559349451864
1242,The Three Musketeers,132274484,20374484,111900000,2011_boxofficemojo_rankings.csv,2011,0.1540318539439549,0.8459681460560451
1243,Blade: Trinity,131977904,52411906,79565998,2004_boxofficemojo_rankings.csv,2004,0.39712637048698696,0.602873629513013
1244,2 Guns,131940411,75612460,56327951,2013_boxofficemojo_rankings.csv,2013,0.5730803733815867,0.4269196266184134
1245,Save the Last Dance,131706809,91057006,40649803,2001_boxofficemojo_rankings.csv,2001,0.6913614162499374,0.3086385837500626
1246,Seven Years in Tibet,131457682,37957682,93500000,1997_boxofficemojo_rankings.csv,1997,0.2887444949774788,0.7112555050225212
1247,The House with a Clock in Its Walls,131457147,68549695,62907452,2018_boxofficemojo_rankings.csv,2018,0.521460388912898,0.478539611087102
1248,Bewitched,131426169,63313159,68113010,2005_boxofficemojo_rankings.csv,2005,0.4817393634900824,0.5182606365099176
1249,Blade,131183530,70087718,61095812,1998_boxofficemojo_rankings.csv,1998,0.5342722367663075,0.4657277632336925
1250,School of Rock,131095614,81261177,49834437,2003_boxofficemojo_rankings.csv,2003,0.6198619047621227,0.3801380952378773
1251,Aliens,131060248,85160248,45900000,1986_boxofficemojo_rankings.csv,1986,0.6497793900100052,0.3502206099899948
1252,Boomerang,131052444,70052444,61000000,1992_boxofficemojo_rankings.csv,1992,0.5345374863821692,0.46546251361783075
1253,Atonement,131016624,50927067,80089557,2007_boxofficemojo_rankings.csv,2007,0.3887069094376909,0.6112930905623091
1254,Wolf,131002597,65002597,66000000,1994_boxofficemojo_rankings.csv,1994,0.49619319378836435,0.5038068062116356
1255,Munich,130982129,47403685,83578444,2005_boxofficemojo_rankings.csv,2005,0.36190956248695577,0.6380904375130443
1256,Man on Fire,130834852,77911774,52923078,2004_boxofficemojo_rankings.csv,2004,0.595497092777695,0.404502907222305
1257,The Invisible Man,130749733,64914050,65835683,2020_boxofficemojo_rankings.csv,2020,0.49647558362509236,0.5035244163749076
1258,"You, Me and Dupree",130628903,75628110,55000793,2006_boxofficemojo_rankings.csv,2006,0.5789538782240252,0.4210461217759748
1259,A Bad Moms Christmas,130560428,72110659,58449769,2017_boxofficemojo_rankings.csv,2017,0.5523163496369665,0.4476836503630334
1260,About a Boy,130549455,41385278,89164177,2002_boxofficemojo_rankings.csv,2002,0.317008431785487,0.682991568214513
1261,Cloud Atlas,130482868,27108272,103374596,2012_boxofficemojo_rankings.csv,2012,0.2077534960375028,0.7922465039624972
1262,Aliens vs. Predator: Requiem,130290885,41797066,88493819,2007_boxofficemojo_rankings.csv,2007,0.32079808192261494,0.6792019180773851
1263,Failure to Launch,130224158,88715192,41508966,2006_boxofficemojo_rankings.csv,2006,0.6812498799185939,0.3187501200814061
1264,Cheaper by the Dozen 2,130154568,82571173,47583395,2005_boxofficemojo_rankings.csv,2005,0.6344085672044949,0.3655914327955051
1265,Mean Girls,130125829,86058055,44067774,2004_boxofficemojo_rankings.csv,2004,0.6613449125461479,0.3386550874538521
1266,Jingle All the Way,129832389,60592389,69240000,1996_boxofficemojo_rankings.csv,1996,0.4666970196473855,0.5333029803526145
1267,An Officer and a Gentleman,129795554,129795554,0,1982_boxofficemojo_rankings.csv,1982,1.0,0.0
1268,Red Cliff,129708433,627047,129081386,2008_boxofficemojo_rankings.csv,2008,0.004834280898297492,0.9951657191017025
1269,Julie & Julia,129540522,94125426,35415096,2009_boxofficemojo_rankings.csv,2009,0.7266099020351331,0.2733900979648669
1270,Resident Evil: Apocalypse,129342769,51201453,78141316,2004_boxofficemojo_rankings.csv,2004,0.3958586428592695,0.6041413571407305
1271,The Fighter,129190869,93617009,35573860,2009_boxofficemojo_rankings.csv,2009,0.7246410657706777,0.27535893422932234
1272,The Woman in Black,128955898,54333290,74622608,2012_boxofficemojo_rankings.csv,2012,0.4213323379749564,0.5786676620250436
1273,Space Cowboys,128884132,90464773,38419359,2000_boxofficemojo_rankings.csv,2000,0.70190776472002,0.29809223527998
1274,The Talented Mr. Ripley,128798265,81298265,47500000,1999_boxofficemojo_rankings.csv,1999,0.6312062122886516,0.36879378771134846
1275,The Forbidden Kingdom,128779982,52075270,76704712,2008_boxofficemojo_rankings.csv,2008,0.4043739499823816,0.5956260500176184
1276,The Heartbreak Kid,128453183,36787257,91665926,2007_boxofficemojo_rankings.csv,2007,0.2863864961602392,0.7136135038397609
1277,Pan,128388320,35088320,93300000,2015_boxofficemojo_rankings.csv,2015,0.2732983810365304,0.7267016189634695
1278,Space Station 3D,128363881,93383953,34979928,2002_boxofficemojo_rankings.csv,2002,0.7274939980974866,0.2725060019025134
1279,Step Brothers,128107642,100468793,27638849,2008_boxofficemojo_rankings.csv,2008,0.7842529253641246,0.21574707463587536
1280,A Perfect Murder,128038368,67638368,60400000,1998_boxofficemojo_rankings.csv,1998,0.5282664021459568,0.47173359785404323
1281,Blended,127994610,46294610,81700000,2014_boxofficemojo_rankings.csv,2014,0.36169187124364066,0.6383081287563593
1282,Everest,127990128,87178599,40811529,1998_boxofficemojo_rankings.csv,1998,0.6811353372503854,0.31886466274961456
1283,Forever Young,127956187,55956187,72000000,1992_boxofficemojo_rankings.csv,1992,0.43730739647626415,0.5626926035237358
1284,Law Abiding Citizen,127944208,73357727,54586481,2009_boxofficemojo_rankings.csv,2009,0.5733571542371031,0.4266428457628969
1285,The Adjustment Bureau,127869379,62495645,65373734,2010_boxofficemojo_rankings.csv,2010,0.4887459803804944,0.5112540196195057
1286,U-571,127666415,77122415,50544000,2000_boxofficemojo_rankings.csv,2000,0.6040932143351875,0.39590678566481247
1287,First Knight,127600435,37600435,90000000,1995_boxofficemojo_rankings.csv,1995,0.29467325091799257,0.7053267490820074
1288,Ad Astra,127461872,50188370,77273502,2019_boxofficemojo_rankings.csv,2019,0.393752023350167,0.606247976649833
1289,March of the Penguins,127392693,77437223,49955470,2005_boxofficemojo_rankings.csv,2005,0.60786235989218,0.39213764010782
1290,Predators,127233108,52000688,75232420,2010_boxofficemojo_rankings.csv,2010,0.40870406152461514,0.5912959384753849
1291,Smokey and the Bandit,126737428,126737428,0,1977_boxofficemojo_rankings.csv,1977,1.0,0.0
1292,Midway,126696475,56846802,69849673,2019_boxofficemojo_rankings.csv,2019,0.4486849535474448,0.5513150464525552
1293,Chronicle,126636097,64575175,62060922,2012_boxofficemojo_rankings.csv,2012,0.5099270786906833,0.49007292130931673
1294,Walking with Dinosaurs 3D,126546518,36076121,90470397,2012_boxofficemojo_rankings.csv,2012,0.2850818937586256,0.7149181062413744
1295,Parenthood,126297830,100047830,26250000,1989_boxofficemojo_rankings.csv,1989,0.7921579491904176,0.2078420508095824
1296,L.A. Confidential,126216940,64616940,61600000,1997_boxofficemojo_rankings.csv,1997,0.5119514068396841,0.4880485931603159
1297,Sex Tape,126069509,38543473,87526036,2014_boxofficemojo_rankings.csv,2014,0.30573191968249835,0.6942680803175016
1298,This Is the End,126041322,101470202,24571120,2013_boxofficemojo_rankings.csv,2013,0.8050550437736602,0.1949449562263398
1299,The Upside,125852517,108252517,17600000,2019_boxofficemojo_rankings.csv,2019,0.860153770305603,0.13984622969439697
1300,Detective Chinatown,125842935,474252,125368683,2015_boxofficemojo_rankings.csv,2015,0.003768602504383738,0.9962313974956163
1301,Wolf Totem,125837070,210591,125626479,2015_boxofficemojo_rankings.csv,2015,0.0016735211651065938,0.9983264788348934
1302,Mechanic: Resurrection,125729635,21218403,104511232,2016_boxofficemojo_rankings.csv,2016,0.1687621458536804,0.8312378541463196
1303,I Know What You Did Last Summer,125586134,72586134,53000000,1997_boxofficemojo_rankings.csv,1997,0.5779788873825832,0.4220211126174168
1304,Ender's Game,125544024,61737191,63806833,2013_boxofficemojo_rankings.csv,2013,0.49175730578780874,0.5082426942121913
1305,Happy Death Day,125479266,55683845,69795421,2017_boxofficemojo_rankings.csv,2017,0.44376929173302626,0.5562307082669737
1306,Captain Underpants: The First Epic Movie,125427681,73921000,51506681,2017_boxofficemojo_rankings.csv,2017,0.5893515642691345,0.4106484357308655
1307,First Blood,125212904,47212904,78000000,1982_boxofficemojo_rankings.csv,1982,0.3770610096224587,0.6229389903775413
1308,Legally Blonde 2,124914842,90186328,34728514,2003_boxofficemojo_rankings.csv,2003,0.7219824846754399,0.2780175153245601
1309,Donnie Brasco,124909762,41909762,83000000,1997_boxofficemojo_rankings.csv,1997,0.3355203094534757,0.6644796905465243
1310,Star Wars: Episode V - The Empire Strikes Back 1997 Special Edition,124830460,67597694,57232766,1997_boxofficemojo_rankings.csv,1997,0.5415160210096157,0.45848397899038423
1311,The Family Man,124745083,75793305,48951778,2000_boxofficemojo_rankings.csv,2000,0.6075855110056723,0.39241448899432774
1312,Ride Along 2,124605297,91221830,33383467,2015_boxofficemojo_rankings.csv,2015,0.7320862932496361,0.2679137067503639
1313,Coraline,124596837,75286229,49310608,2009_boxofficemojo_rankings.csv,2009,0.6042386854491338,0.39576131455086616
1314,The Thomas Crown Affair,124305181,69305181,55000000,1999_boxofficemojo_rankings.csv,1999,0.5575405662294961,0.4424594337705039
1315,Rocky III,124146897,124146897,0,1982_boxofficemojo_rankings.csv,1982,1.0,0.0
1316,Ray,123971376,75331600,48639776,2004_boxofficemojo_rankings.csv,2004,0.6076531731002163,0.39234682689978373
1317,"Good Morning, Vietnam",123922370,123922370,0,1987_boxofficemojo_rankings.csv,1987,1.0,0.0
1318,The Time Machine,123729176,56832494,66896682,2002_boxofficemojo_rankings.csv,2002,0.4593297703687932,0.5406702296312068
1319,The Theory of Everything,123726688,35893537,87833151,2014_boxofficemojo_rankings.csv,2014,0.2901034334645731,0.7098965665354269
1320,The Queen,123384128,56441711,66942417,2006_boxofficemojo_rankings.csv,2006,0.4574470956264326,0.5425529043735674
1321,The Wedding Singer,123306987,80245725,43061262,1998_boxofficemojo_rankings.csv,1998,0.6507800324404974,0.3492199675595025
1322,Nanny McPhee,123276807,47144110,76132697,2005_boxofficemojo_rankings.csv,2005,0.3824248141014879,0.6175751858985121
1323,Big Fish,123218424,66809693,56408731,2003_boxofficemojo_rankings.csv,2003,0.5422053848051165,0.4577946151948835
1324,Hide and Seek,123204920,51100486,72104434,2005_boxofficemojo_rankings.csv,2005,0.41476010860605245,0.5852398913939476
1325,The Curse of La Llorona,123133739,54733739,68400000,2019_boxofficemojo_rankings.csv,2019,0.4445064321485438,0.5554935678514562
1326,The Lego Ninjago Movie,123081555,59281555,63800000,2017_boxofficemojo_rankings.csv,2017,0.4816445079849698,0.5183554920150302
1327,The Pirates! Band of Misfits,123054041,31051126,92002915,2012_boxofficemojo_rankings.csv,2012,0.25233731251458863,0.7476626874854114
1328,Looking Up,122994583,84267,122910316,2019_boxofficemojo_rankings.csv,2019,0.0006851277344466463,0.9993148722655534
1329,Volcano,122823468,49323468,73500000,1997_boxofficemojo_rankings.csv,1997,0.40158016056019524,0.5984198394398048
1330,Zombieland: Double Tap,122810399,73123082,49687317,2019_boxofficemojo_rankings.csv,2019,0.5954144160056023,0.40458558399439776
1331,Dragon Blade,122593849,74068,122519781,2015_boxofficemojo_rankings.csv,2015,0.0006041738684621934,0.9993958261315378
1332,Spirit: Stallion of the Cimarron,122563539,73280117,49283422,2002_boxofficemojo_rankings.csv,2002,0.5978949171825073,0.40210508281749274
1333,Surrogates,122444772,38577772,83867000,2009_boxofficemojo_rankings.csv,2009,0.3150626308487879,0.6849373691512121
1334,Mousehunt,122417389,61917389,60500000,1997_boxofficemojo_rankings.csv,1997,0.5057891652957898,0.4942108347042102
1335,Invictus,122233971,37491364,84742607,2009_boxofficemojo_rankings.csv,2009,0.3067180399465219,0.6932819600534781
1336,Mortal Kombat,122195920,70454098,51741822,1995_boxofficemojo_rankings.csv,1995,0.5765666971532274,0.4234333028467726
1337,Prisoners,122126687,61002302,61124385,2013_boxofficemojo_rankings.csv,2013,0.4995001788593512,0.5004998211406488
1338,Secret Superstar,122026260,0,122026260,2017_boxofficemojo_rankings.csv,2017,0.0,1.0
1339,Peter Pan,121975011,48462608,73512403,2003_boxofficemojo_rankings.csv,2003,0.3973158731668407,0.6026841268331593
1340,Executive Decision,121969216,56569216,65400000,1996_boxofficemojo_rankings.csv,1996,0.4637991278061507,0.5362008721938493
1341,Deepwater Horizon,121790373,61433527,60356846,2016_boxofficemojo_rankings.csv,2016,0.5044202221139433,0.4955797778860567
1342,Pride & Prejudice,121616555,38405088,83211467,2005_boxofficemojo_rankings.csv,2005,0.31578832339067653,0.6842116766093235
1343,Last Christmas,121550750,35150750,86400000,2019_boxofficemojo_rankings.csv,2019,0.2891857927655732,0.7108142072344268
1344,Starship Troopers,121214377,54814377,66400000,1997_boxofficemojo_rankings.csv,1997,0.4522101945052277,0.5477898054947723
1345,The Nut Job,120885527,64251541,56633986,2014_boxofficemojo_rankings.csv,2014,0.531507307735855,0.4684926922641451
1346,Intolerable Cruelty,120801243,35327628,85473615,2003_boxofficemojo_rankings.csv,2003,0.2924442424818427,0.7075557575181574
1347,Apocalypto,120673227,50866635,69806592,2006_boxofficemojo_rankings.csv,2006,0.42152378174157884,0.5784762182584211
1348,Instant Family,120556201,67363237,53192964,2018_boxofficemojo_rankings.csv,2018,0.5587704028596588,0.4412295971403412
1349,Eight Below,120455994,81612565,38843429,2006_boxofficemojo_rankings.csv,2006,0.6775301277244866,0.3224698722755133
1350,Lethal Weapon,120207127,65207127,55000000,1987_boxofficemojo_rankings.csv,1987,0.5424564135868583,0.4575435864131417
1351,National Lampoon's Animal House,120091123,120091123,0,1978_boxofficemojo_rankings.csv,1978,1.0,0.0
1352,We Bought a Zoo,120081841,75624550,44457291,2011_boxofficemojo_rankings.csv,2011,0.629775071486454,0.37022492851354605
1353,The Pianist,120072577,32572577,87500000,2002_boxofficemojo_rankings.csv,2002,0.27127407284679167,0.7287259271532084
1354,The Omen,119974972,54607383,65367589,2006_boxofficemojo_rankings.csv,2006,0.4551564554647281,0.544843544535272
1355,Rocky V,119946358,40946358,79000000,1990_boxofficemojo_rankings.csv,1990,0.3413722490848784,0.6586277509151216
1356,The Commuter,119942387,36343858,83598529,2017_boxofficemojo_rankings.csv,2017,0.3030109614210029,0.6969890385789971
1357,Extreme Job,119932733,1565885,118366848,2019_boxofficemojo_rankings.csv,2019,0.013056360518358236,0.9869436394816418
1358,Parental Guidance,119772232,77267296,42504936,2012_boxofficemojo_rankings.csv,2012,0.6451186114658028,0.35488138853419715
1359,Road Trip,119754278,68540777,51213501,2000_boxofficemojo_rankings.csv,2000,0.5723451232364325,0.4276548767635675
1360,Spy Kids 2: Island of Lost Dreams,119723358,85846429,33876929,2002_boxofficemojo_rankings.csv,2002,0.7170399363505991,0.2829600636494008
1361,Michael,119718203,95318203,24400000,1996_boxofficemojo_rankings.csv,1996,0.7961880533739719,0.2038119466260281
1362,Dora and the Lost City of Gold,119682635,60477943,59204692,2019_boxofficemojo_rankings.csv,2019,0.505319280445321,0.4946807195546789
1363,Wonder Park,119559110,45216793,74342317,2019_boxofficemojo_rankings.csv,2019,0.37819613244026323,0.6218038675597368
1364,Allied,119520023,40098064,79421959,2016_boxofficemojo_rankings.csv,2016,0.33549243878575896,0.664507561214241
1365,Charlie Wilson's War,119483446,66661095,52822351,2007_boxofficemojo_rankings.csv,2007,0.5579107167699198,0.44208928323008023
1366,Fried Green Tomatoes,119418501,82418501,37000000,1991_boxofficemojo_rankings.csv,1991,0.6901652617461678,0.30983473825383223
1367,On Golden Pond,119285432,119285432,0,1981_boxofficemojo_rankings.csv,1981,1.0,0.0
1368,Sahara,119240351,68671925,50568426,2005_boxofficemojo_rankings.csv,2005,0.5759117985152526,0.4240882014847474
1369,Beverly Hills Cop III,119208989,42614912,76594077,1994_boxofficemojo_rankings.csv,1994,0.3574806930037801,0.6425193069962198
1370,Unfaithful,119137784,52775765,66362019,2002_boxofficemojo_rankings.csv,2002,0.442980918631154,0.557019081368846
1371,I Belonged to You,119107580,744541,118363039,2016_boxofficemojo_rankings.csv,2016,0.006250995948368693,0.9937490040516314
1372,The Shallows,119100758,55124043,63976715,2016_boxofficemojo_rankings.csv,2016,0.46283536667331704,0.537164633326683
1373,Final Destination 3,118890272,54098051,64792221,2006_boxofficemojo_rankings.csv,2006,0.4550250419142787,0.5449749580857213
1374,Message in a Bottle,118880016,52880016,66000000,1999_boxofficemojo_rankings.csv,1999,0.4448183788938925,0.5551816211061075
1375,Lost in Translation,118685453,44585453,74100000,2003_boxofficemojo_rankings.csv,2003,0.3756606380396088,0.6243393619603912
1376,The Purge: Election Year,118587880,79213375,39374505,2016_boxofficemojo_rankings.csv,2016,0.6679719293405025,0.3320280706594974
1377,Beethoven's 2nd,118243066,53443066,64800000,1993_boxofficemojo_rankings.csv,1993,0.4519763213853064,0.5480236786146936
1378,Jurassic Park 2013 Re-release,118192315,45385935,72806380,2013_boxofficemojo_rankings.csv,2013,0.38400072796611184,0.6159992720338882
1379,A Cool Fish,118153135,551876,117601259,2018_boxofficemojo_rankings.csv,2018,0.004670853634141828,0.9953291463658581
1380,Disturbia,118114220,80209692,37904528,2007_boxofficemojo_rankings.csv,2007,0.6790858204879988,0.3209141795120012
1381,Why Him?,118102725,60323786,57778939,2016_boxofficemojo_rankings.csv,2016,0.5107738707976467,0.4892261292023533
1382,Corpse Bride,118090836,53359111,64731725,2005_boxofficemojo_rankings.csv,2005,0.4518480248543587,0.5481519751456413
1383,Star Trek: Generations,118071125,75671125,42400000,1994_boxofficemojo_rankings.csv,1994,0.6408944185125702,0.3591055814874297
1384,The Saint,118063304,61363304,56700000,1997_boxofficemojo_rankings.csv,1997,0.519749167785445,0.480250832214555
1385,P Storm,117991727,326711,117665016,2019_boxofficemojo_rankings.csv,2019,0.0027689314183866466,0.9972310685816134
1386,Saving Mr. Banks,117867984,83301580,34566404,2013_boxofficemojo_rankings.csv,2013,0.7067362753909493,0.29326372460905076
1387,Pompeii,117831631,23219748,94611883,2014_boxofficemojo_rankings.csv,2014,0.19705869979852864,0.8029413002014714
1388,Magic Mike XXL,117813057,66013057,51800000,2015_boxofficemojo_rankings.csv,2015,0.5603203811271954,0.43967961887280455
1389,Blue Streak,117758500,68518533,49239967,1999_boxofficemojo_rankings.csv,1999,0.581856367056306,0.4181436329436941
1390,Game Night,117679066,69179066,48500000,2018_boxofficemojo_rankings.csv,2018,0.5878621266419637,0.41213787335803637
1391,The Client,117615211,92115211,25500000,1994_boxofficemojo_rankings.csv,1994,0.7831913084779485,0.2168086915220515
1392,The Forgotten,117592831,67133509,50459322,2004_boxofficemojo_rankings.csv,2004,0.5708979742140914,0.42910202578590867
1393,A Knight's Tale,117487473,56569702,60917771,2001_boxofficemojo_rankings.csv,2001,0.4814956059187689,0.5185043940812311
1394,Dennis the Menace,117270765,51270765,66000000,1993_boxofficemojo_rankings.csv,1993,0.43719988523994024,0.5628001147600598
1395,Hotel for Dogs,117252578,73034460,44218118,2009_boxofficemojo_rankings.csv,2009,0.6228814858126189,0.377118514187381
1396,Paycheck,117248958,53790451,63458507,2003_boxofficemojo_rankings.csv,2003,0.4587712498050516,0.5412287501949484
1397,Water for Elephants,117094902,58709717,58385185,2011_boxofficemojo_rankings.csv,2011,0.5013857648559286,0.49861423514407144
1398,Warm Bodies,116980662,66380662,50600000,2013_boxofficemojo_rankings.csv,2013,0.5674498747493838,0.4325501252506162
1399,Barnyard,116755080,72637803,44117277,2006_boxofficemojo_rankings.csv,2006,0.6221382658467624,0.3778617341532377
1400,The Siege,116672912,40981289,75691623,1998_boxofficemojo_rankings.csv,1998,0.35124938854701765,0.6487506114529823
1401,Finding Neverland,116650613,51680613,64970000,2004_boxofficemojo_rankings.csv,2004,0.4430376461030685,0.5569623538969315
1402,Freddy vs. Jason,116632628,82622655,34009973,2003_boxofficemojo_rankings.csv,2003,0.7084008687517527,0.29159913124824727
1403,Abraham Lincoln: Vampire Hunter,116471580,37519139,78952441,2012_boxofficemojo_rankings.csv,2012,0.32213127872052566,0.6778687212794744
1404,Sliver,116300000,36300000,80000000,1993_boxofficemojo_rankings.csv,1993,0.31212381771281167,0.6878761822871883
1405,Personal Tailor,116126458,375892,115750566,2013_boxofficemojo_rankings.csv,2013,0.0032369195312923434,0.9967630804687077
1406,Casino,116112375,42512375,73600000,1995_boxofficemojo_rankings.csv,1995,0.36613130168080704,0.6338686983191929
1407,Body of Lies,115900897,39394666,76506231,2008_boxofficemojo_rankings.csv,2008,0.33989957817151323,0.6601004218284868
1408,The Chronicles of Riddick,115900534,57761012,58139522,2004_boxofficemojo_rankings.csv,2004,0.49836709121633554,0.5016329087836644
1409,The Iron Lady,115890699,30017992,85872707,2011_boxofficemojo_rankings.csv,2011,0.25901985456140875,0.7409801454385913
1410,The Notebook,115882795,81001787,34881008,2004_boxofficemojo_rankings.csv,2004,0.6989975259053771,0.30100247409462294
1411,A Nightmare on Elm Street,115694863,63075011,52619852,2010_boxofficemojo_rankings.csv,2010,0.5451841971583474,0.4548158028416525
1412,Dragon Ball Super: Broly,115560610,30712119,84848491,2018_boxofficemojo_rankings.csv,2018,0.2657663281632037,0.7342336718367963
1413,Closer,115505027,33987757,81517270,2004_boxofficemojo_rankings.csv,2004,0.2942534873395597,0.7057465126604403
1414,Bride Wars,115375850,58715510,56660340,2009_boxofficemojo_rankings.csv,2009,0.5089064132571938,0.49109358674280623
1415,Pitch Perfect,115350426,65001093,50349333,2012_boxofficemojo_rankings.csv,2012,0.5635097784554346,0.4364902215445654
1416,DragonHeart,115267375,51367375,63900000,1996_boxofficemojo_rankings.csv,1996,0.4456367207113027,0.5543632792886972
1417,The Blues Brothers,115229890,57229890,58000000,1980_boxofficemojo_rankings.csv,1980,0.4966583757044288,0.5033416242955713
1418,The Gentlemen,115171795,36471795,78700000,2019_boxofficemojo_rankings.csv,2019,0.31667297535824634,0.6833270246417537
1419,The Karate Kid Part II,115103979,115103979,0,1986_boxofficemojo_rankings.csv,1986,1.0,0.0
1420,Get Shorty,115101622,72101622,43000000,1995_boxofficemojo_rankings.csv,1995,0.6264170803778942,0.37358291962210577
1421,The Monkey King 3,115084576,187074,114897502,2018_boxofficemojo_rankings.csv,2018,0.0016255349457081026,0.998374465054292
1422,Snow Dogs,115035090,81172560,33862530,2002_boxofficemojo_rankings.csv,2002,0.7056330377104933,0.2943669622895066
1423,Dear John,114984666,80014842,34969824,2010_boxofficemojo_rankings.csv,2010,0.6958740220195969,0.3041259779804031
1424,So Young,114926694,11186,114915508,2013_boxofficemojo_rankings.csv,2013,9.733160861653256e-05,0.9999026683913834
1425,The Lake House,114830111,52330111,62500000,2006_boxofficemojo_rankings.csv,2006,0.455717673215521,0.5442823267844791
1426,Finding Mr Right 2,114679097,0,114679097,2016_boxofficemojo_rankings.csv,2016,0.0,1.0
1427,We Were Soldiers,114660784,78122718,36538066,2002_boxofficemojo_rankings.csv,2002,0.6813377274657393,0.3186622725342607
1428,Office Christmas Party,114501299,54767494,59733805,2016_boxofficemojo_rankings.csv,2016,0.47831329843690246,0.5216867015630976
1429,Hope Springs,114281051,63536011,50745040,2012_boxofficemojo_rankings.csv,2012,0.5559627816163504,0.4440372183836496
1430,The Score,114252154,71107711,43144443,2001_boxofficemojo_rankings.csv,2001,0.6223752332931947,0.3776247667068054
1431,Step Up,114194847,65328121,48866726,2006_boxofficemojo_rankings.csv,2006,0.5720759098700837,0.4279240901299163
1432,Seventh Son,114178613,17223265,96955348,2014_boxofficemojo_rankings.csv,2014,0.15084493100297164,0.8491550689970284
1433,Anna and the King,113996937,39263420,74733517,1999_boxofficemojo_rankings.csv,1999,0.3444252190740879,0.655574780925912
1434,Coyote Ugly,113916474,60786269,53130205,2000_boxofficemojo_rankings.csv,2000,0.5336038490798092,0.4663961509201909
1435,Saw V,113864059,56746769,57117290,2008_boxofficemojo_rankings.csv,2008,0.49837296771582684,0.5016270322841732
1436,Insomnia,113714830,67355513,46359317,2002_boxofficemojo_rankings.csv,2002,0.5923195154053346,0.40768048459466544
1437,Judge Dredd,113493481,34693481,78800000,1995_boxofficemojo_rankings.csv,1995,0.30568699359921825,0.6943130064007818
1438,Changeling,113398237,35739802,77658435,2008_boxofficemojo_rankings.csv,2008,0.31517070234522254,0.6848292976547775
1439,Species,113374103,60074103,53300000,1995_boxofficemojo_rankings.csv,1995,0.5298750015248191,0.47012499847518086
1440,Striptease,113309743,33109743,80200000,1996_boxofficemojo_rankings.csv,1996,0.29220561377497783,0.7077943862250221
1441,Rambo,113244290,42754105,70490185,2008_boxofficemojo_rankings.csv,2008,0.37753872623511525,0.6224612737648847
1442,The Dark Tower,113231078,50701325,62529753,2017_boxofficemojo_rankings.csv,2017,0.44776863291895885,0.5522313670810411
1443,Pet Sematary,113118226,54724696,58393530,2019_boxofficemojo_rankings.csv,2019,0.4837831880425706,0.5162168119574294
1444,White Chicks,113100873,70831760,42269113,2004_boxofficemojo_rankings.csv,2004,0.6262706743209666,0.37372932567903344
1445,Insidious: Chapter 3,112983889,52218558,60765331,2015_boxofficemojo_rankings.csv,2015,0.46217702773534375,0.5378229722646563
1446,Final Destination,112880294,53331147,59549147,2000_boxofficemojo_rankings.csv,2000,0.47245754870199047,0.5275424512980096
1447,Deliver Us from Evil,112781920,30577122,82204798,2014_boxofficemojo_rankings.csv,2014,0.2711172322655972,0.7288827677344029
1448,Star Trek: Insurrection,112587658,70187658,42400000,1998_boxofficemojo_rankings.csv,1998,0.6234045475925967,0.37659545240740333
1449,Cats & Dogs: The Revenge of Kitty Galore,112483764,43585753,68898011,2010_boxofficemojo_rankings.csv,2010,0.3874848373672844,0.6125151626327155
1450,Tooth Fairy,112462508,60022256,52440252,2010_boxofficemojo_rankings.csv,2010,0.5337090295016362,0.46629097049836377
1451,How to Be Single,112343513,46843513,65500000,2016_boxofficemojo_rankings.csv,2016,0.4169667811616324,0.5830332188383677
1452,The Exorcist 2000 Director's Cut,112053066,39671011,72382055,2000_boxofficemojo_rankings.csv,2000,0.3540377110252387,0.6459622889747613
1453,Mary Shelley's Frankenstein,112006296,22006296,90000000,1994_boxofficemojo_rankings.csv,1994,0.1964737410832691,0.8035262589167309
1454,The Purge: Anarchy,111928365,71962800,39965565,2014_boxofficemojo_rankings.csv,2014,0.6429362208587609,0.35706377914123916
1455,Get Hard,111711453,90411453,21300000,2015_boxofficemojo_rankings.csv,2015,0.809330203591569,0.19066979640843093
1456,Underworld: Evolution,111476513,62318875,49157638,2006_boxofficemojo_rankings.csv,2006,0.5590314347202446,0.44096856527975536
1457,Fool's Gold,111231041,70231041,41000000,2008_boxofficemojo_rankings.csv,2008,0.6313978577257044,0.36860214227429555
1458,The Dukes of Hazzard,111069515,80270227,30799288,2005_boxofficemojo_rankings.csv,2005,0.7227025975579348,0.27729740244206524
1459,Good Boys,111037232,83140306,27896926,2019_boxofficemojo_rankings.csv,2019,0.748760613917321,0.251239386082679
1460,The Secret of My Success,110996879,66995879,44001000,1987_boxofficemojo_rankings.csv,1987,0.603583448503989,0.39641655149601096
1461,Mission to Mars,110983407,60883407,50100000,2000_boxofficemojo_rankings.csv,2000,0.5485811676334643,0.4514188323665357
1462,Sea of Love,110879513,58571513,52308000,1989_boxofficemojo_rankings.csv,1989,0.5282446812334033,0.47175531876659665
1463,The Santa Clause 3: The Escape Clause,110768122,84500122,26268000,2006_boxofficemojo_rankings.csv,2006,0.7628559595873622,0.23714404041263784
1464,The Net,110627965,50727965,59900000,1995_boxofficemojo_rankings.csv,1995,0.4585455856482581,0.5414544143517419
1465,The Peacemaker,110463140,41263140,69200000,1997_boxofficemojo_rankings.csv,1997,0.37354668715736306,0.626453312842637
1466,Free Birds,110387072,55750480,54636592,2013_boxofficemojo_rankings.csv,2013,0.5050453734292364,0.49495462657076367
1467,The Kid,110317580,69691949,40625631,2000_boxofficemojo_rankings.csv,2000,0.6317392839835682,0.36826071601643184
1468,10 Cloverfield Lane,110216998,72082998,38134000,2016_boxofficemojo_rankings.csv,2016,0.6540098107190326,0.34599018928096736
1469,Moneyball,110206216,75605492,34600724,2011_boxofficemojo_rankings.csv,2011,0.6860365480654921,0.3139634519345079
1470,Buddies in India,110155128,293194,109861934,2017_boxofficemojo_rankings.csv,2017,0.002661646401064506,0.9973383535989355
1471,Hoodwinked!,110013167,51386611,58626556,2005_boxofficemojo_rankings.csv,2005,0.46709509780770153,0.5329049021922985
1472,The 5th Wave,109906372,34916787,74989585,2015_boxofficemojo_rankings.csv,2015,0.3176957474312772,0.6823042525687227
1473,Peter Pan 2: Return to Never Land,109862682,48430258,61432424,2002_boxofficemojo_rankings.csv,2002,0.4408253750805028,0.5591746249194972
1474,Star Trek IV: The Voyage Home,109713132,109713132,0,1986_boxofficemojo_rankings.csv,1986,1.0,0.0
1475,Sideways,109706931,71503593,38203338,2004_boxofficemojo_rankings.csv,2004,0.6517691484779572,0.34823085152204286
1476,The Prestige,109676311,53089891,56586420,2006_boxofficemojo_rankings.csv,2006,0.4840597802382321,0.5159402197617678
1477,Treasure Planet,109578115,38176783,71401332,2002_boxofficemojo_rankings.csv,2002,0.3483978803614207,0.6516021196385793
1478,The Game,109423648,48323648,61100000,1997_boxofficemojo_rankings.csv,1997,0.44161978588028794,0.5583802141197121
1479,Along With the Gods: The Two Worlds,109383972,1908823,107475149,2017_boxofficemojo_rankings.csv,2017,0.017450664526974757,0.9825493354730253
1480,Billy Elliot,109280263,21995263,87285000,2000_boxofficemojo_rankings.csv,2000,0.20127388419627065,0.7987261158037293
1481,Transporter 3,108979549,31715062,77264487,2008_boxofficemojo_rankings.csv,2008,0.2910184735669993,0.7089815264330007
1482,Earth,108975160,32011576,76963584,2007_boxofficemojo_rankings.csv,2007,0.293751126403485,0.706248873596515
1483,The Reader,108902486,34194407,74708079,2008_boxofficemojo_rankings.csv,2008,0.3139910598551442,0.6860089401448558
1484,The Hours,108846072,41675994,67170078,2002_boxofficemojo_rankings.csv,2002,0.382889278723811,0.617110721276189
1485,Sanctum,108609310,23209310,85400000,2010_boxofficemojo_rankings.csv,2010,0.2136954005140075,0.7863045994859925
1486,Cinderella Man,108539911,61649911,46890000,2005_boxofficemojo_rankings.csv,2005,0.5679930122662437,0.4320069877337563
1487,Junior,108431355,36763355,71668000,1994_boxofficemojo_rankings.csv,1994,0.3390472709669634,0.6609527290330366
1488,Terms of Endearment,108423489,108423489,0,1983_boxofficemojo_rankings.csv,1983,1.0,0.0
1489,Confessions of a Shopaholic,108394089,44277350,64116739,2009_boxofficemojo_rankings.csv,2009,0.40848491286273,0.59151508713727
1490,The Boxtrolls,108255770,50837305,57418465,2014_boxofficemojo_rankings.csv,2014,0.4696036525351027,0.5303963474648973
1491,Superman II,108185706,108185706,0,1981_boxofficemojo_rankings.csv,1981,1.0,0.0
1492,Hidalgo,108040622,67303450,40737172,2004_boxofficemojo_rankings.csv,2004,0.6229457842254925,0.3770542157745075
1493,Neighbors 2: Sorority Rising,108007109,55455765,52551344,2016_boxofficemojo_rankings.csv,2016,0.5134455084803723,0.48655449151962765
1494,Arthur and the Invisibles,107944236,15132763,92811473,2006_boxofficemojo_rankings.csv,2006,0.14019056098558147,0.8598094390144185
1495,The American President,107879496,60079496,47800000,1995_boxofficemojo_rankings.csv,1995,0.556913020802396,0.443086979197604
1496,Three Kings,107752036,60652036,47100000,1999_boxofficemojo_rankings.csv,1999,0.5628852897034818,0.4371147102965182
1497,Horrible Bosses 2,107645357,54445357,53200000,2014_boxofficemojo_rankings.csv,2014,0.5057845365313806,0.49421546346861944
1498,The Call of the Wild,107604626,62342368,45262258,2020_boxofficemojo_rankings.csv,2020,0.579365128781731,0.420634871218269
1499,Paul Blart: Mall Cop 2,107588225,71038190,36550035,2015_boxofficemojo_rankings.csv,2015,0.6602784830774929,0.33972151692250707
1500,The Amityville Horror,107516369,65233369,42283000,2005_boxofficemojo_rankings.csv,2005,0.6067296506265013,0.39327034937349864
1501,Vacation,107228221,58884188,48344033,2015_boxofficemojo_rankings.csv,2015,0.5491482321617552,0.45085176783824477
1502,Ace Ventura: Pet Detective,107217396,72217396,35000000,1994_boxofficemojo_rankings.csv,1994,0.6735604360322275,0.3264395639677725
1503,Rising Sun,107198790,63179523,44019267,1993_boxofficemojo_rankings.csv,1993,0.5893678743948509,0.4106321256051491
1504,Shaft,107196498,70334258,36862240,2000_boxofficemojo_rankings.csv,2000,0.656124587204332,0.343875412795668
1505,ParaNorman,107139399,56003051,51136348,2012_boxofficemojo_rankings.csv,2012,0.5227120137196215,0.4772879862803785
1506,The Texas Chainsaw Massacre,107071655,80571655,26500000,2003_boxofficemojo_rankings.csv,2003,0.7525021911728179,0.24749780882718214
1507,The Man from U.N.C.L.E.,107045109,45445109,61600000,2015_boxofficemojo_rankings.csv,2015,0.42454166682197503,0.575458333178025
1508,The Breakup Guru,106980263,208959,106771304,2014_boxofficemojo_rankings.csv,2014,0.00195324814260365,0.9980467518573963
1509,Hereafter,106956330,32746941,74209389,2010_boxofficemojo_rankings.csv,2010,0.30617113545313307,0.693828864546867
1510,Nell,106683817,33683817,73000000,1994_boxofficemojo_rankings.csv,1994,0.31573501911728563,0.6842649808827144
1511,Made of Honor,106407672,46012734,60394938,2008_boxofficemojo_rankings.csv,2008,0.43241932780937076,0.5675806721906292
1512,Race to Witch Mountain,106387141,67172594,39214547,2009_boxofficemojo_rankings.csv,2009,0.6313976799132143,0.3686023200867857
1513,The Whole Nine Yards,106371651,57262492,49109159,2000_boxofficemojo_rankings.csv,2000,0.5383247459419428,0.46167525405805726
1514,Mr. Holland's Opus,106269971,82569971,23700000,1995_boxofficemojo_rankings.csv,1995,0.7769830952527502,0.2230169047472498
1515,Kramer vs. Kramer,106260000,106260000,0,1979_boxofficemojo_rankings.csv,1979,1.0,0.0
1516,Shaun the Sheep Movie,106209378,19375982,86833396,2015_boxofficemojo_rankings.csv,2015,0.18243193176406702,0.817568068235933
1517,About Schmidt,105834556,65016287,40818269,2002_boxofficemojo_rankings.csv,2002,0.6143200241705554,0.3856799758294446
1518,Forgetting Sarah Marshall,105833257,63172463,42660794,2008_boxofficemojo_rankings.csv,2008,0.5969055927287582,0.4030944072712418
1519,Life as We Know It,105734416,53374681,52359735,2010_boxofficemojo_rankings.csv,2010,0.50479950634049,0.4952004936595101
1520,First Man,105697415,44936545,60760870,2018_boxofficemojo_rankings.csv,2018,0.4251432733714443,0.5748567266285557
1521,Planet 51,105647102,42194060,63453042,2009_boxofficemojo_rankings.csv,2009,0.39938681895883904,0.600613181041161
1522,Porky's,105492483,105492483,0,1982_boxofficemojo_rankings.csv,1982,1.0,0.0
1523,The Brothers Grimm,105316267,37916267,67400000,2005_boxofficemojo_rankings.csv,2005,0.36002289181024616,0.6399771081897538
1524,Sneakers,105232691,51432691,53800000,1992_boxofficemojo_rankings.csv,1992,0.48875202668722023,0.5112479733127798
1525,Gangster Squad,105200903,46000903,59200000,2013_boxofficemojo_rankings.csv,2013,0.4372671877160598,0.5627328122839402
1526,Along Came a Spider,105178561,74078174,31100387,2001_boxofficemojo_rankings.csv,2001,0.7043086851131192,0.2956913148868808
1527,Sisters,105011053,87044645,17966408,2015_boxofficemojo_rankings.csv,2015,0.8289093625220576,0.17109063747794245
1528,Made in America,104942695,44942695,60000000,1993_boxofficemojo_rankings.csv,1993,0.4282593943294481,0.571740605670552
1529,The Campaign,104907746,86907746,18000000,2012_boxofficemojo_rankings.csv,2012,0.8284206773444546,0.17157932265554537
1530,Training Day,104876233,76631907,28244326,2001_boxofficemojo_rankings.csv,2001,0.7306889731632523,0.2693110268367477
1531,Let the Bullets Fly,104723314,63012,104660302,2010_boxofficemojo_rankings.csv,2010,0.0006016998277957476,0.9993983001722042
1532,Scary Stories to Tell in the Dark,104545505,68947075,35598430,2019_boxofficemojo_rankings.csv,2019,0.6594934425922951,0.3405065574077049
1533,The Hitchhiker's Guide to the Galaxy,104478416,51085416,53393000,2005_boxofficemojo_rankings.csv,2005,0.48895664727535687,0.5110433527246432
1534,Book Club,104438188,68566296,35871892,2018_boxofficemojo_rankings.csv,2018,0.6565251400187065,0.34347485998129346
1535,The Girl with the Dragon Tattoo,104414200,10095170,94319030,2009_boxofficemojo_rankings.csv,2009,0.09668388016189369,0.9033161198381063
1536,The Tuxedo,104391623,50547998,53843625,2002_boxofficemojo_rankings.csv,2002,0.4842150792118636,0.5157849207881364
1537,Under Siege 2: Dark Territory,104324083,50024083,54300000,1995_boxofficemojo_rankings.csv,1995,0.47950656800884606,0.5204934319911539
1538,The Cell,104155843,61334059,42821784,2000_boxofficemojo_rankings.csv,2000,0.5888681540410555,0.4111318459589444
1539,Little Man,104003322,58645052,45358270,2006_boxofficemojo_rankings.csv,2006,0.5638767192455642,0.4361232807544359
1540,The Water Horse,103967384,40946255,63021129,2007_boxofficemojo_rankings.csv,2007,0.3938375038848722,0.6061624961151278
1541,T-Rex: Back to the Cretaceous,103960367,53354743,50605624,1998_boxofficemojo_rankings.csv,1998,0.5132219569790476,0.4867780430209524
1542,Snake Eyes,103891409,55591409,48300000,1998_boxofficemojo_rankings.csv,1998,0.535091491539979,0.46490850846002096
1543,Ouija,103590271,50856010,52734261,2014_boxofficemojo_rankings.csv,2014,0.49093423068658637,0.5090657693134136
1544,The Stepford Wives,103370127,59484742,43885385,2004_boxofficemojo_rankings.csv,2004,0.5754538929801257,0.42454610701987433
1545,Rugrats in Paris: The Movie,103291131,76507756,26783375,2000_boxofficemojo_rankings.csv,2000,0.7407001478181123,0.2592998521818877
1546,9 to 5,103290500,103290500,0,1980_boxofficemojo_rankings.csv,1980,1.0,0.0
1547,Birdman or (The Unexpected Virtue of Ignorance),103215094,42340598,60874496,2014_boxofficemojo_rankings.csv,2014,0.41021711417518064,0.5897828858248194
1548,Cold War II,103197501,560824,102636677,2016_boxofficemojo_rankings.csv,2016,0.00543447268165922,0.9945655273183408
1549,She's All That,103166989,63366989,39800000,1999_boxofficemojo_rankings.csv,1999,0.614217683526656,0.385782316473344
1550,Guess Who,103121466,68915888,34205578,2005_boxofficemojo_rankings.csv,2005,0.6682981795468268,0.33170182045317315
1551,Night School,103105878,77339130,25766748,2018_boxofficemojo_rankings.csv,2018,0.75009428657404,0.24990571342596005
1552,Saw,103096345,55185045,47911300,2004_boxofficemojo_rankings.csv,2004,0.5352764445723076,0.4647235554276924
1553,Transcendence,103039258,23022309,80016949,2014_boxofficemojo_rankings.csv,2014,0.22343240282262125,0.7765675971773788
1554,Jimmy Neutron: Boy Genius,102992536,80936232,22056304,2001_boxofficemojo_rankings.csv,2001,0.7858456072972123,0.21415439270278772
1555,Resident Evil,102984862,40119709,62865153,2002_boxofficemojo_rankings.csv,2002,0.3895689931594024,0.6104310068405976
1556,Working Girl,102953112,63779477,39173635,1988_boxofficemojo_rankings.csv,1988,0.619500234242555,0.380499765757445
1557,Jigsaw,102952888,38052832,64900056,2017_boxofficemojo_rankings.csv,2017,0.3696140316141496,0.6303859683858505
1558,Just Like Heaven,102854431,48318130,54536301,2005_boxofficemojo_rankings.csv,2005,0.4697719828910434,0.5302280171089566
1559,The Cable Guy,102825796,60240295,42585501,1996_boxofficemojo_rankings.csv,1996,0.5858480784335479,0.4141519215664521
1560,Love & Other Drugs,102820008,32367005,70453003,2010_boxofficemojo_rankings.csv,2010,0.31479286599549766,0.6852071340045023
1561,Chappie,102811889,31569268,71242621,2015_boxofficemojo_rankings.csv,2015,0.3070585348354022,0.6929414651645979
1562,Star Wars: Episode I - The Phantom Menace 2012 3D Release,102739593,43456382,59283211,2012_boxofficemojo_rankings.csv,2012,0.4229759991359903,0.5770240008640096
1563,Project X,102731865,54731865,48000000,2012_boxofficemojo_rankings.csv,2012,0.5327642499238187,0.46723575007618134
1564,Primal Fear,102616183,56116183,46500000,1996_boxofficemojo_rankings.csv,1996,0.5468550998432674,0.4531449001567326
1565,Zombieland,102392080,75590286,26801794,2009_boxofficemojo_rankings.csv,2009,0.7382434852383114,0.2617565147616886
1566,U.S. Marshals,102367405,57167405,45200000,1998_boxofficemojo_rankings.csv,1998,0.5584532009969384,0.4415467990030616
1567,Ghosts of Girlfriends Past,102366815,55250026,47116789,2009_boxofficemojo_rankings.csv,2009,0.5397259453661815,0.4602740546338186
1568,The Wild,102338515,37384046,64954469,2006_boxofficemojo_rankings.csv,2006,0.36529791349815854,0.6347020865018415
1569,Dawn of the Dead,102278712,59020957,43257755,2004_boxofficemojo_rankings.csv,2004,0.5770600337634287,0.4229399662365713
1570,John Q,102244770,71756802,30487968,2002_boxofficemojo_rankings.csv,2002,0.7018139118509436,0.29818608814905645
1571,Railroad Tigers,102205175,218044,101987131,2016_boxofficemojo_rankings.csv,2016,0.002133394908819441,0.9978666050911805
1572,French Kiss,101982854,38896854,63086000,1995_boxofficemojo_rankings.csv,1995,0.3814058194527484,0.6185941805472516
1573,Heaven Is for Real,101888019,91443253,10444766,2014_boxofficemojo_rankings.csv,2014,0.8974877900020806,0.10251220999791938
1574,The Devil Inside,101758490,53261944,48496546,2012_boxofficemojo_rankings.csv,2012,0.5234152354265477,0.4765847645734523
1575,Alien,101718022,78944891,22773131,1979_boxofficemojo_rankings.csv,1979,0.7761150821434574,0.22388491785654266
1576,Timecop,101646581,44853581,56793000,1994_boxofficemojo_rankings.csv,1994,0.44126994296050154,0.5587300570394984
1577,Pineapple Express,101624843,87341380,14283463,2008_boxofficemojo_rankings.csv,2008,0.8594491014367422,0.1405508985632578
1578,Just Married,101564935,56127162,45437773,2003_boxofficemojo_rankings.csv,2003,0.5526234226408947,0.4473765773591053
1579,Miss Congeniality 2: Armed & Fabulous,101393569,48478006,52915563,2005_boxofficemojo_rankings.csv,2005,0.4781171673718281,0.5218828326281719
1580,Mars Attacks!,101371017,37771017,63600000,1996_boxofficemojo_rankings.csv,1996,0.3726017368455522,0.6273982631544478
1581,The Time Traveler's Wife,101344412,63414846,37929566,2009_boxofficemojo_rankings.csv,2009,0.625735990258644,0.37426400974135604
1582,Stir Crazy,101300000,101300000,0,1980_boxofficemojo_rankings.csv,1980,1.0,0.0
1583,Hitman,101276318,39687694,61588624,2007_boxofficemojo_rankings.csv,2007,0.3918753641892866,0.6081246358107134
1584,The Recruit,101191884,52802140,48389744,2003_boxofficemojo_rankings.csv,2003,0.5218021239727091,0.47819787602729086
1585,Joy,101134059,56451232,44682827,2015_boxofficemojo_rankings.csv,2015,0.5581822044737669,0.4418177955262332
1586,Little Miss Sunshine,101058954,59891098,41167856,2006_boxofficemojo_rankings.csv,2006,0.5926352453638101,0.4073647546361899
1587,Kung Fu Hustle,100912445,17108591,83803854,2004_boxofficemojo_rankings.csv,2004,0.16953896023429024,0.8304610397657097
1588,Courage Under Fire,100860818,59031057,41829761,1996_boxofficemojo_rankings.csv,1996,0.5852724394918154,0.41472756050818466
1589,Fight Club,100853753,37030102,63823651,1999_boxofficemojo_rankings.csv,1999,0.3671663264727491,0.6328336735272508
1590,My Bloody Valentine,100734718,51545952,49188766,2009_boxofficemojo_rankings.csv,2009,0.5116999682274387,0.48830003177256126
1591,Up Close & Personal,100688705,51088705,49600000,1996_boxofficemojo_rankings.csv,1996,0.5073926117134986,0.49260738828650147
1592,"Alexander and the Terrible, Horrible, No Good, Very Bad Day",100654149,66954149,33700000,2014_boxofficemojo_rankings.csv,2014,0.665190155251325,0.334809844748675
1593,Silent Hill,100605135,46982632,53622503,2006_boxofficemojo_rankings.csv,2006,0.46700033750762326,0.5329996624923767
1594,Ladder 49,100572044,74541707,26030337,2004_boxofficemojo_rankings.csv,2004,0.7411772102394578,0.2588227897605422
1595,Life,100541806,30234022,70307784,2017_boxofficemojo_rankings.csv,2017,0.30071095003008,0.69928904996992
1596,Instructions Not Included,100486616,44467206,56019410,2013_boxofficemojo_rankings.csv,2013,0.44251869323572407,0.557481306764276
1597,Tammy,100375432,84525432,15850000,2014_boxofficemojo_rankings.csv,2014,0.8420928340313395,0.15790716596866053
1598,PK,100370104,10616104,89754000,2014_boxofficemojo_rankings.csv,2014,0.10576958254422054,0.8942304174557795
1599,Aftershock,100293273,62962,100230311,2010_boxofficemojo_rankings.csv,2010,0.0006277788940041871,0.9993722211059958
1600,The Good Shepherd,100266865,59952835,40314030,2006_boxofficemojo_rankings.csv,2006,0.5979326769616263,0.40206732303837367
1601,Any Given Sunday,100230832,75530832,24700000,1999_boxofficemojo_rankings.csv,1999,0.7535688419707022,0.2464311580292978
1602,Where the Wild Things Are,100140096,77233467,22906629,2009_boxofficemojo_rankings.csv,2009,0.7712541737527394,0.22874582624726064
1603,Philomena,100129872,37709979,62419893,2013_boxofficemojo_rankings.csv,2013,0.376610678180034,0.623389321819966
1604,Nim's Island,100104565,48006762,52097803,2008_boxofficemojo_rankings.csv,2008,0.4795661616430779,0.520433838356922
1605,Don't Say a Word,100020092,55001642,45018450,2001_boxofficemojo_rankings.csv,2001,0.5499059328999617,0.45009406710003824
1606,Atomic Blonde,100014025,51687870,48326155,2017_boxofficemojo_rankings.csv,2017,0.5168062179279356,0.48319378207206437
1607,The Book of Life,99783556,50151543,49632013,2014_boxofficemojo_rankings.csv,2014,0.5026032846534353,0.4973967153465647
1608,Black Mass,99775678,62575678,37200000,2015_boxofficemojo_rankings.csv,2015,0.6271636460340565,0.3728363539659435
1609,Insidious,99557032,54009150,45547882,2011_boxofficemojo_rankings.csv,2011,0.5424945773795266,0.45750542262047345
1610,Line Walker 2: Invisible Spy,99482027,296751,99185276,2019_boxofficemojo_rankings.csv,2019,0.002982960932229497,0.9970170390677705
1611,Street Fighter,99431786,33423521,66008265,1994_boxofficemojo_rankings.csv,1994,0.3361452342815204,0.6638547657184796
1612,The Lucky One,99357138,60457138,38900000,2012_boxofficemojo_rankings.csv,2012,0.6084830865397914,0.39151691346020856
1613,Hellboy,99318987,59623958,39695029,2004_boxofficemojo_rankings.csv,2004,0.600327890980201,0.399672109019799
1614,Shanghai Noon,99274467,56937502,42336965,2000_boxofficemojo_rankings.csv,2000,0.5735362145031713,0.42646378549682873
1615,Nacho Libre,99255460,80197993,19057467,2006_boxofficemojo_rankings.csv,2006,0.8079957817937673,0.19200421820623267
1616,Blue Jasmine,99104804,33405481,65699323,2013_boxofficemojo_rankings.csv,2013,0.3370722674553698,0.6629277325446302
1617,Ode To My Father,99085291,2300121,96785170,2014_boxofficemojo_rankings.csv,2014,0.023213546398122804,0.9767864536018772
1618,Justin Bieber: Never Say Never,99036827,73013910,26022917,2011_boxofficemojo_rankings.csv,2011,0.7372399965923787,0.2627600034076213
1619,Young Detective Dee: Rise of the Sea Dragon,98774891,87783,98687108,2013_boxofficemojo_rankings.csv,2013,0.0008887177612780155,0.999111282238722
1620,Spotlight,98690254,45055776,53634478,2015_boxofficemojo_rankings.csv,2015,0.45653723821604514,0.5434627617839549
1621,Bowfinger,98625775,66384775,32241000,1999_boxofficemojo_rankings.csv,1999,0.6730976258488209,0.32690237415117906
1622,Devil and Angel,98599942,131058,98468884,2015_boxofficemojo_rankings.csv,2015,0.0013291894228497619,0.9986708105771502
1623,The Visit,98450062,65206105,33243957,2015_boxofficemojo_rankings.csv,2015,0.6623267032579421,0.3376732967420579
1624,Crash,98410061,54580300,43829761,2005_boxofficemojo_rankings.csv,2005,0.5546211377716757,0.4453788622283244
1625,Evolution,98376292,38345494,60030798,2001_boxofficemojo_rankings.csv,2001,0.38978389224102894,0.6102161077589711
1626,Riddick,98337295,42025135,56312160,2013_boxofficemojo_rankings.csv,2013,0.4273570368190421,0.572642963180958
1627,Predator,98268458,59735548,38532910,1987_boxofficemojo_rankings.csv,1987,0.6078811982579395,0.3921188017420605
1628,Deep Sea,98230905,46412757,51818148,2006_boxofficemojo_rankings.csv,2006,0.47248630153616117,0.5275136984638389
1629,Alpha,98203196,35857181,62346015,2018_boxofficemojo_rankings.csv,2018,0.36513252582940375,0.6348674741705962
1630,Killers,98159963,47059963,51100000,2010_boxofficemojo_rankings.csv,2010,0.4794211566685289,0.5205788433314711
1631,The Thin Red Line,98126565,36400491,61726074,1998_boxofficemojo_rankings.csv,1998,0.3709545014645117,0.6290454985354883
1632,Once Upon a Time in Mexico,98096026,56359780,41736246,2003_boxofficemojo_rankings.csv,2003,0.5745368318997958,0.4254631681002042
1633,Ever After: A Cinderella Story,98005666,65705771,32299895,1998_boxofficemojo_rankings.csv,1998,0.6704282893195175,0.3295717106804825
1634,Paul,97984015,37412945,60571070,2011_boxofficemojo_rankings.csv,2011,0.3818270255612612,0.6181729744387388
1635,Along With the Gods: The Last 49 Days,97962238,1200246,96761992,2018_boxofficemojo_rankings.csv,2018,0.012252129233715547,0.9877478707662845
1636,Are We There Yet?,97918663,82674398,15244265,2005_boxofficemojo_rankings.csv,2005,0.8443170634386623,0.15568293656133764
1637,Fred Claus,97838349,72006777,25831572,2007_boxofficemojo_rankings.csv,2007,0.7359770247145114,0.2640229752854885
1638,Phone Booth,97837138,46566212,51270926,2003_boxofficemojo_rankings.csv,2003,0.4759564001146477,0.5240435998853523
1639,I Am Sam,97818139,40311852,57506287,2001_boxofficemojo_rankings.csv,2001,0.4121101915463757,0.5878898084536244
1640,A Simple Favor,97644617,53548586,44096031,2018_boxofficemojo_rankings.csv,2018,0.5484028474401206,0.4515971525598795
1641,Safe Haven,97594140,71349120,26245020,2013_boxofficemojo_rankings.csv,2013,0.7310799603336839,0.26892003966631606
1642,The Little Prince,97571250,1339152,96232098,2015_boxofficemojo_rankings.csv,2015,0.013724862600407395,0.9862751373995926
1643,Evil Dead,97542952,54239856,43303096,2013_boxofficemojo_rankings.csv,2013,0.5560612518677925,0.44393874813220746
1644,One Fine Day,97529550,46151454,51378096,1996_boxofficemojo_rankings.csv,1996,0.47320482869038155,0.5267951713096185
1645,42,97470701,95020213,2450488,2013_boxofficemojo_rankings.csv,2013,0.9748592348792074,0.025140765120792555
1646,Scream 4,97138686,38180928,58957758,2011_boxofficemojo_rankings.csv,2011,0.39305584183010256,0.6069441581698974
1647,Jarhead,97076152,62658220,34417932,2005_boxofficemojo_rankings.csv,2005,0.6454543027210226,0.35454569727897745
1648,Enemy at the Gates,96976270,51401758,45574512,2001_boxofficemojo_rankings.csv,2001,0.530044700626246,0.469955299373754
1649,The Shack,96942115,57386418,39555697,2017_boxofficemojo_rankings.csv,2017,0.5919658138261168,0.40803418617388326
1650,Star Trek VI: The Undiscovered Country,96888996,74888996,22000000,1991_boxofficemojo_rankings.csv,1991,0.7729360308367732,0.22706396916322674
1651,The Butterfly Effect,96822421,57938693,38883728,2004_boxofficemojo_rankings.csv,2004,0.5984016140228512,0.4015983859771488
1652,The Jewel of the Nile,96773200,75973200,20800000,1985_boxofficemojo_rankings.csv,1985,0.7850644599951226,0.21493554000487738
1653,Old Dogs,96753696,49492060,47261636,2009_boxofficemojo_rankings.csv,2009,0.5115262986956075,0.48847370130439255
1654,8MM,96618699,36663315,59955384,1999_boxofficemojo_rankings.csv,1999,0.37946396897768203,0.6205360310223179
1655,Christmas with the Kranks,96572480,73780539,22791941,2004_boxofficemojo_rankings.csv,2004,0.7639913461888935,0.23600865381110644
1656,The Rite,96560591,33047633,63512958,2011_boxofficemojo_rankings.csv,2011,0.34224762563849676,0.6577523743615032
1657,13 Going on 30,96455697,57231747,39223950,2004_boxofficemojo_rankings.csv,2004,0.5933475033620875,0.4066524966379124
1658,Vicky Cristina Barcelona,96409300,23216709,73192591,2008_boxofficemojo_rankings.csv,2008,0.24081399823461014,0.7591860017653899
1659,Contraband,96262212,66528000,29734212,2012_boxofficemojo_rankings.csv,2012,0.6911123131057907,0.3088876868942093
1660,Red Eye,96258201,57891803,38366398,2005_boxofficemojo_rankings.csv,2005,0.6014220336405415,0.3985779663594586
1661,Kick-Ass,96188903,48071303,48117600,2010_boxofficemojo_rankings.csv,2010,0.4997593433413,0.5002406566587
1662,The Tigger Movie,96159800,45554533,50605267,2000_boxofficemojo_rankings.csv,2000,0.4737378093548448,0.5262621906451552
1663,Assassination,96119773,1904682,94215091,2015_boxofficemojo_rankings.csv,2015,0.019815714712518098,0.9801842852874819
1664,The Manchurian Candidate,96105910,65955630,30150280,2004_boxofficemojo_rankings.csv,2004,0.6862806876288877,0.3137193123711122
1665,The 6th Day,96085477,34604280,61481197,2000_boxofficemojo_rankings.csv,2000,0.36014058607420973,0.6398594139257903
1666,Think Like a Man,96070507,91547205,4523302,2012_boxofficemojo_rankings.csv,2012,0.9529168509540602,0.04708314904593977
1667,Dolphin Tale,95932565,72286779,23645786,2011_boxofficemojo_rankings.csv,2011,0.7535165874069978,0.2464834125930022
1668,The Favourite,95918706,34366783,61551923,2018_boxofficemojo_rankings.csv,2018,0.35829072798375744,0.6417092720162426
1669,Steel Magnolias,95904091,83759091,12145000,1989_boxofficemojo_rankings.csv,1989,0.8733630664410343,0.1266369335589657
1670,TMNT,95802916,54149098,41653818,2007_boxofficemojo_rankings.csv,2007,0.5652134638574049,0.43478653614259505
1671,Be Cool,95763716,56046979,39716737,2005_boxofficemojo_rankings.csv,2005,0.5852632013569733,0.41473679864302676
1672,Some Like It Hot,95721320,100026,95621294,2016_boxofficemojo_rankings.csv,2016,0.001044970963626494,0.9989550290363735
1673,My Sister's Keeper,95714875,49200230,46514645,2009_boxofficemojo_rankings.csv,2009,0.5140290890000118,0.48597091099998824
1674,Underworld,95708457,51970690,43737767,2003_boxofficemojo_rankings.csv,2003,0.5430104259229673,0.4569895740770327
1675,Shooter,95696996,47003582,48693414,2007_boxofficemojo_rankings.csv,2007,0.49117092452933425,0.5088290754706658
1676,Arthur,95461682,95461682,0,1981_boxofficemojo_rankings.csv,1981,1.0,0.0
1677,Poltergeist,95437994,47425125,48012869,2015_boxofficemojo_rankings.csv,2015,0.49692080703205055,0.5030791929679495
1678,The Mortal Instruments: City of Bones,95396573,31165421,64231152,2013_boxofficemojo_rankings.csv,2013,0.32669329746258285,0.6733067025374172
1679,Truth or Dare,95330493,41411015,53919478,2018_boxofficemojo_rankings.csv,2018,0.43439421843753606,0.565605781562464
1680,Rush,95224595,26947624,68276971,2013_boxofficemojo_rankings.csv,2013,0.28299016656358583,0.7170098334364142
1681,40 Days and 40 Nights,95146283,37950822,57195461,2002_boxofficemojo_rankings.csv,2002,0.3988681512655623,0.6011318487344377
1682,The Hustle,95017038,35417038,59600000,2019_boxofficemojo_rankings.csv,2019,0.3727440756467277,0.6272559243532723
1683,The Guardian,94973540,55011732,39961808,2006_boxofficemojo_rankings.csv,2006,0.5792321945670341,0.4207678054329659
1684,Changing Lanes,94935764,66818548,28117216,2002_boxofficemojo_rankings.csv,2002,0.7038290438153528,0.2961709561846471
1685,HouseSitter,94900635,58500635,36400000,1992_boxofficemojo_rankings.csv,1992,0.6164409226555755,0.3835590773444245
1686,Green Zone,94882549,35053660,59828889,2009_boxofficemojo_rankings.csv,2009,0.36944264640276475,0.6305573535972353
1687,The Wedding Planner,94728529,60400856,34327673,2001_boxofficemojo_rankings.csv,2001,0.6376205419594344,0.3623794580405656
1688,I Feel Pretty,94539426,48795601,45743825,2018_boxofficemojo_rankings.csv,2018,0.5161402291568811,0.48385977084311893
1689,Veteran,94393020,1200627,93192393,2015_boxofficemojo_rankings.csv,2015,0.01271944684045494,0.9872805531595451
1690,Masquerade,94268432,922921,93345511,2012_boxofficemojo_rankings.csv,2012,0.009790350602203715,0.9902096493977963
1691,Police Story: Lockdown,94249025,0,94249025,2013_boxofficemojo_rankings.csv,2013,0.0,1.0
1692,Fleet of Time,94244191,569280,93674911,2014_boxofficemojo_rankings.csv,2014,0.006040478399353017,0.9939595216006469
1693,The River Wild,94216343,46816343,47400000,1994_boxofficemojo_rankings.csv,1994,0.4969025702897426,0.5030974297102574
1694,The Color Purple,94175854,94175854,0,1985_boxofficemojo_rankings.csv,1985,1.0,0.0
1695,Dirty Grandpa,94073028,35593113,58479915,2016_boxofficemojo_rankings.csv,2016,0.378356195784407,0.6216438042155931
1696,Ben-Hur,94061311,26410477,67650834,2016_boxofficemojo_rankings.csv,2016,0.2807793844166174,0.7192206155833827
1697,Blockers,94017294,60311495,33705799,2018_boxofficemojo_rankings.csv,2018,0.6414936277574634,0.35850637224253656
1698,The Skeleton Key,93983911,47907715,46076196,2005_boxofficemojo_rankings.csv,2005,0.5097437900833899,0.49025620991661006
1699,Syriana,93974620,50824620,43150000,2005_boxofficemojo_rankings.csv,2005,0.540833471845909,0.459166528154091
1700,Speed Racer,93945766,43945766,50000000,2008_boxofficemojo_rankings.csv,2008,0.46777803695804665,0.5322219630419533
1701,In the Heart of the Sea,93920758,25020758,68900000,2015_boxofficemojo_rankings.csv,2015,0.26640285420183685,0.7335971457981632
1702,Forces of Nature,93900680,52900680,41000000,1999_boxofficemojo_rankings.csv,1999,0.5633684441901805,0.4366315558098195
1703,Nothing to Declare,93811164,0,93811164,2011_boxofficemojo_rankings.csv,2011,0.0,1.0
1704,Kill Zone 2,93638358,11998,93626360,2015_boxofficemojo_rankings.csv,2015,0.00012813125151126635,0.9998718687484888
1705,The Lovely Bones,93621340,44114232,49507108,2009_boxofficemojo_rankings.csv,2009,0.47119846821248235,0.5288015317875177
1706,The Internship,93492844,44672764,48820080,2013_boxofficemojo_rankings.csv,2013,0.4778201420421011,0.5221798579578989
1707,BlacKkKlansman,93400823,49275340,44125483,2018_boxofficemojo_rankings.csv,2018,0.5275685847008008,0.47243141529919924
1708,Calendar Girls,93400759,31041759,62359000,2003_boxofficemojo_rankings.csv,2003,0.3323501792956522,0.6676498207043479
1709,Goosebumps 2: Haunted Halloween,93320380,46700633,46619747,2018_boxofficemojo_rankings.csv,2018,0.5004333780038187,0.49956662199618135
1710,Money Monster,93282604,41012075,52270529,2016_boxofficemojo_rankings.csv,2016,0.43965405382551287,0.5603459461744872
1711,Nanny McPhee Returns,93251121,29011215,64239906,2010_boxofficemojo_rankings.csv,2010,0.3111084852266816,0.6888915147733183
1712,Legal Eagles,93151591,49851591,43300000,1986_boxofficemojo_rankings.csv,1986,0.5351662861024027,0.4648337138975973
1713,Mercury Rising,93107289,32935289,60172000,1998_boxofficemojo_rankings.csv,1998,0.3537348080234621,0.646265191976538
1714,Michael Clayton,92991835,49033882,43957953,2007_boxofficemojo_rankings.csv,2007,0.5272923370100181,0.47270766298998185
1715,Deuce Bigalow: Male Gigolo,92938755,65538755,27400000,1999_boxofficemojo_rankings.csv,1999,0.7051821922942695,0.2948178077057305
1716,Flashdance,92921203,92921203,0,1983_boxofficemojo_rankings.csv,1983,1.0,0.0
1717,Secret Window,92913171,48022900,44890271,2004_boxofficemojo_rankings.csv,2004,0.5168578306298469,0.48314216937015314
1718,The Family Stone,92884429,60062868,32821561,2005_boxofficemojo_rankings.csv,2005,0.646640870236711,0.353359129763289
1719,House of Flying Daggers,92863945,11050094,81813851,2004_boxofficemojo_rankings.csv,2004,0.11899229566437222,0.8810077043356278
1720,When Harry Met Sally...,92823546,92823546,0,1989_boxofficemojo_rankings.csv,1989,1.0,0.0
1721,Train to Busan,92742323,2129768,90612555,2016_boxofficemojo_rankings.csv,2016,0.022964359001445327,0.9770356409985547
1722,Role Models,92649419,67294270,25355149,2008_boxofficemojo_rankings.csv,2008,0.7263323475347427,0.2736676524652572
1723,No Reservations,92601050,43107979,49493071,2007_boxofficemojo_rankings.csv,2007,0.4655236522696017,0.5344763477303983
1724,1941,92455742,31755742,60700000,1979_boxofficemojo_rankings.csv,1979,0.34346965708197985,0.6565303429180201
1725,Four Brothers,92374674,74494381,17880293,2005_boxofficemojo_rankings.csv,2005,0.806437281716415,0.19356271828358496
1726,Downfall,92181574,5509040,86672534,2004_boxofficemojo_rankings.csv,2004,0.059762919648128375,0.9402370803518716
1727,Underworld: Rise of the Lycans,92158961,45802315,46356646,2009_boxofficemojo_rankings.csv,2009,0.4969925279431047,0.5030074720568952
1728,The Parent Trap,92108518,66308518,25800000,1998_boxofficemojo_rankings.csv,1998,0.7198956126945827,0.2801043873054173
1729,Fracture,92011561,39015018,52996543,2007_boxofficemojo_rankings.csv,2007,0.42402299858818826,0.5759770014118117
1730,"I Love You, Man",91980359,71440011,20540348,2009_boxofficemojo_rankings.csv,2009,0.7766876730715957,0.22331232692840436
1731,Southpaw,91970827,52421953,39548874,2015_boxofficemojo_rankings.csv,2015,0.5699845778270538,0.4300154221729462
1732,Behind Enemy Lines,91753202,58856790,32896412,2001_boxofficemojo_rankings.csv,2001,0.6414685124558378,0.3585314875441622
1733,Get Him to the Greek,91720255,60974475,30745780,2010_boxofficemojo_rankings.csv,2010,0.6647874561622185,0.33521254383778154
1734,Shadow,91708374,521396,91186978,2018_boxofficemojo_rankings.csv,2018,0.005685369582498541,0.9943146304175015
1735,Season of the Witch,91627228,24827228,66800000,2011_boxofficemojo_rankings.csv,2011,0.2709590647007241,0.7290409352992759
1736,Crawl,91542097,39014193,52527904,2019_boxofficemojo_rankings.csv,2019,0.4261885436161682,0.5738114563838318
1737,Five Feet Apart,91522094,45729221,45792873,2019_boxofficemojo_rankings.csv,2019,0.49965225883052894,0.500347741169471
1738,Friday the 13th,91509154,65002019,26507135,2009_boxofficemojo_rankings.csv,2009,0.7103335148306583,0.2896664851693416
1739,Rambo: Last Blood,91490353,44819352,46671001,2019_boxofficemojo_rankings.csv,2019,0.4898806325514997,0.5101193674485003
1740,Back to School,91258000,91258000,0,1986_boxofficemojo_rankings.csv,1986,1.0,0.0
1741,Overboard,91244913,50316123,40928790,2018_boxofficemojo_rankings.csv,2018,0.551440308787406,0.448559691212594
1742,White Noise,91196419,56386759,34809660,2005_boxofficemojo_rankings.csv,2005,0.6183001440001717,0.38169985599982825
1743,Romeo Must Die,91036760,55973336,35063424,2000_boxofficemojo_rankings.csv,2000,0.6148432347548397,0.3851567652451603
1744,Final Destination 2,90941129,46961214,43979915,2003_boxofficemojo_rankings.csv,2003,0.5163913678705264,0.4836086321294736
1745,Paranormal Activity: The Marked Ones,90894962,32462372,58432590,2014_boxofficemojo_rankings.csv,2014,0.35714159823291414,0.6428584017670859
1746,Fantasia 2000,90874570,60655420,30219150,2000_boxofficemojo_rankings.csv,2000,0.667463075753756,0.33253692424624404
1747,Drag Me to Hell,90842646,42100625,48742021,2009_boxofficemojo_rankings.csv,2009,0.4634456046117371,0.5365543953882629
1748,The Karate Kid,90815558,90815558,0,1984_boxofficemojo_rankings.csv,1984,1.0,0.0
1749,Racing Stripes,90754475,49772522,40981953,2005_boxofficemojo_rankings.csv,2005,0.5484304988817356,0.45156950111826444
1750,White Men Can't Jump,90753806,76253806,14500000,1992_boxofficemojo_rankings.csv,1992,0.8402270864540932,0.15977291354590684
1751,Autumn in New York,90726668,37761915,52964753,2000_boxofficemojo_rankings.csv,2000,0.4162162662030088,0.5837837337969912
1752,Galaxy Quest,90683916,71583916,19100000,1999_boxofficemojo_rankings.csv,1999,0.7893783060713876,0.21062169392861244
1753,Anchorman: The Legend of Ron Burgundy,90649730,85288303,5361427,2004_boxofficemojo_rankings.csv,2004,0.9408555657032845,0.0591444342967155
1754,My Big Fat Greek Wedding 2,90632641,59689605,30943036,2016_boxofficemojo_rankings.csv,2016,0.6585883887020351,0.34141161129796493
1755,Madea Goes to Jail,90508336,90508336,0,2009_boxofficemojo_rankings.csv,2009,1.0,0.0
1756,Sherlock Gnomes,90497778,43242871,47254907,2018_boxofficemojo_rankings.csv,2018,0.4778335110062039,0.522166488993796
1757,Bring It On,90449929,68379000,22070929,2000_boxofficemojo_rankings.csv,2000,0.7559873264245459,0.24401267357545411
1758,Trading Places,90404800,90404800,0,1983_boxofficemojo_rankings.csv,1983,1.0,0.0
1759,Bedazzled,90383208,37886980,52496228,2000_boxofficemojo_rankings.csv,2000,0.4191816249761792,0.5808183750238208
1760,Jojo Rabbit,90335025,33370906,56964119,2019_boxofficemojo_rankings.csv,2019,0.369412705647671,0.630587294352329
1761,Red Riding Hood,90260376,37662162,52598214,2011_boxofficemojo_rankings.csv,2011,0.4172613019028416,0.5827386980971584
1762,Identity,90259536,52159536,38100000,2003_boxofficemojo_rankings.csv,2003,0.5778839368285695,0.42211606317143047
1763,Detective Dee: The Four Heavenly Kings,90040771,262963,89777808,2018_boxofficemojo_rankings.csv,2018,0.0029204880975530517,0.9970795119024469
1764,Sucker Punch,89792502,36392502,53400000,2011_boxofficemojo_rankings.csv,2011,0.4052955557469598,0.5947044442530401
1765,The Abyss,89761361,54222310,35539051,1989_boxofficemojo_rankings.csv,1989,0.6040718344277334,0.3959281655722667
1766,Burlesque,89519773,39440655,50079118,2010_boxofficemojo_rankings.csv,2010,0.4405803732321797,0.5594196267678203
1767,The Hundred-Foot Journey,89514453,54240821,35273632,2014_boxofficemojo_rankings.csv,2014,0.6059448411085079,0.39405515889149206
1768,The Long Kiss Goodnight,89456761,33447612,56009149,1996_boxofficemojo_rankings.csv,1996,0.3738969712976753,0.6261030287023247
1769,Stigmata,89446268,50046268,39400000,1999_boxofficemojo_rankings.csv,1999,0.5595120860716067,0.4404879139283933
1770,The Host,89431890,2201923,87229967,2006_boxofficemojo_rankings.csv,2006,0.024621228512558553,0.9753787714874415
1771,Star Wars: Episode VI - Return of the Jedi 1997 Special Edition,89388357,45470437,43917920,1997_boxofficemojo_rankings.csv,1997,0.5086841119587867,0.49131588804121323
1772,The Purge,89328627,64473115,24855512,2013_boxofficemojo_rankings.csv,2013,0.7217519978226017,0.2782480021773983
1773,Father of the Bride,89325780,89325780,0,1991_boxofficemojo_rankings.csv,1991,1.0,0.0
1774,The Last Song,89137047,62950384,26186663,2010_boxofficemojo_rankings.csv,2010,0.7062202094265025,0.29377979057349746
1775,Transporter 2,89083229,43095856,45987373,2005_boxofficemojo_rankings.csv,2005,0.4837706994208753,0.5162293005791248
1776,Rumor Has It...,88933562,43000262,45933300,2005_boxofficemojo_rankings.csv,2005,0.4835099486963088,0.5164900513036912
1777,Kangaroo Jack,88929111,66934963,21994148,2003_boxofficemojo_rankings.csv,2003,0.7526777480098727,0.24732225199012728
1778,The Inbetweeners,88823111,36000,88787111,2011_boxofficemojo_rankings.csv,2011,0.00040529992244923735,0.9995947000775508
1779,The Cider House Rules,88545092,57545092,31000000,1999_boxofficemojo_rankings.csv,1999,0.6498958971096896,0.3501041028903104
1780,Collateral Beauty,88528280,31016021,57512259,2016_boxofficemojo_rankings.csv,2016,0.350351559976089,0.649648440023911
1781,Shanghai Knights,88323487,60476872,27846615,2003_boxofficemojo_rankings.csv,2003,0.6847201582971922,0.31527984170280776
1782,This Is 40,88215156,67544505,20670651,2012_boxofficemojo_rankings.csv,2012,0.7656791424820469,0.23432085751795304
1783,The Hand That Rocks the Cradle,88036683,88036683,0,1992_boxofficemojo_rankings.csv,1992,1.0,0.0
1784,Dhoom 3,88031955,8031955,80000000,2013_boxofficemojo_rankings.csv,2013,0.09123908471645324,0.9087609152835467
1785,Jaws 3-D,87987055,45517055,42470000,1983_boxofficemojo_rankings.csv,1983,0.5173153596287545,0.48268464037124553
1786,Chasing the Dragon,87965942,456854,87509088,2017_boxofficemojo_rankings.csv,2017,0.005193532742478902,0.9948064672575211
1787,The Illusionist,87892388,39868642,48023746,2006_boxofficemojo_rankings.csv,2006,0.45360745005585695,0.5463925499441431
1788,Spawn,87840042,54870175,32969867,1997_boxofficemojo_rankings.csv,1997,0.6246601635276996,0.3753398364723004
1789,State of Play,87812371,37017955,50794416,2009_boxofficemojo_rankings.csv,2009,0.42155740220247556,0.5784425977975245
1790,Gosford Park,87754044,41308615,46445429,2001_boxofficemojo_rankings.csv,2001,0.47073175339930773,0.5292682466006923
1791,Ali,87713825,58203105,29510720,2001_boxofficemojo_rankings.csv,2001,0.6635567996265127,0.3364432003734873
1792,RV,87528173,71726025,15802148,2006_boxofficemojo_rankings.csv,2006,0.819462151917646,0.180537848082354
1793,Bicentennial Man,87423861,58223861,29200000,1999_boxofficemojo_rankings.csv,1999,0.6659950765615351,0.33400492343846494
1794,Tiger Zinda Hai,87320000,5560921,81759079,2017_boxofficemojo_rankings.csv,2017,0.06368439074667888,0.9363156092533211
1795,Pain & Gain,87305549,49875291,37430258,2013_boxofficemojo_rankings.csv,2013,0.5712728637672274,0.42872713623277253
1796,Sultan,87280000,6200000,81080000,2016_boxofficemojo_rankings.csv,2016,0.07103574702108158,0.9289642529789184
1797,Epic Movie,87238158,39739367,47498791,2007_boxofficemojo_rankings.csv,2007,0.4555273507723535,0.5444726492276465
1798,A Million Ways to Die in the West,87189756,43139300,44050456,2014_boxofficemojo_rankings.csv,2014,0.49477486781818725,0.5052251321818128
1799,Old School,87135520,75585093,11550427,2003_boxofficemojo_rankings.csv,2003,0.8674429555249111,0.13255704447508893
1800,The Shaggy Dog,87134280,61123569,26010711,2006_boxofficemojo_rankings.csv,2006,0.701487049643378,0.298512950356622
1801,The Thieves,87126367,685839,86440528,2012_boxofficemojo_rankings.csv,2012,0.007871773191231536,0.9921282268087684
1802,About Time,87100449,15322921,71777528,2013_boxofficemojo_rankings.csv,2013,0.17592241114623874,0.8240775888537613
1803,Max Payne,87066930,40689393,46377537,2008_boxofficemojo_rankings.csv,2008,0.46733464703533245,0.5326653529646675
1804,The Kingdom,87019158,47536778,39482380,2007_boxofficemojo_rankings.csv,2007,0.5462794526235246,0.45372054737647544
1805,The Tale of Despereaux,86957280,50877145,36080135,2008_boxofficemojo_rankings.csv,2008,0.5850820655843881,0.4149179344156119
1806,The Naked Gun 2½: The Smell of Fear,86930411,86930411,0,1991_boxofficemojo_rankings.csv,1991,1.0,0.0
1807,Dinner for Schmucks,86855739,73026337,13829402,2010_boxofficemojo_rankings.csv,2010,0.8407773376955552,0.15922266230444485
1808,Snowpiercer,86758912,4563650,82195262,2013_boxofficemojo_rankings.csv,2013,0.052601512568530136,0.9473984874314698
1809,The Lincoln Lawyer,86752352,58009200,28743152,2011_boxofficemojo_rankings.csv,2011,0.6686758187259292,0.3313241812740708
1810,Romancing the Stone,86572238,76572238,10000000,1984_boxofficemojo_rankings.csv,1984,0.8844895288487287,0.11551047115127139
1811,Robin Hood,86489031,30824628,55664403,2018_boxofficemojo_rankings.csv,2018,0.35639927564918605,0.643600724350814
1812,Tears of the Sun,86468162,43734876,42733286,2003_boxofficemojo_rankings.csv,2003,0.5057916693082941,0.49420833069170594
1813,The Amityville Horror,86432000,86432000,0,1979_boxofficemojo_rankings.csv,1979,1.0,0.0
1814,Sky High,86369815,63946815,22423000,2005_boxofficemojo_rankings.csv,2005,0.7403838366447815,0.2596161633552185
1815,La Vie En Rose,86274793,10301706,75973087,2007_boxofficemojo_rankings.csv,2007,0.11940574577791221,0.8805942542220878
1816,A Taxi Driver,86252940,1527829,84725111,2017_boxofficemojo_rankings.csv,2017,0.01771335562590678,0.9822866443740932
1817,War Dogs,86234523,43034523,43200000,2016_boxofficemojo_rankings.csv,2016,0.4990405408747956,0.5009594591252045
1818,Step Up All In,86165646,14904384,71261262,2014_boxofficemojo_rankings.csv,2014,0.1729736233858213,0.8270263766141787
1819,Hall Pass,86157237,45060734,41096503,2011_boxofficemojo_rankings.csv,2011,0.523005792305062,0.47699420769493805
1820,I Can Only Imagine,86086881,83482352,2604529,2018_boxofficemojo_rankings.csv,2018,0.9697453436604353,0.030254656339564676
1821,Edward Scissorhands,86024005,56362352,29661653,1990_boxofficemojo_rankings.csv,1990,0.6551933033110933,0.3448066966889068
1822,John Wick,86013056,43037835,42975221,2014_boxofficemojo_rankings.csv,2014,0.5003639796265348,0.49963602037346516
1823,The Second Best Exotic Marigold Hotel,85978266,33078266,52900000,2015_boxofficemojo_rankings.csv,2015,0.38472822887588826,0.6152717711241118
1824,Meet the Spartans,85897593,38233676,47663917,2008_boxofficemojo_rankings.csv,2008,0.4451076527837049,0.5548923472162951
1825,Date Movie,85749034,48548426,37200608,2006_boxofficemojo_rankings.csv,2006,0.5661687803969897,0.43383121960301035
1826,Match Point,85638656,23151529,62487127,2005_boxofficemojo_rankings.csv,2005,0.2703397050042448,0.7296602949957552
1827,Volver,85585177,12899867,72685310,2006_boxofficemojo_rankings.csv,2006,0.15072548135292166,0.8492745186470784
1828,Spy Kids 4-D: All the Time in the World,85564310,38538188,47026122,2011_boxofficemojo_rankings.csv,2011,0.45040026618574963,0.5495997338142503
1829,Paper Towns,85512300,32000304,53511996,2015_boxofficemojo_rankings.csv,2015,0.37421872642882953,0.6257812735711704
1830,Rat Race,85498534,56618055,28880479,2001_boxofficemojo_rankings.csv,2001,0.6622108280827365,0.33778917191726354
1831,The Possession,85446075,49130154,36315921,2012_boxofficemojo_rankings.csv,2012,0.5749843278348362,0.42501567216516384
1832,Cocoon,85313124,76113124,9200000,1985_boxofficemojo_rankings.csv,1985,0.8921619609194009,0.10783803908059914
1833,Stripes,85297000,85297000,0,1981_boxofficemojo_rankings.csv,1981,1.0,0.0
1834,Did You Hear About the Morgans?,85280250,29580087,55700163,2009_boxofficemojo_rankings.csv,2009,0.34685741423131383,0.6531425857686862
1835,Nerve,85251425,38583626,46667799,2016_boxofficemojo_rankings.csv,2016,0.4525862881470896,0.5474137118529103
1836,Every Which Way but Loose,85196485,85196485,0,1978_boxofficemojo_rankings.csv,1978,1.0,0.0
1837,Rocky II,85182160,85182160,0,1979_boxofficemojo_rankings.csv,1979,1.0,0.0
1838,Final Fantasy: The Spirits Within,85131830,32131830,53000000,2001_boxofficemojo_rankings.csv,2001,0.3774361481481133,0.6225638518518867
1839,J. Edgar,84920539,37306030,47614509,2011_boxofficemojo_rankings.csv,2011,0.4393051485459837,0.5606948514540163
1840,Going in Style,84918541,45018541,39900000,2017_boxofficemojo_rankings.csv,2017,0.5301379471416025,0.46986205285839755
1841,Sicario,84872444,46889293,37983151,2015_boxofficemojo_rankings.csv,2015,0.5524678068655593,0.44753219313444065
1842,Carrie,84790678,35266619,49524059,2013_boxofficemojo_rankings.csv,2013,0.41592566343201076,0.5840743365679892
1843,Zodiac,84785914,33080084,51705830,2007_boxofficemojo_rankings.csv,2007,0.39016013910046426,0.6098398608995358
1844,The Animal,84772742,57743062,27029680,2001_boxofficemojo_rankings.csv,2001,0.6811512832745223,0.31884871672547765
1845,Jackass Number Two,84645164,72778712,11866452,2006_boxofficemojo_rankings.csv,2006,0.8598094511341486,0.14019054886585133
1846,Never Been Kissed,84565230,55474756,29090474,1999_boxofficemojo_rankings.csv,1999,0.6559995875373366,0.34400041246266344
1847,An American Tail,84542002,47483002,37059000,1986_boxofficemojo_rankings.csv,1986,0.5616498412233011,0.438350158776699
1848,The Land Before Time,84460846,48092846,36368000,1988_boxofficemojo_rankings.csv,1988,0.5694099488418575,0.43059005115814253
1849,Field of Dreams,84431625,64431625,20000000,1989_boxofficemojo_rankings.csv,1989,0.7631219344647222,0.2368780655352778
1850,The Judge,84419388,47119388,37300000,2014_boxofficemojo_rankings.csv,2014,0.5581583699706517,0.44184163002934823
1851,What to Expect When You're Expecting,84384002,41152203,43231799,2012_boxofficemojo_rankings.csv,2012,0.4876777828100639,0.5123222171899361
1852,Nights in Rodanthe,84375346,41850659,42524687,2008_boxofficemojo_rankings.csv,2008,0.4960057763792755,0.5039942236207244
1853,Leap!,84197417,2844490,81352927,2016_boxofficemojo_rankings.csv,2016,0.0337835779451524,0.9662164220548476
1854,Premonition,84146832,47852604,36294228,2007_boxofficemojo_rankings.csv,2007,0.5686798048439898,0.43132019515601017
1855,Finding Mr. Right,84112033,6945,84105088,2013_boxofficemojo_rankings.csv,2013,8.256844772733052e-05,0.9999174315522726
1856,Pan's Labyrinth,83850267,37634615,46215652,2006_boxofficemojo_rankings.csv,2006,0.4488311885757024,0.5511688114242975
1857,Marmaduke,83761844,33644788,50117056,2010_boxofficemojo_rankings.csv,2010,0.40167200712534457,0.5983279928746554
1858,In Her Shoes,83697473,32880591,50816882,2005_boxofficemojo_rankings.csv,2005,0.3928504627612831,0.6071495372387169
1859,Mortal Engines,83672673,15951040,67721633,2018_boxofficemojo_rankings.csv,2018,0.19063619492591088,0.8093638050740891
1860,Snatch,83557872,30328156,53229716,2000_boxofficemojo_rankings.csv,2000,0.3629598896439105,0.6370401103560895
1861,Point Break,83531958,43218387,40313571,1991_boxofficemojo_rankings.csv,1991,0.5173874530751452,0.4826125469248548
1862,Airplane!,83453539,83453539,0,1980_boxofficemojo_rankings.csv,1980,1.0,0.0
1863,Blow,83282296,52990775,30291521,2001_boxofficemojo_rankings.csv,2001,0.6362789877935162,0.36372101220648384
1864,Piranha 3D,83188165,25003155,58185010,2010_boxofficemojo_rankings.csv,2010,0.30056144404675833,0.6994385559532417
1865,"South Park: Bigger, Longer & Uncut",83137603,52037603,31100000,1999_boxofficemojo_rankings.csv,1999,0.6259213775985338,0.37407862240146617
1866,Oceans,83090556,19422319,63668237,2010_boxofficemojo_rankings.csv,2010,0.23374881496761196,0.766251185032388
1867,Rings,83080890,27793018,55287872,2017_boxofficemojo_rankings.csv,2017,0.33452961324800445,0.6654703867519955
1868,Savages,82966152,47382068,35584084,2012_boxofficemojo_rankings.csv,2012,0.5711011883496778,0.4288988116503222
1869,Once Upon A Time,82886178,485728,82400450,2017_boxofficemojo_rankings.csv,2017,0.005860180933906736,0.9941398190660933
1870,Firewall,82751189,48751189,34000000,2006_boxofficemojo_rankings.csv,2006,0.5891297706912707,0.41087022930872935
1871,28 Days Later...,82719885,45064915,37654970,2002_boxofficemojo_rankings.csv,2002,0.5447893816583521,0.45521061834164783
1872,"Big Mommas: Like Father, Like Son",82686066,37915414,44770652,2011_boxofficemojo_rankings.csv,2011,0.4585465947793429,0.5414534052206571
1873,Sinister,82515113,48086903,34428210,2012_boxofficemojo_rankings.csv,2012,0.5827647960683275,0.4172352039316725
1874,Act of Valor,82497035,70012847,12484188,2012_boxofficemojo_rankings.csv,2012,0.8486710704208945,0.1513289295791055
1875,The Constant Gardener,82466670,33579797,48886873,2005_boxofficemojo_rankings.csv,2005,0.4071923481328881,0.5928076518671119
1876,The Strangers,82410456,52597610,29812846,2008_boxofficemojo_rankings.csv,2008,0.6382395214510159,0.36176047854898413
1877,Hitman: Agent 47,82347656,22467450,59880206,2015_boxofficemojo_rankings.csv,2015,0.2728365455842483,0.7271634544157517
1878,Men of Honor,82343495,48818921,33524574,2000_boxofficemojo_rankings.csv,2000,0.5928691877846575,0.4071308122153426
1879,Dying Young,82264675,33669178,48595497,1991_boxofficemojo_rankings.csv,1991,0.40927868492764363,0.5907213150723564
1880,Star Trek: The Motion Picture,82258456,82258456,0,1979_boxofficemojo_rankings.csv,1979,1.0,0.0
1881,Hannibal Rising,82169884,27670986,54498898,2007_boxofficemojo_rankings.csv,2007,0.33675337791641524,0.6632466220835848
1882,Elizabeth,82150642,30082699,52067943,1998_boxofficemojo_rankings.csv,1998,0.36618945716821055,0.6338105428317894
1883,Reign of Fire,82150183,43061982,39088201,2002_boxofficemojo_rankings.csv,2002,0.5241860751545739,0.4758139248454261
1884,Catwoman,82102379,40202379,41900000,2004_boxofficemojo_rankings.csv,2004,0.48966156023323026,0.5103384397667697
1885,Abduction,82087155,28087155,54000000,2011_boxofficemojo_rankings.csv,2011,0.34216260753585626,0.6578373924641437
1886,The Chorus,82032134,2087128,79945006,2004_boxofficemojo_rankings.csv,2004,0.025442810009063035,0.974557189990937
1887,Hostel,81979826,47326473,34653353,2006_boxofficemojo_rankings.csv,2006,0.5772941381944382,0.4227058618055618
1888,Ouija: Origin of Evil,81705746,35144505,46561241,2016_boxofficemojo_rankings.csv,2016,0.43013504827432825,0.5698649517256718
1889,Heaven Can Wait,81640278,81640278,0,1978_boxofficemojo_rankings.csv,1978,1.0,0.0
1890,Midnight Run,81613606,38413606,43200000,1988_boxofficemojo_rankings.csv,1988,0.47067649479916374,0.5293235052008363
1891,One Piece: Stampede,81562741,1298528,80264213,2019_boxofficemojo_rankings.csv,2019,0.01592060276640286,0.9840793972335972
1892,Frankenweenie,81491068,35291068,46200000,2012_boxofficemojo_rankings.csv,2012,0.43306670124877983,0.5669332987512202
1893,Hope Floats,81471882,60053195,21418687,1998_boxofficemojo_rankings.csv,1998,0.7371033235736472,0.26289667642635284
1894,Waiting to Exhale,81452156,67052156,14400000,1995_boxofficemojo_rankings.csv,1995,0.8232090995847918,0.17679090041520817
1895,Tinker Tailor Soldier Spy,81244605,24149393,57095212,2011_boxofficemojo_rankings.csv,2011,0.297243035399089,0.7027569646009111
1896,Police Academy,81198894,81198894,0,1984_boxofficemojo_rankings.csv,1984,1.0,0.0
1897,Edge of Darkness,81126522,43313890,37812632,2010_boxofficemojo_rankings.csv,2010,0.5339054224461884,0.46609457755381156
1898,Underworld: Blood Wars,81093313,30353973,50739340,2016_boxofficemojo_rankings.csv,2016,0.37430919858953104,0.625690801410469
1899,Sinbad: Legend of the Seven Seas,80773077,26483452,54289625,2003_boxofficemojo_rankings.csv,2003,0.32787474469989547,0.6721252553001045
1900,Hot Fuzz,80743363,23637265,57106098,2007_boxofficemojo_rankings.csv,2007,0.292745609320236,0.707254390679764
1901,A Dog's Way Home,80708134,42004346,38703788,2019_boxofficemojo_rankings.csv,2019,0.5204474929379485,0.4795525070620515
1902,The Rookie,80693537,75600072,5093465,2002_boxofficemojo_rankings.csv,2002,0.9368788977486512,0.06312110225134883
1903,The Rundown,80657921,47726342,32931579,2003_boxofficemojo_rankings.csv,2003,0.5917130197293332,0.4082869802706668
1904,Moonstruck,80640528,80640528,0,1987_boxofficemojo_rankings.csv,1987,1.0,0.0
1905,Go Away Mr. Tumor,80606893,286639,80320254,2015_boxofficemojo_rankings.csv,2015,0.0035560110225312867,0.9964439889774687
1906,Vampires Suck,80547866,36661504,43886362,2010_boxofficemojo_rankings.csv,2010,0.4551517727359779,0.5448482272640222
1907,Den of Thieves,80509622,44947622,35562000,2018_boxofficemojo_rankings.csv,2018,0.5582888216764947,0.44171117832350526
1908,Halloween,80460948,58272029,22188919,2007_boxofficemojo_rankings.csv,2007,0.7242274724379335,0.2757725275620665
1909,Muppets Most Wanted,80383113,51183113,29200000,2014_boxofficemojo_rankings.csv,2014,0.6367396221641727,0.36326037783582726
1910,Hereditary,80200936,44069456,36131480,2018_boxofficemojo_rankings.csv,2018,0.5494880508626483,0.4505119491373517
1911,Runaway Jury,80154140,49443628,30710512,2003_boxofficemojo_rankings.csv,2003,0.6168568211199073,0.3831431788800928
1912,Finding Forrester,80049764,51804714,28245050,2000_boxofficemojo_rankings.csv,2000,0.6471563613854002,0.3528436386145998
1913,Footloose,80035402,80035402,0,1984_boxofficemojo_rankings.csv,1984,1.0,0.0
1914,Exit Wounds,79958599,51758599,28200000,2001_boxofficemojo_rankings.csv,2001,0.6473174823886046,0.35268251761139535
1915,The Golden Child,79817937,79817937,0,1986_boxofficemojo_rankings.csv,1986,1.0,0.0
1916,The Wedding Ringer,79799880,64460211,15339669,2015_boxofficemojo_rankings.csv,2015,0.8077732823658381,0.19222671763416185
1917,The Grey,79781695,51580236,28201459,2012_boxofficemojo_rankings.csv,2012,0.6465171741462751,0.353482825853725
1918,WarGames,79567667,79567667,0,1983_boxofficemojo_rankings.csv,1983,1.0,0.0
1919,Jackass: The Movie,79493831,64255312,15238519,2002_boxofficemojo_rankings.csv,2002,0.8083056407232405,0.19169435927675949
1920,Good Bye Lenin!,79316957,4064200,75252757,2003_boxofficemojo_rankings.csv,2003,0.05123998894713018,0.9487600110528698
1921,Letters to Juliet,79293444,53032453,26260991,2010_boxofficemojo_rankings.csv,2010,0.6688125817816666,0.3311874182183334
1922,Stealth,79268322,32116746,47151576,2005_boxofficemojo_rankings.csv,2005,0.40516495353591564,0.5948350464640844
1923,Uncle Buck,79258538,66758538,12500000,1989_boxofficemojo_rankings.csv,1989,0.8422882844495567,0.15771171555044328
1924,Home Alone 3,79082515,30882515,48200000,1997_boxofficemojo_rankings.csv,1997,0.3905100261416825,0.6094899738583175
1925,Manchester by the Sea,78988148,47695371,31292777,2016_boxofficemojo_rankings.csv,2016,0.603829463124012,0.396170536875988
1926,Lady Bird,78965611,48958273,30007338,2017_boxofficemojo_rankings.csv,2017,0.6199948608008617,0.3800051391991382
1927,Star Trek II: The Wrath of Khan,78912963,78912963,0,1982_boxofficemojo_rankings.csv,1982,1.0,0.0
1928,Paranormal Activity: The Ghost Dimension,78903124,18300124,60603000,2015_boxofficemojo_rankings.csv,2015,0.2319315519116835,0.7680684480883165
1929,48 Hrs.,78868508,78868508,0,1982_boxofficemojo_rankings.csv,1982,1.0,0.0
1930,The Boss,78844582,63285885,15558697,2016_boxofficemojo_rankings.csv,2016,0.8026662504216207,0.1973337495783794
1931,The Sentinel,78810595,36280697,42529898,2006_boxofficemojo_rankings.csv,2006,0.4603530400956876,0.5396469599043123
1932,Apocalypse Now,78784010,78784010,0,1979_boxofficemojo_rankings.csv,1979,1.0,0.0
1933,The Naked Gun: From the Files of Police Squad!,78756177,78756177,0,1988_boxofficemojo_rankings.csv,1988,1.0,0.0
1934,Teenage Mutant Ninja Turtles II: The Secret of the Ooze,78656813,78656813,0,1991_boxofficemojo_rankings.csv,1991,1.0,0.0
1935,The Orphanage,78638987,7161284,71477703,2007_boxofficemojo_rankings.csv,2007,0.09106531344306355,0.9089346865569364
1936,Curse of the Golden Flower,78568977,6566773,72002204,2006_boxofficemojo_rankings.csv,2006,0.08357971874827898,0.916420281251721
1937,The Attorney,78547586,557236,77990350,2013_boxofficemojo_rankings.csv,2013,0.007094247301247424,0.9929057526987526
1938,Righteous Kill,78460699,40081410,38379289,2008_boxofficemojo_rankings.csv,2008,0.5108469655617012,0.48915303443829883
1939,The Family,78418811,36918811,41500000,2013_boxofficemojo_rankings.csv,2013,0.47079024189744473,0.5292097581025552
1940,Collateral Damage,78382433,40077257,38305176,2002_boxofficemojo_rankings.csv,2002,0.5113040698800457,0.4886959301199543
1941,Scary Movie V,78378744,32015787,46362957,2013_boxofficemojo_rankings.csv,2013,0.4084753769465864,0.5915246230534136
1942,The Terminator,78371200,38371200,40000000,1984_boxofficemojo_rankings.csv,1984,0.4896084275856437,0.5103915724143563
1943,R.I.P.D.,78324220,33618855,44705365,2013_boxofficemojo_rankings.csv,2013,0.4292268087700075,0.5707731912299925
1944,Priest,78309505,29137000,49172505,2011_boxofficemojo_rankings.csv,2011,0.37207488414082046,0.6279251158591795
1945,If I Stay,78274843,50474843,27800000,2014_boxofficemojo_rankings.csv,2014,0.6448411911857811,0.3551588088142189
1946,K-9,78247647,43247647,35000000,1989_boxofficemojo_rankings.csv,1989,0.5527022045787524,0.44729779542124765
1947,The Other Boleyn Girl,78199679,26814957,51384722,2008_boxofficemojo_rankings.csv,2008,0.3429036709984449,0.6570963290015551
1948,Duplicity,78176181,40572825,37603356,2009_boxofficemojo_rankings.csv,2009,0.518992159517232,0.481007840482768
1949,Tag,78130625,54730625,23400000,2018_boxofficemojo_rankings.csv,2018,0.7005015638874001,0.2994984361125999
1950,Exorcist: The Beginning,78110021,41821986,36288035,2004_boxofficemojo_rankings.csv,2004,0.5354240783010416,0.46457592169895845
1951,Mirrors,78094714,30691439,47403275,2008_boxofficemojo_rankings.csv,2008,0.3930027709685959,0.6069972290314041
1952,Hooper,78000000,78000000,0,1978_boxofficemojo_rankings.csv,1978,1.0,0.0
1953,Shin Godzilla,77947607,1918403,76029204,2016_boxofficemojo_rankings.csv,2016,0.024611441888139043,0.975388558111861
1954,Orphan,77912251,41596251,36316000,2009_boxofficemojo_rankings.csv,2009,0.5338858840055847,0.4661141159944153
1955,Out of Sight,77745568,37562568,40183000,1998_boxofficemojo_rankings.csv,1998,0.4831473866137295,0.5168526133862704
1956,Showtime,77741732,38082712,39659020,2002_boxofficemojo_rankings.csv,2002,0.4898618929663157,0.5101381070336843
1957,Tiny Times,77717014,23462,77693552,2013_boxofficemojo_rankings.csv,2013,0.0003018901369525082,0.9996981098630475
1958,The Number 23,77677553,35193167,42484386,2007_boxofficemojo_rankings.csv,2007,0.4530674003080401,0.54693259969196
1959,Windtalkers,77628265,40914068,36714197,2002_boxofficemojo_rankings.csv,2002,0.5270511713742411,0.47294882862575893
1960,Next,77621983,18211013,59410970,2007_boxofficemojo_rankings.csv,2007,0.23461154039313836,0.7653884596068616
1961,Hostage,77608617,34639939,42968678,2005_boxofficemojo_rankings.csv,2005,0.4463414030429121,0.5536585969570879
1962,The Haunting in Connecticut,77536359,55389516,22146843,2009_boxofficemojo_rankings.csv,2009,0.7143682875281776,0.2856317124718224
1963,Serendipity,77516304,50294317,27221987,2001_boxofficemojo_rankings.csv,2001,0.6488224335360468,0.3511775664639532
1964,The Back-up Plan,77477008,37490007,39987001,2010_boxofficemojo_rankings.csv,2010,0.48388558060992753,0.5161144193900725
1965,The Lives of Others,77356942,11286112,66070830,2006_boxofficemojo_rankings.csv,2006,0.14589656349135413,0.8541034365086458
1966,Diary of a Wimpy Kid: Dog Days,77229695,49008662,28221033,2012_boxofficemojo_rankings.csv,2012,0.6345831354118386,0.3654168645881613
1967,Fame,77211836,22455510,54756326,2009_boxofficemojo_rankings.csv,2009,0.2908298929713315,0.7091701070286686
1968,Mike and Dave Need Wedding Dates,77068246,46009673,31058573,2016_boxofficemojo_rankings.csv,2016,0.596999093504736,0.40300090649526393
1969,Barbershop,77063924,75782105,1281819,2002_boxofficemojo_rankings.csv,2002,0.983366808573101,0.01663319142689905
1970,Drive,76976666,35061555,41915111,2011_boxofficemojo_rankings.csv,2011,0.45548289919441304,0.544517100805587
1971,"I, Frankenstein",76801179,19075290,57725889,2014_boxofficemojo_rankings.csv,2014,0.248372358971208,0.751627641028792
1972,United 93,76700659,31483450,45217209,2006_boxofficemojo_rankings.csv,2006,0.4104717014230608,0.5895282985769392
1973,Sanju,76693052,7909317,68783735,2018_boxofficemojo_rankings.csv,2018,0.10312951165380665,0.8968704883461933
1974,Coach Carter,76669554,67264877,9404677,2005_boxofficemojo_rankings.csv,2005,0.8773349196735903,0.12266508032640962
1975,The Ladykillers,76665191,39799191,36866000,2004_boxofficemojo_rankings.csv,2004,0.519129874730241,0.480870125269759
1976,Poltergeist,76606280,76606280,0,1982_boxofficemojo_rankings.csv,1982,1.0,0.0
1977,Father of the Bride Part II,76594107,76594107,0,1995_boxofficemojo_rankings.csv,1995,1.0,0.0
1978,The Book Thief,76586316,21488481,55097835,2013_boxofficemojo_rankings.csv,2013,0.28057859578987976,0.7194214042101202
1979,Bend It Like Beckham,76583333,32543449,44039884,2002_boxofficemojo_rankings.csv,2002,0.4249416645264055,0.5750583354735945
1980,The Unborn,76514050,42670410,33843640,2009_boxofficemojo_rankings.csv,2009,0.5576807135421533,0.4423192864578466
1981,Bad Santa,76488889,60060328,16428561,2003_boxofficemojo_rankings.csv,2003,0.7852163730604061,0.2147836269395938
1982,Star Trek III: The Search for Spock,76471046,76471046,0,1984_boxofficemojo_rankings.csv,1984,1.0,0.0
1983,The Road to El Dorado,76432727,50863742,25568985,2000_boxofficemojo_rankings.csv,2000,0.665470721723693,0.33452927827630696
1984,Cold Pursuit,76419755,32138862,44280893,2019_boxofficemojo_rankings.csv,2019,0.42055698817668286,0.5794430118233171
1985,The Ides of March,76338111,40962534,35375577,2011_boxofficemojo_rankings.csv,2011,0.5365934978401549,0.4634065021598452
1986,The Untouchables,76270454,76270454,0,1987_boxofficemojo_rankings.csv,1987,1.0,0.0
1987,Kubo and the Two Strings,76249438,48023088,28226350,2016_boxofficemojo_rankings.csv,2016,0.6298156322148892,0.37018436778511077
1988,Diary of a Wimpy Kid,76196538,64003625,12192913,2010_boxofficemojo_rankings.csv,2010,0.8399807482066968,0.16001925179330326
1989,Tae Guk Gi: The Brotherhood of War,76194339,1111061,75083278,2004_boxofficemojo_rankings.csv,2004,0.014581936329941782,0.9854180636700582
1990,There Will Be Blood,76181545,40222514,35959031,2007_boxofficemojo_rankings.csv,2007,0.5279823873354105,0.4720176126645896
1991,The Mechanic,76130093,29121498,47008595,2011_boxofficemojo_rankings.csv,2011,0.38252282182290254,0.6174771781770975
1992,If You Are the One 2,76085443,426894,75658549,2010_boxofficemojo_rankings.csv,2010,0.005610718465554574,0.9943892815344454
1993,Vice,76073488,47836282,28237206,2018_boxofficemojo_rankings.csv,2018,0.6288167304751426,0.3711832695248573
1994,The Pink Panther 2,76025134,35922978,40102156,2009_boxofficemojo_rankings.csv,2009,0.4725144976396885,0.5274855023603116
1995,Kate & Leopold,76019048,47121859,28897189,2001_boxofficemojo_rankings.csv,2001,0.6198691017546023,0.38013089824539764
1996,Death Race,76014335,36316032,39698303,2008_boxofficemojo_rankings.csv,2008,0.47775241340991803,0.522247586590082
1997,Widows,75984700,42402632,33582068,2018_boxofficemojo_rankings.csv,2018,0.5580417110286676,0.4419582889713324
1998,Revolutionary Road,75981180,22911480,53069700,2008_boxofficemojo_rankings.csv,2008,0.3015415133063214,0.6984584866936786
1999,Cruel Intentions,75902208,38328567,37573641,1999_boxofficemojo_rankings.csv,1999,0.5049730173857393,0.4950269826142607
2000,Sicario: Day of the Soldado,75837743,50072235,25765508,2018_boxofficemojo_rankings.csv,2018,0.6602548153364743,0.33974518466352566
2001,Elizabeth: The Golden Age,75782758,16383509,59399249,2007_boxofficemojo_rankings.csv,2007,0.21619045588179833,0.7838095441182017
2002,A Dog's Journey,75727748,22782371,52945377,2019_boxofficemojo_rankings.csv,2019,0.30084574811335996,0.69915425188664
2003,Dreamcatcher,75715436,33715436,42000000,2003_boxofficemojo_rankings.csv,2003,0.44529144625146183,0.5547085537485381
2004,Bajrangi Bhaijaan,75547184,8178001,67369183,2015_boxofficemojo_rankings.csv,2015,0.10825024265629808,0.8917497573437019
2005,30 Days of Night,75513170,39569000,35944170,2007_boxofficemojo_rankings.csv,2007,0.5240013099701681,0.47599869002983186
2006,Stomp the Yard,75511123,61356221,14154902,2007_boxofficemojo_rankings.csv,2007,0.8125454709500215,0.1874545290499785
2007,The Last of the Mohicans,75505856,75505856,0,1992_boxofficemojo_rankings.csv,1992,1.0,0.0
2008,Der Schuh des Manitu,75482094,0,75482094,2001_boxofficemojo_rankings.csv,2001,0.0,1.0
2009,Searching,75462037,26020957,49441080,2018_boxofficemojo_rankings.csv,2018,0.3448218208050758,0.6551781791949242
2010,The Change-Up,75450437,37081475,38368962,2011_boxofficemojo_rankings.csv,2011,0.49146799507602584,0.5085320049239741
2011,The Count of Monte Cristo,75395048,54234062,21160986,2002_boxofficemojo_rankings.csv,2002,0.719331885033086,0.280668114966914
2012,The Spy Who Dumped Me,75320680,33562069,41758611,2018_boxofficemojo_rankings.csv,2018,0.4455890334500432,0.5544109665499568
2013,Dragon Wars: D-War,75108817,10977721,64131096,2007_boxofficemojo_rankings.csv,2007,0.1461575543121655,0.8538424456878345
2014,Larry Crowne,75055070,35608245,39446825,2011_boxofficemojo_rankings.csv,2011,0.47442824315532584,0.5255717568446742
2015,Easy A,75026216,58401464,16624752,2010_boxofficemojo_rankings.csv,2010,0.7784140946146078,0.22158590538539222
2016,The Kite Runner,75011029,15800078,59210951,2007_boxofficemojo_rankings.csv,2007,0.21063673183312817,0.7893632681668719
2017,10,74865517,74865517,0,1979_boxofficemojo_rankings.csv,1979,1.0,0.0
2018,Tyler Perry's Boo! A Madea Halloween,74827344,73206343,1621001,2016_boxofficemojo_rankings.csv,2016,0.9783367828744529,0.021663217125547047
2019,The Prince of Tides,74787599,74787599,0,1991_boxofficemojo_rankings.csv,1991,1.0,0.0
2020,Tyler Perry's a Madea Family Funeral,74747725,73257045,1490680,2019_boxofficemojo_rankings.csv,2019,0.9800571856869222,0.019942814313077754
2021,Crimson Peak,74679822,31090320,43589502,2014_boxofficemojo_rankings.csv,2014,0.4163148648104705,0.5836851351895295
2022,Random Hearts,74608570,31502583,43105987,1999_boxofficemojo_rankings.csv,1999,0.42223812894416823,0.5777618710558318
2023,Escape from Planet Earth,74597643,57012977,17584666,2013_boxofficemojo_rankings.csv,2013,0.7642731687916735,0.23572683120832652
2024,From Hell,74558115,31602566,42955549,2001_boxofficemojo_rankings.csv,2001,0.4238648737297074,0.5761351262702926
2025,Hubble 3D,74249729,52522904,21726825,2010_boxofficemojo_rankings.csv,2010,0.7073817602755156,0.29261823972448436
2026,Hard Target,74189677,32589677,41600000,1993_boxofficemojo_rankings.csv,1993,0.4392750894440476,0.5607249105559524
2027,August: Osage County,74188937,37738810,36450127,2013_boxofficemojo_rankings.csv,2013,0.5086851426379111,0.4913148573620889
2028,Always,74134790,43858790,30276000,1989_boxofficemojo_rankings.csv,1989,0.5916087440188338,0.4083912559811662
2029,Eternal Sunshine of the Spotless Mind,74036715,34400301,39636414,2004_boxofficemojo_rankings.csv,2004,0.4646384027168142,0.5353615972831858
2030,Miracles from Heaven,73983003,61705123,12277880,2016_boxofficemojo_rankings.csv,2016,0.8340445845378837,0.16595541546211634
2031,The Hurricane,73956241,50699241,23257000,1999_boxofficemojo_rankings.csv,1999,0.6855302583591288,0.3144697416408711
2032,Divine Secrets of the Ya-Ya Sisterhood,73839240,69599016,4240224,2002_boxofficemojo_rankings.csv,2002,0.94257492357722,0.05742507642278008
2033,Cats,73834284,27166770,46667514,2019_boxofficemojo_rankings.csv,2019,0.3679424859053282,0.6320575140946718
2034,Obsessed,73830347,68261644,5568703,2009_boxofficemojo_rankings.csv,2009,0.9245743352662287,0.07542566473377132
2035,Beetlejuice,73707461,73707461,0,1988_boxofficemojo_rankings.csv,1988,1.0,0.0
2036,The Jerk,73691419,73691419,0,1979_boxofficemojo_rankings.csv,1979,1.0,0.0
2037,Perfect Stranger,73534117,23984949,49549168,2007_boxofficemojo_rankings.csv,2007,0.3261744341065522,0.6738255658934478
2038,The Core,73498611,31186896,42311715,2003_boxofficemojo_rankings.csv,2003,0.4243195289772211,0.575680471022779
2039,Life,73475268,64016268,9459000,1999_boxofficemojo_rankings.csv,1999,0.8712628036960682,0.12873719630393182
2040,Charlie's Angels,73279888,17803077,55476811,2019_boxofficemojo_rankings.csv,2019,0.24294629107511737,0.7570537089248827
2041,War Room,73267874,67790117,5477757,2015_boxofficemojo_rankings.csv,2015,0.9252365777666758,0.07476342223332426
2042,To Rome With Love,73244881,16685867,56559014,2012_boxofficemojo_rankings.csv,2012,0.22780932636097806,0.7721906736390219
2043,"Dude, Where's My Car?",73180723,46729800,26450923,2000_boxofficemojo_rankings.csv,2000,0.6385534070222291,0.36144659297777093
2044,Here Comes the Boom,73100172,45290318,27809854,2012_boxofficemojo_rankings.csv,2012,0.6195651359069305,0.3804348640930694
2045,Without a Paddle,73029190,58169327,14859863,2004_boxofficemojo_rankings.csv,2004,0.7965215963644127,0.20347840363558736
2046,The Best Man Holiday,72835710,70525195,2310515,2013_boxofficemojo_rankings.csv,2013,0.9682777170703766,0.0317222829296234
2047,Lady in the Water,72785169,42285169,30500000,2006_boxofficemojo_rankings.csv,2006,0.580958587868361,0.4190414121316391
2048,The One,72689126,43905746,28783380,2001_boxofficemojo_rankings.csv,2001,0.6040208269941229,0.3959791730058771
2049,"Yours, Mine & Ours",72662923,53412862,19250061,2005_boxofficemojo_rankings.csv,2005,0.7350772552874043,0.26492274471259575
2050,The Transporter Refueled,72629670,16029670,56600000,2015_boxofficemojo_rankings.csv,2015,0.22070415575342694,0.779295844246573
2051,Lord of War,72617068,24149632,48467436,2005_boxofficemojo_rankings.csv,2005,0.3325613752403223,0.6674386247596777
2052,Urban Legend,72527595,38072438,34455157,1998_boxofficemojo_rankings.csv,1998,0.524937273874861,0.475062726125139
2053,Diary of a Wimpy Kid: Rodrick Rules,72526996,52698535,19828461,2011_boxofficemojo_rankings.csv,2011,0.7266057868989914,0.27339421310100864
2054,Doctor Sleep,72381712,31581712,40800000,2019_boxofficemojo_rankings.csv,2019,0.4363217051290525,0.5636782948709476
2055,Second Act,72282227,39282227,33000000,2018_boxofficemojo_rankings.csv,2018,0.5434562357908536,0.45654376420914644
2056,Problem Child,72270891,53470891,18800000,1990_boxofficemojo_rankings.csv,1990,0.7398676045103691,0.2601323954896308
2057,What Men Want,72216294,54611903,17604391,2019_boxofficemojo_rankings.csv,2019,0.7562268841987377,0.24377311580126224
2058,The Cannonball Run,72179579,72179579,0,1981_boxofficemojo_rankings.csv,1981,1.0,0.0
2059,Around the World in 80 Days,72178895,24008137,48170758,2004_boxofficemojo_rankings.csv,2004,0.33261990225813237,0.6673800977418676
2060,Babylon A.D.,72109200,22532572,49576628,2008_boxofficemojo_rankings.csv,2008,0.3124784632196724,0.6875215367803276
2061,The Adventures of Sharkboy and Lavagirl 3-D,71992655,39177684,32814971,2005_boxofficemojo_rankings.csv,2005,0.5441900149397185,0.4558099850602815
2062,"O Brother, Where Art Thou?",71868327,45512588,26355739,2000_boxofficemojo_rankings.csv,2000,0.6332774102282915,0.36672258977170846
2063,Rules of Engagement,71732303,61335230,10397073,2000_boxofficemojo_rankings.csv,2000,0.8550573093965769,0.14494269060342313
2064,Ruthless People,71624879,71624879,0,1986_boxofficemojo_rankings.csv,1986,1.0,0.0
2065,Three Men and a Little Lady,71609321,71609321,0,1990_boxofficemojo_rankings.csv,1990,1.0,0.0
2066,Funny People,71585235,51855045,19730190,2009_boxofficemojo_rankings.csv,2009,0.7243818505310488,0.27561814946895125
2067,Superhero Movie,71571300,25881068,45690232,2008_boxofficemojo_rankings.csv,2008,0.3616123781459887,0.6383876218540113
2068,Run All Night,71561644,26461644,45100000,2015_boxofficemojo_rankings.csv,2015,0.3697741208963841,0.6302258791036159
2069,Grumpier Old Men,71518503,71518503,0,1995_boxofficemojo_rankings.csv,1995,1.0,0.0
2070,The Royal Tenenbaums,71441250,52364010,19077240,2001_boxofficemojo_rankings.csv,2001,0.7329660385281612,0.2670339614718387
2071,Brick Mansions,71416730,20396829,51019901,2014_boxofficemojo_rankings.csv,2014,0.28560295325759105,0.714397046742409
2072,Holes,71406573,67406573,4000000,2003_boxofficemojo_rankings.csv,2003,0.9439827479187385,0.05601725208126148
2073,National Lampoon's Christmas Vacation,71319526,71319526,0,1989_boxofficemojo_rankings.csv,1989,1.0,0.0
2074,Down to Earth,71186502,64186502,7000000,2001_boxofficemojo_rankings.csv,2001,0.9016667513737365,0.09833324862626344
2075,Turner & Hooch,71079915,71079915,0,1989_boxofficemojo_rankings.csv,1989,1.0,0.0
2076,xXx: State of the Union,71022693,26873932,44148761,2005_boxofficemojo_rankings.csv,2005,0.37838514515353566,0.6216148548464644
2077,The Counselor,71009334,16973715,54035619,2013_boxofficemojo_rankings.csv,2013,0.23903498376706364,0.7609650162329363
2078,Anacondas: The Hunt for the Blood Orchid,70992898,32238923,38753975,2004_boxofficemojo_rankings.csv,2004,0.45411476229636377,0.5458852377036362
2079,Groundhog Day,70906973,70906973,0,1993_boxofficemojo_rankings.csv,1993,1.0,0.0
2080,Son of God,70829270,59700064,11129206,2014_boxofficemojo_rankings.csv,2014,0.842872784090532,0.15712721590946793
2081,I Am Not Madame Bovary,70826207,436798,70389409,2016_boxofficemojo_rankings.csv,2016,0.006167180461887504,0.9938328195381125
2082,Taxi 2004 Re-release,70778329,36611066,34167263,2004_boxofficemojo_rankings.csv,2004,0.5172637799911891,0.4827362200088109
2083,Brotherhood of the Wolf,70752904,11260096,59492808,2001_boxofficemojo_rankings.csv,2001,0.15914676802523894,0.840853231974761
2084,Ferris Bueller's Day Off,70712677,70136369,576308,1986_boxofficemojo_rankings.csv,1986,0.9918500044907083,0.008149995509291777
2085,The Grudge 2,70711175,39143839,31567336,2006_boxofficemojo_rankings.csv,2006,0.5535735900301473,0.4464264099698527
2086,Any Which Way You Can,70687344,70687344,0,1980_boxofficemojo_rankings.csv,1980,1.0,0.0
2087,Hannah Montana and Miley Cyrus: Best of Both Worlds Concert,70642966,65281781,5361185,2008_boxofficemojo_rankings.csv,2008,0.9241087215958628,0.07589127840413722
2088,Stop! Or My Mom Will Shoot,70611210,28411210,42200000,1992_boxofficemojo_rankings.csv,1992,0.40236118316057745,0.5976388168394225
2089,Children of Men,70455770,35552383,34903387,2006_boxofficemojo_rankings.csv,2006,0.5046056980145133,0.4953943019854868
2090,Departures,70442129,1498210,68943919,2008_boxofficemojo_rankings.csv,2008,0.021268664381225617,0.9787313356187743
2091,The House Bunny,70439696,48237389,22202307,2008_boxofficemojo_rankings.csv,2008,0.6848040485580744,0.3151959514419256
2092,Spirited Away 2018 Re-release,70186029,1175067,69010962,2018_boxofficemojo_rankings.csv,2018,0.016742178133485795,0.9832578218665142
2093,Think Like a Man Too,70181428,65182182,4999246,2014_boxofficemojo_rankings.csv,2014,0.9287668241803231,0.07123317581967696
2094,License to Wed,70181325,43799818,26381507,2007_boxofficemojo_rankings.csv,2007,0.6240950566265313,0.37590494337346864
2095,Grumpy Old Men,70172621,70172621,0,1993_boxofficemojo_rankings.csv,1993,1.0,0.0
2096,A Cinderella Story,70067909,51438175,18629734,2004_boxofficemojo_rankings.csv,2004,0.7341188817265832,0.2658811182734167
2097,3:10 to Yuma,70016220,53606916,16409304,2007_boxofficemojo_rankings.csv,2007,0.7656356769902746,0.23436432300972546
2098,The Hills Have Eyes,70008952,41778863,28230089,2006_boxofficemojo_rankings.csv,2006,0.5967645823351276,0.40323541766487236
2099,The Cabin in the Woods,69935600,42073277,27862323,2012_boxofficemojo_rankings.csv,2012,0.6016002865493397,0.39839971345066033
2100,Curious George,69865924,58360760,11505164,2006_boxofficemojo_rankings.csv,2006,0.8353251006885702,0.1646748993114297
2101,Private Benjamin,69847348,69847348,0,1980_boxofficemojo_rankings.csv,1980,1.0,0.0
2102,Splash,69821334,69821334,0,1984_boxofficemojo_rankings.csv,1984,1.0,0.0
2103,The Brave One,69787394,36793804,32993590,2007_boxofficemojo_rankings.csv,2007,0.5272270805813439,0.472772919418656
2104,After,69746452,12138565,57607887,2019_boxofficemojo_rankings.csv,2019,0.17403845861578737,0.8259615413842126
2105,The Dilemma,69721966,48475290,21246676,2011_boxofficemojo_rankings.csv,2011,0.6952656785380952,0.3047343214619048
2106,The Best Little Whorehouse in Texas,69701637,69701637,0,1982_boxofficemojo_rankings.csv,1982,1.0,0.0
2107,Exit,69501772,470699,69031073,2019_boxofficemojo_rankings.csv,2019,0.006772474808268198,0.9932275251917319
2108,Because I Said So,69485490,42674040,26811450,2007_boxofficemojo_rankings.csv,2007,0.6141431829868366,0.3858568170131635
2109,Mr. Magorium's Wonder Emporium,69474661,32061555,37413106,2007_boxofficemojo_rankings.csv,2007,0.46148559112796533,0.5385144088720346
2110,The Last Exorcism,69432527,41034350,28398177,2010_boxofficemojo_rankings.csv,2010,0.5909960615433167,0.40900393845668326
2111,A Very Long Engagement,69424389,6524389,62900000,2004_boxofficemojo_rankings.csv,2004,0.0939783423949183,0.9060216576050817
2112,13 Hours,69411370,52853219,16558151,2015_boxofficemojo_rankings.csv,2015,0.7614490104431018,0.23855098955689824
2113,The X Files: I Want to Believe,69363381,20982478,48380903,2008_boxofficemojo_rankings.csv,2008,0.302500796493758,0.697499203506242
2114,Finding Nemo 2012 3D Release,69328283,41128283,28200000,2012_boxofficemojo_rankings.csv,2012,0.5932396017942634,0.4067603982057366
2115,E.T. the Extra-Terrestrial 20th Anniversary,69177751,35306015,33871736,2002_boxofficemojo_rankings.csv,2002,0.5103666206205518,0.4896333793794482
2116,Babe: Pig in the City,69131860,18319860,50812000,1998_boxofficemojo_rankings.csv,1998,0.2649988008423323,0.7350011991576677
2117,The Men Who Stare at Goats,69095771,32428195,36667576,2009_boxofficemojo_rankings.csv,2009,0.4693224278516264,0.5306775721483736
2118,Takers,69055695,57744720,11310975,2010_boxofficemojo_rankings.csv,2010,0.8362050371080908,0.1637949628919092
2119,Anna Karenina,68929150,12816367,56112783,2012_boxofficemojo_rankings.csv,2012,0.18593536986891612,0.8140646301310839
2120,Conan the Barbarian,68851475,39565475,29286000,1982_boxofficemojo_rankings.csv,1982,0.5746496353200857,0.4253503646799143
2121,John Tucker Must Die,68844775,41011711,27833064,2006_boxofficemojo_rankings.csv,2006,0.5957127610628403,0.40428723893715973
2122,Don Juan DeMarco,68792531,22150451,46642080,1995_boxofficemojo_rankings.csv,1995,0.3219891851340664,0.6780108148659336
2123,Running Man,68782475,310978,68471497,2015_boxofficemojo_rankings.csv,2015,0.004521180722269735,0.9954788192777303
2124,Land of the Lost,68777554,49438370,19339184,2009_boxofficemojo_rankings.csv,2009,0.718815472850343,0.28118452714965697
2125,House of Wax,68766121,32064800,36701321,2005_boxofficemojo_rankings.csv,2005,0.46628775236573256,0.5337122476342675
2126,The Nut Job 2: Nutty by Nature,68743485,28370522,40372963,2017_boxofficemojo_rankings.csv,2017,0.41270124725273966,0.5872987527472603
2127,Witness,68706993,68706993,0,1985_boxofficemojo_rankings.csv,1985,1.0,0.0
2128,The Sweetest Thing,68696770,24718164,43978606,2002_boxofficemojo_rankings.csv,2002,0.35981551971075204,0.6401844802892479
2129,Letters from Iwo Jima,68673228,13756082,54917146,2006_boxofficemojo_rankings.csv,2006,0.20031215075545888,0.7996878492445412
2130,Playing with Fire,68631669,44451847,24179822,2019_boxofficemojo_rankings.csv,2019,0.6476871049136224,0.3523128950863777
2131,The Call,68572631,51872378,16700253,2013_boxofficemojo_rankings.csv,2013,0.7564589143444124,0.24354108565558757
2132,One Direction: This Is Us,68532898,28873374,39659524,2013_boxofficemojo_rankings.csv,2013,0.4213067715303678,0.5786932284696322
2133,Looney Tunes: Back in Action,68514844,20991364,47523480,2003_boxofficemojo_rankings.csv,2003,0.3063768779799017,0.6936231220200983
2134,Dan in Real Life,68471669,47642963,20828706,2007_boxofficemojo_rankings.csv,2007,0.6958054870840085,0.3041945129159916
2135,Thir13en Ghosts,68467960,41867960,26600000,2001_boxofficemojo_rankings.csv,2001,0.6114971148548898,0.3885028851451102
2136,Pokémon 3 the Movie: Spell of the Unown,68411275,17052128,51359147,2001_boxofficemojo_rankings.csv,2001,0.24925902930474544,0.7507409706952546
2137,Purple Rain,68392977,68392977,0,1984_boxofficemojo_rankings.csv,1984,1.0,0.0
2138,Ghost Ship,68349884,30113491,38236393,2002_boxofficemojo_rankings.csv,2002,0.4405785238786945,0.5594214761213054
2139,Stalingrad,68316452,1013945,67302507,2013_boxofficemojo_rankings.csv,2013,0.014841886109659207,0.9851581138903408
2140,Open Range,68296293,58331254,9965039,2003_boxofficemojo_rankings.csv,2003,0.8540910705065646,0.1459089294934353
2141,Star Wars: The Clone Wars,68282844,35161554,33121290,2008_boxofficemojo_rankings.csv,2008,0.514939799519774,0.485060200480226
2142,The Watch,68267862,35353000,32914862,2012_boxofficemojo_rankings.csv,2012,0.5178571433802922,0.4821428566197078
2143,Moonrise Kingdom,68263166,45512466,22750700,2012_boxofficemojo_rankings.csv,2012,0.6667207026407185,0.3332792973592816
2144,Saw VI,68234154,27693292,40540862,2009_boxofficemojo_rankings.csv,2009,0.40585675027201185,0.5941432497279882
2145,Frequency,68106245,45010278,23095967,2000_boxofficemojo_rankings.csv,2000,0.6608832714239348,0.33911672857606523
2146,Fearless,68072848,24633730,43439118,2006_boxofficemojo_rankings.csv,2006,0.3618730628105937,0.6381269371894063
2147,Shoplifters,67999335,3313513,64685822,2018_boxofficemojo_rankings.csv,2018,0.04872860889007223,0.9512713911099278
2148,Prime,67937494,22827153,45110341,2005_boxofficemojo_rankings.csv,2005,0.33600228174445174,0.6639977182555482
2149,Legion,67918658,40168080,27750578,2010_boxofficemojo_rankings.csv,2010,0.591414512342102,0.4085854876578981
2150,Octopussy,67893619,67893619,0,1983_boxofficemojo_rankings.csv,1983,1.0,0.0
2151,The American,67876281,35606376,32269905,2010_boxofficemojo_rankings.csv,2010,0.5245775913975016,0.4754224086024984
2152,All About My Mother,67872296,8272296,59600000,1999_boxofficemojo_rankings.csv,1999,0.12188030297369047,0.8781196970263095
2153,A Beautiful Day in the Neighborhood,67760877,61704055,6056822,2019_boxofficemojo_rankings.csv,2019,0.9106147637374882,0.08938523626251177
2154,Austin Powers: International Man of Mystery,67683989,53883989,13800000,1997_boxofficemojo_rankings.csv,1997,0.7961113078013177,0.20388869219868233
2155,Jersey Boys,67647013,47047013,20600000,2014_boxofficemojo_rankings.csv,2014,0.6954780545890474,0.30452194541095257
2156,Sudden Impact,67642693,67642693,0,1983_boxofficemojo_rankings.csv,1983,1.0,0.0
2157,Bandits,67631903,41575141,26056762,2001_boxofficemojo_rankings.csv,2001,0.614726765857823,0.38527323414217696
2158,12 Strong,67450815,45819713,21631102,2018_boxofficemojo_rankings.csv,2018,0.6793055502739292,0.32069444972607075
2159,The Next Three Days,67448651,21148651,46300000,2010_boxofficemojo_rankings.csv,2010,0.3135518751887269,0.6864481248112732
2160,Star Trek: Nemesis,67336470,43254409,24082061,2002_boxofficemojo_rankings.csv,2002,0.6423622889646576,0.35763771103534236
2161,Broadcast News,67331309,51249404,16081905,1987_boxofficemojo_rankings.csv,1987,0.7611526459406871,0.23884735405931287
2162,The Little Rascals,67308282,52125282,15183000,1994_boxofficemojo_rankings.csv,1994,0.7744259762862467,0.22557402371375337
2163,American Assassin,67234188,36249674,30984514,2017_boxofficemojo_rankings.csv,2017,0.5391553773208356,0.4608446226791644
2164,Boogeyman,67192859,46752382,20440477,2005_boxofficemojo_rankings.csv,2005,0.6957939086949702,0.3042060913050299
2165,Coal Miner's Daughter,67182787,67182787,0,1980_boxofficemojo_rankings.csv,1980,1.0,0.0
2166,War,67179155,4654000,62525155,2019_boxofficemojo_rankings.csv,2019,0.06927744178979328,0.9307225582102068
2167,The Girl Who Played with Fire,67153225,7638241,59514984,2009_boxofficemojo_rankings.csv,2009,0.11374347248400951,0.8862565275159905
2168,"Lust, Caution",67091915,4604982,62486933,2007_boxofficemojo_rankings.csv,2007,0.06863691400074062,0.9313630859992593
2169,When a Stranger Calls,67062123,47860214,19201909,2006_boxofficemojo_rankings.csv,2006,0.7136698311802625,0.2863301688197375
2170,Skyline,66984887,21393620,45591267,2010_boxofficemojo_rankings.csv,2010,0.31937980279044137,0.6806201972095586
2171,The Giver,66980456,45090374,21890082,2014_boxofficemojo_rankings.csv,2014,0.6731870263767687,0.32681297362323125
2172,The Messenger: The Story of Joan of Arc,66976317,14276317,52700000,1999_boxofficemojo_rankings.csv,1999,0.2131547036245663,0.7868452963754338
2173,Madea's Witness Protection,66899242,65653242,1246000,2012_boxofficemojo_rankings.csv,2012,0.9813749758181116,0.018625024181888338
2174,Mulan,66800000,0,66800000,2020_boxofficemojo_rankings.csv,2020,0.0,1.0
2175,Selma,66787908,52076908,14711000,2014_boxofficemojo_rankings.csv,2014,0.779735577284439,0.22026442271556101
2176,Dragnet,66673516,57387516,9286000,1987_boxofficemojo_rankings.csv,1987,0.8607243091844744,0.1392756908155256
2177,Thirteen Days,66579890,34592089,31987801,2000_boxofficemojo_rankings.csv,2000,0.5195576171723925,0.48044238282760754
2178,Victoria & Abdul,66558465,22245070,44313395,2017_boxofficemojo_rankings.csv,2017,0.33421849497280326,0.6657815050271968
2179,Take the Lead,66499627,34742066,31757561,2006_boxofficemojo_rankings.csv,2006,0.5224400130845847,0.47755998691541535
2180,Street Kings,66476363,26418667,40057696,2008_boxofficemojo_rankings.csv,2008,0.39741444639502915,0.6025855536049708
2181,Not Another Teen Movie,66468332,38252284,28216048,2001_boxofficemojo_rankings.csv,2001,0.5754963732202577,0.4245036267797423
2182,Mighty Morphin Power Rangers: The Movie,66433194,38187431,28245763,1995_boxofficemojo_rankings.csv,1995,0.5748245523164218,0.4251754476835782
2183,"Love, Simon",66316289,40826341,25489948,2018_boxofficemojo_rankings.csv,2018,0.615630663531248,0.38436933646875204
2184,Mile 22,66308758,36108758,30200000,2018_boxofficemojo_rankings.csv,2018,0.5445548836851989,0.4554451163148011
2185,One Piece Film: Gold,66207073,423593,65783480,2016_boxofficemojo_rankings.csv,2016,0.00639800221949096,0.9936019977805091
2186,Smokey and the Bandit II,66132626,66132626,0,1980_boxofficemojo_rankings.csv,1980,1.0,0.0
2187,August Rush,66122026,31664162,34457864,2007_boxofficemojo_rankings.csv,2007,0.47887464912221533,0.5211253508777847
2188,Barbershop 2: Back in Business,65991448,65111277,880171,2004_boxofficemojo_rankings.csv,2004,0.9866623475211516,0.013337652478848471
2189,Bad Company,65977295,30160161,35817134,2002_boxofficemojo_rankings.csv,2002,0.45712939580199524,0.5428706041980048
2190,Flags of Our Fathers,65900249,33602376,32297873,2006_boxofficemojo_rankings.csv,2006,0.50989755744322,0.49010244255678004
2191,Life of the Party,65859911,53059911,12800000,2018_boxofficemojo_rankings.csv,2018,0.8056480823364611,0.1943519176635389
2192,Beijing Love Story,65842375,428318,65414057,2014_boxofficemojo_rankings.csv,2014,0.0065052027664554936,0.9934947972335445
2193,In the Name of the Father,65796862,25096862,40700000,1993_boxofficemojo_rankings.csv,1993,0.3814294669554302,0.6185705330445698
2194,Stuck on You,65784503,33832741,31951762,2003_boxofficemojo_rankings.csv,2003,0.5142965205650334,0.4857034794349666
2195,Sweet November,65754228,25288103,40466125,2001_boxofficemojo_rankings.csv,2001,0.384585201121972,0.6154147988780281
2196,The Widowmaker,65716126,35168966,30547160,2002_boxofficemojo_rankings.csv,2002,0.5351649304464478,0.4648350695535522
2197,Stakeout,65673233,65673233,0,1987_boxofficemojo_rankings.csv,1987,1.0,0.0
2198,16 Blocks,65664721,36895141,28769580,2006_boxofficemojo_rankings.csv,2006,0.5618715870276827,0.43812841297231736
2199,The Age of Adaline,65663276,42629776,23033500,2015_boxofficemojo_rankings.csv,2015,0.6492179281460158,0.35078207185398425
2200,The Hard Way,65595485,25895485,39700000,1991_boxofficemojo_rankings.csv,1991,0.3947754178507865,0.6052245821492135
2201,Matchstick Men,65565672,36906460,28659212,2003_boxofficemojo_rankings.csv,2003,0.5628930334154129,0.43710696658458714
2202,Taxi 3,65497208,497208,65000000,2003_boxofficemojo_rankings.csv,2003,0.007591285417845597,0.9924087145821544
2203,Taking Lives,65470529,32682342,32788187,2004_boxofficemojo_rankings.csv,2004,0.4991916591967662,0.5008083408032338
2204,Moonlight,65336603,27854932,37481671,2016_boxofficemojo_rankings.csv,2016,0.42632966394044086,0.5736703360595592
2205,Underdog,65270477,43760605,21509872,2007_boxofficemojo_rankings.csv,2007,0.6704502098245735,0.32954979017542646
2206,The Muppet Movie,65200000,65200000,0,1979_boxofficemojo_rankings.csv,1979,1.0,0.0
2207,Scarface,65144798,44668798,20476000,1983_boxofficemojo_rankings.csv,1983,0.6856848032593486,0.3143151967406515
2208,Something Borrowed,65100369,39046489,26053880,2011_boxofficemojo_rankings.csv,2011,0.5997890580312993,0.40021094196870066
2209,Space Chimps,65097693,30105968,34991725,2008_boxofficemojo_rankings.csv,2008,0.4624736547883502,0.5375263452116498
2210,*batteries not included,65088797,32945797,32143000,1987_boxofficemojo_rankings.csv,1987,0.5061669368386084,0.49383306316139164
2211,Zathura: A Space Adventure,65079104,29258869,35820235,2005_boxofficemojo_rankings.csv,2005,0.44958930288898874,0.5504106971110112
2212,28 Weeks Later,65048678,28638916,36409762,2007_boxofficemojo_rankings.csv,2007,0.440268993629663,0.559731006370337
2213,K-PAX,65001485,50338485,14663000,2001_boxofficemojo_rankings.csv,2001,0.7744205382384726,0.22557946176152746
2214,The Benchwarmers,64962629,59843754,5118875,2006_boxofficemojo_rankings.csv,2006,0.921202773366823,0.07879722663317705
2215,Staying Alive,64892670,64892670,0,1983_boxofficemojo_rankings.csv,1983,1.0,0.0
2216,The Pirates,64858224,415775,64442449,2014_boxofficemojo_rankings.csv,2014,0.006410520892462304,0.9935894791075377
2217,The Bank Job,64822796,30060660,34762136,2008_boxofficemojo_rankings.csv,2008,0.4637359363517735,0.5362640636482264
2218,Lions for Lambs,64811540,15002854,49808686,2007_boxofficemojo_rankings.csv,2007,0.2314843004810563,0.7685156995189437
2219,Mr. Mom,64783827,64783827,0,1983_boxofficemojo_rankings.csv,1983,1.0,0.0
2220,Hot Tub Time Machine,64735752,50287556,14448196,2010_boxofficemojo_rankings.csv,2010,0.7768127262969,0.22318727370309996
2221,God's Not Dead,64667874,60755732,3912142,2014_boxofficemojo_rankings.csv,2014,0.9395040882277961,0.060495911772203925
2222,The Darkest Hour,64626786,21443494,43183292,2011_boxofficemojo_rankings.csv,2011,0.3318050506178661,0.6681949493821339
2223,Happy Death Day 2U,64600152,28148130,36452022,2019_boxofficemojo_rankings.csv,2019,0.43572854131984085,0.5642714586801592
2224,Monster Trucks,64493915,33370166,31123749,2016_boxofficemojo_rankings.csv,2016,0.5174157282900255,0.4825842717099745
2225,Miracle,64445708,64378093,67615,2004_boxofficemojo_rankings.csv,2004,0.9989508222952567,0.0010491777047433478
2226,Baby Mama,64444713,60494212,3950501,2008_boxofficemojo_rankings.csv,2008,0.9386993778682823,0.061300622131717775
2227,Kiss of the Dragon,64437847,36845124,27592723,2001_boxofficemojo_rankings.csv,2001,0.5717932195965517,0.4282067804034483
2228,Capernaum,64417003,1661096,62755907,2018_boxofficemojo_rankings.csv,2018,0.025786607923997954,0.974213392076002
2229,Fences,64414761,57682904,6731857,2016_boxofficemojo_rankings.csv,2016,0.8954920130806664,0.10450798691933359
2230,Sudden Death,64350171,20350171,44000000,1995_boxofficemojo_rankings.csv,1995,0.3162411332209203,0.6837588667790797
2231,Zhongkui: Snow Girl and the Dark Crystal,64325947,165428,64160519,2015_boxofficemojo_rankings.csv,2015,0.002571714956641058,0.9974282850433589
2232,Wag the Dog,64256513,43061945,21194568,1997_boxofficemojo_rankings.csv,1997,0.6701568913333346,0.32984310866666544
2233,Isle of Dogs,64241499,32015231,32226268,2018_boxofficemojo_rankings.csv,2018,0.49835747139088393,0.5016425286091161
2234,Thunder and the House of Magic,64197205,4091,64193114,2013_boxofficemojo_rankings.csv,2013,6.372551577595941e-05,0.9999362744842241
2235,The Danish Girl,64191523,11114018,53077505,2015_boxofficemojo_rankings.csv,2015,0.1731384064528271,0.8268615935471729
2236,The Boy,64188367,35819556,28368811,2015_boxofficemojo_rankings.csv,2015,0.5580381255064488,0.4419618744935511
2237,My Cousin Vinny,64088552,52929168,11159384,1992_boxofficemojo_rankings.csv,1992,0.8258755479449746,0.17412445205502536
2238,The Grandmaster,64076736,6594959,57481777,2013_boxofficemojo_rankings.csv,2013,0.10292282990194757,0.8970771700980524
2239,In & Out,63856929,63856929,0,1997_boxofficemojo_rankings.csv,1997,1.0,0.0
2240,Carlito's Way,63848322,36948322,26900000,1993_boxofficemojo_rankings.csv,1993,0.5786890061104504,0.4213109938895497
2241,Hanna,63782078,40259119,23522959,2011_boxofficemojo_rankings.csv,2011,0.6311979832328448,0.3688020167671552
2242,High Crimes,63781810,41543917,22237893,2002_boxofficemojo_rankings.csv,2002,0.651344278251119,0.34865572174888104
2243,The Witches of Eastwick,63766510,63766510,0,1987_boxofficemojo_rankings.csv,1987,1.0,0.0
2244,What About Bob?,63707829,63707829,0,1991_boxofficemojo_rankings.csv,1991,1.0,0.0
2245,Precious,63649529,47566524,16083005,2009_boxofficemojo_rankings.csv,2009,0.7473193399435839,0.25268066005641615
2246,"Hail, Caesar!",63647656,30498085,33149571,2016_boxofficemojo_rankings.csv,2016,0.4791705919225054,0.5208294080774947
2247,Elite Squad 2: The Enemy Within,63618850,100119,63518731,2010_boxofficemojo_rankings.csv,2010,0.0015737316848701288,0.9984262683151298
2248,Footloose 2011 Re-release,63543328,51802742,11740586,2011_boxofficemojo_rankings.csv,2011,0.815234952755386,0.18476504724461396
2249,Risky Business,63541777,63541777,0,1983_boxofficemojo_rankings.csv,1983,1.0,0.0
2250,Conan the Barbarian,63523283,21295021,42228262,2011_boxofficemojo_rankings.csv,2011,0.33523174487061697,0.664768255129383
2251,Dragon: The Bruce Lee Story,63513743,35113743,28400000,1993_boxofficemojo_rankings.csv,1993,0.5528526794586803,0.44714732054131967
2252,Begin Again,63464861,16170632,47294229,2014_boxofficemojo_rankings.csv,2014,0.25479661887229216,0.7452033811277078
2253,Colombiana,63458440,36665854,26792586,2011_boxofficemojo_rankings.csv,2011,0.5777931824356224,0.42220681756437756
2254,Side Effects,63414135,32172757,31241378,2013_boxofficemojo_rankings.csv,2013,0.5073436229950941,0.49265637700490594
2255,Tango & Cash,63408614,63408614,0,1989_boxofficemojo_rankings.csv,1989,1.0,0.0
2256,Madea's Family Reunion,63368939,63318000,50939,2006_boxofficemojo_rankings.csv,2006,0.9991961519191602,0.0008038480808397313
2257,The Host,63365859,26627201,36738658,2013_boxofficemojo_rankings.csv,2013,0.42021368320754554,0.5797863167924544
2258,Dave,63270710,63270710,0,1993_boxofficemojo_rankings.csv,1993,1.0,0.0
2259,Beavis and Butt-Head Do America,63118386,63118386,0,1996_boxofficemojo_rankings.csv,1996,1.0,0.0
2260,Jeepers Creepers 2,63102666,35667218,27435448,2003_boxofficemojo_rankings.csv,2003,0.5652252156826464,0.43477478431735356
2261,The Longest Ride,62944815,37446117,25498698,2015_boxofficemojo_rankings.csv,2015,0.5949039170263667,0.4050960829736333
2262,Unfriended,62882090,32482090,30400000,2015_boxofficemojo_rankings.csv,2015,0.5165555088897331,0.4834444911102668
2263,Piglet's Big Movie,62870546,23103423,39767123,2003_boxofficemojo_rankings.csv,2003,0.36747609922140645,0.6325239007785936
2264,The Mountain Between Us,62832209,30348555,32483654,2017_boxofficemojo_rankings.csv,2017,0.48300951825519933,0.5169904817448007
2265,The Star,62812974,40852824,21960150,2017_boxofficemojo_rankings.csv,2017,0.65038830990553,0.34961169009446996
2266,Inkheart,62803180,17303424,45499756,2008_boxofficemojo_rankings.csv,2008,0.27551827789611927,0.7244817221038807
2267,The Nice Guys,62788218,36261763,26526455,2016_boxofficemojo_rankings.csv,2016,0.5775249585837904,0.4224750414162097
2268,The Reaping,62771059,25126214,37644845,2007_boxofficemojo_rankings.csv,2007,0.4002834172353218,0.5997165827646782
2269,Beauty and the Beast 2012 3D Release,62767829,47617067,15150762,2012_boxofficemojo_rankings.csv,2012,0.7586221757008674,0.2413778242991326
2270,Proof of Life,62761005,32598931,30162074,2000_boxofficemojo_rankings.csv,2000,0.5194137824912141,0.4805862175087859
2271,Devil,62695489,33601190,29094299,2010_boxofficemojo_rankings.csv,2010,0.5359427055429777,0.46405729445702226
2272,Runner Runner,62675095,19316646,43358449,2013_boxofficemojo_rankings.csv,2013,0.3082028994132358,0.6917971005867641
2273,After the Sunset,62657868,28331233,34326635,2004_boxofficemojo_rankings.csv,2004,0.45215762847213375,0.5478423715278662
2274,The Crying Game,62548947,62548947,0,1992_boxofficemojo_rankings.csv,1992,1.0,0.0
2275,How to Be a Latin Lover,62547032,32149404,30397628,2017_boxofficemojo_rankings.csv,2017,0.5140036700702281,0.4859963299297719
2276,A Fish Called Wanda,62493712,62493712,0,1988_boxofficemojo_rankings.csv,1988,1.0,0.0
2277,Andhadhun,62475342,1193046,61282296,2018_boxofficemojo_rankings.csv,2018,0.019096270013215774,0.9809037299867842
2278,Snow Day,62464731,60020107,2444624,2000_boxofficemojo_rankings.csv,2000,0.9608639313599221,0.03913606864007787
2279,Year One,62357900,43337279,19020621,2009_boxofficemojo_rankings.csv,2009,0.6949765627129842,0.30502343728701575
2280,Like Mike,62274780,51432760,10842020,2002_boxofficemojo_rankings.csv,2002,0.8259003082788892,0.17409969172111087
2281,Honey,62228395,30308417,31919978,2003_boxofficemojo_rankings.csv,2003,0.4870512408362774,0.5129487591637226
2282,28 Days,62198945,37170488,25028457,2000_boxofficemojo_rankings.csv,2000,0.5976064063466028,0.40239359365339716
2283,47 Meters Down,62187529,44307191,17880338,2017_boxofficemojo_rankings.csv,2017,0.7124771109654477,0.28752288903455225
2284,Two Brothers,62172050,19176754,42995296,2004_boxofficemojo_rankings.csv,2004,0.30844654470939914,0.6915534552906009
2285,Down and Out in Beverly Hills,62134225,62134225,0,1986_boxofficemojo_rankings.csv,1986,1.0,0.0
2286,Captain Corelli's Mandolin,62112895,25543895,36569000,2001_boxofficemojo_rankings.csv,2001,0.41124946760250025,0.5887505323974997
2287,Brooklyn,62076141,38322743,23753398,2015_boxofficemojo_rankings.csv,2015,0.6173506017392415,0.3826493982607585
2288,Snakes on a Plane,62022014,34020814,28001200,2006_boxofficemojo_rankings.csv,2006,0.5485280436072263,0.4514719563927737
2289,Friday Night Lights,61950770,61255921,694849,2004_boxofficemojo_rankings.csv,2004,0.9887838520812574,0.011216147918742576
2290,The Imaginarium of Doctor Parnassus,61808775,7689607,54119168,2009_boxofficemojo_rankings.csv,2009,0.12440963277463435,0.8755903672253657
2291,The Electric Horseman,61801971,61801971,0,1979_boxofficemojo_rankings.csv,1979,1.0,0.0
2292,"Dragon Ball Z: Resurrection ""F""",61768190,8008363,53759827,2015_boxofficemojo_rankings.csv,2015,0.1296518968744268,0.8703481031255732
2293,Valiant,61746888,19478106,42268782,2005_boxofficemojo_rankings.csv,2005,0.3154508126790131,0.6845491873209869
2294,The 13th Warrior,61698899,32698899,29000000,1999_boxofficemojo_rankings.csv,1999,0.5299754052337303,0.4700245947662697
2295,White Snake,61631776,34730,61597046,2019_boxofficemojo_rankings.csv,2019,0.000563508018980339,0.9994364919810197
2296,"Everything, Everything",61621140,34121140,27500000,2017_boxofficemojo_rankings.csv,2017,0.5537245821807256,0.4462754178192744
2297,Woman in Gold,61619773,33307793,28311980,2015_boxofficemojo_rankings.csv,2015,0.540537418078447,0.459462581921553
2298,Ninja Assassin,61601280,38122883,23478397,2009_boxofficemojo_rankings.csv,2009,0.6188651112444417,0.38113488875555834
2299,The Face Reader,61559184,515876,61043308,2013_boxofficemojo_rankings.csv,2013,0.008380163063889865,0.9916198369361101
2300,Krampus,61548707,42725475,18823232,2015_boxofficemojo_rankings.csv,2015,0.694173396688902,0.305826603311098
2301,Flatliners,61489265,61489265,0,1990_boxofficemojo_rankings.csv,1990,1.0,0.0
2302,From Up on Poppy Hill,61459425,1002895,60456530,2011_boxofficemojo_rankings.csv,2011,0.0163180016734618,0.9836819983265382
2303,National Lampoon's Vacation,61399552,61399552,0,1983_boxofficemojo_rankings.csv,1983,1.0,0.0
2304,The Goonies,61389680,61389680,0,1985_boxofficemojo_rankings.csv,1985,1.0,0.0
2305,A History of Violence,61385065,31504633,29880432,2005_boxofficemojo_rankings.csv,2005,0.5132296104923894,0.4867703895076107
2306,In Good Company,61315215,45806659,15508556,2004_boxofficemojo_rankings.csv,2004,0.7470683907738072,0.2529316092261929
2307,The Legend of Hercules,61279452,18848538,42430914,2013_boxofficemojo_rankings.csv,2013,0.30758333152195944,0.6924166684780406
2308,Misery,61276872,61276872,0,1990_boxofficemojo_rankings.csv,1990,1.0,0.0
2309,Ashfall,61255955,372562,60883393,2019_boxofficemojo_rankings.csv,2019,0.0060820535734035985,0.9939179464265964
2310,The Walk,61181942,10137502,51044440,2014_boxofficemojo_rankings.csv,2014,0.16569434817874856,0.8343056518212515
2311,Gorillas in the Mist: The Adventure of Dian Fossey,61149479,24720479,36429000,1988_boxofficemojo_rankings.csv,1988,0.4042631172703859,0.5957368827296141
2312,Crossroads,61141030,37191304,23949726,2002_boxofficemojo_rankings.csv,2002,0.6082871682076668,0.39171283179233324
2313,My Super Ex-Girlfriend,61108981,22530295,38578686,2006_boxofficemojo_rankings.csv,2006,0.36869040575230666,0.6313095942476933
2314,Ma,61105672,45896028,15209644,2019_boxofficemojo_rankings.csv,2019,0.7510927627144007,0.24890723728559927
2315,Marie Antoinette,60917189,15962471,44954718,2006_boxofficemojo_rankings.csv,2006,0.2620355807947737,0.7379644192052263
2316,E.T. the Extra-Terrestrial 1985 Re-release,60903502,40607502,20296000,1985_boxofficemojo_rankings.csv,1985,0.6667515112677757,0.3332484887322243
2317,Harlem Nights,60864870,60864870,0,1989_boxofficemojo_rankings.csv,1989,1.0,0.0
2318,Snatched,60845711,45852178,14993533,2017_boxofficemojo_rankings.csv,2017,0.7535811028652455,0.24641889713475448
2319,One Hundred and One Dalmatians 1991 Re-release,60830285,60830285,0,1991_boxofficemojo_rankings.csv,1991,1.0,0.0
2320,Kick-Ass 2,60795985,28795985,32000000,2013_boxofficemojo_rankings.csv,2013,0.4736494523445915,0.5263505476554085
2321,Zoolander,60780981,45172250,15608731,2001_boxofficemojo_rankings.csv,2001,0.7431971195068404,0.2568028804931595
2322,127 Hours,60738797,18335230,42403567,2010_boxofficemojo_rankings.csv,2010,0.301870153931432,0.698129846068568
2323,Taxi 2,60726164,626164,60100000,2000_boxofficemojo_rankings.csv,2000,0.010311272090231156,0.9896887279097688
2324,500 Days of Summer,60722734,32391374,28331360,2009_boxofficemojo_rankings.csv,2009,0.5334307575808428,0.4665692424191572
2325,The Wild Thornberrys,60694737,40108697,20586040,2002_boxofficemojo_rankings.csv,2002,0.660826605114048,0.339173394885952
2326,Why Did I Get Married Too?,60673972,60095852,578120,2010_boxofficemojo_rankings.csv,2010,0.9904716968257822,0.009528303174217769
2327,The Fly,60629159,40456565,20172594,1986_boxofficemojo_rankings.csv,1986,0.6672790067894558,0.3327209932105441
2328,The Good Son,60613008,44789789,15823219,1993_boxofficemojo_rankings.csv,1993,0.7389468115490985,0.2610531884509015
2329,Fargo,60611975,24611975,36000000,1996_boxofficemojo_rankings.csv,1996,0.4060579613186998,0.5939420386813002
2330,Kiss the Girls,60527873,60527873,0,1997_boxofficemojo_rankings.csv,1997,1.0,0.0
2331,Evangelion: 3.0 You Can (Not) Redo,60488344,174945,60313399,2012_boxofficemojo_rankings.csv,2012,0.002892210109107963,0.997107789890892
2332,21 Grams,60427839,16290476,44137363,2003_boxofficemojo_rankings.csv,2003,0.2695856126842464,0.7304143873157536
2333,The Ghost Writer,60331447,15541549,44789898,2010_boxofficemojo_rankings.csv,2010,0.2576027888076346,0.7423972111923653
2334,My Little Pony: The Movie,60330833,21885107,38445726,2017_boxofficemojo_rankings.csv,2017,0.3627516132588456,0.6372483867411544
2335,Scrooged,60328558,60328558,0,1988_boxofficemojo_rankings.csv,1988,1.0,0.0
2336,Secretariat,60321861,59713955,607906,2010_boxofficemojo_rankings.csv,2010,0.9899222936772458,0.0100777063227542
2337,The Insider,60289912,29089912,31200000,1999_boxofficemojo_rankings.csv,1999,0.48250048863896167,0.5174995113610383
2338,The Perfect Guy,60273173,57027435,3245738,2015_boxofficemojo_rankings.csv,2015,0.9461495415215655,0.05385045847843451
2339,3 Idiots,60262836,6532874,53729962,2009_boxofficemojo_rankings.csv,2009,0.10840634848316796,0.891593651516832
2340,The International,60253843,25450527,34803316,2009_boxofficemojo_rankings.csv,2009,0.42238844416944493,0.5776115558305551
2341,Chain Reaction,60209334,21226204,38983130,1996_boxofficemojo_rankings.csv,1996,0.3525400895482418,0.6474599104517582
2342,A Haunted House,60159584,40041683,20117901,2013_boxofficemojo_rankings.csv,2013,0.6655910885288037,0.33440891147119634
2343,The Crimson Rivers,60094966,594966,59500000,2001_boxofficemojo_rankings.csv,2001,0.009900429929521884,0.9900995700704781
2344,Spies Like Us,60088980,60088980,0,1985_boxofficemojo_rankings.csv,1985,1.0,0.0
2345,Beautiful Creatures,60052138,19452138,40600000,2013_boxofficemojo_rankings.csv,2013,0.323920823601651,0.676079176398349
2346,Morning Glory,60040976,31011732,29029244,2010_boxofficemojo_rankings.csv,2010,0.5165094584738262,0.4834905415261737
2347,Forever Young,59981902,149761,59832141,2015_boxofficemojo_rankings.csv,2015,0.0024967697756566637,0.9975032302243433
2348,Son of the Mask,59981548,17018422,42963126,2005_boxofficemojo_rankings.csv,2005,0.28372762236813226,0.7162723776318677
2349,Superman III,59950623,59950623,0,1983_boxofficemojo_rankings.csv,1983,1.0,0.0
2350,Keeping the Faith,59945183,37047880,22897303,2000_boxofficemojo_rankings.csv,2000,0.6180293085434404,0.3819706914565596
2351,Adrift,59945012,31445012,28500000,2018_boxofficemojo_rankings.csv,2018,0.5245642790095696,0.47543572099043035
2352,Jungle 2 Jungle,59927618,59927618,0,1997_boxofficemojo_rankings.csv,1997,1.0,0.0
2353,Next Friday,59827328,57328603,2498725,2000_boxofficemojo_rankings.csv,2000,0.9582343874692181,0.04176561253078192
2354,Good Luck Chuck,59768495,35017297,24751198,2007_boxofficemojo_rankings.csv,2007,0.5858821942898177,0.41411780571018225
2355,Bombshell,59636523,31762808,27873715,2019_boxofficemojo_rankings.csv,2019,0.5326066377142745,0.4673933622857255
2356,Fletch,59612888,50612888,9000000,1985_boxofficemojo_rankings.csv,1985,0.8490259354654986,0.15097406453450132
2357,Quartet,59520298,18390117,41130181,2012_boxofficemojo_rankings.csv,2012,0.3089721929819639,0.6910278070180361
2358,The Last Boy Scout,59509925,59509925,0,1991_boxofficemojo_rankings.csv,1991,1.0,0.0
2359,My Girl,59489799,59489799,0,1991_boxofficemojo_rankings.csv,1991,1.0,0.0
2360,The Flintstones in Viva Rock Vegas,59468275,35268275,24200000,2000_boxofficemojo_rankings.csv,2000,0.5930603334298834,0.4069396665701166
2361,Rock of Ages,59418613,38518613,20900000,2012_boxofficemojo_rankings.csv,2012,0.6482583664482373,0.35174163355176263
2362,Miss Granny,59396311,234573,59161738,2015_boxofficemojo_rankings.csv,2015,0.003949285671967069,0.9960507143280329
2363,One Day,59389433,13843771,45545662,2011_boxofficemojo_rankings.csv,2011,0.23310158559688557,0.7668984144031145
2364,Molly's Game,59284015,28780744,30503271,2017_boxofficemojo_rankings.csv,2017,0.48547224745152634,0.5145277525484736
2365,Jeepers Creepers,59217789,37904175,21313614,2001_boxofficemojo_rankings.csv,2001,0.6400808885316539,0.3599191114683461
2366,The Devotion of Suspect X,59035664,686435,58349229,2017_boxofficemojo_rankings.csv,2017,0.011627463019641822,0.9883725369803582
2367,The Gift,58978653,43787265,15191388,2015_boxofficemojo_rankings.csv,2015,0.742425653566554,0.257574346433446
2368,Chariots of Fire,58972904,58972904,0,1981_boxofficemojo_rankings.csv,1981,1.0,0.0
2369,The Story of Us,58900031,27100031,31800000,1999_boxofficemojo_rankings.csv,1999,0.46010215172891844,0.5398978482710816
2370,Under the Tuscan Sun,58878723,43610723,15268000,2003_boxofficemojo_rankings.csv,2003,0.7406873107624974,0.25931268923750267
2371,The Blue Lagoon,58853106,58853106,0,1980_boxofficemojo_rankings.csv,1980,1.0,0.0
2372,A Walk Among the Tombstones,58834384,26307600,32526784,2014_boxofficemojo_rankings.csv,2014,0.44714668891578774,0.5528533110842122
2373,Shock Wave,58815633,0,58815633,2017_boxofficemojo_rankings.csv,2017,0.0,1.0
2374,Agent Cody Banks,58795814,47938330,10857484,2003_boxofficemojo_rankings.csv,2003,0.8153357652298172,0.1846642347701828
2375,"Honey, I Blew Up the Kid",58662452,58662452,0,1992_boxofficemojo_rankings.csv,1992,1.0,0.0
2376,Jack,58620973,58620973,0,1996_boxofficemojo_rankings.csv,1996,1.0,0.0
2377,Invincible,58480828,57806952,673876,2006_boxofficemojo_rankings.csv,2006,0.98847697573639,0.011523024263609948
2378,Monster,58469210,34469210,24000000,2003_boxofficemojo_rankings.csv,2003,0.5895275479179555,0.4104724520820445
2379,The Tree of Life,58409247,13303319,45105928,2011_boxofficemojo_rankings.csv,2011,0.22776049484082547,0.7722395051591745
2380,The Ninth Gate,58401898,18661336,39740562,2000_boxofficemojo_rankings.csv,2000,0.31953303983373965,0.6804669601662604
2381,Are We Done Yet?,58388068,49662533,8725535,2007_boxofficemojo_rankings.csv,2007,0.8505596211883565,0.14944037881164352
2382,Beginning of the Great Revival,58309289,151000,58158289,2011_boxofficemojo_rankings.csv,2011,0.0025896388481087464,0.9974103611518913
2383,Little Nicky,58292295,39464775,18827520,2000_boxofficemojo_rankings.csv,2000,0.6770152899281114,0.32298471007188856
2384,Must Love Dogs,58231520,43894863,14336657,2005_boxofficemojo_rankings.csv,2005,0.7537990249953976,0.2462009750046023
2385,Huo guo ying xiong,58106427,779818,57326609,2016_boxofficemojo_rankings.csv,2016,0.013420511985705126,0.9865794880142948
2386,L.O.R.D: Legend of Ravaging Dynasties,58089494,350456,57739038,2016_boxofficemojo_rankings.csv,2016,0.0060330358532646195,0.9939669641467354
2387,Doom,58072119,28212337,29859782,2005_boxofficemojo_rankings.csv,2005,0.4858155253470258,0.5141844746529741
2388,Demolition Man,58055768,58055768,0,1993_boxofficemojo_rankings.csv,1993,1.0,0.0
2389,The Eye,58010320,31418697,26591623,2008_boxofficemojo_rankings.csv,2008,0.5416053040217672,0.45839469597823285
2390,Bowling for Columbine,58008423,21576018,36432405,2002_boxofficemojo_rankings.csv,2002,0.3719462947648137,0.6280537052351862
2391,Marked for Death,57968936,46044396,11924540,1990_boxofficemojo_rankings.csv,1990,0.7942943096281774,0.2057056903718226
2392,Sky Captain and the World of Tomorrow,57947036,37762677,20184359,2004_boxofficemojo_rankings.csv,2004,0.6516757302306195,0.3483242697693804
2393,Throw Momma from the Train,57915972,57915972,0,1987_boxofficemojo_rankings.csv,1987,1.0,0.0
2394,Aliens in the Attic,57881056,25200412,32680644,2009_boxofficemojo_rankings.csv,2009,0.4353827269495567,0.5646172730504433
2395,Snitch,57824674,42930462,14894212,2013_boxofficemojo_rankings.csv,2013,0.7424246265530179,0.25757537344698217
2396,Dolphin Tale 2,57824533,42024533,15800000,2014_boxofficemojo_rankings.csv,2014,0.7267595745217692,0.27324042547823085
2397,Nine Lives,57814445,19700032,38114413,2016_boxofficemojo_rankings.csv,2016,0.3407458464748732,0.6592541535251268
2398,Heartbreakers,57756408,40336607,17419801,2001_boxofficemojo_rankings.csv,2001,0.6983918909915589,0.3016081090084411
2399,That's My Boy,57719093,36931089,20788004,2012_boxofficemojo_rankings.csv,2012,0.6398418110970663,0.3601581889029337
2400,Cellular,57678321,32003620,25674701,2004_boxofficemojo_rankings.csv,2004,0.5548639323256306,0.44513606767436936
2401,The Motorcycle Diaries,57663224,16781387,40881837,2004_boxofficemojo_rankings.csv,2004,0.2910240849523086,0.7089759150476914
2402,Goldbuster,57628292,186135,57442157,2017_boxofficemojo_rankings.csv,2017,0.0032299239408310073,0.996770076059169
2403,Ready or Not,57615777,28714231,28901546,2019_boxofficemojo_rankings.csv,2019,0.4983744469852416,0.5016255530147584
2404,Drumline,57588485,56399184,1189301,2002_boxofficemojo_rankings.csv,2002,0.9793482846440569,0.02065171535594312
2405,Boyz n the Hood,57504069,57504069,0,1991_boxofficemojo_rankings.csv,1991,1.0,0.0
2406,Commando,57491000,35100000,22391000,1985_boxofficemojo_rankings.csv,1985,0.6105303438799117,0.3894696561200884
2407,Derailed,57479076,36024076,21455000,2005_boxofficemojo_rankings.csv,2005,0.6267337352465443,0.3732662647534557
2408,The Mist,57470220,25594957,31875263,2007_boxofficemojo_rankings.csv,2007,0.4453603448881873,0.5546396551118127
2409,Pet Sematary,57469467,57469467,0,1989_boxofficemojo_rankings.csv,1989,1.0,0.0
2410,The Beverly Hillbillies,57405220,44029386,13375834,1993_boxofficemojo_rankings.csv,1993,0.7669927229614311,0.23300727703856897
2411,The Quest,57400547,21686547,35714000,1996_boxofficemojo_rankings.csv,1996,0.37781080727331745,0.6221891927266826
2412,Sister Act 2: Back in the Habit,57319029,57319029,0,1993_boxofficemojo_rankings.csv,1993,1.0,0.0
2413,Willow,57269863,57269863,0,1988_boxofficemojo_rankings.csv,1988,1.0,0.0
2414,Smokin' Aces,57232879,35787686,21445193,2007_boxofficemojo_rankings.csv,2007,0.6252994192376728,0.3747005807623272
2415,Walking Tall,57223890,46437717,10786173,2004_boxofficemojo_rankings.csv,2004,0.8115092664969124,0.18849073350308762
2416,Prom Night,57197876,43869350,13328526,2008_boxofficemojo_rankings.csv,2008,0.766975158308326,0.233024841691674
2417,She's the Man,57194667,33741133,23453534,2006_boxofficemojo_rankings.csv,2006,0.5899349497043143,0.4100650502956858
2418,Unlawful Entry,57138719,57138719,0,1992_boxofficemojo_rankings.csv,1992,1.0,0.0
2419,Predator 2,57120318,30669413,26450905,1990_boxofficemojo_rankings.csv,1990,0.5369265101080145,0.46307348989198555
2420,Killer Elite,57084522,25124966,31959556,2011_boxofficemojo_rankings.csv,2011,0.44013622466699465,0.5598637753330054
2421,The 15:17 to Paris,57076286,36276286,20800000,2018_boxofficemojo_rankings.csv,2018,0.6355754472181319,0.36442455278186814
2422,Annie,57059003,57059003,0,1982_boxofficemojo_rankings.csv,1982,1.0,0.0
2423,The Descent,57051053,26024456,31026597,2005_boxofficemojo_rankings.csv,2005,0.45616083545381714,0.5438391645461829
2424,Beaches,57041866,57041866,0,1988_boxofficemojo_rankings.csv,1988,1.0,0.0
2425,All the Money in the World,56996304,25113707,31882597,2017_boxofficemojo_rankings.csv,2017,0.44061992160053043,0.5593800783994696
2426,Elektra,56995646,24409722,32585924,2005_boxofficemojo_rankings.csv,2005,0.4282734509229003,0.5717265490770996
2427,Lake Placid,56870414,31770414,25100000,1999_boxofficemojo_rankings.csv,1999,0.5586457309770947,0.4413542690229053
2428,Zoolander 2,56722693,28848693,27874000,2016_boxofficemojo_rankings.csv,2016,0.5085917377018754,0.4914082622981247
2429,Murder by Numbers,56714147,31945749,24768398,2002_boxofficemojo_rankings.csv,2002,0.5632765489711059,0.4367234510288941
2430,A Civil Action,56709981,56709981,0,1998_boxofficemojo_rankings.csv,1998,1.0,0.0
2431,Into the Wild,56674477,18354356,38320121,2007_boxofficemojo_rankings.csv,2007,0.32385576315066833,0.6761442368493317
2432,Clueless,56631572,56631572,0,1995_boxofficemojo_rankings.csv,1995,1.0,0.0
2433,Tombstone,56505065,56505065,0,1993_boxofficemojo_rankings.csv,1993,1.0,0.0
2434,Pinocchio 1992 Re-release,56501437,18863559,37637878,1992_boxofficemojo_rankings.csv,1992,0.3338598096186474,0.6661401903813526
2435,Rookie of the Year,56500758,53615089,2885669,1993_boxofficemojo_rankings.csv,1993,0.9489268975825068,0.05107310241749323
2436,Cradle 2 the Grave,56489558,34712347,21777211,2003_boxofficemojo_rankings.csv,2003,0.6144913897184325,0.3855086102815674
2437,The Big Sick,56411585,42873127,13538458,2017_boxofficemojo_rankings.csv,2017,0.7600057151381228,0.2399942848618772
2438,15 Minutes,56359980,24403552,31956428,2001_boxofficemojo_rankings.csv,2001,0.43299433392275866,0.5670056660772413
2439,The Big Chill,56342711,56342711,0,1983_boxofficemojo_rankings.csv,1983,1.0,0.0
2440,Lucky Number Slevin,56308881,22495466,33813415,2006_boxofficemojo_rankings.csv,2006,0.3995012083440266,0.6004987916559734
2441,Frida,56298474,25885000,30413474,2002_boxofficemojo_rankings.csv,2002,0.4597815564237141,0.5402184435762859
2442,Eastern Promises,56106607,17266000,38840607,2007_boxofficemojo_rankings.csv,2007,0.30773559342128814,0.6922644065787118
2443,Kicking & Screaming,56070433,52842724,3227709,2005_boxofficemojo_rankings.csv,2005,0.9424347409623178,0.05756525903768212
2444,Remember Me,56032889,19068240,36964649,2010_boxofficemojo_rankings.csv,2010,0.3403044237108674,0.6596955762891327
2445,The Odd Life of Timothy Green,56012642,51854875,4157767,2012_boxofficemojo_rankings.csv,2012,0.9257709179295631,0.07422908207043688
2446,"Definitely, Maybe",55990299,32241649,23748650,2008_boxofficemojo_rankings.csv,2008,0.5758434867440161,0.42415651325598386
2447,Confidential Assignment,55972241,475618,55496623,2017_boxofficemojo_rankings.csv,2017,0.008497390697649572,0.9915026093023505
2448,Under the Sea 3D,55902624,36262926,19639698,2009_boxofficemojo_rankings.csv,2009,0.6486802122204496,0.35131978777955036
2449,Why Did I Get Married?,55862886,55204525,658361,2007_boxofficemojo_rankings.csv,2007,0.9882146976796007,0.011785302320399272
2450,Dallas Buyers Club,55736588,27298285,28438303,2013_boxofficemojo_rankings.csv,2013,0.4897731630073947,0.5102268369926053
2451,Dragonball Evolution,55720772,9362785,46357987,2009_boxofficemojo_rankings.csv,2009,0.16803042499124024,0.8319695750087598
2452,Pay It Forward,55707411,33519628,22187783,2000_boxofficemojo_rankings.csv,2000,0.6017085949300355,0.3982914050699646
2453,All Eyez on Me,55668698,44922302,10746396,2017_boxofficemojo_rankings.csv,2017,0.806958014358446,0.1930419856415539
2454,Cop Out,55611001,44875481,10735520,2010_boxofficemojo_rankings.csv,2010,0.8069533040773713,0.19304669592262869
2455,Police Academy 2: Their First Assignment,55600000,55600000,0,1985_boxofficemojo_rankings.csv,1985,1.0,0.0
2456,The Lizzie McGuire Movie,55534455,42734455,12800000,2003_boxofficemojo_rankings.csv,2003,0.7695124585268731,0.23048754147312692
2457,Out of Time,55495563,41088845,14406718,2003_boxofficemojo_rankings.csv,2003,0.7403987414273101,0.25960125857268984
2458,Great Expectations,55494066,26420672,29073394,1998_boxofficemojo_rankings.csv,1998,0.4760990481396696,0.5239009518603305
2459,Spanglish,55470154,42726869,12743285,2004_boxofficemojo_rankings.csv,2004,0.7702677191053048,0.2297322808946952
2460,Never Say Never Again,55432841,55432841,0,1983_boxofficemojo_rankings.csv,1983,1.0,0.0
2461,Lawless,55404159,37400127,18004032,2012_boxofficemojo_rankings.csv,2012,0.6750418682467502,0.3249581317532498
2462,What Dreams May Come,55382927,55382927,0,1998_boxofficemojo_rankings.csv,1998,1.0,0.0
2463,Silent Hill: Revelation,55362705,17529157,37833548,2011_boxofficemojo_rankings.csv,2011,0.31662392579986837,0.6833760742001317
2464,Waking Ned Devine,55257450,24792251,30465199,1998_boxofficemojo_rankings.csv,1998,0.4486680257594225,0.5513319742405776
2465,Rugrats Go Wild,55250496,39402572,15847924,2003_boxofficemojo_rankings.csv,2003,0.7131623216558997,0.2868376783441003
2466,Extremely Loud & Incredibly Close,55247881,31847881,23400000,2011_boxofficemojo_rankings.csv,2011,0.5764543440136646,0.4235456559863355
2467,The Ant Bully,55181129,28142535,27038594,2006_boxofficemojo_rankings.csv,2006,0.5100028852254908,0.48999711477450925
2468,The Mothman Prophecies,55157539,35746370,19411169,2002_boxofficemojo_rankings.csv,2002,0.6480776816384066,0.3519223183615933
2469,End of Watch,55078146,41003371,14074775,2012_boxofficemojo_rankings.csv,2012,0.744458083247755,0.2555419167522451
2470,Halloween H20: 20 Years Later,55041738,55041738,0,1998_boxofficemojo_rankings.csv,1998,1.0,0.0
2471,We Own the Night,55033767,28563179,26470588,2007_boxofficemojo_rankings.csv,2007,0.5190118822867422,0.4809881177132578
2472,Barbershop: The Next Cut,55030051,54030051,1000000,2016_boxofficemojo_rankings.csv,2016,0.9818281106081476,0.018171889391852464
2473,The Messengers,55010659,35374833,19635826,2007_boxofficemojo_rankings.csv,2007,0.6430541579223764,0.35694584207762353
2474,Downsizing,55003890,24449754,30554136,2017_boxofficemojo_rankings.csv,2017,0.44450954287051336,0.5554904571294866
2475,Analyze That,55003135,32130627,22872508,2002_boxofficemojo_rankings.csv,2002,0.5841599210663174,0.4158400789336826
2476,The Money Pit,54999651,37499651,17500000,1986_boxofficemojo_rankings.csv,1986,0.6818161627971058,0.3181838372028942
2477,St. Vincent,54837234,44137712,10699522,2014_boxofficemojo_rankings.csv,2014,0.8048858190039272,0.19511418099607286
2478,Doc Hollywood,54830779,54830779,0,1991_boxofficemojo_rankings.csv,1991,1.0,0.0
2479,The Three Stooges,54819301,44338224,10481077,2012_boxofficemojo_rankings.csv,2012,0.8088068105793614,0.19119318942063854
2480,For Your Eyes Only,54812802,54812802,0,1981_boxofficemojo_rankings.csv,1981,1.0,0.0
2481,The Crazies,54806823,39123589,15683234,2010_boxofficemojo_rankings.csv,2010,0.7138452268981181,0.28615477310188187
2482,Ordinary People,54766923,54766923,0,1980_boxofficemojo_rankings.csv,1980,1.0,0.0
2483,Driven,54744738,32720065,22024673,2001_boxofficemojo_rankings.csv,2001,0.5976842011738187,0.40231579882618124
2484,The Punisher,54700105,33810189,20889916,2004_boxofficemojo_rankings.csv,2004,0.6181009890200394,0.38189901097996065
2485,Open Water,54683487,30610863,24072624,2004_boxofficemojo_rankings.csv,2004,0.5597825720221536,0.4402174279778464
2486,Small Soldiers,54682547,54682547,0,1998_boxofficemojo_rankings.csv,1998,1.0,0.0
2487,"Good Night, and Good Luck.",54641191,31558003,23083188,2005_boxofficemojo_rankings.csv,2005,0.5775496914040545,0.4224503085959455
2488,The Hot Chick,54639553,35081594,19557959,2002_boxofficemojo_rankings.csv,2002,0.6420549231067099,0.3579450768932901
2489,Early Man,54622814,8267544,46355270,2018_boxofficemojo_rankings.csv,2018,0.15135697695838227,0.8486430230416178
2490,Milk,54589558,31841299,22748259,2008_boxofficemojo_rankings.csv,2008,0.5832855250449179,0.41671447495508207
2491,The Age of Shadows,54491162,541719,53949443,2016_boxofficemojo_rankings.csv,2016,0.009941410315309481,0.9900585896846905
2492,No Escape,54418872,27288872,27130000,2015_boxofficemojo_rankings.csv,2015,0.5014597141962075,0.4985402858037925
2493,No Good Deed,54323210,52543632,1779578,2014_boxofficemojo_rankings.csv,2014,0.9672409270365282,0.03275907296347178
2494,Varsity Blues,54294169,52894169,1400000,1999_boxofficemojo_rankings.csv,1999,0.9742145422651187,0.025785457734881254
2495,Mickey Blue Eyes,54264342,33864342,20400000,1999_boxofficemojo_rankings.csv,1999,0.6240625197298071,0.3759374802701929
2496,Domestic Disturbance,54249294,45246095,9003199,2001_boxofficemojo_rankings.csv,2001,0.8340402549754841,0.1659597450245159
2497,La Bamba,54215416,54215416,0,1987_boxofficemojo_rankings.csv,1987,1.0,0.0
2498,The Five-Year Engagement,54169363,28835528,25333835,2012_boxofficemojo_rankings.csv,2012,0.5323217110749484,0.4676782889250516
2499,Tyler Perry's Madea's Big Happy Family,54161287,53345287,816000,2011_boxofficemojo_rankings.csv,2011,0.9849338882955274,0.015066111704472605
2500,Nine,54004950,19676965,34327985,2009_boxofficemojo_rankings.csv,2009,0.36435484154693226,0.6356451584530677
2501,The Verdict,53977250,53977250,0,1982_boxofficemojo_rankings.csv,1982,1.0,0.0
2502,"I, Tonya",53939297,30014539,23924758,2017_boxofficemojo_rankings.csv,2017,0.5564503185868366,0.4435496814131634
2503,Peppermint,53918723,35418723,18500000,2018_boxofficemojo_rankings.csv,2018,0.6568909838610235,0.34310901613897643
2504,The Three Musketeers,53898845,53898845,0,1993_boxofficemojo_rankings.csv,1993,1.0,0.0
2505,Long Shot,53873809,30316271,23557538,2019_boxofficemojo_rankings.csv,2019,0.5627274470234692,0.4372725529765308
2506,Tin Cup,53854588,53854588,0,1996_boxofficemojo_rankings.csv,1996,1.0,0.0
2507,Sabrina,53696278,53672080,24198,1995_boxofficemojo_rankings.csv,1995,0.9995493542401579,0.0004506457598420509
2508,Stranger Than Fiction,53653224,40660952,12992272,2006_boxofficemojo_rankings.csv,2006,0.7578473196689913,0.24215268033100862
2509,10 Things I Hate About You,53478166,38178166,15300000,1999_boxofficemojo_rankings.csv,1999,0.7139019314910687,0.28609806850893127
2510,Bounce,53425292,36805288,16620004,2000_boxofficemojo_rankings.csv,2000,0.6889113118932508,0.31108868810674917
2511,RoboCop,53424681,53424681,0,1987_boxofficemojo_rankings.csv,1987,1.0,0.0
2512,Tyler Perry's A Madea Christmas,53396635,52543354,853281,2013_boxofficemojo_rankings.csv,2013,0.9840199480735069,0.01598005192649312
2513,Sinister 2,53329150,27740955,25588195,2015_boxofficemojo_rankings.csv,2015,0.5201837081596088,0.4798162918403912
2514,Æon Flux,53321673,25874337,27447336,2005_boxofficemojo_rankings.csv,2005,0.48524990954428604,0.514750090455714
2515,Little White Lies,53319615,206088,53113527,2010_boxofficemojo_rankings.csv,2010,0.003865144187556493,0.9961348558124435
2516,Radio,53293628,52333738,959890,2003_boxofficemojo_rankings.csv,2003,0.9819886535028165,0.01801134649718349
2517,Oliver & Company,53279055,53279055,0,1988_boxofficemojo_rankings.csv,1988,1.0,0.0
2518,3 Days to Kill,53260230,30697999,22562231,2014_boxofficemojo_rankings.csv,2014,0.5763775147046868,0.4236224852953132
2519,Arachnophobia,53208180,53208180,0,1990_boxofficemojo_rankings.csv,1990,1.0,0.0
2520,Pitch Black,53187659,39240659,13947000,2000_boxofficemojo_rankings.csv,2000,0.7377775171492319,0.26222248285076805
2521,Temptation: Confessions of a Marriage Counselor,53143144,51975354,1167790,2013_boxofficemojo_rankings.csv,2013,0.9780255756038823,0.021974424396117777
2522,Delivery Man,53120346,30664106,22456240,2013_boxofficemojo_rankings.csv,2013,0.5772572716299702,0.4227427283700298
2523,Big Fat Liar,52970014,48360547,4609467,2002_boxofficemojo_rankings.csv,2002,0.91297969073597,0.08702030926403002
2524,Untraceable,52933513,28687835,24245678,2008_boxofficemojo_rankings.csv,2008,0.5419597788644785,0.45804022113552145
2525,Outrageous Fortune,52864741,52864741,0,1987_boxofficemojo_rankings.csv,1987,1.0,0.0
2526,Pooh's Heffalump Movie,52858433,18098433,34760000,2005_boxofficemojo_rankings.csv,2005,0.34239442928624086,0.6576055707137591
2527,From Paris with Love,52830951,24077427,28753524,2010_boxofficemojo_rankings.csv,2010,0.4557447205521627,0.5442552794478374
2528,Gandhi,52767889,52767889,0,1982_boxofficemojo_rankings.csv,1982,1.0,0.0
2529,Found a Treasure Called Love,52715771,4364639,48351132,2015_boxofficemojo_rankings.csv,2015,0.08279569694617575,0.9172043030538243
2530,Wild,52501541,37880356,14621185,2014_boxofficemojo_rankings.csv,2014,0.7215094124570554,0.2784905875429447
2531,King Ralph,52487045,34002045,18485000,1991_boxofficemojo_rankings.csv,1991,0.647817856768275,0.3521821432317251
2532,Teo-neol,52444295,568876,51875419,2016_boxofficemojo_rankings.csv,2016,0.010847242774452398,0.9891527572255476
2533,The Boy Next Door,52425855,35423380,17002475,2015_boxofficemojo_rankings.csv,2015,0.6756853083273511,0.3243146916726489
2534,The Night Before,52395996,43047372,9348624,2015_boxofficemojo_rankings.csv,2015,0.8215775113808315,0.17842248861916854
2535,Dragonfly,52323400,30323400,22000000,2002_boxofficemojo_rankings.csv,2002,0.5795380269630797,0.4204619730369204
2536,The Color of Money,52293982,52293982,0,1986_boxofficemojo_rankings.csv,1986,1.0,0.0
2537,Stand by Me,52287414,52287414,0,1986_boxofficemojo_rankings.csv,1986,1.0,0.0
2538,One Hour Photo,52223306,31597131,20626175,2002_boxofficemojo_rankings.csv,2002,0.6050388881929459,0.3949611118070541
2539,Star Trek V: The Final Frontier,52210049,52210049,0,1989_boxofficemojo_rankings.csv,1989,1.0,0.0
2540,Patriots Day,52185751,31886361,20299390,2016_boxofficemojo_rankings.csv,2016,0.6110166163940038,0.3889833836059962
2541,Elizabethtown,52164016,26850426,25313590,2005_boxofficemojo_rankings.csv,2005,0.51473080600236,0.48526919399764007
2542,The Finest Hours,52099090,27569558,24529532,2016_boxofficemojo_rankings.csv,2016,0.5291754232175648,0.47082457678243517
2543,Awakenings,52096475,52096475,0,1990_boxofficemojo_rankings.csv,1990,1.0,0.0
2544,Teen Titans GO! To the Movies,52090236,29790236,22300000,2018_boxofficemojo_rankings.csv,2018,0.5718967370391641,0.4281032629608359
2545,Primary Colors,52090187,39001187,13089000,1998_boxofficemojo_rankings.csv,1998,0.7487242654744165,0.2512757345255835
2546,Detective Dee: Mystery of the Phantom Flame,51899269,459836,51439433,2010_boxofficemojo_rankings.csv,2010,0.008860163329082727,0.9911398366709173
2547,Jaws: The Revenge,51881013,20763013,31118000,1987_boxofficemojo_rankings.csv,1987,0.40020446401075477,0.5997955359892453
2548,Hanging Up,51880044,36050230,15829814,2000_boxofficemojo_rankings.csv,2000,0.6948766273212875,0.3051233726787125
2549,Blue Crush,51843679,40390647,11453032,2002_boxofficemojo_rankings.csv,2002,0.7790852767219703,0.22091472327802972
2550,"Yo-kai Watch Movie: It's the Secret of Birth, Meow!",51838845,257343,51581502,2015_boxofficemojo_rankings.csv,2015,0.004964288845555876,0.9950357111544441
2551,Enough,51806184,40007742,11798442,2002_boxofficemojo_rankings.csv,2002,0.7722580377663022,0.2277419622336978
2552,The Texas Chainsaw Massacre: The Beginning,51764406,39517763,12246643,2006_boxofficemojo_rankings.csv,2006,0.7634157532880799,0.23658424671192016
2553,Slender Man,51738549,30569484,21169065,2018_boxofficemojo_rankings.csv,2018,0.5908454061979975,0.4091545938020025
2554,I Can Do Bad All by Myself,51733921,51733921,0,2009_boxofficemojo_rankings.csv,2009,1.0,0.0
2555,The China Syndrome,51718367,51718367,0,1979_boxofficemojo_rankings.csv,1979,1.0,0.0
2556,Doubt,51699984,33446470,18253514,2008_boxofficemojo_rankings.csv,2008,0.6469338559176343,0.3530661440823657
2557,Biloxi Blues,51684798,43184798,8500000,1988_boxofficemojo_rankings.csv,1988,0.8355415842004452,0.16445841579955484
2558,Master,51636415,597251,51039164,2016_boxofficemojo_rankings.csv,2016,0.011566469128424194,0.9884335308715758
2559,Amadeus,51564280,51564280,0,1984_boxofficemojo_rankings.csv,1984,1.0,0.0
2560,College Road Trip,51549674,45610425,5939249,2008_boxofficemojo_rankings.csv,2008,0.8847859057265813,0.11521409427341868
2561,The Breakfast Club,51525171,45875171,5650000,1985_boxofficemojo_rankings.csv,1985,0.8903448568855793,0.10965514311442072
2562,Daybreakers,51416464,30101577,21314887,2010_boxofficemojo_rankings.csv,2010,0.5854462687282423,0.4145537312717576
2563,Breaking In,51411620,46840590,4571030,2018_boxofficemojo_rankings.csv,2018,0.9110895552406246,0.08891044475937541
2564,I Spy,51386477,33561137,17825340,2002_boxofficemojo_rankings.csv,2002,0.6531122380699498,0.3468877619300502
2565,Hot Pursuit,51380201,34580201,16800000,2015_boxofficemojo_rankings.csv,2015,0.6730258022929883,0.3269741977070117
2566,Mortal Kombat: Annihilation,51376861,35927406,15449455,1997_boxofficemojo_rankings.csv,1997,0.6992915740804017,0.30070842591959834
2567,Meet Dave,51339567,11803254,39536313,2008_boxofficemojo_rankings.csv,2008,0.22990560087894782,0.7700943991210522
2568,Simmba,51329025,5102129,46226896,2018_boxofficemojo_rankings.csv,2018,0.09940046591572702,0.900599534084273
2569,Defiance,51262751,28644813,22617938,2008_boxofficemojo_rankings.csv,2008,0.5587841549900433,0.44121584500995664
2570,Once Upon a Deadpool 2018 Re-release,51247568,6100309,45147259,2018_boxofficemojo_rankings.csv,2018,0.11903606820912946,0.8809639317908705
2571,The Living Daylights,51185897,51185897,0,1987_boxofficemojo_rankings.csv,1987,1.0,0.0
2572,The 100 Year-Old Man Who Climbed Out the Window and Disappeared,51167572,944193,50223379,2013_boxofficemojo_rankings.csv,2013,0.018452956884489263,0.9815470431155108
2573,Hollywood Homicide,51142659,30940691,20201968,2003_boxofficemojo_rankings.csv,2003,0.6049879221180111,0.3950120778819889
2574,Naked Gun 33 1/3: The Final Insult,51132598,51132598,0,1994_boxofficemojo_rankings.csv,1994,1.0,0.0
2575,Magic in the Moonlight,51029361,10539326,40490035,2014_boxofficemojo_rankings.csv,2014,0.20653454782629946,0.7934654521737006
2576,Talk to Her 2002 Re-release,51001550,9285469,41716081,2002_boxofficemojo_rankings.csv,2002,0.1820624863361996,0.8179375136638004
2577,Red Dawn,50950296,44806783,6143513,2012_boxofficemojo_rankings.csv,2012,0.8794214463444923,0.12057855365550771
2578,Just Friends,50912434,32619671,18292763,2005_boxofficemojo_rankings.csv,2005,0.6407014640077903,0.3592985359922097
2579,Bull Durham,50888729,50888729,0,1988_boxofficemojo_rankings.csv,1988,1.0,0.0
2580,Unleashed,50871113,24537621,26333492,2005_boxofficemojo_rankings.csv,2005,0.4823488135594753,0.5176511864405247
2581,Something to Talk About,50865589,50865589,0,1995_boxofficemojo_rankings.csv,1995,1.0,0.0
2582,Team America: World Police,50826898,32786074,18040824,2004_boxofficemojo_rankings.csv,2004,0.64505360921298,0.3549463907870199
2583,Coco Before Chanel,50812934,6113834,44699100,2009_boxofficemojo_rankings.csv,2009,0.12032042865306695,0.8796795713469331
2584,The Skulls,50802120,35046120,15756000,2000_boxofficemojo_rankings.csv,2000,0.6898554627247839,0.31014453727521607
2585,The Mighty Ducks,50752337,50752337,0,1992_boxofficemojo_rankings.csv,1992,1.0,0.0
2586,A Bridge Too Far,50750000,50750000,0,1977_boxofficemojo_rankings.csv,1977,1.0,0.0
2587,What a Girl Wants,50732139,36105433,14626706,2003_boxofficemojo_rankings.csv,2003,0.7116875754046168,0.2883124245953832
2588,The Crow,50693129,50693129,0,1994_boxofficemojo_rankings.csv,1994,1.0,0.0
2589,Bride of Chucky,50688658,32400658,18288000,1998_boxofficemojo_rankings.csv,1998,0.6392092290152956,0.3607907709847043
2590,Sea Monsters: A Prehistoric Adventure,50652463,23746066,26906397,2007_boxofficemojo_rankings.csv,2007,0.46880377761689496,0.531196222383105
2591,Diary of a Mad Black Woman,50652203,50633099,19104,2005_boxofficemojo_rankings.csv,2005,0.9996228397015624,0.0003771602984375625
2592,Mighty Joe Young,50632037,50632037,0,1998_boxofficemojo_rankings.csv,1998,1.0,0.0
2593,Fever Pitch,50605163,42071069,8534094,2005_boxofficemojo_rankings.csv,2005,0.8313592231685925,0.1686407768314075
2594,War of the Arrows,50587661,251200,50336461,2011_boxofficemojo_rankings.csv,2011,0.004965637766885486,0.9950343622331145
2595,You Got Served,50576805,40363810,10212995,2004_boxofficemojo_rankings.csv,2004,0.7980695894096118,0.20193041059038822
2596,The Himalayas,50544493,696717,49847776,2015_boxofficemojo_rankings.csv,2015,0.013784231647154914,0.9862157683528451
2597,Alpha and Omega,50507267,25107267,25400000,2010_boxofficemojo_rankings.csv,2010,0.49710207048027366,0.5028979295197263
2598,Eddie Murphy: Raw,50504655,50504655,0,1987_boxofficemojo_rankings.csv,1987,1.0,0.0
2599,Dragon Ball Z: Battle of Gods,50461371,2553002,47908369,2013_boxofficemojo_rankings.csv,2013,0.05059319533747904,0.9494068046625209
2600,About Last Night,50445860,48637684,1808176,2014_boxofficemojo_rankings.csv,2014,0.9641561071612219,0.03584389283877805
2601,Breakthrough,50444358,40713082,9731276,2019_boxofficemojo_rankings.csv,2019,0.8070889117074302,0.1929110882925698
2602,The Four Seasons,50427646,50427646,0,1981_boxofficemojo_rankings.csv,1981,1.0,0.0
2603,Just Mercy,50401502,36001502,14400000,2019_boxofficemojo_rankings.csv,2019,0.7142942287711981,0.28570577122880186
2604,Red Tails,50365498,49876377,489121,2012_boxofficemojo_rankings.csv,2012,0.9902885701636466,0.009711429836353449
2605,A View to a Kill,50327960,50327960,0,1985_boxofficemojo_rankings.csv,1985,1.0,0.0
2606,Natural Born Killers,50282766,50282766,0,1994_boxofficemojo_rankings.csv,1994,1.0,0.0
2607,Angels in the Outfield,50236831,50236831,0,1994_boxofficemojo_rankings.csv,1994,1.0,0.0
2608,"Monsters, Inc. 2012 3D Release",50207820,34043006,16164814,2012_boxofficemojo_rankings.csv,2012,0.6780419066193274,0.32195809338067255
2609,Breakdown,50159144,50159144,0,1997_boxofficemojo_rankings.csv,1997,1.0,0.0
2610,The Closet,50104745,6678894,43425851,2001_boxofficemojo_rankings.csv,2001,0.13329863269436856,0.8667013673056314
2611,National Security,50097949,36381186,13716763,2003_boxofficemojo_rankings.csv,2003,0.7262011065562783,0.2737988934437216
2612,Little Women,50083616,50083616,0,1994_boxofficemojo_rankings.csv,1994,1.0,0.0
2613,Absolute Power,50068310,50068310,0,1997_boxofficemojo_rankings.csv,1997,1.0,0.0
2614,The Replacements,50054511,44737059,5317452,2000_boxofficemojo_rankings.csv,2000,0.8937667775837427,0.10623322241625735
2615,Uncut Gems,50023780,50023780,0,2019_boxofficemojo_rankings.csv,2019,1.0,0.0
2616,When a Man Loves a Woman,50021959,50021959,0,1994_boxofficemojo_rankings.csv,1994,1.0,0.0
2617,A Walk in the Clouds,50008143,50008143,0,1995_boxofficemojo_rankings.csv,1995,1.0,0.0
2618,The Women,50007546,26902075,23105471,2008_boxofficemojo_rankings.csv,2008,0.5379603110298594,0.46203968897014064
2619,The Nightmare Before Christmas,50003043,50003043,0,1993_boxofficemojo_rankings.csv,1993,1.0,0.0
2620,Harry and the Hendersons,49998613,29760613,20238000,1987_boxofficemojo_rankings.csv,1987,0.5952287716461254,0.4047712283538745
2621,Drillbit Taylor,49944325,32862104,17082221,2008_boxofficemojo_rankings.csv,2008,0.6579747348672748,0.3420252651327253
2622,21 Bridges,49939757,28539757,21400000,2019_boxofficemojo_rankings.csv,2019,0.5714836978481894,0.42851630215181064
2623,Winnie the Pooh,49871429,26692846,23178583,2011_boxofficemojo_rankings.csv,2011,0.535233229430823,0.464766770569177
2624,The Wailing,49851770,786633,49065137,2016_boxofficemojo_rankings.csv,2016,0.015779439727014708,0.9842205602729853
2625,The Switch,49830607,27779426,22051181,2010_boxofficemojo_rankings.csv,2010,0.5574771746208108,0.44252282537918913
2626,Popeye,49823037,49823037,0,1980_boxofficemojo_rankings.csv,1980,1.0,0.0
2627,Notes on a Scandal,49814392,17510118,32304274,2006_boxofficemojo_rankings.csv,2006,0.35150721100841703,0.648492788991583
2628,Pleasantville,49805462,40584421,9221041,1998_boxofficemojo_rankings.csv,1998,0.8148588401810227,0.18514115981897727
2629,Major League,49797148,49797148,0,1989_boxofficemojo_rankings.csv,1989,1.0,0.0
2630,An Inconvenient Truth,49782012,24146161,25635851,2006_boxofficemojo_rankings.csv,2006,0.4850378686984367,0.5149621313015633
2631,She's Out of My League,49779728,32010860,17768868,2010_boxofficemojo_rankings.csv,2010,0.6430501187149917,0.3569498812850082
2632,This Christmas,49778552,49121934,656618,2007_boxofficemojo_rankings.csv,2007,0.9868092185566185,0.01319078144338148
2633,Raising Helen,49718611,37486512,12232099,2004_boxofficemojo_rankings.csv,2004,0.7539734366271817,0.24602656337281828
2634,The Boy and the Beast,49714378,490643,49223735,2015_boxofficemojo_rankings.csv,2015,0.009869237426645467,0.9901307625733545
2635,The Island of Dr. Moreau,49627779,27663982,21963797,1996_boxofficemojo_rankings.csv,1996,0.5574293784132471,0.44257062158675287
2636,Revenge of the Pink Panther,49579269,49579269,0,1978_boxofficemojo_rankings.csv,1978,1.0,0.0
2637,Surprise,49567466,0,49567466,2015_boxofficemojo_rankings.csv,2015,0.0,1.0
2638,Death Wish,49562710,34017028,15545682,2018_boxofficemojo_rankings.csv,2018,0.6863431801852643,0.3136568198147357
2639,"Planes, Trains and Automobiles",49530280,49530280,0,1987_boxofficemojo_rankings.csv,1987,1.0,0.0
2640,CJ7,49529913,207378,49322535,2008_boxofficemojo_rankings.csv,2008,0.004186924374367466,0.9958130756256325
2641,The Grudge,49511319,21221803,28289516,2019_boxofficemojo_rankings.csv,2019,0.4286252806151256,0.5713747193848744
2642,A Nightmare on Elm Street 4: The Dream Master,49369899,49369899,0,1988_boxofficemojo_rankings.csv,1988,1.0,0.0
2643,National Lampoon's European Vacation,49364621,49364621,0,1985_boxofficemojo_rankings.csv,1985,1.0,0.0
2644,The Black Dahlia,49332692,22545080,26787612,2006_boxofficemojo_rankings.csv,2006,0.45700080587534125,0.5429991941246588
2645,Capote,49327405,28750530,20576875,2005_boxofficemojo_rankings.csv,2005,0.5828510540945748,0.4171489459054252
2646,Entourage,49263404,32363404,16900000,2015_boxofficemojo_rankings.csv,2015,0.6569461582476112,0.34305384175238884
2647,The Hurt Locker,49230772,17017811,32212961,2008_boxofficemojo_rankings.csv,2008,0.3456742664933225,0.6543257335066774
2648,Bugsy,49114016,49114016,0,1991_boxofficemojo_rankings.csv,1991,1.0,0.0
2649,The 'Burbs,49101993,36601993,12500000,1989_boxofficemojo_rankings.csv,1989,0.7454278485193055,0.25457215148069445
2650,Death at a Funeral,49050886,42739347,6311539,2010_boxofficemojo_rankings.csv,2010,0.8713267075338863,0.12867329246611367
2651,Cobra,49042224,49042224,0,1986_boxofficemojo_rankings.csv,1986,1.0,0.0
2652,The Deer Hunter,48991826,48979328,12498,1978_boxofficemojo_rankings.csv,1978,0.9997448962200347,0.0002551037799652538
2653,Little,48987096,40860481,8126615,2019_boxofficemojo_rankings.csv,2019,0.8341070268790786,0.16589297312092147
2654,Whiplash,48982041,13092000,35890041,2014_boxofficemojo_rankings.csv,2014,0.2672816349159481,0.732718365084052
2655,Zhi qing chun 2: Yuan lai ni hai zai zhe li,48980792,96421,48884371,2016_boxofficemojo_rankings.csv,2016,0.0019685471806989156,0.9980314528193011
2656,The Berlin File,48972848,665210,48307638,2013_boxofficemojo_rankings.csv,2013,0.013583241064518036,0.986416758935482
2657,Trouble with the Curve,48963137,35763137,13200000,2012_boxofficemojo_rankings.csv,2012,0.7304094302617906,0.2695905697382094
2658,Addams Family Values,48919043,48919043,0,1993_boxofficemojo_rankings.csv,1993,1.0,0.0
2659,Luck-Key,48913975,466505,48447470,2016_boxofficemojo_rankings.csv,2016,0.00953725392385305,0.9904627460761469
2660,Florence Foster Jenkins,48902953,27383770,21519183,2016_boxofficemojo_rankings.csv,2016,0.559961481262696,0.44003851873730404
2661,Darkman,48878502,33878502,15000000,1990_boxofficemojo_rankings.csv,1990,0.693116618017467,0.30688338198253295
2662,Push,48858618,31811527,17047091,2009_boxofficemojo_rankings.csv,2009,0.6510934672773594,0.34890653272264066
2663,The Woman in Black 2: Angel of Death,48854305,26501323,22352982,2015_boxofficemojo_rankings.csv,2015,0.5424562482262311,0.457543751773769
2664,Isn't It Romantic,48791187,48791187,0,2019_boxofficemojo_rankings.csv,2019,1.0,0.0
2665,Mother's Day,48782670,32492859,16289811,2016_boxofficemojo_rankings.csv,2016,0.6660738126879894,0.33392618731201057
2666,How Do You Know,48668907,30212620,18456287,2010_boxofficemojo_rankings.csv,2010,0.6207786831950017,0.3792213168049983
2667,Concussion,48623572,34542474,14081098,2015_boxofficemojo_rankings.csv,2015,0.7104059323325732,0.28959406766742685
2668,The Last King of Scotland,48618191,17606684,31011507,2006_boxofficemojo_rankings.csv,2006,0.36214189869795854,0.6378581013020415
2669,Shutter,48555306,25928550,22626756,2008_boxofficemojo_rankings.csv,2008,0.534000341795807,0.465999658204193
2670,Fat Albert,48551322,48116322,435000,2004_boxofficemojo_rankings.csv,2004,0.9910404087452037,0.008959591254796317
2671,Her,48517427,25568251,22949176,2013_boxofficemojo_rankings.csv,2013,0.5269910747740189,0.47300892522598115
2672,Fantasy Island,48505021,27309289,21195732,2020_boxofficemojo_rankings.csv,2020,0.5630198366474267,0.43698016335257334
2673,Logan Lucky,48453605,27780977,20672628,2017_boxofficemojo_rankings.csv,2017,0.5733521169374292,0.4266478830625709
2674,Magnolia,48451803,22455976,25995827,1999_boxofficemojo_rankings.csv,1999,0.4634703893268946,0.5365296106731055
2675,Homefront,48449416,20158898,28290518,2013_boxofficemojo_rankings.csv,2013,0.4160813414138986,0.5839186585861015
2676,Mr. Brooks,48443734,28549298,19894436,2007_boxofficemojo_rankings.csv,2007,0.5893290141507259,0.41067098584927414
2677,9,48428063,31749894,16678169,2009_boxofficemojo_rankings.csv,2009,0.6556094139053218,0.3443905860946782
2678,Chef,48428048,31424003,17004045,2014_boxofficemojo_rankings.csv,2014,0.6488802315550691,0.3511197684449309
2679,The Paper,48424341,38824341,9600000,1994_boxofficemojo_rankings.csv,1994,0.8017525938040128,0.19824740619598727
2680,Money Talks,48407611,40922619,7484992,1997_boxofficemojo_rankings.csv,1997,0.8453757199461878,0.1546242800538122
2681,"Girl, Interrupted",48350205,28912646,19437559,1999_boxofficemojo_rankings.csv,1999,0.5979839382273561,0.402016061772644
2682,Boo 2! A Madea Halloween,48333932,47319572,1014360,2017_boxofficemojo_rankings.csv,2017,0.979013501322425,0.020986498677575
2683,The Last Stand,48330757,12050299,36280458,2013_boxofficemojo_rankings.csv,2013,0.24932982117370933,0.7506701788262907
2684,Secondhand Lions,48249017,42070939,6178078,2003_boxofficemojo_rankings.csv,2003,0.8719543239606311,0.12804567603936884
2685,Mask,48230162,48230162,0,1985_boxofficemojo_rankings.csv,1985,1.0,0.0
2686,Wayne's World 2,48198564,48197805,759,1992_boxofficemojo_rankings.csv,1992,0.9999842526428796,1.5747357120432053e-05
2687,Charlie St. Cloud,48190704,31162545,17028159,2010_boxofficemojo_rankings.csv,2010,0.6466505448851713,0.3533494551148288
2688,Malcolm X,48169910,48169910,0,1992_boxofficemojo_rankings.csv,1992,1.0,0.0
2689,G.I. Jane,48169156,48169156,0,1997_boxofficemojo_rankings.csv,1997,1.0,0.0
2690,Arthur,48147945,33035397,15112548,2011_boxofficemojo_rankings.csv,2011,0.6861226787560715,0.3138773212439285
2691,Tightrope,48143579,48143579,0,1984_boxofficemojo_rankings.csv,1984,1.0,0.0
2692,Boyhood,48137666,25352281,22785385,2014_boxofficemojo_rankings.csv,2014,0.5266620321807874,0.4733379678192125
2693,The Preacher's Wife,48102795,48102795,0,1996_boxofficemojo_rankings.csv,1996,1.0,0.0
2694,21 & Over,48065672,25682380,22383292,2013_boxofficemojo_rankings.csv,2013,0.5343185465086184,0.4656814534913815
2695,The Shadow,48063435,32063435,16000000,1994_boxofficemojo_rankings.csv,1994,0.6671066060925525,0.33289339390744754
2696,Heartbreaker,48023509,504030,47519479,2010_boxofficemojo_rankings.csv,2010,0.010495484617752526,0.9895045153822475
2697,Countdown,48021766,25621766,22400000,2019_boxofficemojo_rankings.csv,2019,0.5335448513076341,0.4664551486923659
2698,Single White Female,48017402,48017402,0,1992_boxofficemojo_rankings.csv,1992,1.0,0.0
2699,The Natural,47951979,47951979,0,1984_boxofficemojo_rankings.csv,1984,1.0,0.0
2700,Midsommar: The Directors Cut,47863365,27426361,20437004,2019_boxofficemojo_rankings.csv,2019,0.5730136399728686,0.4269863600271314
2701,The Nanny Diaries,47817020,25930652,21886368,2007_boxofficemojo_rankings.csv,2007,0.5422891681664813,0.4577108318335187
2702,Queen & Slim,47802566,43808310,3994256,2019_boxofficemojo_rankings.csv,2019,0.9164426445224718,0.08355735547752813
2703,Look Who's Talking Too,47789074,47789074,0,1990_boxofficemojo_rankings.csv,1990,1.0,0.0
2704,"To Wong Foo Thanks for Everything, Julie Newmar",47774193,36474193,11300000,1995_boxofficemojo_rankings.csv,1995,0.7634706252390281,0.23652937476097188
2705,Phantom Thread,47756590,21198205,26558385,2017_boxofficemojo_rankings.csv,2017,0.4438802058522185,0.5561197941477815
2706,Book of Shadows: Blair Witch 2,47737094,26437094,21300000,2000_boxofficemojo_rankings.csv,2000,0.5538061030694496,0.4461938969305505
2707,The Fourth Kind,47709193,25486040,22223153,2009_boxofficemojo_rankings.csv,2009,0.5341955794557246,0.4658044205442754
2708,Scott Pilgrim vs. the World,47664559,31524275,16140284,2010_boxofficemojo_rankings.csv,2010,0.6613776705665104,0.3386223294334896
2709,Man on a Ledge,47636031,18620000,29016031,2012_boxofficemojo_rankings.csv,2012,0.3908805920459662,0.6091194079540337
2710,New Jack City,47624353,47624353,0,1991_boxofficemojo_rankings.csv,1991,1.0,0.0
2711,Coming Home,47587984,377607,47210377,2014_boxofficemojo_rankings.csv,2014,0.007934923236084135,0.9920650767639159
2712,47 Meters Down: Uncaged,47582563,22260900,25321663,2019_boxofficemojo_rankings.csv,2019,0.46783734621441053,0.5321626537855895
2713,A Walk to Remember,47494916,41281092,6213824,2002_boxofficemojo_rankings.csv,2002,0.8691686495455639,0.130831350454436
2714,Darkness Falls,47488536,32551396,14937140,2003_boxofficemojo_rankings.csv,2003,0.685457980848262,0.314542019151738
2715,Man on the Moon,47434430,34607430,12827000,1999_boxofficemojo_rankings.csv,1999,0.7295846076362675,0.2704153923637324
2716,Beauty and the Beast,47430624,0,47430624,2014_boxofficemojo_rankings.csv,2014,0.0,1.0
2717,Hard to Kill,47410827,47410827,0,1990_boxofficemojo_rankings.csv,1990,1.0,0.0
2718,Crazy Heart,47405566,39464306,7941260,2009_boxofficemojo_rankings.csv,2009,0.8324825401304142,0.16751745986958577
2719,Nightcrawler,47398992,32381217,15017775,2014_boxofficemojo_rankings.csv,2014,0.683162565988745,0.3168374340112549
2720,Almost Famous,47383689,32534850,14848839,2000_boxofficemojo_rankings.csv,2000,0.6866255179076496,0.31337448209235036
2721,Rough Night,47347283,22105643,25241640,2017_boxofficemojo_rankings.csv,2017,0.466883031070653,0.533116968929347
2722,The Deep,47346365,47346365,0,1977_boxofficemojo_rankings.csv,1977,1.0,0.0
2723,Texas Chainsaw,47340586,34341945,12998641,2013_boxofficemojo_rankings.csv,2013,0.7254228961170865,0.2745771038829135
2724,Broken Flowers,47329961,13744960,33585001,2005_boxofficemojo_rankings.csv,2005,0.29040716936149596,0.709592830638504
2725,A Monster Calls,47309313,3740823,43568490,2016_boxofficemojo_rankings.csv,2016,0.07907159843982516,0.9209284015601749
2726,Tiny Times 2.0,47289937,43788,47246149,2013_boxofficemojo_rankings.csv,2013,0.0009259475224084143,0.9990740524775916
2727,Golden Job,47287851,285795,47002056,2018_boxofficemojo_rankings.csv,2018,0.006043729921243407,0.9939562700787566
2728,Mortdecai,47275695,7696134,39579561,2015_boxofficemojo_rankings.csv,2015,0.16279261468287246,0.8372073853171276
2729,The Watcher,47267829,28946615,18321214,2000_boxofficemojo_rankings.csv,2000,0.612395695177792,0.3876043048222079
2730,Last Man Standing,47267001,18115927,29151074,1996_boxofficemojo_rankings.csv,1996,0.38326795897205324,0.6167320410279468
2731,Deck the Halls,47232776,35093569,12139207,2006_boxofficemojo_rankings.csv,2006,0.7429918791984617,0.25700812080153834
2732,High Fidelity,47126295,27287137,19839158,2000_boxofficemojo_rankings.csv,2000,0.5790214783487647,0.4209785216512353
2733,Soul Surfer,47120948,43853424,3267524,2011_boxofficemojo_rankings.csv,2011,0.9306566582658736,0.0693433417341264
2734,The Toy,47118057,47118057,0,1982_boxofficemojo_rankings.csv,1982,1.0,0.0
2735,The Wedding Date,47096206,31726995,15369211,2005_boxofficemojo_rankings.csv,2005,0.6736635006225342,0.3263364993774658
2736,Land of the Dead,47074133,20700082,26374051,2005_boxofficemojo_rankings.csv,2005,0.4397336855890686,0.5602663144109313
2737,Dracula 2000,47053625,33022767,14030858,2000_boxofficemojo_rankings.csv,2000,0.7018113269700262,0.29818867302997376
2738,The Place Beyond the Pines,47052899,21403519,25649380,2013_boxofficemojo_rankings.csv,2013,0.45488204669387106,0.5451179533061289
2739,Son of Bigfoot,47046281,289308,46756973,2017_boxofficemojo_rankings.csv,2017,0.006149434000957483,0.9938505659990425
2740,Halloween,47000000,47000000,0,1978_boxofficemojo_rankings.csv,1978,1.0,0.0
2741,Parker,46922566,17616641,29305925,2013_boxofficemojo_rankings.csv,2013,0.3754406994706982,0.6245593005293019
2742,Urban Cowboy,46918287,46918287,0,1980_boxofficemojo_rankings.csv,1980,1.0,0.0
2743,"See No Evil, Hear No Evil",46908987,46908987,0,1989_boxofficemojo_rankings.csv,1989,1.0,0.0
2744,The Object of My Affection,46905889,29187243,17718646,1998_boxofficemojo_rankings.csv,1998,0.6222511420687497,0.3777488579312504
2745,The Spy Who Loved Me,46838673,46838673,0,1977_boxofficemojo_rankings.csv,1977,1.0,0.0
2746,Goodfellas,46836214,46836214,0,1990_boxofficemojo_rankings.csv,1990,1.0,0.0
2747,Death at a Funeral,46789413,8580428,38208985,2007_boxofficemojo_rankings.csv,2007,0.18338396337650142,0.8166160366234986
2748,Practical Magic,46732881,46732881,0,1998_boxofficemojo_rankings.csv,1998,1.0,0.0
2749,Mary Queen of Scots,46712809,16468499,30244310,2018_boxofficemojo_rankings.csv,2018,0.35254782044899075,0.6474521795510092
2750,Firefox,46708276,46708276,0,1982_boxofficemojo_rankings.csv,1982,1.0,0.0
2751,The Rocketeer,46704056,46704056,0,1991_boxofficemojo_rankings.csv,1991,1.0,0.0
2752,The Distinguished Gentleman,46666502,46666502,0,1992_boxofficemojo_rankings.csv,1992,1.0,0.0
2753,Uncle Drew,46664414,42469946,4194468,2018_boxofficemojo_rankings.csv,2018,0.9101142039413588,0.08988579605864118
2754,Colors,46616067,46616067,0,1988_boxofficemojo_rankings.csv,1988,1.0,0.0
2755,Snow White and the Seven Dwarfs 1987 Re-release,46594212,46594212,0,1987_boxofficemojo_rankings.csv,1987,1.0,0.0
2756,The Brady Bunch Movie,46576136,46576136,0,1995_boxofficemojo_rankings.csv,1995,1.0,0.0
2757,Get Rich or Die Tryin',46563961,30985352,15578609,2005_boxofficemojo_rankings.csv,2005,0.6654363446443055,0.3345636553556945
2758,Torque,46546197,21215059,25331138,2003_boxofficemojo_rankings.csv,2003,0.45578501289804624,0.5442149871019538
2759,The Big Wedding,46522137,21819348,24702789,2013_boxofficemojo_rankings.csv,2013,0.4690100112984922,0.5309899887015078
2760,Fantastic Mr. Fox,46471023,21002919,25468104,2009_boxofficemojo_rankings.csv,2009,0.45195731972588593,0.5480426802741141
2761,Risen,46432579,36880033,9552546,2016_boxofficemojo_rankings.csv,2016,0.7942706133122608,0.20572938668773924
2762,The Nativity Story,46432264,37629831,8802433,2006_boxofficemojo_rankings.csv,2006,0.8104242127844552,0.18957578721554477
2763,Malice,46405336,46405336,0,1993_boxofficemojo_rankings.csv,1993,1.0,0.0
2764,Tyler Perry's Acrimony,46403669,43549096,2854573,2018_boxofficemojo_rankings.csv,2018,0.9384838944523978,0.061516105547602284
2765,Full Metal Jacket,46357676,46357676,0,1987_boxofficemojo_rankings.csv,1987,1.0,0.0
2766,A Werewolf Boy,46282588,342922,45939666,2012_boxofficemojo_rankings.csv,2012,0.007409309090494248,0.9925906909095058
2767,Miracle on 34th Street,46264384,17320136,28944248,1994_boxofficemojo_rankings.csv,1994,0.3743729950019436,0.6256270049980563
2768,The Thousand Faces of Dunjia,46263237,124187,46139050,2017_boxofficemojo_rankings.csv,2017,0.002684356047113608,0.9973156439528864
2769,Asterix: The Secret of the Magic Potion,46221204,1271953,44949251,2018_boxofficemojo_rankings.csv,2018,0.027518820150163114,0.9724811798498368
2770,The Fog,46201432,29550869,16650563,2005_boxofficemojo_rankings.csv,2005,0.6396093740124765,0.3603906259875235
2771,The Battleship Island,46183383,1104957,45078426,2017_boxofficemojo_rankings.csv,2017,0.023925423566307388,0.9760745764336927
2772,Eddie the Eagle,46152800,15789389,30363411,2016_boxofficemojo_rankings.csv,2016,0.342111182853478,0.657888817146522
2773,The Big Lebowski,46142637,17451873,28690764,1998_boxofficemojo_rankings.csv,1998,0.37821577037307164,0.6217842296269284
2774,Napoleon Dynamite,46118097,44540956,1577141,2004_boxofficemojo_rankings.csv,2004,0.9658021231882139,0.03419787681178606
2775,Into the Blue,46117696,18801234,27316462,2005_boxofficemojo_rankings.csv,2005,0.4076793862382024,0.5923206137617977
2776,For Love of the Game,46112640,35188640,10924000,1999_boxofficemojo_rankings.csv,1999,0.7631018306477356,0.23689816935226438
2777,The World's End,46089287,26004851,20084436,2013_boxofficemojo_rankings.csv,2013,0.5642276696534707,0.43577233034652935
2778,The Hunted,46061847,34244097,11817750,2003_boxofficemojo_rankings.csv,2003,0.7434373398009854,0.2565626601990146
2779,Let's Get Married,45972724,462918,45509806,2015_boxofficemojo_rankings.csv,2015,0.010069405502271303,0.9899305944977287
2780,The Rainmaker,45916769,45916769,0,1997_boxofficemojo_rankings.csv,1997,1.0,0.0
2781,Eight Legged Freaks,45867333,17322606,28544727,2002_boxofficemojo_rankings.csv,2002,0.37766760932012333,0.6223323906798767
2782,Greystoke,45858563,45858563,0,1984_boxofficemojo_rankings.csv,1984,1.0,0.0
2783,One Missed Call,45847751,26890041,18957710,2008_boxofficemojo_rankings.csv,2008,0.5865073076321672,0.4134926923678328
2784,Brewster's Millions,45833132,40833132,5000000,1985_boxofficemojo_rankings.csv,1985,0.8909086117003743,0.1090913882996257
2785,Avatar 2010 Special Edition,45823494,10741486,35082008,2010_boxofficemojo_rankings.csv,2010,0.23441001683546872,0.7655899831645313
2786,Somewhere Only We Know,45737711,482341,45255370,2015_boxofficemojo_rankings.csv,2015,0.010545805407708313,0.9894541945922917
2787,Chasing the Dragon II: Wild Wild Bunch,45733356,196634,45536722,2019_boxofficemojo_rankings.csv,2019,0.004299575128490461,0.9957004248715096
2788,"McFarland, USA",45710059,44482410,1227649,2015_boxofficemojo_rankings.csv,2015,0.9731426949153577,0.026857305084642312
2789,RoboCop 2,45681173,45681173,0,1990_boxofficemojo_rankings.csv,1990,1.0,0.0
2790,Earth to Echo,45681062,38934842,6746220,2014_boxofficemojo_rankings.csv,2014,0.8523191076424624,0.14768089235753756
2791,Young Guns,45661556,45661556,0,1988_boxofficemojo_rankings.csv,1988,1.0,0.0
2792,That Awkward Moment,45640143,26068955,19571188,2014_boxofficemojo_rankings.csv,2014,0.5711847791537376,0.42881522084626245
2793,The Debt,45636368,31177548,14458820,2011_boxofficemojo_rankings.csv,2011,0.6831732972264576,0.31682670277354236
2794,D2: The Mighty Ducks,45610410,45610410,0,1994_boxofficemojo_rankings.csv,1994,1.0,0.0
2795,Hero,45565534,88675,45476859,2015_boxofficemojo_rankings.csv,2015,0.0019460981188105905,0.9980539018811894
2796,Medicine Man,45500797,45500797,0,1992_boxofficemojo_rankings.csv,1992,1.0,0.0
2797,Machete,45491656,26593646,18898010,2010_boxofficemojo_rankings.csv,2010,0.5845829397813085,0.4154170602186915
2798,Queen of the Damned,45479110,30336800,15142310,2002_boxofficemojo_rankings.csv,2002,0.6670491133181806,0.33295088668181944
2799,Thelma & Louise,45454078,45360915,93163,1991_boxofficemojo_rankings.csv,1991,0.9979503929218408,0.002049607078159192
2800,Wei ai zhi jian ru jia jing,45386560,271734,45114826,2014_boxofficemojo_rankings.csv,2014,0.005987102789900799,0.9940128972100992
2801,Good Boy,45312217,37667746,7644471,2003_boxofficemojo_rankings.csv,2003,0.8312933794433408,0.16870662055665914
2802,The Last House on the Left,45289053,32752215,12536838,2009_boxofficemojo_rankings.csv,2009,0.7231817145746015,0.2768182854253985
2803,The Spy Next Door,45236543,24307086,20929457,2009_boxofficemojo_rankings.csv,2009,0.5373329699398117,0.4626670300601883
2804,Blair Witch,45173154,20777061,24396093,2016_boxofficemojo_rankings.csv,2016,0.4599426686035693,0.5400573313964308
2805,Flatliners,45158254,16883115,28275139,2017_boxofficemojo_rankings.csv,2017,0.3738655396198445,0.6261344603801555
2806,Deuce Bigalow: European Gigolo,45109561,22400154,22709407,2005_boxofficemojo_rankings.csv,2005,0.49657220117925777,0.5034277988207423
2807,Foul Play,44999621,44999621,0,1978_boxofficemojo_rankings.csv,1978,1.0,0.0
2808,Pacific Heights,44926706,29381956,15544750,1990_boxofficemojo_rankings.csv,1990,0.6539975577109971,0.3460024422890029
2809,The End,44917151,44917151,0,1978_boxofficemojo_rankings.csv,1978,1.0,0.0
2810,Monster's Ball,44909486,31273922,13635564,2001_boxofficemojo_rankings.csv,2001,0.6963767521186949,0.30362324788130507
2811,Grudge Match,44907260,29807260,15100000,2013_boxofficemojo_rankings.csv,2013,0.6637514735924659,0.3362485264075341
2812,Child's Play,44902237,29208403,15693834,2019_boxofficemojo_rankings.csv,2019,0.6504888164035124,0.34951118359648764
2813,Cop Land,44862187,44862187,0,1997_boxofficemojo_rankings.csv,1997,1.0,0.0
2814,A Nightmare on Elm Street 3: Dream Warriors,44793222,44793222,0,1987_boxofficemojo_rankings.csv,1987,1.0,0.0
2815,Still Alice,44779195,18754371,26024824,2015_boxofficemojo_rankings.csv,2015,0.41881885103115407,0.5811811489688459
2816,The Wrestler,44734660,26238243,18496417,2008_boxofficemojo_rankings.csv,2008,0.5865305112411718,0.41346948875882816
2817,The Man from Nowhere,44723232,528175,44195057,2010_boxofficemojo_rankings.csv,2010,0.011809857570222116,0.9881901424297779
2818,Mysteries of Egypt,44703731,40593486,4110245,1998_boxofficemojo_rankings.csv,1998,0.9080558846419329,0.0919441153580671
2819,Hellboy,44664690,21903748,22760942,2019_boxofficemojo_rankings.csv,2019,0.4904041201226293,0.5095958798773706
2820,Lakeview Terrace,44655002,39263506,5391496,2008_boxofficemojo_rankings.csv,2008,0.8792633353817787,0.12073666461822127
2821,The Jungle Book 1990 Re-release,44645619,44645619,0,1990_boxofficemojo_rankings.csv,1990,1.0,0.0
2822,Uptown Girls,44617342,37182494,7434848,2003_boxofficemojo_rankings.csv,2003,0.8333641658886807,0.16663583411131933
2823,The Gift,44567606,12008642,32558964,2000_boxofficemojo_rankings.csv,2000,0.2694477688570483,0.7305522311429516
2824,The Negotiator,44547681,44547681,0,1998_boxofficemojo_rankings.csv,1998,1.0,0.0
2825,Mother!,44516999,17800004,26716995,2017_boxofficemojo_rankings.csv,2017,0.3998473482006278,0.6001526517993722
2826,Nothing to Lose,44480039,44480039,0,1997_boxofficemojo_rankings.csv,1997,1.0,0.0
2827,Recess: School's Out,44460850,36706141,7754709,2001_boxofficemojo_rankings.csv,2001,0.8255834290167642,0.17441657098323582
2828,Oculus,44446287,27695246,16751041,2014_boxofficemojo_rankings.csv,2014,0.6231172021185931,0.37688279788140683
2829,Notorious,44420167,36843682,7576485,2009_boxofficemojo_rankings.csv,2009,0.8294359181495198,0.17056408185048022
2830,Up in Smoke,44364244,44364244,0,1978_boxofficemojo_rankings.csv,1978,1.0,0.0
2831,The Sisterhood of the Traveling Pants 2,44352417,44089964,262453,2008_boxofficemojo_rankings.csv,2008,0.9940825547342775,0.005917445265722497
2832,A Man Apart,44350926,26736098,17614828,2003_boxofficemojo_rankings.csv,2003,0.6028306601760693,0.3971693398239306
2833,Dark Water 2005 Re-release,44347079,25473352,18873727,2005_boxofficemojo_rankings.csv,2005,0.5744087902610227,0.4255912097389774
2834,Picture Perfect,44332015,31407873,12924142,1997_boxofficemojo_rankings.csv,1997,0.7084693307985211,0.2915306692014789
2835,House at the End of the Street,44287131,31611916,12675215,2012_boxofficemojo_rankings.csv,2012,0.7137946235442526,0.2862053764557474
2836,The Girl Who Kicked the Hornet's Nest,44276335,5190196,39086139,2009_boxofficemojo_rankings.csv,2009,0.11722280084835386,0.8827771991516461
2837,The Good the Bad the Weird,44261209,128486,44132723,2008_boxofficemojo_rankings.csv,2008,0.0029029030815674287,0.9970970969184326
2838,Amistad,44229441,44229441,0,1997_boxofficemojo_rankings.csv,1997,1.0,0.0
2839,Child's Play,44196684,33244684,10952000,1988_boxofficemojo_rankings.csv,1988,0.7521986038590588,0.24780139614094127
2840,Young Guns II,44143410,44143410,0,1990_boxofficemojo_rankings.csv,1990,1.0,0.0
2841,Hardball,44102389,40222729,3879660,2001_boxofficemojo_rankings.csv,2001,0.912030615847137,0.08796938415286301
2842,Passenger 57,44065653,44065653,0,1992_boxofficemojo_rankings.csv,1992,1.0,0.0
2843,Winchester,44019588,25091816,18927772,2018_boxofficemojo_rankings.csv,2018,0.5700147852360635,0.4299852147639365
2844,The Shining,44017374,44017374,0,1980_boxofficemojo_rankings.csv,1980,1.0,0.0
2845,Semi-Pro,44004502,33479698,10524804,2008_boxofficemojo_rankings.csv,2008,0.7608243811053697,0.23917561889463038
2846,Kick,43996483,2472695,41523788,2014_boxofficemojo_rankings.csv,2014,0.056202105972879696,0.9437978940271203
2847,Seems Like Old Times,43995918,43995918,0,1980_boxofficemojo_rankings.csv,1980,1.0,0.0
2848,The Last Emperor,43984230,43984230,0,1987_boxofficemojo_rankings.csv,1987,1.0,0.0
2849,Wind River,43980821,33800859,10179962,2017_boxofficemojo_rankings.csv,2017,0.7685363354176585,0.23146366458234147
2850,Max,43967255,42656255,1311000,2015_boxofficemojo_rankings.csv,2015,0.9701823550276223,0.029817644972377738
2851,Timeline,43935763,19481943,24453820,2003_boxofficemojo_rankings.csv,2003,0.4434187930228957,0.5565812069771042
2852,The Transporter,43928932,25296447,18632485,2002_boxofficemojo_rankings.csv,2002,0.5758493514023969,0.42415064859760304
2853,Battle of Memories,43892362,594552,43297810,2017_boxofficemojo_rankings.csv,2017,0.01354568250393998,0.98645431749606
2854,Jungle Fever,43882682,32482682,11400000,1991_boxofficemojo_rankings.csv,1991,0.7402164252403716,0.25978357475962843
2855,Wall Street,43848069,43848069,0,1987_boxofficemojo_rankings.csv,1987,1.0,0.0
2856,Shining Through,43838238,21633781,22204457,1992_boxofficemojo_rankings.csv,1992,0.4934911161347315,0.5065088838652685
2857,Of Gods and Men,43803417,3951596,39851821,2010_boxofficemojo_rankings.csv,2010,0.09021204898238874,0.9097879510176112
2858,Café Society,43763247,11103205,32660042,2016_boxofficemojo_rankings.csv,2016,0.25371072215002693,0.746289277849973
2859,Richard Jewell,43745542,22345542,21400000,2019_boxofficemojo_rankings.csv,2019,0.5108072955182497,0.4891927044817504
2860,The DUFF,43709744,34030343,9679401,2015_boxofficemojo_rankings.csv,2015,0.7785527867653491,0.22144721323465083
2861,Soul Food,43700855,43700855,0,1997_boxofficemojo_rankings.csv,1997,1.0,0.0
2862,The Sea Inside,43685449,2104923,41580526,2004_boxofficemojo_rankings.csv,2004,0.04818361830274424,0.9518163816972558
2863,Judy,43660268,24313888,19346380,2019_boxofficemojo_rankings.csv,2019,0.5568881986706998,0.4431118013293001
2864,"Welcome Home, Roscoe Jenkins",43655418,42436517,1218901,2008_boxofficemojo_rankings.csv,2008,0.9720790441177313,0.027920955882268724
2865,City Slickers II: The Legend of Curly's Gold,43622150,43622150,0,1994_boxofficemojo_rankings.csv,1994,1.0,0.0
2866,Police Academy 3: Back in Training,43579163,43579163,0,1986_boxofficemojo_rankings.csv,1986,1.0,0.0
2867,Boy,43551154,256211,43294943,2010_boxofficemojo_rankings.csv,2010,0.005882989920313018,0.994117010079687
2868,We Are Marshall,43545364,43545364,0,2006_boxofficemojo_rankings.csv,2006,1.0,0.0
2869,League of Gods,43498766,181633,43317133,2016_boxofficemojo_rankings.csv,2016,0.004175589716728976,0.9958244102832711
2870,Harold & Kumar Escape from Guantanamo Bay,43495888,38108728,5387160,2008_boxofficemojo_rankings.csv,2008,0.8761455335731966,0.12385446642680338
2871,Brothers,43474578,28544157,14930421,2009_boxofficemojo_rankings.csv,2009,0.6565712265223138,0.3434287734776862
2872,The Great Outdoors,43455230,41455230,2000000,1988_boxofficemojo_rankings.csv,1988,0.9539756204258958,0.0460243795741042
2873,Last Holiday,43446924,38399961,5046963,2006_boxofficemojo_rankings.csv,2006,0.8838361261202289,0.1161638738797711
2874,A River Runs Through It,43440294,43440294,0,1992_boxofficemojo_rankings.csv,1992,1.0,0.0
2875,The Master of Disguise,43411001,40388794,3022207,2002_boxofficemojo_rankings.csv,2002,0.9303815408449116,0.06961845915508837
2876,In the Bedroom,43368779,35930604,7438175,2001_boxofficemojo_rankings.csv,2001,0.8284900988335411,0.17150990116645895
2877,Harriet,43347017,43082155,264862,2019_boxofficemojo_rankings.csv,2019,0.9938897294824232,0.006110270517576792
2878,The Duchess,43343384,13848978,29494406,2008_boxofficemojo_rankings.csv,2008,0.31951769155818566,0.6804823084418143
2879,Orange County,43325009,41076018,2248991,2002_boxofficemojo_rankings.csv,2002,0.94809023582661,0.051909764173390015
2880,The Edge,43312294,27873386,15438908,1997_boxofficemojo_rankings.csv,1997,0.6435444402921721,0.356455559707828
2881,The Jungle Book,43229904,43229904,0,1994_boxofficemojo_rankings.csv,1994,1.0,0.0
2882,Beastly,43202283,27865571,15336712,2011_boxofficemojo_rankings.csv,2011,0.6450022791619601,0.35499772083804
2883,The Snowman,43155261,6700035,36455226,2017_boxofficemojo_rankings.csv,2017,0.1552541878961177,0.8447458121038823
2884,Boogie Nights,43101594,26400640,16700954,1997_boxofficemojo_rankings.csv,1997,0.6125211981719284,0.3874788018280716
2885,Freedom Writers,43095175,36605602,6489573,2007_boxofficemojo_rankings.csv,2007,0.8494130027317444,0.15058699726825567
2886,Annihilation,43070915,32732301,10338614,2018_boxofficemojo_rankings.csv,2018,0.7599629819798349,0.2400370180201651
2887,See Spot Run,43057552,33357476,9700076,2001_boxofficemojo_rankings.csv,2001,0.7747183583497733,0.22528164165022665
2888,When in Rome,43053376,32680633,10372743,2010_boxofficemojo_rankings.csv,2010,0.7590724824924299,0.24092751750757013
2889,Gifted,43046590,24801212,18245378,2017_boxofficemojo_rankings.csv,2017,0.5761481223019059,0.42385187769809407
2890,Meatballs,43046003,43046003,0,1979_boxofficemojo_rankings.csv,1979,1.0,0.0
2891,The Possession of Hannah Grace,43016528,14837422,28179106,2018_boxofficemojo_rankings.csv,2018,0.3449237465190124,0.6550762534809876
2892,Regarding Henry,43001500,43001500,0,1991_boxofficemojo_rankings.csv,1991,1.0,0.0
2893,Escape from Alcatraz,43000000,43000000,0,1979_boxofficemojo_rankings.csv,1979,1.0,0.0
2894,The New Mutants,42991061,21991061,21000000,2020_boxofficemojo_rankings.csv,2020,0.5115263612591464,0.4884736387408536
2895,Legend,42972994,1872994,41100000,2015_boxofficemojo_rankings.csv,2015,0.04358537364187378,0.9564146263581262
2896,The Gallows,42964410,22764410,20200000,2015_boxofficemojo_rankings.csv,2015,0.5298434215668271,0.47015657843317293
2897,Glory Road,42938449,42647449,291000,2006_boxofficemojo_rankings.csv,2006,0.9932228572112607,0.006777142788739295
2898,Crank,42931041,27838408,15092633,2006_boxofficemojo_rankings.csv,2006,0.6484447465413196,0.3515552534586804
2899,A Lot Like Love,42886719,21845719,21041000,2005_boxofficemojo_rankings.csv,2005,0.5093819137808141,0.49061808621918596
2900,The Warlords,42883181,129078,42754103,2007_boxofficemojo_rankings.csv,2007,0.0030099912597435345,0.9969900087402565
2901,The Main Event,42800000,42800000,0,1979_boxofficemojo_rankings.csv,1979,1.0,0.0
2902,Basic,42792561,26793311,15999250,2003_boxofficemojo_rankings.csv,2003,0.6261207643076094,0.37387923569239057
2903,Zack and Miri Make a Porno,42782463,31457946,11324517,2008_boxofficemojo_rankings.csv,2008,0.735300022347942,0.26469997765205805
2904,Shaolin Soccer,42776760,489600,42287160,2001_boxofficemojo_rankings.csv,2001,0.01144546711812676,0.9885545328818732
2905,Xin Shao Lin si,42741494,66099,42675395,2011_boxofficemojo_rankings.csv,2011,0.001546483143523247,0.9984535168564768
2906,Heartbreak Ridge,42724017,42724017,0,1986_boxofficemojo_rankings.csv,1986,1.0,0.0
2907,Mannequin,42721196,42721196,0,1987_boxofficemojo_rankings.csv,1987,1.0,0.0
2908,House on Haunted Hill,42593455,40846082,1747373,1999_boxofficemojo_rankings.csv,1999,0.9589755515254632,0.041024448474536755
2909,Almost Christmas,42580920,42158780,422140,2016_boxofficemojo_rankings.csv,2016,0.9900861700498721,0.009913829950127897
2910,Oliver Twist,42580321,2080321,40500000,2005_boxofficemojo_rankings.csv,2005,0.04885639542266485,0.9511436045773352
2911,Bangkok Dangerous,42487390,15298133,27189257,2008_boxofficemojo_rankings.csv,2008,0.36006290336968216,0.6399370966303178
2912,Man of the Year,42472472,37327390,5145082,2006_boxofficemojo_rankings.csv,2006,0.8788607830502543,0.1211392169497457
2913,Love the Coopers,42426912,26302731,16124181,2015_boxofficemojo_rankings.csv,2015,0.6199539339558816,0.3800460660441184
2914,8 Women,42426583,3098776,39327807,2002_boxofficemojo_rankings.csv,2002,0.0730385475540182,0.9269614524459818
2915,Time Bandits,42365581,42365581,0,1981_boxofficemojo_rankings.csv,1981,1.0,0.0
2916,My Name Is Khan,42345360,4018771,38326589,2010_boxofficemojo_rankings.csv,2010,0.09490463654105195,0.905095363458948
2917,After We Collided,42332008,0,42332008,2020_boxofficemojo_rankings.csv,2020,0.0,1.0
2918,Blue Thunder,42313354,42313354,0,1983_boxofficemojo_rankings.csv,1983,1.0,0.0
2919,Teenage Mutant Ninja Turtles III,42273609,42273609,0,1993_boxofficemojo_rankings.csv,1993,1.0,0.0
2920,A Good Year,42269923,7459300,34810623,2006_boxofficemojo_rankings.csv,2006,0.17646826562707482,0.8235317343729252
2921,Loving Vincent,42187665,6735118,35452547,2017_boxofficemojo_rankings.csv,2017,0.15964661708582353,0.8403533829141765
2922,White Nights,42160849,42160849,0,1985_boxofficemojo_rankings.csv,1985,1.0,0.0
2923,Long Day's Journey Into Night,42140994,521365,41619629,2018_boxofficemojo_rankings.csv,2018,0.01237191984602926,0.9876280801539707
2924,Jobs,42128352,16131410,25996942,2013_boxofficemojo_rankings.csv,2013,0.3829110144161348,0.6170889855838653
2925,Going the Distance,42059111,17804299,24254812,2010_boxofficemojo_rankings.csv,2010,0.4233161038520286,0.5766838961479713
2926,Bang Bang,42045981,2546172,39499809,2014_boxofficemojo_rankings.csv,2014,0.060556846087144456,0.9394431539128556
2927,Dirty Rotten Scoundrels,42039085,42039085,0,1988_boxofficemojo_rankings.csv,1988,1.0,0.0
2928,The Sisterhood of the Traveling Pants,42013878,39053061,2960817,2005_boxofficemojo_rankings.csv,2005,0.9295276432230322,0.07047235677696784
2929,Mary and the Witch's Flower,41978431,2418404,39560027,2017_boxofficemojo_rankings.csv,2017,0.05761063342267366,0.9423893665773263
2930,Meet the Browns,41975388,41975388,0,2008_boxofficemojo_rankings.csv,2008,1.0,0.0
2931,"As Above, So Below",41898409,21321100,20577309,2014_boxofficemojo_rankings.csv,2014,0.5088761246280259,0.49112387537197416
2932,The Fisher King,41895491,41895491,0,1991_boxofficemojo_rankings.csv,1991,1.0,0.0
2933,Call Me by Your Name,41887595,18095701,23791894,2017_boxofficemojo_rankings.csv,2017,0.4320062061333433,0.5679937938666567
2934,The Guilt Trip,41863726,37134215,4729511,2012_boxofficemojo_rankings.csv,2012,0.8870260377683534,0.11297396223164656
2935,Homeward Bound: The Incredible Journey,41833324,41833324,0,1993_boxofficemojo_rankings.csv,1993,1.0,0.0
2936,The Informant!,41771168,33316821,8454347,2009_boxofficemojo_rankings.csv,2009,0.7976032894268122,0.2023967105731877
2937,Balls of Fury,41739111,32886940,8852171,2007_boxofficemojo_rankings.csv,2007,0.7879166377070178,0.21208336229298225
2938,Fly Me to the Moon 3D,41721414,13816982,27904432,2008_boxofficemojo_rankings.csv,2008,0.33117242862382373,0.6688275713761763
2939,"Oh, God!",41687243,41687243,0,1977_boxofficemojo_rankings.csv,1977,1.0,0.0
2940,Wimbledon,41682237,17001133,24681104,2004_boxofficemojo_rankings.csv,2004,0.4078747740914193,0.5921252259085806
2941,T2 Trainspotting,41681746,2402004,39279742,2017_boxofficemojo_rankings.csv,2017,0.05762724047116452,0.9423727595288355
2942,Cheech and Chong's Next Movie,41675194,41675194,0,1980_boxofficemojo_rankings.csv,1980,1.0,0.0
2943,Overlord,41657844,21704844,19953000,2018_boxofficemojo_rankings.csv,2018,0.5210265802522089,0.47897341974779106
2944,Born to Be Wild,41644475,25978556,15665919,2011_boxofficemojo_rankings.csv,2011,0.6238175892480335,0.3761824107519665
2945,Snow White and the Seven Dwarfs 1993 Re-release,41634471,41634471,0,1993_boxofficemojo_rankings.csv,1993,1.0,0.0
2946,The Uninvited,41633384,28596818,13036566,2009_boxofficemojo_rankings.csv,2009,0.6868722945989689,0.3131277054010311
2947,Never Back Down,41627431,24850922,16776509,2008_boxofficemojo_rankings.csv,2008,0.5969842818308918,0.40301571816910825
2948,My Best Friend's Girl,41624687,19219250,22405437,2008_boxofficemojo_rankings.csv,2008,0.4617271956903844,0.5382728043096155
2949,Ronin,41616262,41616262,0,1998_boxofficemojo_rankings.csv,1998,1.0,0.0
2950,Undercover Brother,41604473,39089928,2514545,2002_boxofficemojo_rankings.csv,2002,0.9395607054078056,0.06043929459219445
2951,Set It Off,41590886,36461139,5129747,1996_boxofficemojo_rankings.csv,1996,0.8766617522887106,0.12333824771128944
2952,Safe,41564670,17142080,24422590,2012_boxofficemojo_rankings.csv,2012,0.4124194899177595,0.5875805100822405
2953,The Great Battle,41509280,472166,41037114,2018_boxofficemojo_rankings.csv,2018,0.0113749503725432,0.9886250496274568
2954,Gremlins 2: The New Batch,41482207,41482207,0,1990_boxofficemojo_rankings.csv,1990,1.0,0.0
2955,Gridiron Gang,41480851,38432823,3048028,2006_boxofficemojo_rankings.csv,2006,0.9265196367355144,0.07348036326448558
2956,Pale Rider,41410568,41410568,0,1985_boxofficemojo_rankings.csv,1985,1.0,0.0
2957,The Lady in the Van,41387687,10021175,31366512,2015_boxofficemojo_rankings.csv,2015,0.24212938017048405,0.757870619829516
2958,Peggy Sue Got Married,41382841,41382841,0,1986_boxofficemojo_rankings.csv,1986,1.0,0.0
2959,Shark Night 3D,41363927,18877153,22486774,2011_boxofficemojo_rankings.csv,2011,0.45636752525938845,0.5436324747406115
2960,Ricki and the Flash,41325328,26822144,14503184,2015_boxofficemojo_rankings.csv,2015,0.6490485447568619,0.35095145524313803
2961,Quarantine,41319906,31691811,9628095,2008_boxofficemojo_rankings.csv,2008,0.7669865221861831,0.2330134778138169
2962,Leatherheads,41319039,31373938,9945101,2008_boxofficemojo_rankings.csv,2008,0.7593094795839758,0.2406905204160242
2963,Pinocchio,41314585,3675719,37638866,2002_boxofficemojo_rankings.csv,2002,0.08896904083630515,0.9110309591636948
2964,This Is Where I Leave You,41296320,34296320,7000000,2014_boxofficemojo_rankings.csv,2014,0.8304933708378858,0.1695066291621142
2965,Tequila Sunrise,41292551,41292551,0,1988_boxofficemojo_rankings.csv,1988,1.0,0.0
2966,Toy Story 2009 Re-release,41258298,30702446,10555852,2009_boxofficemojo_rankings.csv,2009,0.744152024884788,0.25584797511521196
2967,Private Parts,41230799,41230799,0,1997_boxofficemojo_rankings.csv,1997,1.0,0.0
2968,Happy Gilmore,41205099,38824099,2381000,1996_boxofficemojo_rankings.csv,1996,0.9422158893490342,0.057784110650965795
2969,How to Make an American Quilt,41200020,23600020,17600000,1995_boxofficemojo_rankings.csv,1995,0.5728157413515819,0.42718425864841814
2970,Evangelion: 2.0 You Can (Not) Advance,41162041,133640,41028401,2009_boxofficemojo_rankings.csv,2009,0.0032466806007019912,0.996753319399298
2971,The Concert,41146351,657986,40488365,2009_boxofficemojo_rankings.csv,2009,0.01599135728949573,0.9840086427105043
2972,The Darkest Minds,41142379,12695691,28446688,2018_boxofficemojo_rankings.csv,2018,0.30857940908084097,0.6914205909191591
2973,50/50,41097853,35014192,6083661,2011_boxofficemojo_rankings.csv,2011,0.8519713183070659,0.14802868169293418
2974,Clash of the Titans,41092328,41092328,0,1981_boxofficemojo_rankings.csv,1981,1.0,0.0
2975,Fist Fight,41087017,32187017,8900000,2017_boxofficemojo_rankings.csv,2017,0.7833865622320549,0.21661343776794503
2976,The Mirror Has Two Faces,41083864,41083864,0,1996_boxofficemojo_rankings.csv,1996,1.0,0.0
2977,Arlington Road,41067311,24756177,16311134,1999_boxofficemojo_rankings.csv,1999,0.6028195271903729,0.3971804728096271
2978,Whale Rider,41062976,20779666,20283310,2003_boxofficemojo_rankings.csv,2003,0.5060438386151067,0.4939561613848933
2979,Dredd,41037742,13414714,27623028,2012_boxofficemojo_rankings.csv,2012,0.32688723468264896,0.6731127653173511
2980,Fright Night,41002607,18302607,22700000,2011_boxofficemojo_rankings.csv,2011,0.4463766657568871,0.5536233342431128
2981,Poltergeist II: The Other Side,40996665,40996665,0,1986_boxofficemojo_rankings.csv,1986,1.0,0.0
2982,Grand Canyon,40991329,33243020,7748309,1991_boxofficemojo_rankings.csv,1991,0.8109768775733034,0.18902312242669664
2983,Twisted,40954603,25198598,15756005,2004_boxofficemojo_rankings.csv,2004,0.6152812175959806,0.3847187824040194
2984,Breach,40953935,33231264,7722671,2007_boxofficemojo_rankings.csv,2007,0.8114303057813614,0.18856969421863856
2985,Pee-wee's Big Adventure,40940662,40940662,0,1985_boxofficemojo_rankings.csv,1985,1.0,0.0
2986,Drive Angry,40909909,10721033,30188876,2011_boxofficemojo_rankings.csv,2011,0.262064454848824,0.737935545151176
2987,Falling Down,40903593,40903593,0,1993_boxofficemojo_rankings.csv,1993,1.0,0.0
2988,Underwater,40882928,17291078,23591850,2020_boxofficemojo_rankings.csv,2020,0.4229412824834855,0.5770587175165145
2989,The Love Guru,40877556,32235793,8641763,2008_boxofficemojo_rankings.csv,2008,0.7885939413794699,0.21140605862053005
2990,Revenge of the Nerds,40874452,40874452,0,1984_boxofficemojo_rankings.csv,1984,1.0,0.0
2991,Where the Heart Is,40863718,33772838,7090880,2000_boxofficemojo_rankings.csv,2000,0.8264749184105078,0.17352508158949217
2992,Gamer,40828540,20534907,20293633,2009_boxofficemojo_rankings.csv,2009,0.5029547223584286,0.4970452776415713
2993,Fighting with My Family,40811919,22958886,17853033,2019_boxofficemojo_rankings.csv,2019,0.5625534540534592,0.43744654594654075
2994,An American Tail: Fievel Goes West,40766041,22166041,18600000,1991_boxofficemojo_rankings.csv,1991,0.5437378871301238,0.45626211286987617
2995,Absence of Malice,40716963,40716963,0,1981_boxofficemojo_rankings.csv,1981,1.0,0.0
2996,Short Circuit,40697761,40697761,0,1986_boxofficemojo_rankings.csv,1986,1.0,0.0
2997,Encino Man,40693477,40693477,0,1992_boxofficemojo_rankings.csv,1992,1.0,0.0
2998,Cop & ½,40689691,31889691,8800000,1993_boxofficemojo_rankings.csv,1993,0.7837290039877668,0.21627099601223318
2999,30 Minutes or Less,40662632,37053924,3608708,2011_boxofficemojo_rankings.csv,2011,0.9112524737700206,0.0887475262299794
3000,The Circle,40656399,20497844,20158555,2017_boxofficemojo_rankings.csv,2017,0.504172639588666,0.495827360411334
3001,Three Fugitives,40586886,40586886,0,1989_boxofficemojo_rankings.csv,1989,1.0,0.0
3002,The Dark Crystal,40577001,40577001,0,1982_boxofficemojo_rankings.csv,1982,1.0,0.0
3003,The Roommate,40492652,37300000,3192652,2011_boxofficemojo_rankings.csv,2011,0.9211547813662587,0.07884521863374125
3004,Jagged Edge,40491165,40491165,0,1985_boxofficemojo_rankings.csv,1985,1.0,0.0
3005,Bill & Ted's Excellent Adventure,40485039,40485039,0,1989_boxofficemojo_rankings.csv,1989,1.0,0.0
3006,War,40481352,22486409,17994943,2007_boxofficemojo_rankings.csv,2007,0.5554757410276218,0.4445242589723782
3007,Pretty in Pink,40471663,40471663,0,1986_boxofficemojo_rankings.csv,1986,1.0,0.0
3008,Holmes & Watson,40466970,30573626,9893344,2018_boxofficemojo_rankings.csv,2018,0.7555205146320567,0.24447948536794328
3009,Serenity,40445129,25514517,14930612,2005_boxofficemojo_rankings.csv,2005,0.6308427647739732,0.36915723522602684
3010,Bless the Child,40443010,29381494,11061516,2000_boxofficemojo_rankings.csv,2000,0.7264912774790996,0.2735087225209004
3011,The Ringer,40442443,35428675,5013768,2005_boxofficemojo_rankings.csv,2005,0.8760270738342884,0.12397292616571161
3012,The Witch,40423945,25138705,15285240,2016_boxofficemojo_rankings.csv,2016,0.6218765882449128,0.37812341175508724
3013,The Boy in the Striped Pajamas,40416563,9046156,31370407,2008_boxofficemojo_rankings.csv,2008,0.22382299058927896,0.7761770094107211
3014,2010,40400657,40400657,0,1984_boxofficemojo_rankings.csv,1984,1.0,0.0
3015,The Art of War,40400425,30208599,10191826,2000_boxofficemojo_rankings.csv,2000,0.7477297330411747,0.2522702669588253
3016,Reds,40382659,40382659,0,1981_boxofficemojo_rankings.csv,1981,1.0,0.0
3017,Bad Education,40350837,5211842,35138995,2004_boxofficemojo_rankings.csv,2004,0.12916316952731366,0.8708368304726863
3018,Magnificent Desolation: Walking on the Moon 3D,40339402,34137524,6201878,2005_boxofficemojo_rankings.csv,2005,0.8462575622712504,0.15374243772874968
3019,The Faculty,40283321,40283321,0,1998_boxofficemojo_rankings.csv,1998,1.0,0.0
3020,Carol,40272135,12711491,27560644,2015_boxofficemojo_rankings.csv,2015,0.3156398586764769,0.6843601413235231
3021,Blast from the Past,40263020,26511114,13751906,1999_boxofficemojo_rankings.csv,1999,0.6584482237050276,0.3415517762949724
3022,Mo' Money,40227006,40227006,0,1992_boxofficemojo_rankings.csv,1992,1.0,0.0
3023,Yentl,40218899,40218899,0,1983_boxofficemojo_rankings.csv,1983,1.0,0.0
3024,The Invasion,40170558,15074191,25096367,2007_boxofficemojo_rankings.csv,2007,0.37525470768914887,0.6247452923108512
3025,The Piano,40157856,40157856,0,1993_boxofficemojo_rankings.csv,1993,1.0,0.0
3026,Crimson Rivers 2: Angels of the Apocalypse,40152148,152148,40000000,2004_boxofficemojo_rankings.csv,2004,0.0037892866902164237,0.9962107133097836
3027,Big Business,40150487,40150487,0,1988_boxofficemojo_rankings.csv,1988,1.0,0.0
3028,Diary of a Wimpy Kid: The Long Haul,40140972,20738724,19402248,2017_boxofficemojo_rankings.csv,2017,0.5166472799911273,0.48335272000887275
3029,All About Steve,40105542,33862903,6242639,2009_boxofficemojo_rankings.csv,2009,0.8443447292147305,0.15565527078526953
3030,The Wild Life,40075446,8005586,32069860,2016_boxofficemojo_rankings.csv,2016,0.19976286726790266,0.8002371327320974
3031,Man of the House,40070995,40070995,0,1995_boxofficemojo_rankings.csv,1995,1.0,0.0
3032,Roxanne,40050884,40050884,0,1987_boxofficemojo_rankings.csv,1987,1.0,0.0
3033,Northern Limit Line,40034677,337907,39696770,2015_boxofficemojo_rankings.csv,2015,0.008440357842777151,0.9915596421572228
3034,Dancer in the Dark,40031879,4184036,35847843,2000_boxofficemojo_rankings.csv,2000,0.10451760208407904,0.895482397915921
3035,I Still Know What You Did Last Summer,40002112,40002112,0,1998_boxofficemojo_rankings.csv,1998,1.0,0.0
3036,Om Shanti Om,39990809,3597372,36393437,2007_boxofficemojo_rankings.csv,2007,0.0899549694030946,0.9100450305969054
3037,Dream House,39984400,21302340,18682060,2011_boxofficemojo_rankings.csv,2011,0.532766278848751,0.467233721151249
3038,Black Knight,39976235,33426971,6549264,2001_boxofficemojo_rankings.csv,2001,0.8361710651340728,0.16382893486592723
3039,Brotherhood of Blades 2,39966092,14204,39951888,2017_boxofficemojo_rankings.csv,2017,0.0003554012736596813,0.9996445987263404
3040,The Secret Life of Bees,39952437,37770162,2182275,2008_boxofficemojo_rankings.csv,2008,0.945378175554097,0.054621824445903015
3041,Manhattan,39946780,39946780,0,1979_boxofficemojo_rankings.csv,1979,1.0,0.0
3042,The Fox and the Hound,39900000,39900000,0,1981_boxofficemojo_rankings.csv,1981,1.0,0.0
3043,Astro Boy,39886986,19551067,20335919,2009_boxofficemojo_rankings.csv,2009,0.49016155294360925,0.5098384470563908
3044,Caddyshack,39846344,39846344,0,1980_boxofficemojo_rankings.csv,1980,1.0,0.0
3045,Monte Carlo,39782683,23186769,16595914,2011_boxofficemojo_rankings.csv,2011,0.5828357277964384,0.41716427220356156
3046,Friday the 13th,39754601,39754601,0,1980_boxofficemojo_rankings.csv,1980,1.0,0.0
3047,Memento,39723096,25544867,14178229,2001_boxofficemojo_rankings.csv,2001,0.6430734150228371,0.3569265849771629
3048,The Forest,39712000,26594261,13117739,2016_boxofficemojo_rankings.csv,2016,0.6696782080983078,0.3303217919016922
3049,Jackie Brown,39673162,39673162,0,1997_boxofficemojo_rankings.csv,1997,1.0,0.0
3050,Out for Justice,39673161,39673161,0,1991_boxofficemojo_rankings.csv,1991,1.0,0.0
3051,The November Man,39661919,25018119,14643800,2014_boxofficemojo_rankings.csv,2014,0.6307843803523475,0.3692156196476524
3052,Thugs of Hindostan,39570044,1449848,38120196,2018_boxofficemojo_rankings.csv,2018,0.0366400401273246,0.9633599598726754
3053,Hocus Pocus,39514713,39514713,0,1993_boxofficemojo_rankings.csv,1993,1.0,0.0
3054,Nobody's Fool,39491975,39491975,0,1994_boxofficemojo_rankings.csv,1994,1.0,0.0
3055,Down with Love,39468111,20305251,19162860,2003_boxofficemojo_rankings.csv,2003,0.5144723293192319,0.4855276706807681
3056,The Legend of Bagger Vance,39459427,30919168,8540259,2000_boxofficemojo_rankings.csv,2000,0.7835686007300613,0.2164313992699387
3057,Agora,39457342,619423,38837919,2009_boxofficemojo_rankings.csv,2009,0.01569854857430589,0.9843014514256941
3058,Fletch Lives,39450960,35150960,4300000,1989_boxofficemojo_rankings.csv,1989,0.891003919803219,0.10899608019678102
3059,Don Jon,39439355,24477704,14961651,2013_boxofficemojo_rankings.csv,2013,0.6206415901071405,0.37935840989285957
3060,Crocodile Dundee in Los Angeles,39438674,25635682,13802992,2001_boxofficemojo_rankings.csv,2001,0.6500137910316153,0.34998620896838467
3061,Halloween II,39421467,33392973,6028494,2009_boxofficemojo_rankings.csv,2009,0.8470758584402757,0.1529241415597243
3062,Frank Miller's Sin City: A Dame to Kill For,39407616,13757804,25649812,2014_boxofficemojo_rankings.csv,2014,0.3491153588179503,0.6508846411820497
3063,Joe Versus the Volcano,39404261,39404261,0,1990_boxofficemojo_rankings.csv,1990,1.0,0.0
3064,Dead Man Walking,39363635,39363635,0,1995_boxofficemojo_rankings.csv,1995,1.0,0.0
3065,Uri: The Surgical Strike,39346577,4186168,35160409,2019_boxofficemojo_rankings.csv,2019,0.10639217739322025,0.8936078226067797
3066,Thank You for Smoking,39323027,24793509,14529518,2006_boxofficemojo_rankings.csv,2006,0.6305086584509376,0.3694913415490623
3067,Blind Date,39321715,39321715,0,1987_boxofficemojo_rankings.csv,1987,1.0,0.0
3068,Cirque du Freak: The Vampire's Assistant,39291383,13869515,25421868,2009_boxofficemojo_rankings.csv,2009,0.35299126528582614,0.6470087347141739
3069,The Gambler,39280992,33680992,5600000,2014_boxofficemojo_rankings.csv,2014,0.8574374089126874,0.14256259108731267
3070,How Stella Got Her Groove Back,39278722,37672941,1605781,1998_boxofficemojo_rankings.csv,1998,0.9591182981971765,0.040881701802823425
3071,Dumb and Dumberer: When Harry Met Lloyd,39267515,26276465,12991050,2003_boxofficemojo_rankings.csv,2003,0.6691654666713694,0.33083453332863055
3072,¡Three Amigos!,39246734,39246734,0,1986_boxofficemojo_rankings.csv,1986,1.0,0.0
3073,Mars Needs Moms,39233678,21392758,17840920,2011_boxofficemojo_rankings.csv,2011,0.5452651673391417,0.45473483266085835
3074,Scoop,39220946,10525717,28695229,2006_boxofficemojo_rankings.csv,2006,0.26836978893879815,0.7316302110612019
3075,Absolutely Fabulous: The Movie,39219109,4772155,34446954,2016_boxofficemojo_rankings.csv,2016,0.12167933238870877,0.8783206676112912
3076,Samba,39178695,151530,39027165,2014_boxofficemojo_rankings.csv,2014,0.0038676632797493638,0.9961323367202506
3077,The Spirit,39164441,19806188,19358253,2008_boxofficemojo_rankings.csv,2008,0.5057186441139297,0.49428135588607025
3078,Show Dogs,39156854,17857020,21299834,2018_boxofficemojo_rankings.csv,2018,0.4560381689499366,0.5439618310500635
3079,Women Who Flirt,39156132,375495,38780637,2014_boxofficemojo_rankings.csv,2014,0.009589685722787941,0.990410314277212
3080,The Sword and the Sorcerer,39103425,39103425,0,1982_boxofficemojo_rankings.csv,1982,1.0,0.0
3081,What's Love Got to Do with It,39100956,39100956,0,1993_boxofficemojo_rankings.csv,1993,1.0,0.0
3082,Haunted Castle,39093166,13651656,25441510,2001_boxofficemojo_rankings.csv,2001,0.3492082478047442,0.6507917521952559
3083,Postcards from the Edge,39071603,39071603,0,1990_boxofficemojo_rankings.csv,1990,1.0,0.0
3084,Believer,39047153,365639,38681514,2018_boxofficemojo_rankings.csv,2018,0.009364037372968011,0.990635962627032
3085,Bambi 1988 Re-release,39047150,39047150,0,1988_boxofficemojo_rankings.csv,1988,1.0,0.0
3086,The Exorcist III,39024251,26098824,12925427,1990_boxofficemojo_rankings.csv,1990,0.6687847513075907,0.33121524869240926
3087,The Karate Kid Part III,38956288,38956288,0,1989_boxofficemojo_rankings.csv,1989,1.0,0.0
3088,The Life of David Gale,38955598,19955598,19000000,2003_boxofficemojo_rankings.csv,2003,0.512265220521066,0.48773477947893396
3089,Weird Science,38934048,23834048,15100000,1985_boxofficemojo_rankings.csv,1985,0.6121646534159509,0.387835346584049
3090,The Fly II,38903179,20021322,18881857,1989_boxofficemojo_rankings.csv,1989,0.5146448828770522,0.4853551171229477
3091,The Spy Gone North,38844509,500803,38343706,2018_boxofficemojo_rankings.csv,2018,0.012892504317663018,0.987107495682337
3092,First Sunday,38810311,37931869,878442,2008_boxofficemojo_rankings.csv,2008,0.9773657572597138,0.02263424274028621
3093,The Wicker Man,38805380,23649127,15156253,2006_boxofficemojo_rankings.csv,2006,0.6094290791637654,0.39057092083623457
3094,Criminal,38803993,14708696,24095297,2015_boxofficemojo_rankings.csv,2015,0.3790510940459143,0.6209489059540857
3095,Clockstoppers,38793283,36989956,1803327,2002_boxofficemojo_rankings.csv,2002,0.9535144524891075,0.046485547510892546
3096,Little Shop of Horrors,38748395,38748395,0,1986_boxofficemojo_rankings.csv,1986,1.0,0.0
3097,Dreamer: Inspired by a True Story,38741732,32751093,5990639,2005_boxofficemojo_rankings.csv,2005,0.8453698714347618,0.15463012856523814
3098,About Last Night,38702310,38702310,0,1986_boxofficemojo_rankings.csv,1986,1.0,0.0
3099,Someone Like You,38689940,27343067,11346873,2001_boxofficemojo_rankings.csv,2001,0.7067229103999645,0.29327708960003557
3100,Breakin',38682707,38682707,0,1984_boxofficemojo_rankings.csv,1984,1.0,0.0
3101,On the Basis of Sex,38673750,24622687,14051063,2018_boxofficemojo_rankings.csv,2018,0.6366769966708685,0.36332300332913153
3102,"Crouching Tiger, Hidden Dragon: Sword of Destiny",38659039,0,38659039,2016_boxofficemojo_rankings.csv,2016,0.0,1.0
3103,Basic Instinct 2,38629478,5971336,32658142,2006_boxofficemojo_rankings.csv,2006,0.15457977454419652,0.8454202254558034
3104,Accepted,38623262,36323505,2299757,2006_boxofficemojo_rankings.csv,2006,0.9404566864393794,0.05954331356062054
3105,Head of State,38620484,38125247,495237,2003_boxofficemojo_rankings.csv,2003,0.987176830823767,0.012823169176233006
3106,The Ghost and the Darkness,38619405,38619405,0,1996_boxofficemojo_rankings.csv,1996,1.0,0.0
3107,The Best of Me,38609668,26766213,11843455,2014_boxofficemojo_rankings.csv,2014,0.6932515710831805,0.30674842891681947
3108,On Deadly Ground,38590458,38590458,0,1994_boxofficemojo_rankings.csv,1994,1.0,0.0
3109,Urban Legends: Final Cut,38574362,21468807,17105555,2000_boxofficemojo_rankings.csv,2000,0.5565563728571843,0.44344362714281577
3110,Running Scared,38500726,38500726,0,1986_boxofficemojo_rankings.csv,1986,1.0,0.0
3111,Million Dollar Arm,38483455,36457627,2025828,2014_boxofficemojo_rankings.csv,2014,0.9473584687237672,0.05264153127623286
3112,What's the Worst That Could Happen?,38464131,32269834,6194297,2001_boxofficemojo_rankings.csv,2001,0.8389591331206728,0.16104086687932714
3113,Bachelor Party,38435947,38435947,0,1984_boxofficemojo_rankings.csv,1984,1.0,0.0
3114,Employee of the Month,38395414,28444855,9950559,2006_boxofficemojo_rankings.csv,2006,0.7408399086411727,0.2591600913588274
3115,Chernobyl Diaries,38390020,18119640,20270380,2012_boxofficemojo_rankings.csv,2012,0.4719882927906784,0.5280117072093216
3116,Red Dawn,38376497,38376497,0,1984_boxofficemojo_rankings.csv,1984,1.0,0.0
3117,The Missing,38364277,27011180,11353097,2003_boxofficemojo_rankings.csv,2003,0.7040711336746943,0.2959288663253057
3118,Boruto: Naruto The Movie,38362448,919651,37442797,2015_boxofficemojo_rankings.csv,2015,0.023972688082887723,0.9760273119171122
3119,The Lazarus Effect,38356892,25801570,12555322,2015_boxofficemojo_rankings.csv,2015,0.6726710287162996,0.3273289712837005
3120,City Heat,38348988,38348988,0,1984_boxofficemojo_rankings.csv,1984,1.0,0.0
3121,The Soloist,38332994,31720158,6612836,2009_boxofficemojo_rankings.csv,2009,0.8274897076914994,0.1725102923085006
3122,Ghajini,38316584,2430627,35885957,2008_boxofficemojo_rankings.csv,2008,0.0634353782685847,0.9365646217314153
3123,Higher Learning,38290723,38290723,0,1995_boxofficemojo_rankings.csv,1995,1.0,0.0
3124,Van Wilder: Party Liaison,38275483,21305259,16970224,2002_boxofficemojo_rankings.csv,2002,0.5566293964206801,0.44337060357931996
3125,Don't Be Afraid of the Dark,38269529,24046682,14222847,2011_boxofficemojo_rankings.csv,2011,0.6283506128335157,0.3716493871664843
3126,Annie Hall,38251425,38251425,0,1977_boxofficemojo_rankings.csv,1977,1.0,0.0
3127,The Original Kings of Comedy,38182790,38182790,0,2000_boxofficemojo_rankings.csv,2000,1.0,0.0
3128,The Water Diviner,38176317,4196641,33979676,2014_boxofficemojo_rankings.csv,2014,0.10992786444014492,0.8900721355598551
3129,Encounter in the Third Dimension,38171557,7195792,30975765,1999_boxofficemojo_rankings.csv,1999,0.18851188071788635,0.8114881192821136
3130,Just My Luck,38159905,17326650,20833255,2006_boxofficemojo_rankings.csv,2006,0.45405380333100936,0.5459461966689907
3131,Jumping the Broom,38158601,37295394,863207,2011_boxofficemojo_rankings.csv,2011,0.9773784421499101,0.022621557850089943
3132,The Running Man,38122105,38122105,0,1987_boxofficemojo_rankings.csv,1987,1.0,0.0
3133,The Doctor,38120905,38120905,0,1991_boxofficemojo_rankings.csv,1991,1.0,0.0
3134,Spaceballs,38119483,38119483,0,1987_boxofficemojo_rankings.csv,1987,1.0,0.0
3135,Ri¢hie Ri¢h,38087756,38087756,0,1994_boxofficemojo_rankings.csv,1994,1.0,0.0
3136,Happily N'Ever After,38085778,15589393,22496385,2007_boxofficemojo_rankings.csv,2007,0.40932321246004216,0.5906767875399578
3137,One for the Money,38080789,26414527,11666262,2011_boxofficemojo_rankings.csv,2011,0.6936444252770078,0.30635557472299224
3138,The Producers,38075318,19398532,18676786,2005_boxofficemojo_rankings.csv,2005,0.5094778722530958,0.4905221277469042
3139,The Banger Sisters,38068353,30307416,7760937,2002_boxofficemojo_rankings.csv,2002,0.7961315268879638,0.20386847311203612
3140,But Always,38039248,430760,37608488,2014_boxofficemojo_rankings.csv,2014,0.011324093473141214,0.9886759065268588
3141,Bill & Ted's Bogus Journey,38037513,38037513,0,1991_boxofficemojo_rankings.csv,1991,1.0,0.0
3142,Overcomer,38026103,34746945,3279158,2019_boxofficemojo_rankings.csv,2019,0.9137656046426845,0.08623439535731547
3143,Dead Again,38016380,38016380,0,1991_boxofficemojo_rankings.csv,1991,1.0,0.0
3144,The Eagle,37989684,19490041,18499643,2011_boxofficemojo_rankings.csv,2011,0.5130350913158425,0.48696490868415754
3145,For Colored Girls,37981984,37729698,252286,2010_boxofficemojo_rankings.csv,2010,0.9933577456090761,0.0066422543909238655
3146,Howard the Duck,37962774,16295774,21667000,1986_boxofficemojo_rankings.csv,1986,0.42925667128540185,0.5707433287145981
3147,Sgt. Bilko,37956793,30356793,7600000,1996_boxofficemojo_rankings.csv,1996,0.7997723358767428,0.2002276641232572
3148,It Could Happen to You,37939757,37939757,0,1994_boxofficemojo_rankings.csv,1994,1.0,0.0
3149,Killing Them Softly,37930465,15026056,22904409,2012_boxofficemojo_rankings.csv,2012,0.39614742397700636,0.6038525760229937
3150,The Dead Pool,37903295,37903295,0,1988_boxofficemojo_rankings.csv,1988,1.0,0.0
3151,Hell or High Water,37879877,27007844,10872033,2016_boxofficemojo_rankings.csv,2016,0.7129865812394269,0.28701341876057307
3152,All That Jazz,37823676,37823676,0,1979_boxofficemojo_rankings.csv,1979,1.0,0.0
3153,St. Elmo's Fire,37803872,37803872,0,1985_boxofficemojo_rankings.csv,1985,1.0,0.0
3154,The Black Stallion,37799643,37799643,0,1979_boxofficemojo_rankings.csv,1979,1.0,0.0
3155,Bulletproof Monk,37713879,23358708,14355171,2003_boxofficemojo_rankings.csv,2003,0.6193663611213261,0.3806336388786738
3156,The Hills Have Eyes 2,37697773,20804166,16893607,2007_boxofficemojo_rankings.csv,2007,0.5518672416007173,0.4481327583992826
3157,The Handmaiden,37692886,2006788,35686098,2016_boxofficemojo_rankings.csv,2016,0.05324049742436809,0.9467595025756319
3158,Casanova,37691644,11304403,26387241,2005_boxofficemojo_rankings.csv,2005,0.2999180136584119,0.700081986341588
3159,The Prince and Me,37666766,28176497,9490269,2004_boxofficemojo_rankings.csv,2004,0.7480466201956387,0.2519533798043612
3160,Halloween: Resurrection,37664855,30354442,7310413,2002_boxofficemojo_rankings.csv,2002,0.8059089036716058,0.1940910963283942
3161,The Covenant,37598767,23380495,14218272,2006_boxofficemojo_rankings.csv,2006,0.6218420673209842,0.37815793267901576
3162,Now and Then,37591674,27112329,10479345,1995_boxofficemojo_rankings.csv,1995,0.7212322867026353,0.2787677132973647
3163,Down Periscope,37553752,25785603,11768149,1996_boxofficemojo_rankings.csv,1996,0.6866318710311555,0.3133681289688444
3164,Pokémon the Movie: I Choose You!,37552144,2401722,35150422,2017_boxofficemojo_rankings.csv,2017,0.06395698738266449,0.9360430126173355
3165,Broken Embraces,37472507,5014305,32458202,2009_boxofficemojo_rankings.csv,2009,0.13381290448488006,0.86618709551512
3166,A Walk in the Woods,37461274,29504281,7956993,2015_boxofficemojo_rankings.csv,2015,0.7875941699153104,0.21240583008468958
3167,Pain and Glory,37359689,4567338,32792351,2019_boxofficemojo_rankings.csv,2019,0.12225310547954508,0.877746894520455
3168,Snowden,37357216,21587519,15769697,2016_boxofficemojo_rankings.csv,2016,0.5778674460109662,0.4221325539890339
3169,Unhinged,37353385,19353385,18000000,2020_boxofficemojo_rankings.csv,2020,0.518115961913492,0.4818840380865081
3170,The Majestic,37317558,27807266,9510292,2001_boxofficemojo_rankings.csv,2001,0.7451523489291555,0.25484765107084445
3171,Becoming Jane,37311672,18670946,18640726,2007_boxofficemojo_rankings.csv,2007,0.5004049671105599,0.49959503288944007
3172,Do the Right Thing,37295445,27545445,9750000,1989_boxofficemojo_rankings.csv,1989,0.7385739733096093,0.2614260266903907
3173,Home Again,37270721,27020284,10250437,2017_boxofficemojo_rankings.csv,2017,0.7249734718037786,0.27502652819622136
3174,Beauty Shop,37245453,36351350,894103,2005_boxofficemojo_rankings.csv,2005,0.9759943045933688,0.024005695406631247
3175,Semi-Tough,37187139,37187139,0,1977_boxofficemojo_rankings.csv,1977,1.0,0.0
3176,Psycho,37170655,21485655,15685000,1998_boxofficemojo_rankings.csv,1998,0.5780273444199463,0.4219726555800537
3177,"Like Father, Like Son",37170163,334616,36835547,2013_boxofficemojo_rankings.csv,2013,0.009002274216553745,0.9909977257834462
3178,Raising Cain,37170057,21370057,15800000,1992_boxofficemojo_rankings.csv,1992,0.5749266674517072,0.4250733325482928
3179,Brubaker,37121708,37121708,0,1980_boxofficemojo_rankings.csv,1980,1.0,0.0
3180,The Family That Preys,37105289,37105289,0,2008_boxofficemojo_rankings.csv,2008,1.0,0.0
3181,Sphere,37020277,37020277,0,1998_boxofficemojo_rankings.csv,1998,1.0,0.0
3182,Till The End Of The World,37013733,118660,36895073,2018_boxofficemojo_rankings.csv,2018,0.003205837141582018,0.9967941628584179
3183,Train to Busan Presents: Peninsula,36995513,1169697,35825816,2020_boxofficemojo_rankings.csv,2020,0.031617266666906334,0.9683827333330937
3184,2.0,36945969,4152000,32793969,2018_boxofficemojo_rankings.csv,2018,0.11238032490093845,0.8876196750990616
3185,Devil's Due,36921560,15821461,21100099,2014_boxofficemojo_rankings.csv,2014,0.42851550692874296,0.571484493071257
3186,The Bachelor,36911617,21760240,15151377,1999_boxofficemojo_rankings.csv,1999,0.589522805245839,0.410477194754161
3187,Ex Machina,36869414,25442958,11426456,2015_boxofficemojo_rankings.csv,2015,0.6900830590906598,0.3099169409093402
3188,Just Cause,36853222,36853222,0,1995_boxofficemojo_rankings.csv,1995,1.0,0.0
3189,My Favorite Martian,36850101,36850101,0,1999_boxofficemojo_rankings.csv,1999,1.0,0.0
3190,Best Friends,36821203,36821203,0,1982_boxofficemojo_rankings.csv,1982,1.0,0.0
3191,The Adventurers,36796816,216556,36580260,2017_boxofficemojo_rankings.csv,2017,0.0058851831093211975,0.9941148168906788
3192,Titan A.E.,36754634,22753426,14001208,2000_boxofficemojo_rankings.csv,2000,0.6190627826684385,0.3809372173315615
3193,Alive,36733909,36733909,0,1993_boxofficemojo_rankings.csv,1993,1.0,0.0
3194,Valentine,36684136,20384136,16300000,2001_boxofficemojo_rankings.csv,2001,0.5556662422143457,0.44433375778565426
3195,Joy Ride,36642838,21974919,14667919,2001_boxofficemojo_rankings.csv,2001,0.5997057051094132,0.4002942948905868
3196,Gung Ho,36611610,36611610,0,1986_boxofficemojo_rankings.csv,1986,1.0,0.0
3197,Return to Me,36609995,32722798,3887197,2000_boxofficemojo_rankings.csv,2000,0.8938214277275919,0.10617857227240812
3198,Burnt,36606743,13651946,22954797,2015_boxofficemojo_rankings.csv,2015,0.3729352813496683,0.6270647186503318
3199,The Intruder,36599361,35419122,1180239,2019_boxofficemojo_rankings.csv,2019,0.9677524697767265,0.03224753022327357
3200,The Priests,36577134,185093,36392041,2015_boxofficemojo_rankings.csv,2015,0.005060347265042691,0.9949396527349573
3201,Tarzan the Ape Man,36565280,36565280,0,1981_boxofficemojo_rankings.csv,1981,1.0,0.0
3202,Soapdish,36489888,36489888,0,1991_boxofficemojo_rankings.csv,1991,1.0,0.0
3203,Baby Geniuses,36450736,27250736,9200000,1999_boxofficemojo_rankings.csv,1999,0.7476045476832073,0.2523954523167927
3204,Son in Law,36448400,36448400,0,1993_boxofficemojo_rankings.csv,1993,1.0,0.0
3205,Brooklyn's Finest,36440201,27163593,9276608,2009_boxofficemojo_rankings.csv,2009,0.7454292856397801,0.2545707143602199
3206,All of Me,36403064,36403064,0,1984_boxofficemojo_rankings.csv,1984,1.0,0.0
3207,Vegas Vacation,36400360,36400360,0,1997_boxofficemojo_rankings.csv,1997,1.0,0.0
3208,Pirate Radio,36348784,8017917,28330867,2009_boxofficemojo_rankings.csv,2009,0.22058281234387372,0.7794171876561262
3209,The Little Mermaid 1997 Re-release,36325688,27187616,9138072,1997_boxofficemojo_rankings.csv,1997,0.748440497534417,0.251559502465583
3210,Universal Soldier,36299898,36299898,0,1992_boxofficemojo_rankings.csv,1992,1.0,0.0
3211,Richard Pryor: Live on the Sunset Strip,36299720,36299720,0,1982_boxofficemojo_rankings.csv,1982,1.0,0.0
3212,Furry Vengeance,36288132,17630465,18657667,2010_boxofficemojo_rankings.csv,2010,0.48584658477322556,0.5141534152267744
3213,A Most Wanted Man,36233517,17237855,18995662,2014_boxofficemojo_rankings.csv,2014,0.4757433566275115,0.5242566433724886
3214,Mad Max Beyond Thunderdome,36230219,36230219,0,1985_boxofficemojo_rankings.csv,1985,1.0,0.0
3215,A Very Harold & Kumar Christmas,36192775,35061031,1131744,2011_boxofficemojo_rankings.csv,2011,0.9687301125708101,0.031269887429189944
3216,Sicko,36093504,24540079,11553425,2007_boxofficemojo_rankings.csv,2007,0.6799029265764831,0.3200970734235169
3217,Love Happens,36088028,22965110,13122918,2009_boxofficemojo_rankings.csv,2009,0.6363636716309353,0.3636363283690647
3218,Nothing to Lose,36075317,1016188,35059129,2018_boxofficemojo_rankings.csv,2018,0.028168512005036575,0.9718314879949634
3219,Whatever Works,36020534,5306706,30713828,2009_boxofficemojo_rankings.csv,2009,0.14732446776052793,0.8526755322394721
3220,Shine,35999081,35892330,106751,1996_boxofficemojo_rankings.csv,1996,0.9970346187448508,0.0029653812551492633
3221,Kundo: Age of the Rampant,35941291,280958,35660333,2014_boxofficemojo_rankings.csv,2014,0.00781713711953196,0.9921828628804681
3222,Ra.One,35911689,2511689,33400000,2011_boxofficemojo_rankings.csv,2011,0.06994070927713815,0.9300592907228619
3223,You Will Meet a Tall Dark Stranger,35867322,3248246,32619076,2010_boxofficemojo_rankings.csv,2010,0.09056282484652743,0.9094371751534726
3224,Taps,35856053,35856053,0,1981_boxofficemojo_rankings.csv,1981,1.0,0.0
3225,The Black Hole,35841901,35841901,0,1979_boxofficemojo_rankings.csv,1979,1.0,0.0
3226,Garden State,35825316,26782316,9043000,2004_boxofficemojo_rankings.csv,2004,0.747580733132961,0.2524192668670389
3227,Conquest 1453,35797045,35730,35761315,2012_boxofficemojo_rankings.csv,2012,0.0009981270800425008,0.9990018729199575
3228,Child's Play 2,35763605,28501605,7262000,1990_boxofficemojo_rankings.csv,1990,0.7969444075897829,0.20305559241021703
3229,Riding in Cars with Boys,35743308,30165536,5577772,2001_boxofficemojo_rankings.csv,2001,0.8439491946296632,0.15605080537033675
3230,Robin Hood: Men in Tights,35739755,35739755,0,1993_boxofficemojo_rankings.csv,1993,1.0,0.0
3231,Hostel: Part II,35728183,17609452,18118731,2007_boxofficemojo_rankings.csv,2007,0.4928728673383698,0.5071271326616302
3232,Tad the Lost Explorer and the Secret of King Midas,35704046,5874,35698172,2017_boxofficemojo_rankings.csv,2017,0.00016451916962016014,0.9998354808303799
3233,Hostiles,35669017,29819114,5849903,2017_boxofficemojo_rankings.csv,2017,0.835994835517895,0.164005164482105
3234,Summer School,35659098,35659098,0,1987_boxofficemojo_rankings.csv,1987,1.0,0.0
3235,The Indian in the Cupboard,35656131,35656131,0,1995_boxofficemojo_rankings.csv,1995,1.0,0.0
3236,Starting Over,35649012,35649012,0,1979_boxofficemojo_rankings.csv,1979,1.0,0.0
3237,Faster,35626958,23240020,12386938,2010_boxofficemojo_rankings.csv,2010,0.6523155864163311,0.34768441358366886
3238,Silkwood,35615609,35615609,0,1983_boxofficemojo_rankings.csv,1983,1.0,0.0
3239,Sharky's Machine,35610100,35610100,0,1981_boxofficemojo_rankings.csv,1981,1.0,0.0
3240,A Thin Line Between Love and Hate,35599803,34767836,831967,1996_boxofficemojo_rankings.csv,1996,0.976630011126747,0.023369988873253034
3241,Tyler Perry's Good Deeds,35579177,35025791,553386,2012_boxofficemojo_rankings.csv,2012,0.9844463518647438,0.015553648135256191
3242,My Dog Skip,35547761,34134641,1413120,2000_boxofficemojo_rankings.csv,2000,0.9602472853353549,0.039752714664645125
3243,No Way Out,35509515,35509515,0,1987_boxofficemojo_rankings.csv,1987,1.0,0.0
3244,Jersey Girl,35492921,25268157,10224764,2004_boxofficemojo_rankings.csv,2004,0.7119210334928477,0.28807896650715226
3245,Pete's Dragon,35488000,35488000,0,1977_boxofficemojo_rankings.csv,1977,1.0,0.0
3246,Mia and the White Lion,35487190,399471,35087719,2018_boxofficemojo_rankings.csv,2018,0.011256766173934877,0.9887432338260651
3247,Arbitrage,35485056,7919574,27565482,2012_boxofficemojo_rankings.csv,2012,0.22318054112694652,0.7768194588730535
3248,Vacancy,35442935,19363565,16079370,2007_boxofficemojo_rankings.csv,2007,0.5463307426430684,0.45366925735693164
3249,Money Train,35431113,35431113,0,1995_boxofficemojo_rankings.csv,1995,1.0,0.0
3250,Mermaids,35419397,35419397,0,1990_boxofficemojo_rankings.csv,1990,1.0,0.0
3251,Original Sin,35402320,16534221,18868099,2001_boxofficemojo_rankings.csv,2001,0.46703778170470184,0.5329622182952981
3252,Room,35401758,14677654,20724104,2015_boxofficemojo_rankings.csv,2015,0.4146024047732319,0.5853975952267682
3253,Hannah and Her Sisters,35392203,35392203,0,1986_boxofficemojo_rankings.csv,1986,1.0,0.0
3254,Namiya,35351623,70814,35280809,2017_boxofficemojo_rankings.csv,2017,0.0020031329254670996,0.997996867074533
3255,A Goofy Movie,35348597,35348597,0,1995_boxofficemojo_rankings.csv,1995,1.0,0.0
3256,The Darjeeling Limited,35307949,11902715,23405234,2007_boxofficemojo_rankings.csv,2007,0.337111481609991,0.662888518390009
3257,Assault on Precinct 13,35294470,20040895,15253575,2005_boxofficemojo_rankings.csv,2005,0.5678196896000989,0.4321803103999012
3258,Selena,35281794,35281794,0,1997_boxofficemojo_rankings.csv,1997,1.0,0.0
3259,Eye in the Sky,35259653,18704595,16555058,2016_boxofficemojo_rankings.csv,2016,0.5304815393390286,0.46951846066097136
3260,Edtv,35242897,22431897,12811000,1999_boxofficemojo_rankings.csv,1999,0.636494128164322,0.363505871835678
3261,Honeymoon in Vegas,35208854,35208854,0,1992_boxofficemojo_rankings.csv,1992,1.0,0.0
3262,Courageous,35185884,34522221,663663,2011_boxofficemojo_rankings.csv,2011,0.9811383735591239,0.01886162644087612
3263,The Girl in the Spider's Web,35164920,14841338,20323582,2018_boxofficemojo_rankings.csv,2018,0.42204953118050603,0.577950468819494
3264,The Adventures of Rocky & Bullwinkle,35134820,26005820,9129000,2000_boxofficemojo_rankings.csv,2000,0.7401722849298786,0.2598277150701213
3265,The Secret in Their Eyes,35079650,6391436,28688214,2009_boxofficemojo_rankings.csv,2009,0.18219782694525175,0.8178021730547482
3266,Miss Potter,35078241,3005605,32072636,2006_boxofficemojo_rankings.csv,2006,0.08568288814709951,0.9143171118529005
3267,Alfie,35060882,13399812,21661070,2004_boxofficemojo_rankings.csv,2004,0.3821869626668262,0.6178130373331737
3268,My Week with Marilyn,35057696,14600347,20457349,2011_boxofficemojo_rankings.csv,2011,0.4164662446727817,0.5835337553272183
3269,Flight of the Phoenix,35021497,21009180,14012317,2004_boxofficemojo_rankings.csv,2004,0.5998938309233326,0.4001061690766674
3270,Midnight Express,35000000,35000000,0,1978_boxofficemojo_rankings.csv,1978,1.0,0.0
3271,Red Heat,34994648,34994648,0,1988_boxofficemojo_rankings.csv,1988,1.0,0.0
3272,Excalibur,34967437,34967437,0,1981_boxofficemojo_rankings.csv,1981,1.0,0.0
3273,When Marnie Was There,34949567,561085,34388482,2014_boxofficemojo_rankings.csv,2014,0.016054133088401354,0.9839458669115987
3274,The Sitter,34942188,30441326,4500862,2011_boxofficemojo_rankings.csv,2011,0.8711911801287315,0.12880881987126852
3275,The Hate U Give,34934009,29719483,5214526,2018_boxofficemojo_rankings.csv,2018,0.8507321046376326,0.14926789536236737
3276,Lost and Love,34930177,188817,34741360,2015_boxofficemojo_rankings.csv,2015,0.005405555202311171,0.9945944447976889
3277,Places in the Heart,34901614,34901614,0,1984_boxofficemojo_rankings.csv,1984,1.0,0.0
3278,Freddy's Dead: The Final Nightmare,34872033,34872033,0,1991_boxofficemojo_rankings.csv,1991,1.0,0.0
3279,The Truth About Cats & Dogs,34861807,34861807,0,1996_boxofficemojo_rankings.csv,1996,1.0,0.0
3280,Gomorrah,34861529,1579146,33282383,2008_boxofficemojo_rankings.csv,2008,0.045297668957663906,0.9547023310423361
3281,Secret in Their Eyes,34854990,20180155,14674835,2015_boxofficemojo_rankings.csv,2015,0.578974631752871,0.42102536824712905
3282,Chimpanzee,34823764,28972764,5851000,2012_boxofficemojo_rankings.csv,2012,0.8319825507661952,0.16801744923380482
3283,Disaster Movie,34816824,14190901,20625923,2008_boxofficemojo_rankings.csv,2008,0.40758746403750096,0.5924125359624991
3284,Kidnap,34814102,30971040,3843062,2017_boxofficemojo_rankings.csv,2017,0.8896119164584513,0.11038808354154876
3285,The Life Aquatic with Steve Zissou,34808403,24020403,10788000,2004_boxofficemojo_rankings.csv,2004,0.6900748362399735,0.30992516376002655
3286,Sunshine,34806360,3675753,31130607,2007_boxofficemojo_rankings.csv,2007,0.10560578583913974,0.8943942141608603
3287,White Fang,34793160,34793160,0,1991_boxofficemojo_rankings.csv,1991,1.0,0.0
3288,Broken City,34737199,19701164,15036035,2013_boxofficemojo_rankings.csv,2013,0.5671488941868917,0.4328511058131083
3289,Psycho II,34725000,34725000,0,1983_boxofficemojo_rankings.csv,1983,1.0,0.0
3290,Endless Love,34718173,23438250,11279923,2014_boxofficemojo_rankings.csv,2014,0.6751003285800782,0.32489967141992177
3291,Jane Eyre,34710627,11242660,23467967,2011_boxofficemojo_rankings.csv,2011,0.3238967708650149,0.6761032291349851
3292,The Kids Are All Right,34705850,20811365,13894485,2010_boxofficemojo_rankings.csv,2010,0.5996500589958177,0.4003499410041823
3293,The Killing Fields,34700291,34700291,0,1984_boxofficemojo_rankings.csv,1984,1.0,0.0
3294,October Sky,34698685,32570685,2128000,1999_boxofficemojo_rankings.csv,1999,0.9386720274846151,0.06132797251538495
3295,Addicted to Love,34673095,34673095,0,1997_boxofficemojo_rankings.csv,1997,1.0,0.0
3296,Dangerous Liaisons,34670720,34670720,0,1988_boxofficemojo_rankings.csv,1988,1.0,0.0
3297,The Man Standing Next,34664900,113527,34551373,2020_boxofficemojo_rankings.csv,2020,0.003274984205925879,0.9967250157940741
3298,Malibu's Most Wanted,34622504,34432201,190303,2003_boxofficemojo_rankings.csv,2003,0.9945034882514563,0.005496511748543664
3299,Alex Cross,34618867,25888412,8730455,2012_boxofficemojo_rankings.csv,2012,0.7478122262060165,0.2521877737939835
3300,Gone Baby Gone,34612443,20292962,14319481,2007_boxofficemojo_rankings.csv,2007,0.5862909474491587,0.41370905255084134
3301,Mississippi Burning,34603943,34603943,0,1988_boxofficemojo_rankings.csv,1988,1.0,0.0
3302,That Thing You Do!,34585416,25857416,8728000,1996_boxofficemojo_rankings.csv,1996,0.7476392939729278,0.2523607060270722
3303,Friday the 13th Part III,34581519,34581519,0,1982_boxofficemojo_rankings.csv,1982,1.0,0.0
3304,The Best Man,34573780,34102780,471000,1999_boxofficemojo_rankings.csv,1999,0.9863769596497692,0.013623040350230724
3305,Crank: High Voltage,34572541,13684249,20888292,2009_boxofficemojo_rankings.csv,2009,0.3958126479624393,0.6041873520375607
3306,Salmon Fishing in the Yemen,34564651,9047981,25516670,2012_boxofficemojo_rankings.csv,2012,0.2617697774526929,0.7382302225473071
3307,Jack Frost,34562556,34562556,0,1998_boxofficemojo_rankings.csv,1998,1.0,0.0
3308,Haywire,34513760,18942396,15571364,2012_boxofficemojo_rankings.csv,2012,0.548836058430029,0.4511639415699709
3309,Steve Jobs,34441873,17766658,16675215,2015_boxofficemojo_rankings.csv,2015,0.515844710303647,0.484155289696353
3310,The Doors,34416893,34416893,0,1991_boxofficemojo_rankings.csv,1991,1.0,0.0
3311,Swimfan,34411240,28564995,5846245,2002_boxofficemojo_rankings.csv,2002,0.8301065291457094,0.16989347085429063
3312,Like Father Like Son,34377585,34377585,0,1987_boxofficemojo_rankings.csv,1987,1.0,0.0
3313,Adventures in Babysitting,34368475,34368475,0,1987_boxofficemojo_rankings.csv,1987,1.0,0.0
3314,Muppet Treasure Island,34327391,34327391,0,1996_boxofficemojo_rankings.csv,1996,1.0,0.0
3315,Little Darlings,34326249,34326249,0,1980_boxofficemojo_rankings.csv,1980,1.0,0.0
3316,The Medallion,34268701,22219192,12049509,2003_boxofficemojo_rankings.csv,2003,0.648381507078427,0.35161849292157293
3317,American Psycho,34266564,15070285,19196279,2000_boxofficemojo_rankings.csv,2000,0.43979562701413544,0.5602043729858646
3318,Wild Safari - A South African Adventure,34257135,16621530,17635605,2005_boxofficemojo_rankings.csv,2005,0.48519906874874386,0.5148009312512561
3319,Bad News Bears,34252847,32868349,1384498,2005_boxofficemojo_rankings.csv,2005,0.95958006060051,0.040419939399489915
3320,Victor Frankenstein,34227298,5775076,28452222,2015_boxofficemojo_rankings.csv,2015,0.16872719546836562,0.8312728045316343
3321,The House,34184504,25584504,8600000,2017_boxofficemojo_rankings.csv,2017,0.748424022767743,0.25157597723225705
3322,Cirque du Soleil: Worlds Away,34153101,12512862,21640239,2012_boxofficemojo_rankings.csv,2012,0.36637557450493297,0.633624425495067
3323,Instinct,34105207,34105207,0,1999_boxofficemojo_rankings.csv,1999,1.0,0.0
3324,Cinderella 1987 Re-release,34101149,34101149,0,1987_boxofficemojo_rankings.csv,1987,1.0,0.0
3325,In Bruges,34085749,7800824,26284925,2008_boxofficemojo_rankings.csv,2008,0.22885881134664227,0.7711411886533578
3326,The Bad Guys: The Movie,34024386,166972,33857414,2019_boxofficemojo_rankings.csv,2019,0.004907421400638942,0.9950925785993611
3327,Darkness,33988736,22163442,11825294,2002_boxofficemojo_rankings.csv,2002,0.6520819720980504,0.34791802790194964
3328,Dungeons & Dragons,33978694,15391970,18586724,2000_boxofficemojo_rankings.csv,2000,0.45298886413939277,0.5470111358606072
3329,The Fighting Temptations,33972062,30250745,3721317,2003_boxofficemojo_rankings.csv,2003,0.8904594899185101,0.1095405100814899
3330,The Witness,33963557,418063,33545494,2015_boxofficemojo_rankings.csv,2015,0.012309164202088727,0.9876908357979113
3331,The Relic,33956608,33956608,0,1997_boxofficemojo_rankings.csv,1997,1.0,0.0
3332,Hotel Rwanda,33882243,23530892,10351351,2004_boxofficemojo_rankings.csv,2004,0.6944903854210597,0.3055096145789404
3333,The Good Liar,33856058,17156058,16700000,2019_boxofficemojo_rankings.csv,2019,0.5067352495674482,0.49326475043255186
3334,The Sandlot,33832313,32434006,1398307,1993_boxofficemojo_rankings.csv,1993,0.9586694826333629,0.04133051736663704
3335,Jay and Silent Bob Strike Back,33788161,30085147,3703014,2001_boxofficemojo_rankings.csv,2001,0.890404985343831,0.10959501465616907
3336,The Art of Racing in the Rain,33766787,26395642,7371145,2019_boxofficemojo_rankings.csv,2019,0.7817042823766442,0.21829571762335576
3337,Porky's II: The Next Day,33759266,33759266,0,1983_boxofficemojo_rankings.csv,1983,1.0,0.0
3338,Love and Honour,33755574,60910,33694664,2006_boxofficemojo_rankings.csv,2006,0.0018044427269996949,0.9981955572730004
3339,I Want to Eat Your Pancreas,33748006,277019,33470987,2017_boxofficemojo_rankings.csv,2017,0.008208455338072419,0.9917915446619275
3340,Nobody's Fool,33705333,31713110,1992223,2018_boxofficemojo_rankings.csv,2018,0.9408929441521909,0.05910705584780901
3341,Curly Sue,33691313,33691313,0,1991_boxofficemojo_rankings.csv,1991,1.0,0.0
3342,Mr. Woodcock,33683200,25799486,7883714,2007_boxofficemojo_rankings.csv,2007,0.7659452189815694,0.23405478101843055
3343,The Skin I Live In,33678406,3185812,30492594,2011_boxofficemojo_rankings.csv,2011,0.09459509455405936,0.9054049054459407
3344,Y Tu Mamá También,33616692,13839658,19777034,2001_boxofficemojo_rankings.csv,2001,0.411690061592021,0.588309938407979
3345,Because of Winn-Dixie,33589427,32647042,942385,2005_boxofficemojo_rankings.csv,2005,0.9719439989256143,0.0280560010743857
3346,Nick and Norah's Infinite Playlist,33556631,31487293,2069338,2008_boxofficemojo_rankings.csv,2008,0.938332963163078,0.06166703683692204
3347,Friday After Next,33526835,33253609,273226,2002_boxofficemojo_rankings.csv,2002,0.9918505280919001,0.008149471908099885
3348,Heroes,33500000,33500000,0,1977_boxofficemojo_rankings.csv,1977,1.0,0.0
3349,"Run, Fat Boy, Run",33478921,6003262,27475659,2007_boxofficemojo_rankings.csv,2007,0.17931467982495614,0.8206853201750439
3350,Bloodshot,33477953,12561824,20916129,2020_boxofficemojo_rankings.csv,2020,0.375226764910029,0.624773235089971
3351,Fireproof,33473297,33456317,16980,2008_boxofficemojo_rankings.csv,2008,0.9994927299811548,0.0005072700188451709
3352,Red Planet,33463969,17480890,15983079,2000_boxofficemojo_rankings.csv,2000,0.5223794583362182,0.4776205416637817
3353,Air America,33461269,31053601,2407668,1990_boxofficemojo_rankings.csv,1990,0.9280461240128102,0.07195387598718984
3354,Mystery Men,33461011,29762011,3699000,1999_boxofficemojo_rankings.csv,1999,0.8894534298440654,0.11054657015593462
3355,Matilda,33459416,33459416,0,1996_boxofficemojo_rankings.csv,1996,1.0,0.0
3356,2016: Obama's America,33449086,33449086,0,2012_boxofficemojo_rankings.csv,2012,1.0,0.0
3357,Get on Up,33448971,30703100,2745871,2014_boxofficemojo_rankings.csv,2014,0.9179086555457865,0.08209134445421355
3358,Wonder Boys,33426588,19393557,14033031,2000_boxofficemojo_rankings.csv,2000,0.5801835652505125,0.41981643474948743
3359,Tell No One,33406992,6177192,27229800,2006_boxofficemojo_rankings.csv,2006,0.1849071595551015,0.8150928404448985
3360,The Perks of Being a Wallflower,33384127,17742948,15641179,2012_boxofficemojo_rankings.csv,2012,0.5314785676438386,0.46852143235616134
3361,Reality Bites,33351557,20982557,12369000,1994_boxofficemojo_rankings.csv,1994,0.6291327568305132,0.3708672431694868
3362,The Box,33333531,15051977,18281554,2009_boxofficemojo_rankings.csv,2009,0.45155663226917064,0.5484433677308294
3363,And Justice for All,33300000,33300000,0,1979_boxofficemojo_rankings.csv,1979,1.0,0.0
3364,The Cave,33296457,15007991,18288466,2005_boxofficemojo_rankings.csv,2005,0.450738377359489,0.5492616226405109
3365,Perfect Strangers,33262366,1014507,32247859,2017_boxofficemojo_rankings.csv,2017,0.03050014541960124,0.9694998545803988
3366,Confessions of a Teenage Drama Queen,33251890,29331068,3920822,2004_boxofficemojo_rankings.csv,2004,0.8820872437626853,0.11791275623731463
3367,Project Almanac,33213241,22348241,10865000,2015_boxofficemojo_rankings.csv,2015,0.6728714310054836,0.32712856899451637
3368,Bharat,33185983,2971549,30214434,2019_boxofficemojo_rankings.csv,2019,0.08954229259986062,0.9104577074001394
3369,Forget Paris,33177694,33177694,0,1995_boxofficemojo_rankings.csv,1995,1.0,0.0
3370,Baaghi 2,33139063,1319579,31819484,2018_boxofficemojo_rankings.csv,2018,0.039819442088631175,0.9601805579113688
3371,Teen Wolf,33086611,33086611,0,1985_boxofficemojo_rankings.csv,1985,1.0,0.0
3372,The Crocodile Hunter: Collision Course,33082548,28442574,4639974,2002_boxofficemojo_rankings.csv,2002,0.8597455673607728,0.14025443263922718
3373,One Hundred and One Dalmatians 1985 Re-release,33049729,33049729,0,1985_boxofficemojo_rankings.csv,1985,1.0,0.0
3374,The Eighth Day,33031984,416401,32615583,1997_boxofficemojo_rankings.csv,1997,0.01260599423879595,0.9873940057612041
3375,Girl with a Pearl Earring,33030115,11670971,21359144,2003_boxofficemojo_rankings.csv,2003,0.3533433353168767,0.6466566646831232
3376,Confessions of a Dangerous Mind,33013805,16007718,17006087,2002_boxofficemojo_rankings.csv,2002,0.4848795223695057,0.5151204776304943
3377,TRON,33000000,33000000,0,1982_boxofficemojo_rankings.csv,1982,1.0,0.0
3378,Friday the 13th: The Final Chapter,32980880,32980880,0,1984_boxofficemojo_rankings.csv,1984,1.0,0.0
3379,Lockout,32948113,14326864,18621249,2012_boxofficemojo_rankings.csv,2012,0.43483109336185655,0.5651689066381435
3380,Inside Llewyn Davis,32935319,13235319,19700000,2013_boxofficemojo_rankings.csv,2013,0.40185792644060925,0.5981420735593908
3381,Sleepless,32917353,20783704,12133649,2017_boxofficemojo_rankings.csv,2017,0.6313905009312262,0.3686094990687738
3382,The Joy Luck Club,32901136,32901136,0,1993_boxofficemojo_rankings.csv,1993,1.0,0.0
3383,Brightburn,32893421,17300439,15592982,2019_boxofficemojo_rankings.csv,2019,0.5259543846169117,0.4740456153830883
3384,Adaptation.,32801173,22498520,10302653,2002_boxofficemojo_rankings.csv,2002,0.6859059583021619,0.31409404169783806
3385,Homeward Bound II: Lost in San Francisco,32772492,32772492,0,1996_boxofficemojo_rankings.csv,1996,1.0,0.0
3386,For Richer or Poorer,32748995,31642995,1106000,1997_boxofficemojo_rankings.csv,1997,0.9662279712705688,0.03377202872943124
3387,Awake,32730062,14377198,18352864,2007_boxofficemojo_rankings.csv,2007,0.439265834571288,0.560734165428712
3388,Katy Perry: Part of Me,32726956,25326071,7400885,2012_boxofficemojo_rankings.csv,2012,0.7738596586862524,0.2261403413137476
3389,FernGully: The Last Rainforest,32710894,24650296,8060598,1992_boxofficemojo_rankings.csv,1992,0.7535806266866323,0.24641937331336772
3390,Problem Child 2,32704700,25104700,7600000,1991_boxofficemojo_rankings.csv,1991,0.7676174984023703,0.2323825015976297
3391,Leap Year,32686500,25918920,6767580,2010_boxofficemojo_rankings.csv,2010,0.7929548896333348,0.20704511036666515
3392,Tommy Boy,32679899,32679899,0,1995_boxofficemojo_rankings.csv,1995,1.0,0.0
3393,Coming Home,32653905,32653905,0,1978_boxofficemojo_rankings.csv,1978,1.0,0.0
3394,The Accidental Tourist,32632093,32632093,0,1988_boxofficemojo_rankings.csv,1988,1.0,0.0
3395,Mud,32613173,21590086,11023087,2013_boxofficemojo_rankings.csv,2013,0.6620050738393348,0.3379949261606652
3396,88 Minutes,32593385,17213467,15379918,2007_boxofficemojo_rankings.csv,2007,0.5281276246698525,0.47187237533014753
3397,Cry Wolf,32586408,10047674,22538734,2005_boxofficemojo_rankings.csv,2005,0.30833941562383926,0.6916605843761607
3398,Last Chance Harvey,32566966,14889042,17677924,2008_boxofficemojo_rankings.csv,2008,0.4571823485184343,0.5428176514815657
3399,The Musketeer,32533802,27073640,5460162,2001_boxofficemojo_rankings.csv,2001,0.832169569360507,0.16783043063949304
3400,The Hurricane Heist,32517248,6115825,26401423,2018_boxofficemojo_rankings.csv,2018,0.18807941557661953,0.8119205844233804
3401,Endless Love,32492674,31184024,1308650,1981_boxofficemojo_rankings.csv,1981,0.959724767496821,0.04027523250317903
3402,Fighting,32482728,23091010,9391718,2009_boxofficemojo_rankings.csv,2009,0.7108704047270906,0.2891295952729093
3403,UglyDolls,32450241,20150241,12300000,2019_boxofficemojo_rankings.csv,2019,0.6209581309426947,0.3790418690573053
3404,Movie 43,32438988,8840453,23598535,2012_boxofficemojo_rankings.csv,2012,0.2725255485775327,0.7274744514224674
3405,Black Sheep,32417995,32417995,0,1996_boxofficemojo_rankings.csv,1996,1.0,0.0
3406,The Invention of Lying,32406507,18451251,13955256,2009_boxofficemojo_rankings.csv,2009,0.5693687073401648,0.43063129265983524
3407,Dhoom 2,32396427,2643586,29752841,2006_boxofficemojo_rankings.csv,2006,0.08160115928833757,0.9183988407116624
3408,Rumble in the Bronx,32392047,32392047,0,1996_boxofficemojo_rankings.csv,1996,1.0,0.0
3409,Stuber,32390945,22370452,10020493,2019_boxofficemojo_rankings.csv,2019,0.6906390659488323,0.3093609340511677
3410,Alpha Dog,32351125,15309602,17041523,2007_boxofficemojo_rankings.csv,2007,0.47323244554864785,0.5267675544513521
3411,Nothing in Common,32324557,32324557,0,1986_boxofficemojo_rankings.csv,1986,1.0,0.0
3412,Kevin Hart: Let Me Explain,32318051,32244051,74000,2013_boxofficemojo_rankings.csv,2013,0.997710257960791,0.002289742039208986
3413,Potiche,32309881,1618844,30691037,2010_boxofficemojo_rankings.csv,2010,0.050103681904616115,0.9498963180953839
3414,Hart's War,32287044,19077641,13209403,2002_boxofficemojo_rankings.csv,2002,0.5908760492289106,0.4091239507710895
3415,The Age of Innocence,32255440,32255440,0,1993_boxofficemojo_rankings.csv,1993,1.0,0.0
3416,Seven Psychopaths,32226382,15024049,17202333,2012_boxofficemojo_rankings.csv,2012,0.4662034044032619,0.5337965955967381
3417,The Lost Boys,32222567,32222567,0,1987_boxofficemojo_rankings.csv,1987,1.0,0.0
3418,Silverado,32192570,32192570,0,1985_boxofficemojo_rankings.csv,1985,1.0,0.0
3419,Reindeer Games,32168970,23368995,8799975,2000_boxofficemojo_rankings.csv,2000,0.7264452358903627,0.2735547641096373
3420,Alien Nation,32155047,25216243,6938804,1988_boxofficemojo_rankings.csv,1988,0.7842079347605991,0.21579206523940084
3421,The Kid Who Would Be King,32140970,16790790,15350180,2019_boxofficemojo_rankings.csv,2019,0.5224108046521309,0.4775891953478691
3422,Amazing Grace,32120360,21250683,10869677,2007_boxofficemojo_rankings.csv,2007,0.6615954179841073,0.33840458201589274
3423,The Lawnmower Man,32100816,32100816,0,1992_boxofficemojo_rankings.csv,1992,1.0,0.0
3424,The Accused,32078318,32078318,0,1988_boxofficemojo_rankings.csv,1988,1.0,0.0
3425,You Again,32054369,25702053,6352316,2010_boxofficemojo_rankings.csv,2010,0.8018268274131367,0.1981731725868633
3426,Copycat,32051917,32051917,0,1995_boxofficemojo_rankings.csv,1995,1.0,0.0
3427,Leaving Las Vegas,32029928,32029928,0,1995_boxofficemojo_rankings.csv,1995,1.0,0.0
3428,Metro,32000301,32000301,0,1997_boxofficemojo_rankings.csv,1997,1.0,0.0
3429,Dilwale,31994323,4871263,27123060,2015_boxofficemojo_rankings.csv,2015,0.15225397955756087,0.8477460204424391
3430,Stick It,31976848,26910736,5066112,2006_boxofficemojo_rankings.csv,2006,0.8415693754431331,0.1584306245568669
3431,Suffragette,31972096,4702420,27269676,2015_boxofficemojo_rankings.csv,2015,0.1470788777814254,0.8529211222185746
3432,Lean on Me,31906454,31906454,0,1989_boxofficemojo_rankings.csv,1989,1.0,0.0
3433,Dressed to Kill,31899000,31899000,0,1980_boxofficemojo_rankings.csv,1980,1.0,0.0
3434,Bad Times at the El Royale,31882724,17839115,14043609,2018_boxofficemojo_rankings.csv,2018,0.5595229253309724,0.44047707466902764
3435,The Muppet Christmas Carol,31879583,27281507,4598076,1992_boxofficemojo_rankings.csv,1992,0.8557673731177726,0.1442326268822274
3436,Children of a Lesser God,31853080,31853080,0,1986_boxofficemojo_rankings.csv,1986,1.0,0.0
3437,The Seeker: The Dark Is Rising,31852619,8794452,23058167,2007_boxofficemojo_rankings.csv,2007,0.2760982385781213,0.7239017614218787
3438,Self/less,31807156,12279691,19527465,2015_boxofficemojo_rankings.csv,2015,0.38606692783221486,0.6139330721677851
3439,Blood Work,31794718,26235081,5559637,2002_boxofficemojo_rankings.csv,2002,0.825139603376888,0.17486039662311206
3440,The Bear,31753898,31753898,0,1989_boxofficemojo_rankings.csv,1989,1.0,0.0
3441,Spring Breakers,31724284,14124284,17600000,2013_boxofficemojo_rankings.csv,2013,0.44521994570468476,0.5547800542953152
3442,History of the World: Part I,31672907,31672907,0,1981_boxofficemojo_rankings.csv,1981,1.0,0.0
3443,Hunter Killer,31672678,15767460,15905218,2018_boxofficemojo_rankings.csv,2018,0.49782528651350544,0.5021747134864946
3444,Rent,31670620,29077547,2593073,2005_boxofficemojo_rankings.csv,2005,0.918123705819463,0.08187629418053705
3445,New World,31670607,457806,31212801,2013_boxofficemojo_rankings.csv,2013,0.014455232891494628,0.9855447671085054
3446,Ae Dil Hai Mushkil,31668920,4264983,27403937,2016_boxofficemojo_rankings.csv,2016,0.1346740905594507,0.8653259094405493
3447,Anna,31626978,7743794,23883184,2019_boxofficemojo_rankings.csv,2019,0.2448477372703772,0.7551522627296228
3448,Super Troopers 2,31626386,30617396,1008990,2018_boxofficemojo_rankings.csv,2018,0.9680965760678442,0.03190342393215589
3449,Can't Buy Me Love,31623833,31623833,0,1987_boxofficemojo_rankings.csv,1987,1.0,0.0
3450,Daddy's Little Girls,31609243,31366978,242265,2007_boxofficemojo_rankings.csv,2007,0.9923356279047872,0.007664372095212783
3451,Double Take,31603059,29831583,1771476,2001_boxofficemojo_rankings.csv,2001,0.9439460591457302,0.05605394085426983
3452,Rob Roy,31596911,31596911,0,1995_boxofficemojo_rankings.csv,1995,1.0,0.0
3453,Love in the Time of Cholera,31575877,4607608,26968269,2007_boxofficemojo_rankings.csv,2007,0.14592177439758838,0.8540782256024116
3454,Jennifer's Body,31556061,16204793,15351268,2009_boxofficemojo_rankings.csv,2009,0.5135239471111429,0.4864760528888571
3455,Bodyguard,31516209,1834384,29681825,2011_boxofficemojo_rankings.csv,2011,0.058204462345074565,0.9417955376549254
3456,The New World 2005 Re-release,31510855,12712093,18798762,2005_boxofficemojo_rankings.csv,2005,0.4034194883001429,0.596580511699857
3457,The Thing,31505287,16928670,14576617,2011_boxofficemojo_rankings.csv,2011,0.5373279094394537,0.46267209056054626
3458,Beverly Hills Ninja,31480418,31480418,0,1997_boxofficemojo_rankings.csv,1997,1.0,0.0
3459,Dance Flick,31439140,25662155,5776985,2009_boxofficemojo_rankings.csv,2009,0.8162486314829223,0.18375136851707777
3460,A Serious Man,31430334,9228768,22201566,2009_boxofficemojo_rankings.csv,2009,0.2936261510933991,0.7063738489066008
3461,I Don't Know How She Does It,31410151,9662284,21747867,2011_boxofficemojo_rankings.csv,2011,0.3076166045811114,0.6923833954188886
3462,Eddie,31387164,31387164,0,1996_boxofficemojo_rankings.csv,1996,1.0,0.0
3463,Lost Souls,31355910,16815253,14540657,2000_boxofficemojo_rankings.csv,2000,0.5362706105483783,0.46372938945162173
3464,The People Under the Stairs,31347154,24204154,7143000,1991_boxofficemojo_rankings.csv,1991,0.7721324238876678,0.22786757611233224
3465,Johnson Family Vacation,31326183,31203964,122219,2004_boxofficemojo_rankings.csv,2004,0.9960985032871703,0.003901496712829648
3466,What's in a Name?,31303580,8111,31295469,2012_boxofficemojo_rankings.csv,2012,0.00025910774422605975,0.9997408922557739
3467,How High,31283740,31178740,105000,2001_boxofficemojo_rankings.csv,2001,0.9966436238122424,0.003356376187757602
3468,Tazza: The Hidden Card,31278476,251555,31026921,2014_boxofficemojo_rankings.csv,2014,0.008042431479078457,0.9919575685209215
3469,Bustin' Loose,31261269,31261269,0,1981_boxofficemojo_rankings.csv,1981,1.0,0.0
3470,Saving Mr. Wu,31222161,92696,31129465,2015_boxofficemojo_rankings.csv,2015,0.0029689168536412326,0.9970310831463588
3471,The Great Muppet Caper,31206251,31206251,0,1981_boxofficemojo_rankings.csv,1981,1.0,0.0
3472,Pride and Glory,31200557,15740721,15459836,2008_boxofficemojo_rankings.csv,2008,0.5045012818200649,0.49549871817993507
3473,The Stepfather,31198531,29062561,2135970,2009_boxofficemojo_rankings.csv,2009,0.9315361995729863,0.0684638004270137
3474,The Secret Garden,31181347,31181347,0,1993_boxofficemojo_rankings.csv,1993,1.0,0.0
3475,My Dear Liar,31177968,90545,31087423,2019_boxofficemojo_rankings.csv,2019,0.0029041340987969455,0.997095865901203
3476,The New Guy,31167388,29760152,1407236,2002_boxofficemojo_rankings.csv,2002,0.9548490877708457,0.0451509122291544
3477,Joyful Noise,31158113,30932113,226000,2012_boxofficemojo_rankings.csv,2012,0.9927466724316714,0.007253327568328673
3478,Lady and the Tramp 1986 Re-release,31129082,31129082,0,1986_boxofficemojo_rankings.csv,1986,1.0,0.0
3479,Dogma,31117471,30652890,464581,1999_boxofficemojo_rankings.csv,1999,0.9850700913322937,0.014929908667706318
3480,Premium Rush,31083599,20275446,10808153,2012_boxofficemojo_rankings.csv,2012,0.6522875938529512,0.3477124061470488
3481,Ultraviolet,31070211,18535812,12534399,2006_boxofficemojo_rankings.csv,2006,0.5965782466041186,0.4034217533958813
3482,High Anxiety,31063038,31063038,0,1977_boxofficemojo_rankings.csv,1977,1.0,0.0
3483,The Wild Goose Lake,31042413,12573,31029840,2019_boxofficemojo_rankings.csv,2019,0.00040502650357754084,0.9995949734964225
3484,Conan the Destroyer,31042035,31042035,0,1984_boxofficemojo_rankings.csv,1984,1.0,0.0
3485,The Strangers: Prey at Night,31039126,24586708,6452418,2018_boxofficemojo_rankings.csv,2018,0.7921198554366512,0.20788014456334886
3486,Beauty and the Beast 2000 IMAX Release,31033346,25487190,5546156,2001_boxofficemojo_rankings.csv,2001,0.8212839827197492,0.17871601728025074
3487,This Is Not What I Expected,30996615,337670,30658945,2017_boxofficemojo_rankings.csv,2017,0.010893770174581966,0.9891062298254181
3488,Joe Dirt,30987695,27087695,3900000,2001_boxofficemojo_rankings.csv,2001,0.8741435915126956,0.1258564084873044
3489,Pathfinder,30984583,10232081,20752502,2007_boxofficemojo_rankings.csv,2007,0.3302313605446941,0.6697686394553058
3490,Playing for Keeps,30962335,13103272,17859063,2012_boxofficemojo_rankings.csv,2012,0.42320038201253235,0.5767996179874677
3491,Nuts,30950002,30950002,0,1987_boxofficemojo_rankings.csv,1987,1.0,0.0
3492,Billy Lynn's Long Halftime Walk,30930984,1738477,29192507,2016_boxofficemojo_rankings.csv,2016,0.05620503376161586,0.9437949662383841
3493,The Promise,30925693,669625,30256068,2005_boxofficemojo_rankings.csv,2005,0.021652707992671338,0.9783472920073286
3494,Dune,30925690,30925690,0,1984_boxofficemojo_rankings.csv,1984,1.0,0.0
3495,Hearts in Atlantis,30919415,24185781,6733634,2001_boxofficemojo_rankings.csv,2001,0.7822198770578292,0.2177801229421708
3496,Igor,30893885,19528602,11365283,2008_boxofficemojo_rankings.csv,2008,0.632118686270762,0.367881313729238
3497,Murphy's Romance,30867525,30867525,0,1985_boxofficemojo_rankings.csv,1985,1.0,0.0
3498,Powder,30862156,30862156,0,1995_boxofficemojo_rankings.csv,1995,1.0,0.0
3499,The Princess Bride,30857814,30857814,0,1987_boxofficemojo_rankings.csv,1987,1.0,0.0
3500,African Cats,30857747,15428747,15429000,2011_boxofficemojo_rankings.csv,2011,0.499995900543225,0.500004099456775
3501,Attack on Titan Part 1,30810658,449523,30361135,2015_boxofficemojo_rankings.csv,2015,0.014589853939503662,0.9854101460604964
3502,I Love Trouble,30806194,30806194,0,1994_boxofficemojo_rankings.csv,1994,1.0,0.0
3503,Winter's Tale,30800231,12600231,18200000,2014_boxofficemojo_rankings.csv,2014,0.40909534087585253,0.5909046591241475
3504,Monsoon Wedding,30787356,13885966,16901390,2001_boxofficemojo_rankings.csv,2001,0.45102820781362324,0.5489717921863768
3505,Wolf Creek,30762648,16188180,14574468,2005_boxofficemojo_rankings.csv,2005,0.5262284313105946,0.4737715686894054
3506,Exorcist II: The Heretic,30749142,30749142,0,1977_boxofficemojo_rankings.csv,1977,1.0,0.0
3507,Norm of the North,30734502,17062499,13672003,2016_boxofficemojo_rankings.csv,2016,0.5551578157993254,0.44484218420067456
3508,Carnage,30722632,2547047,28175585,2011_boxofficemojo_rankings.csv,2011,0.08290458317503527,0.9170954168249648
3509,Out to Sea,30716901,29022252,1694649,1997_boxofficemojo_rankings.csv,1997,0.9448300790499666,0.05516992095003334
3510,A Man Called Ove,30691696,3479315,27212381,2015_boxofficemojo_rankings.csv,2015,0.11336339966354417,0.8866366003364559
3511,Young Doctors in Love,30688860,30688860,0,1982_boxofficemojo_rankings.csv,1982,1.0,0.0
3512,Nancy Drew,30666930,25612520,5054410,2007_boxofficemojo_rankings.csv,2007,0.8351836978791161,0.16481630212088397
3513,A Wedding Invitation,30665036,14350,30650686,2013_boxofficemojo_rankings.csv,2013,0.0004679596658552757,0.9995320403341448
3514,When the Bough Breaks,30658387,29747603,910784,2016_boxofficemojo_rankings.csv,2016,0.9702925010373181,0.02970749896268189
3515,Virus,30652005,14036005,16616000,1999_boxofficemojo_rankings.csv,1999,0.4579147432606774,0.5420852567393226
3516,Wild Tales,30642704,3106530,27536174,2014_boxofficemojo_rankings.csv,2014,0.10137910805782675,0.8986208919421732
3517,City of God,30641770,7564459,23077311,2002_boxofficemojo_rankings.csv,2002,0.2468675601964247,0.7531324398035754
3518,Superstar,30636478,30636478,0,1999_boxofficemojo_rankings.csv,1999,1.0,0.0
3519,Major League II,30626182,30626182,0,1994_boxofficemojo_rankings.csv,1994,1.0,0.0
3520,Be Kind Rewind,30579406,11175164,19404242,2008_boxofficemojo_rankings.csv,2008,0.36544738638808094,0.6345526136119191
3521,Blank Check,30577969,30577969,0,1994_boxofficemojo_rankings.csv,1994,1.0,0.0
3522,An American Werewolf in London,30565292,30565292,0,1981_boxofficemojo_rankings.csv,1981,1.0,0.0
3523,Cabin Fever,30553394,21158188,9395206,2003_boxofficemojo_rankings.csv,2003,0.6924987777135332,0.30750122228646676
3524,Two for the Money,30526509,22991379,7535130,2005_boxofficemojo_rankings.csv,2005,0.7531610968027821,0.24683890319721788
3525,Sleepwalkers,30524763,30524763,0,1992_boxofficemojo_rankings.csv,1992,1.0,0.0
3526,A Dangerous Method,30519436,5704709,24814727,2011_boxofficemojo_rankings.csv,2011,0.18692052500577008,0.81307947499423
3527,Uncommon Valor,30503151,30503151,0,1983_boxofficemojo_rankings.csv,1983,1.0,0.0
3528,The Lord of the Rings,30471420,30471420,0,1978_boxofficemojo_rankings.csv,1978,1.0,0.0
3529,The Champ,30441738,30441738,0,1979_boxofficemojo_rankings.csv,1979,1.0,0.0
3530,What's Your Number?,30426096,14011084,16415012,2011_boxofficemojo_rankings.csv,2011,0.4604956219161341,0.5395043780838659
3531,The Girl Next Door,30381722,14589444,15792278,2004_boxofficemojo_rankings.csv,2004,0.4802046440948936,0.5197953559051064
3532,A Night at the Roxbury,30331165,30331165,0,1998_boxofficemojo_rankings.csv,1998,1.0,0.0
3533,Nocturnal Animals,30311857,10663357,19648500,2016_boxofficemojo_rankings.csv,2016,0.3517883117487655,0.6482116882512345
3534,Assassins,30303072,30303072,0,1995_boxofficemojo_rankings.csv,1995,1.0,0.0
3535,The Great Debaters,30236407,30236407,0,2007_boxofficemojo_rankings.csv,2007,1.0,0.0
3536,Far from the Madding Crowd,30229977,12236500,17993477,2015_boxofficemojo_rankings.csv,2015,0.40478032781831097,0.595219672181689
3537,Weekend at Bernie's,30218387,30218387,0,1989_boxofficemojo_rankings.csv,1989,1.0,0.0
3538,Being There,30177511,30177511,0,1979_boxofficemojo_rankings.csv,1979,1.0,0.0
3539,A Silent Voice: The Movie,30156463,310407,29846056,2016_boxofficemojo_rankings.csv,2016,0.010293216415996797,0.9897067835840032
3540,Blown Away,30156002,30156002,0,1994_boxofficemojo_rankings.csv,1994,1.0,0.0
3541,Wild Things,30147739,30147739,0,1998_boxofficemojo_rankings.csv,1998,1.0,0.0
3542,When the Game Stands Tall,30138754,30127963,10791,2014_boxofficemojo_rankings.csv,2014,0.9996419560012335,0.0003580439987665051
3543,The Rum Diary,30134958,13109815,17025143,2011_boxofficemojo_rankings.csv,2011,0.4350367768888213,0.5649632231111787
3544,Godsend,30120671,14379751,15740920,2004_boxofficemojo_rankings.csv,2004,0.47740473643498843,0.5225952635650115
3545,Major Payne,30112050,29412050,700000,1995_boxofficemojo_rankings.csv,1995,0.9767534923726549,0.0232465076273452
3546,Double Impact,30102717,30102717,0,1991_boxofficemojo_rankings.csv,1991,1.0,0.0
3547,Snow White and the Seven Dwarfs 1983 Re-release,30100000,30100000,0,1983_boxofficemojo_rankings.csv,1983,1.0,0.0
3548,Free Willy 2: The Adventure Home,30077111,30077111,0,1995_boxofficemojo_rankings.csv,1995,1.0,0.0
3549,Shaun of the Dead,30076102,13542874,16533228,2004_boxofficemojo_rankings.csv,2004,0.45028687560642,0.54971312439358
3550,Revenge of the Nerds II: Nerds in Paradise,30063289,30063289,0,1987_boxofficemojo_rankings.csv,1987,1.0,0.0
3551,The Getaway,30057974,16094974,13963000,1994_boxofficemojo_rankings.csv,1994,0.5354643662942818,0.46453563370571815
3552,Road House,30050028,30050028,0,1989_boxofficemojo_rankings.csv,1989,1.0,0.0
3553,Point of No Return,30038362,30038362,0,1993_boxofficemojo_rankings.csv,1993,1.0,0.0
3554,Sophie's Choice,30036000,30036000,0,1982_boxofficemojo_rankings.csv,1982,1.0,0.0
3555,Laws of Attraction,30031874,17871255,12160619,2003_boxofficemojo_rankings.csv,2003,0.5950762513188488,0.4049237486811512
3556,The Gods Must Be Crazy,30031783,30031783,0,1984_boxofficemojo_rankings.csv,1984,1.0,0.0
3557,Solaris,30002758,14973382,15029376,2002_boxofficemojo_rankings.csv,2002,0.49906685245403104,0.500933147545969
3558,A Nightmare on Elm Street 2: Freddy's Revenge,29999213,29999213,0,1985_boxofficemojo_rankings.csv,1985,1.0,0.0
3559,Madeline,29967750,29967750,0,1998_boxofficemojo_rankings.csv,1998,1.0,0.0
3560,Reset 2017 Re-release,29949252,108970,29840282,2017_boxofficemojo_rankings.csv,2017,0.0036384881999724067,0.9963615118000276
3561,Small Time Crooks,29934477,17266359,12668118,2000_boxofficemojo_rankings.csv,2000,0.5768051000189514,0.4231948999810486
3562,Keeping Up with the Joneses,29918745,14904426,15014319,2016_boxofficemojo_rankings.csv,2016,0.4981634757741342,0.5018365242258658
3563,Neighbors,29916207,29916207,0,1981_boxofficemojo_rankings.csv,1981,1.0,0.0
3564,Rab Ne Bana Di Jodi,29914469,2078956,27835513,2008_boxofficemojo_rankings.csv,2008,0.0694966706579348,0.9305033293420653
3565,Pulse,29907685,20264436,9643249,2006_boxofficemojo_rankings.csv,2006,0.6775661840760995,0.32243381592390047
3566,Green Card,29888235,29888235,0,1990_boxofficemojo_rankings.csv,1990,1.0,0.0
3567,The Four Feathers,29882645,18306166,11576479,2002_boxofficemojo_rankings.csv,2002,0.6126019299831056,0.3873980700168944
3568,The Bye Bye Man,29874280,22395806,7478474,2017_boxofficemojo_rankings.csv,2017,0.7496684773658143,0.2503315226341857
3569,Jumpin' Jack Flash,29844101,29844101,0,1986_boxofficemojo_rankings.csv,1986,1.0,0.0
3570,Draft Day,29824199,28842237,981962,2014_boxofficemojo_rankings.csv,2014,0.9670749916871195,0.03292500831288042
3571,The Disaster Artist,29820616,21120616,8700000,2017_boxofficemojo_rankings.csv,2017,0.7082555236283516,0.2917444763716484
3572,Like a Boss,29753143,22169514,7583629,2020_boxofficemojo_rankings.csv,2020,0.7451150286878936,0.2548849713121064
3573,Battlefield Earth,29725663,21471685,8253978,2000_boxofficemojo_rankings.csv,2000,0.7223282118215496,0.2776717881784504
3574,The Swindlers,29721916,241916,29480000,2017_boxofficemojo_rankings.csv,2017,0.008139313764294335,0.9918606862357057
3575,Angel Eyes,29715606,24174218,5541388,2001_boxofficemojo_rankings.csv,2001,0.8135192666102787,0.1864807333897212
3576,The World According to Garp,29712172,29712172,0,1982_boxofficemojo_rankings.csv,1982,1.0,0.0
3577,The Raven,29699345,16008272,13691073,2012_boxofficemojo_rankings.csv,2012,0.5390109445174632,0.4609890554825367
3578,Masterminds,29674699,17368022,12306677,2016_boxofficemojo_rankings.csv,2016,0.5852804774868988,0.4147195225131011
3579,Amour,29652180,6739492,22912688,2012_boxofficemojo_rankings.csv,2012,0.22728487416439533,0.7727151258356046
3580,Cursed,29621722,19297522,10324200,2005_boxofficemojo_rankings.csv,2005,0.6514652321698245,0.34853476783017545
3581,An American Haunting,29612137,16298046,13314091,2006_boxofficemojo_rankings.csv,2006,0.5503839861337937,0.44961601386620625
3582,Never Cry Wolf,29600000,29600000,0,1983_boxofficemojo_rankings.csv,1983,1.0,0.0
3583,W.,29560587,25534493,4026094,2008_boxofficemojo_rankings.csv,2008,0.8638019603602595,0.1361980396397406
3584,In the Valley of Elah,29541790,6777741,22764049,2007_boxofficemojo_rankings.csv,2007,0.22942892086092279,0.7705710791390772
3585,Fools Rush In,29481428,29481428,0,1997_boxofficemojo_rankings.csv,1997,1.0,0.0
3586,Politics,29459596,1514558,27945038,2010_boxofficemojo_rankings.csv,2010,0.051411363550267285,0.9485886364497327
3587,Twilight Zone: The Movie,29450919,29450919,0,1983_boxofficemojo_rankings.csv,1983,1.0,0.0
3588,Peter Pan 1989 Re-release,29445131,29445131,0,1989_boxofficemojo_rankings.csv,1989,1.0,0.0
3589,The Pledge,29419291,19733089,9686202,2001_boxofficemojo_rankings.csv,2001,0.670753384233495,0.32924661576650505
3590,The Valet,29414553,1926800,27487753,2006_boxofficemojo_rankings.csv,2006,0.0655049899959384,0.9344950100040615
3591,City by the Sea,29414087,22449000,6965087,2002_boxofficemojo_rankings.csv,2002,0.7632057388012757,0.23679426119872427
3592,Luther,29413900,5791328,23622572,2003_boxofficemojo_rankings.csv,2003,0.19689085772372925,0.8031091422762707
3593,The Losers,29397654,23591432,5806222,2010_boxofficemojo_rankings.csv,2010,0.8024936955853689,0.19750630441463118
3594,A Low Down Dirty Shame,29392418,29392418,0,1994_boxofficemojo_rankings.csv,1994,1.0,0.0
3595,Bugs!,29388999,19063544,10325455,2003_boxofficemojo_rankings.csv,2003,0.6486625828936875,0.35133741710631244
3596,Baby Boy,29381649,28734552,647097,2001_boxofficemojo_rankings.csv,2001,0.977976151032231,0.022023848967768964
3597,Across the Universe,29367143,24343673,5023470,2007_boxofficemojo_rankings.csv,2007,0.828942502169857,0.17105749783014304
3598,Nurse Betty,29360400,25170054,4190346,2000_boxofficemojo_rankings.csv,2000,0.8572789880246863,0.1427210119753137
3599,The Frighteners,29359216,16759216,12600000,1996_boxofficemojo_rankings.csv,1996,0.5708332266093209,0.4291667733906791
3600,Mr. Holmes,29355203,17737646,11617557,2015_boxofficemojo_rankings.csv,2015,0.6042419805443008,0.3957580194556992
3601,Galapagos,29349172,18630372,10718800,1999_boxofficemojo_rankings.csv,1999,0.6347835639111046,0.3652164360888955
3602,Spice World,29342592,29342592,0,1998_boxofficemojo_rankings.csv,1998,1.0,0.0
3603,Rowdy Rathore,29342463,777373,28565090,2012_boxofficemojo_rankings.csv,2012,0.02649310659435781,0.9735068934056422
3604,Sword Art Online The Movie: Ordinal Scale,29322339,1522976,27799363,2017_boxofficemojo_rankings.csv,2017,0.05193910349375607,0.9480608965062439
3605,Free Solo,29318861,17541090,11777771,2018_boxofficemojo_rankings.csv,2018,0.5982868843370143,0.4017131156629857
3606,Easy Money,29309766,29309766,0,1983_boxofficemojo_rankings.csv,1983,1.0,0.0
3607,The Class,29303505,3766810,25536695,2008_boxofficemojo_rankings.csv,2008,0.12854469115554606,0.8714553088444539
3608,Hoffa,29302121,24276506,5025615,1992_boxofficemojo_rankings.csv,1992,0.8284897192254445,0.17151028077455555
3609,Shoot to Kill,29300090,29300090,0,1988_boxofficemojo_rankings.csv,1988,1.0,0.0
3610,Big Eyes,29253166,14482031,14771135,2014_boxofficemojo_rankings.csv,2014,0.495058586137309,0.504941413862691
3611,Romy and Michele's High School Reunion,29235353,29235353,0,1997_boxofficemojo_rankings.csv,1997,1.0,0.0
3612,Bulworth,29202884,26528185,2674699,1998_boxofficemojo_rankings.csv,1998,0.9084097652820865,0.09159023471791347
3613,Fort Apache the Bronx,29200000,29200000,0,1981_boxofficemojo_rankings.csv,1981,1.0,0.0
3614,My Hero Academia: Heroes Rising,29187012,13304000,15883012,2019_boxofficemojo_rankings.csv,2019,0.4558191842316713,0.5441808157683288
3615,The Young Victoria,29181829,11001272,18180557,2009_boxofficemojo_rankings.csv,2009,0.3769904895268902,0.6230095104731098
3616,Raising Arizona,29180280,22847564,6332716,1987_boxofficemojo_rankings.csv,1987,0.7829796012923796,0.21702039870762035
3617,The Rose,29174648,29174648,0,1979_boxofficemojo_rankings.csv,1979,1.0,0.0
3618,Singh Is King,29169677,2159376,27010301,2008_boxofficemojo_rankings.csv,2008,0.0740281080246449,0.9259718919753551
3619,Yu-Gi-Oh!: The Movie - Pyramid of Light,29144802,19765868,9378934,2004_boxofficemojo_rankings.csv,2004,0.6781953090640314,0.32180469093596864
3620,Special ID,29139936,12666,29127270,2013_boxofficemojo_rankings.csv,2013,0.0004346612154535961,0.9995653387845465
3621,Cold Creek Manor,29119434,21386011,7733423,2003_boxofficemojo_rankings.csv,2003,0.7344239932685505,0.26557600673144954
3622,Sacrifice,29093560,29792,29063768,2010_boxofficemojo_rankings.csv,2010,0.0010240066873906115,0.9989759933126093
3623,Pad Man,29045020,1670192,27374828,2018_boxofficemojo_rankings.csv,2018,0.057503558269197265,0.9424964417308027
3624,Far from Heaven,29027914,15901849,13126065,2002_boxofficemojo_rankings.csv,2002,0.5478123229936537,0.4521876770063464
3625,Madonna: Truth or Dare,29012935,15012935,14000000,1991_boxofficemojo_rankings.csv,1991,0.5174566103015775,0.4825433896984224
3626,New in Town,29010817,16734283,12276534,2009_boxofficemojo_rankings.csv,2009,0.5768290841309295,0.4231709158690705
3627,3 Ninjas,29000301,29000301,0,1992_boxofficemojo_rankings.csv,1992,1.0,0.0
3628,The Rescuers,29000000,29000000,0,1977_boxofficemojo_rankings.csv,1977,1.0,0.0
3629,Shorts,28972508,20919166,8053342,2009_boxofficemojo_rankings.csv,2009,0.7220350409429519,0.27796495905704816
3630,James and the Giant Peach,28946127,28946127,0,1996_boxofficemojo_rankings.csv,1996,1.0,0.0
3631,M.S. Dhoni: The Untold Story,28903047,1801550,27101497,2016_boxofficemojo_rankings.csv,2016,0.06233079854867897,0.937669201451321
3632,The Dream Team,28890240,28890240,0,1989_boxofficemojo_rankings.csv,1989,1.0,0.0
3633,In the Army Now,28881266,28881266,0,1994_boxofficemojo_rankings.csv,1994,1.0,0.0
3634,L.A. Story,28862081,28862081,0,1991_boxofficemojo_rankings.csv,1991,1.0,0.0
3635,Agent Cody Banks 2: Destination London,28818995,23630159,5188836,2004_boxofficemojo_rankings.csv,2004,0.8199508345103638,0.18004916548963626
3636,Boiler Room,28780255,16970581,11809674,2000_boxofficemojo_rankings.csv,2000,0.5896605502626714,0.4103394497373286
3637,Speak Bachchan,28775262,1216258,27559004,2012_boxofficemojo_rankings.csv,2012,0.04226748656536993,0.9577325134346301
3638,Starman,28744356,28744356,0,1984_boxofficemojo_rankings.csv,1984,1.0,0.0
3639,Deceived,28738096,28738096,0,1991_boxofficemojo_rankings.csv,1991,1.0,0.0
3640,Drop Zone,28735315,28735315,0,1994_boxofficemojo_rankings.csv,1994,1.0,0.0
3641,Twins 2,28733523,1431255,27302268,2017_boxofficemojo_rankings.csv,2017,0.04981133013170713,0.9501886698682929
3642,The Last Starfighter,28733290,28733290,0,1984_boxofficemojo_rankings.csv,1984,1.0,0.0
3643,The Suspect,28674130,218693,28455437,2013_boxofficemojo_rankings.csv,2013,0.007626839942484741,0.9923731600575153
3644,Wrong Turn,28650575,15418790,13231785,2003_boxofficemojo_rankings.csv,2003,0.5381668605254868,0.46183313947451315
3645,The Fortress,28645448,252895,28392553,2017_boxofficemojo_rankings.csv,2017,0.008828453302598025,0.9911715466974019
3646,Love & Mercy,28641776,12551031,16090745,2015_boxofficemojo_rankings.csv,2015,0.43820714888629814,0.5617928511137019
3647,Hoosiers,28607524,28607524,0,1986_boxofficemojo_rankings.csv,1986,1.0,0.0
3648,Fathers' Day,28598376,28598376,0,1997_boxofficemojo_rankings.csv,1997,1.0,0.0
3649,Final Analysis,28590665,28590665,0,1992_boxofficemojo_rankings.csv,1992,1.0,0.0
3650,The Out-of-Towners,28544120,28544120,0,1999_boxofficemojo_rankings.csv,1999,1.0,0.0
3651,Heist,28510652,23510841,4999811,2001_boxofficemojo_rankings.csv,2001,0.8246335790566979,0.17536642094330218
3652,House Calls,28460702,28460702,0,1978_boxofficemojo_rankings.csv,1978,1.0,0.0
3653,Go,28451622,16943454,11508168,1999_boxofficemojo_rankings.csv,1999,0.5955180340860707,0.40448196591392926
3654,High Road to China,28445927,28445927,0,1983_boxofficemojo_rankings.csv,1983,1.0,0.0
3655,Grease 1998 Re-release,28411018,28411018,0,1998_boxofficemojo_rankings.csv,1998,1.0,0.0
3656,The Shawshank Redemption,28341469,28341469,0,1994_boxofficemojo_rankings.csv,1994,1.0,0.0
3657,I Give It a Year,28328531,34657,28293874,2013_boxofficemojo_rankings.csv,2013,0.0012233955936507969,0.9987766044063492
3658,Brown Sugar,28316451,27363891,952560,2002_boxofficemojo_rankings.csv,2002,0.9663601911129329,0.0336398088870671
3659,Thunderbirds,28283637,6880917,21402720,2004_boxofficemojo_rankings.csv,2004,0.24328260895159984,0.7567173910484002
3660,Class Action,28277918,24277858,4000060,1991_boxofficemojo_rankings.csv,1991,0.8585447485914628,0.1414552514085372
3661,The Master,28258060,16377274,11880786,2012_boxofficemojo_rankings.csv,2012,0.5795611588339752,0.42043884116602487
3662,Fan,28240000,2300000,25940000,2016_boxofficemojo_rankings.csv,2016,0.08144475920679886,0.9185552407932012
3663,The Upside of Anger,28237488,18761993,9475495,2005_boxofficemojo_rankings.csv,2005,0.664435625435237,0.33556437456476296
3664,Friday,28215918,27467564,748354,1995_boxofficemojo_rankings.csv,1995,0.973477595164545,0.026522404835454937
3665,Victor Victoria,28215453,28215453,0,1982_boxofficemojo_rankings.csv,1982,1.0,0.0
3666,Ernest Saves Christmas,28202109,28202109,0,1988_boxofficemojo_rankings.csv,1988,1.0,0.0
3667,L'auberge espagnole,28193749,1067438,27126311,2002_boxofficemojo_rankings.csv,2002,0.03786080382569909,0.9621391961743009
3668,Case 39,28190603,13261851,14928752,2009_boxofficemojo_rankings.csv,2009,0.4704351659310019,0.5295648340689981
3669,Gully Boy,28141995,5566534,22575461,2019_boxofficemojo_rankings.csv,2019,0.19780168392468267,0.8021983160753173
3670,The Deep End of the Ocean,28121100,13898649,14222451,1999_boxofficemojo_rankings.csv,1999,0.4942427216574032,0.5057572783425969
3671,Grosse Pointe Blank,28084357,28084357,0,1997_boxofficemojo_rankings.csv,1997,1.0,0.0
3672,Cannonball Run II,28078073,28078073,0,1984_boxofficemojo_rankings.csv,1984,1.0,0.0
3673,Police Academy 4: Citizens on Patrol,28061343,28061343,0,1987_boxofficemojo_rankings.csv,1987,1.0,0.0
3674,Tristan & Isolde,28047963,14734633,13313330,2006_boxofficemojo_rankings.csv,2006,0.52533700932221,0.47466299067779005
3675,Cinderella 1981 Re-release,28040000,28040000,0,1981_boxofficemojo_rankings.csv,1981,1.0,0.0
3676,Pokemon 4Ever: Celebi - Voice of the Forest,28023563,1727447,26296116,2002_boxofficemojo_rankings.csv,2002,0.06164266121335107,0.938357338786649
3677,Your Highness,28013733,21596445,6417288,2011_boxofficemojo_rankings.csv,2011,0.7709234967007075,0.22907650329929252
3678,The Tailor of Panama,28008462,13729742,14278720,2001_boxofficemojo_rankings.csv,2001,0.4901997831940933,0.5098002168059067
3679,Herbie Goes to Monte Carlo,28000000,28000000,0,1977_boxofficemojo_rankings.csv,1977,1.0,0.0
3680,Slap Shot,28000000,28000000,0,1977_boxofficemojo_rankings.csv,1977,1.0,0.0
3681,Mandela: Long Walk to Freedom,27985788,8323085,19662703,2013_boxofficemojo_rankings.csv,2013,0.29740398948208996,0.70259601051791
3682,Loaded Weapon 1,27979399,27979399,0,1993_boxofficemojo_rankings.csv,1993,1.0,0.0
3683,The Brothers Grimsby,27979040,6874837,21104203,2016_boxofficemojo_rankings.csv,2016,0.24571382720779555,0.7542861727922044
3684,The 33,27972023,12227722,15744301,2015_boxofficemojo_rankings.csv,2015,0.4371411392018375,0.5628588607981625
3685,The Little Vampire,27965865,13572400,14393465,2000_boxofficemojo_rankings.csv,2000,0.4853202287860576,0.5146797712139424
3686,The Brothers,27958191,27457409,500782,2001_boxofficemojo_rankings.csv,2001,0.9820881830301539,0.017911816969846152
3687,Priceless,27949650,2165188,25784462,2006_boxofficemojo_rankings.csv,2006,0.07746744592508314,0.9225325540749169
3688,The Rescuers Down Under,27931461,27931461,0,1990_boxofficemojo_rankings.csv,1990,1.0,0.0
3689,The Divine Move,27926871,136707,27790164,2014_boxofficemojo_rankings.csv,2014,0.004895177837860891,0.9951048221621391
3690,Menace II Society,27912072,27912072,0,1993_boxofficemojo_rankings.csv,1993,1.0,0.0
3691,Greenland,27900000,0,27900000,2020_boxofficemojo_rankings.csv,2020,0.0,1.0
3692,Monster Family,27890108,127259,27762849,2017_boxofficemojo_rankings.csv,2017,0.004562872255639885,0.9954371277443601
3693,Mrs. Henderson Presents,27876417,11036366,16840051,2005_boxofficemojo_rankings.csv,2005,0.3959033185649361,0.6040966814350639
3694,The Beguiled,27869129,10709995,17159134,2017_boxofficemojo_rankings.csv,2017,0.3842960072415611,0.6157039927584389
3695,Dark Skies,27858103,17418667,10439436,2013_boxofficemojo_rankings.csv,2013,0.6252639312877837,0.3747360687122163
3696,Soul Man,27820000,27820000,0,1986_boxofficemojo_rankings.csv,1986,1.0,0.0
3697,The Other Sister,27807627,27807627,0,1999_boxofficemojo_rankings.csv,1999,1.0,0.0
3698,My Life,27804899,27804899,0,1993_boxofficemojo_rankings.csv,1993,1.0,0.0
3699,Teachers,27774237,27774237,0,1984_boxofficemojo_rankings.csv,1984,1.0,0.0
3700,Internal Affairs,27734391,27734391,0,1990_boxofficemojo_rankings.csv,1990,1.0,0.0
3701,Love & Basketball,27728118,27459615,268503,2000_boxofficemojo_rankings.csv,2000,0.9903165804473278,0.009683419552672129
3702,Ruby & Quentin,27720972,312824,27408148,2003_boxofficemojo_rankings.csv,2003,0.011284741386413145,0.9887152586135869
3703,Appaloosa,27712362,20211394,7500968,2008_boxofficemojo_rankings.csv,2008,0.7293277274596802,0.2706722725403197
3704,Default,27694043,203775,27490268,2018_boxofficemojo_rankings.csv,2018,0.007358080580722721,0.9926419194192773
3705,Dirty Dancing: Havana Nights,27685016,14161590,13523426,2004_boxofficemojo_rankings.csv,2004,0.5115254403320554,0.48847455966794456
3706,Nebraska,27682872,17654912,10027960,2013_boxofficemojo_rankings.csv,2013,0.6377557935462765,0.36224420645372346
3707,Traitor,27674464,23530831,4143633,2008_boxofficemojo_rankings.csv,2008,0.8502723304776563,0.1497276695223438
3708,The Quiet American,27674124,12988801,14685323,2002_boxofficemojo_rankings.csv,2002,0.46934822580111296,0.530651774198887
3709,Ice Princess,27645491,24402491,3243000,2005_boxofficemojo_rankings.csv,2005,0.882693347714461,0.11730665228553908
3710,The Last Castle,27642707,18244060,9398647,2001_boxofficemojo_rankings.csv,2001,0.659995419406645,0.34000458059335503
3711,The Road,27639579,8117000,19522579,2009_boxofficemojo_rankings.csv,2009,0.29367306933293014,0.7063269306670699
3712,Cadillac Man,27627310,27627310,0,1990_boxofficemojo_rankings.csv,1990,1.0,0.0
3713,Goal! The Dream Begins,27610873,4283255,23327618,2005_boxofficemojo_rankings.csv,2005,0.15512928548112187,0.8448707145188781
3714,One Cut of the Dead,27590180,52406,27537774,2018_boxofficemojo_rankings.csv,2018,0.0018994439325876091,0.9981005560674124
3715,Blade Runner,27580111,27580111,0,1982_boxofficemojo_rankings.csv,1982,1.0,0.0
3716,Cirque du Soleil: Journey of Man,27538359,15627434,11910925,2000_boxofficemojo_rankings.csv,2000,0.5674787666178657,0.43252123338213433
3717,The Women on the 6th Floor,27533970,719823,26814147,2011_boxofficemojo_rankings.csv,2011,0.026143087974600104,0.9738569120253999
3718,Mirai,27526961,812794,26714167,2018_boxofficemojo_rankings.csv,2018,0.029527196990615855,0.9704728030093841
3719,Poetic Justice,27515786,27515786,0,1993_boxofficemojo_rankings.csv,1993,1.0,0.0
3720,The Happytime Murders,27506452,20706452,6800000,2018_boxofficemojo_rankings.csv,2018,0.7527852737968532,0.2472147262031468
3721,Dad,27503037,22103037,5400000,1989_boxofficemojo_rankings.csv,1989,0.8036580469276902,0.19634195307230978
3722,Memphis Belle,27441977,27441977,0,1990_boxofficemojo_rankings.csv,1990,1.0,0.0
3723,The Incredible Burt Wonderstone,27437881,22537881,4900000,2013_boxofficemojo_rankings.csv,2013,0.8214147805364416,0.17858521946355843
3724,Frost/Nixon,27426335,18622031,8804304,2008_boxofficemojo_rankings.csv,2008,0.678983575457676,0.321016424542324
3725,Left Behind,27405896,14019924,13385972,2014_boxofficemojo_rankings.csv,2014,0.5115659783573578,0.48843402164264216
3726,Desperately Seeking Susan,27398584,27398584,0,1985_boxofficemojo_rankings.csv,1985,1.0,0.0
3727,Irrational Man,27391084,4030360,23360724,2015_boxofficemojo_rankings.csv,2015,0.14714131065422603,0.852858689345774
3728,Jing wu feng yun: Chen Zhen,27390678,50433,27340245,2010_boxofficemojo_rankings.csv,2010,0.0018412468650830767,0.998158753134917
3729,Ella Enchanted,27388767,22918387,4470380,2004_boxofficemojo_rankings.csv,2004,0.8367805312301938,0.16321946876980625
3730,Detective K: Secret of the Lost Island,27387870,185367,27202503,2015_boxofficemojo_rankings.csv,2015,0.006768215271943382,0.9932317847280566
3731,Midnight Sun,27365467,9561064,17804403,2018_boxofficemojo_rankings.csv,2018,0.34938428056060583,0.6506157194393942
3732,Bed of Roses,27315527,19030691,8284836,1996_boxofficemojo_rankings.csv,1996,0.6966986578732308,0.3033013421267691
3733,The Last Mimzy,27308918,21471047,5837871,2007_boxofficemojo_rankings.csv,2007,0.7862284034834335,0.2137715965165665
3734,Stay Alive,27298695,23086480,4212215,2006_boxofficemojo_rankings.csv,2006,0.8456990343311283,0.15430096566887172
3735,Ramona and Beezus,27293743,26167002,1126741,2010_boxofficemojo_rankings.csv,2010,0.9587179742990912,0.04128202570090881
3736,American Ultra,27262374,14440985,12821389,2015_boxofficemojo_rankings.csv,2015,0.5297038695162791,0.4702961304837209
3737,Sorority Row,27206120,11965282,15240838,2009_boxofficemojo_rankings.csv,2009,0.4398011182777993,0.5601988817222008
3738,Dark City,27200316,14378331,12821985,1998_boxofficemojo_rankings.csv,1998,0.5286089691016825,0.4713910308983175
3739,A Passage to India,27187653,27187653,0,1984_boxofficemojo_rankings.csv,1984,1.0,0.0
3740,Khumba,27187375,1029,27186346,2013_boxofficemojo_rankings.csv,2013,3.7848449877930475e-05,0.999962151550122
3741,The Protector,27165581,12044087,15121494,2005_boxofficemojo_rankings.csv,2005,0.44335834378068334,0.5566416562193166
3742,Airplane II: The Sequel,27150534,27150534,0,1982_boxofficemojo_rankings.csv,1982,1.0,0.0
3743,Splice 2010 Re-release,27127620,17010170,10117450,2010_boxofficemojo_rankings.csv,2010,0.627042475528631,0.37295752447136904
3744,Shoot 'Em Up,27122238,12807139,14315099,2007_boxofficemojo_rankings.csv,2007,0.47220067164074,0.52779932835926
3745,The Jazz Singer,27118000,27118000,0,1980_boxofficemojo_rankings.csv,1980,1.0,0.0
3746,Flash Gordon,27107960,27107960,0,1980_boxofficemojo_rankings.csv,1980,1.0,0.0
3747,All Dogs Go to Heaven,27100027,27100027,0,1989_boxofficemojo_rankings.csv,1989,1.0,0.0
3748,Let Me In,27093592,12134935,14958657,2010_boxofficemojo_rankings.csv,2010,0.4478894861928976,0.5521105138071024
3749,Fast Times at Ridgemont High,27092880,27092880,0,1982_boxofficemojo_rankings.csv,1982,1.0,0.0
3750,Ghost Town,27090159,13367624,13722535,2008_boxofficemojo_rankings.csv,2008,0.4934494478234698,0.5065505521765302
3751,My Neighbor Totoro 2018 Re-release,27083857,1144649,25939208,2018_boxofficemojo_rankings.csv,2018,0.042263145902741994,0.9577368540972581
3752,Rendition,27066382,9736045,17330337,2007_boxofficemojo_rankings.csv,2007,0.3597098792147395,0.6402901207852605
3753,Guarding Tess,27058304,27058304,0,1994_boxofficemojo_rankings.csv,1994,1.0,0.0
3754,Hitchcock,27039669,6008677,21030992,2012_boxofficemojo_rankings.csv,2012,0.22221710628188532,0.7777828937181147
3755,The Big Hit,27007143,27007143,0,1998_boxofficemojo_rankings.csv,1998,1.0,0.0
3756,The Crime of Padre Amaro,26996738,5717044,21279694,2002_boxofficemojo_rankings.csv,2002,0.21176795507664667,0.7882320449233533
3757,Clerks II,26984975,24148068,2836907,2006_boxofficemojo_rankings.csv,2006,0.8948708679552232,0.10512913204477677
3758,Observe and Report,26973554,24007324,2966230,2009_boxofficemojo_rankings.csv,2009,0.8900319179296877,0.10996808207031228
3759,Spy Hard,26960191,26960191,0,1996_boxofficemojo_rankings.csv,1996,1.0,0.0
3760,The Baader Meinhof Complex,26937355,476270,26461085,2008_boxofficemojo_rankings.csv,2008,0.017680652016502735,0.9823193479834973
3761,Total Dhamaal,26911995,2167632,24744363,2019_boxofficemojo_rankings.csv,2019,0.08054519926895051,0.9194548007310495
3762,The Painted Veil,26910847,8060487,18850360,2006_boxofficemojo_rankings.csv,2006,0.2995255779203085,0.7004744220796915
3763,You're Next,26895481,18494006,8401475,2013_boxofficemojo_rankings.csv,2013,0.6876250326216512,0.3123749673783488
3764,The In-Laws,26891849,20453431,6438418,2003_boxofficemojo_rankings.csv,2003,0.7605810593388354,0.23941894066116465
3765,Jodhaa Akbar,26890354,3440718,23449636,2008_boxofficemojo_rankings.csv,2008,0.12795361489104978,0.8720463851089503
3766,The French Lieutenant's Woman,26890068,26890068,0,1981_boxofficemojo_rankings.csv,1981,1.0,0.0
3767,Eye for an Eye,26877589,26877589,0,1996_boxofficemojo_rankings.csv,1996,1.0,0.0
3768,Paulie,26875268,26875268,0,1998_boxofficemojo_rankings.csv,1998,1.0,0.0
3769,Going in Style,26869286,26869286,0,1979_boxofficemojo_rankings.csv,1979,1.0,0.0
3770,Glory,26828365,26828365,0,1989_boxofficemojo_rankings.csv,1989,1.0,0.0
3771,The Invisible,26810113,20578909,6231204,2007_boxofficemojo_rankings.csv,2007,0.7675800918854762,0.2324199081145238
3772,Chips,26800152,18600152,8200000,2017_boxofficemojo_rankings.csv,2017,0.6940315860895118,0.3059684139104883
3773,Black Book,26768563,4398532,22370031,2006_boxofficemojo_rankings.csv,2006,0.16431707596705883,0.8356829240329412
3774,Overboard,26713187,26713187,0,1987_boxofficemojo_rankings.csv,1987,1.0,0.0
3775,Baby Boom,26712476,26712476,0,1987_boxofficemojo_rankings.csv,1987,1.0,0.0
3776,Doogal,26711924,7438000,19273924,2005_boxofficemojo_rankings.csv,2005,0.27845242446781443,0.7215475755321855
3777,Event Horizon,26673242,26673242,0,1997_boxofficemojo_rankings.csv,1997,1.0,0.0
3778,Prizzi's Honor,26657534,26657534,0,1985_boxofficemojo_rankings.csv,1985,1.0,0.0
3779,A Cure for Wellness,26620002,8106986,18513016,2017_boxofficemojo_rankings.csv,2017,0.3045449057441844,0.6954550942558156
3780,One True Thing,26616840,23245840,3371000,1998_boxofficemojo_rankings.csv,1998,0.8733508560745753,0.12664914392542465
3781,An American Werewolf in Paris,26570463,26570463,0,1997_boxofficemojo_rankings.csv,1997,1.0,0.0
3782,Harriet the Spy,26570048,26570048,0,1996_boxofficemojo_rankings.csv,1996,1.0,0.0
3783,Mongol: The Rise of Genghis Khan,26527510,5705761,20821749,2007_boxofficemojo_rankings.csv,2007,0.215088449688644,0.7849115503113561
3784,Missing Link,26527094,16649539,9877555,2019_boxofficemojo_rankings.csv,2019,0.6276427791148175,0.3723572208851825
3785,Damien: Omen II,26518355,26518355,0,1978_boxofficemojo_rankings.csv,1978,1.0,0.0
3786,No Manches Frida 2,26493648,9270920,17222728,2019_boxofficemojo_rankings.csv,2019,0.3499299152762957,0.6500700847237043
3787,First Kid,26491793,26491793,0,1996_boxofficemojo_rankings.csv,1996,1.0,0.0
3788,A Hard Day,26488847,19004,26469843,2014_boxofficemojo_rankings.csv,2014,0.0007174340204388662,0.9992825659795611
3789,Billy Madison,26488734,25588734,900000,1995_boxofficemojo_rankings.csv,1995,0.9660232912603525,0.03397670873964758
3790,"The Way, Way Back",26474920,21506546,4968374,2013_boxofficemojo_rankings.csv,2013,0.8123365811870253,0.18766341881297469
3791,The Gauntlet,26414658,26414658,0,1977_boxofficemojo_rankings.csv,1977,1.0,0.0
3792,Pinocchio 1984 Re-release,26414038,26414038,0,1984_boxofficemojo_rankings.csv,1984,1.0,0.0
3793,Mad Money,26412163,20668843,5743320,2008_boxofficemojo_rankings.csv,2008,0.7825501834136038,0.2174498165863962
3794,Center Stage,26385941,17200925,9185016,2000_boxofficemojo_rankings.csv,2000,0.65189734942559,0.3481026505744101
3795,House Party,26385627,26385627,0,1990_boxofficemojo_rankings.csv,1990,1.0,0.0
3796,I.Q.,26381221,26381221,0,1994_boxofficemojo_rankings.csv,1994,1.0,0.0
3797,Only the Brave,26351322,18343983,8007339,2017_boxofficemojo_rankings.csv,2017,0.6961314123063731,0.3038685876936269
3798,Saving Grace,26330482,12178602,14151880,2000_boxofficemojo_rankings.csv,2000,0.46252863886046597,0.537471361139534
3799,Houseguest,26325256,26325256,0,1995_boxofficemojo_rankings.csv,1995,1.0,0.0
3800,All About the Benjamins,26306533,25916319,390214,2002_boxofficemojo_rankings.csv,2002,0.9851666504286216,0.014833349571378334
3801,Wildcats,26285544,26285544,0,1986_boxofficemojo_rankings.csv,1986,1.0,0.0
3802,Private Lessons,26279000,26279000,0,1981_boxofficemojo_rankings.csv,1981,1.0,0.0
3803,Necessary Roughness,26255594,26255594,0,1991_boxofficemojo_rankings.csv,1991,1.0,0.0
3804,Aloha,26250020,21067116,5182904,2015_boxofficemojo_rankings.csv,2015,0.8025561885286182,0.19744381147138174
3805,Apollo 18,26236153,17687709,8548444,2011_boxofficemojo_rankings.csv,2011,0.6741731152429246,0.3258268847570755
3806,Protocol,26186631,26186631,0,1984_boxofficemojo_rankings.csv,1984,1.0,0.0
3807,Typhoon,26179656,139059,26040597,2005_boxofficemojo_rankings.csv,2005,0.005311719909535863,0.9946882800904642
3808,The Whole Ten Yards,26170671,16328471,9842200,2004_boxofficemojo_rankings.csv,2004,0.6239225199842985,0.37607748001570157
3809,Modern Problems,26154211,26154211,0,1981_boxofficemojo_rankings.csv,1981,1.0,0.0
3810,The Zookeeper's Wife,26152835,17571660,8581175,2017_boxofficemojo_rankings.csv,2017,0.6718835644395722,0.32811643556042774
3811,Badrinath Ki Dulhania,26134309,1993259,24141050,2017_boxofficemojo_rankings.csv,2017,0.0762698183449197,0.9237301816550803
3812,Jacob's Ladder,26118851,26118851,0,1990_boxofficemojo_rankings.csv,1990,1.0,0.0
3813,Top Five,26117471,25317471,800000,2014_boxofficemojo_rankings.csv,2014,0.9693691628871723,0.030630837112827655
3814,Lady and the Tramp 1980 Re-release,26114207,26114207,0,1980_boxofficemojo_rankings.csv,1980,1.0,0.0
3815,An Education,26096852,12574914,13521938,2009_boxofficemojo_rankings.csv,2009,0.48185558932548644,0.5181444106745136
3816,Saving Silverman,26086706,19402030,6684676,2001_boxofficemojo_rankings.csv,2001,0.7437516258281134,0.2562483741718866
3817,Micki + Maude,26080861,26080861,0,1984_boxofficemojo_rankings.csv,1984,1.0,0.0
3818,North Dallas Forty,26079312,26079312,0,1979_boxofficemojo_rankings.csv,1979,1.0,0.0
3819,Hichki,26055222,330279,25724943,2018_boxofficemojo_rankings.csv,2018,0.012676115367583512,0.9873238846324165
3820,Iceman,26033917,7679,26026238,2014_boxofficemojo_rankings.csv,2014,0.0002949613767302093,0.9997050386232698
3821,Bratz,26013153,10010209,16002944,2007_boxofficemojo_rankings.csv,2007,0.38481336729922744,0.6151866327007726
3822,The Elephant Man,26010864,26010864,0,1980_boxofficemojo_rankings.csv,1980,1.0,0.0
3823,Agneepath,26001696,1986748,24014948,2012_boxofficemojo_rankings.csv,2012,0.07640840043664844,0.9235915995633516
3824,A Prairie Home Companion,25978867,20342852,5636015,2006_boxofficemojo_rankings.csv,2006,0.783053856813694,0.216946143186306
3825,The Light Between Oceans,25975621,12545979,13429642,2016_boxofficemojo_rankings.csv,2016,0.48299053177592943,0.5170094682240706
3826,Howards End,25966555,25966555,0,1992_boxofficemojo_rankings.csv,1992,1.0,0.0
3827,White Boy Rick,25957482,24011188,1946294,2018_boxofficemojo_rankings.csv,2018,0.925019922964793,0.07498007703520704
3828,The Turning Point,25933445,25933445,0,1977_boxofficemojo_rankings.csv,1977,1.0,0.0
3829,The Cotton Club,25928721,25928721,0,1984_boxofficemojo_rankings.csv,1984,1.0,0.0
3830,"Paul, Apostle of Christ",25915966,17560475,8355491,2018_boxofficemojo_rankings.csv,2018,0.6775929170458087,0.32240708295419124
3831,Innerspace,25893810,25893810,0,1987_boxofficemojo_rankings.csv,1987,1.0,0.0
3832,Huevos: Little Rooster's Egg-cellent Adventure,25892561,9080818,16811743,2015_boxofficemojo_rankings.csv,2015,0.3507114649647827,0.6492885350352172
3833,Rollerball,25852764,18990798,6861966,2002_boxofficemojo_rankings.csv,2002,0.7345751502624632,0.26542484973753677
3834,Boys and Girls,25850615,21799652,4050963,2000_boxofficemojo_rankings.csv,2000,0.8432933607188843,0.15670663928111575
3835,Shadowlands,25842377,25842377,0,1993_boxofficemojo_rankings.csv,1993,1.0,0.0
3836,From Dusk Till Dawn,25836616,25836616,0,1996_boxofficemojo_rankings.csv,1996,1.0,0.0
3837,The Alamo,25819961,22414961,3405000,2004_boxofficemojo_rankings.csv,2004,0.8681252849297487,0.13187471507025128
3838,Betrayed,25816139,25816139,0,1988_boxofficemojo_rankings.csv,1988,1.0,0.0
3839,Rust and Bone,25807712,2062027,23745685,2012_boxofficemojo_rankings.csv,2012,0.07989964395138942,0.9201003560486106
3840,Murder at 1600,25804707,25804707,0,1997_boxofficemojo_rankings.csv,1997,1.0,0.0
3841,Our Idiot Brother,25804448,24816118,988330,2011_boxofficemojo_rankings.csv,2011,0.9616992388289026,0.038300761171097326
3842,Fair Game,25798915,9540691,16258224,2010_boxofficemojo_rankings.csv,2010,0.3698097768840279,0.6301902231159722
3843,Candyman,25792310,25792310,0,1992_boxofficemojo_rankings.csv,1992,1.0,0.0
3844,"The Gangster, the Cop, the Devil",25775371,216494,25558877,2019_boxofficemojo_rankings.csv,2019,0.008399258346271718,0.9916007416537282
3845,The Last Dragon,25754284,25754284,0,1985_boxofficemojo_rankings.csv,1985,1.0,0.0
3846,RocknRolla,25740863,5700626,20040237,2008_boxofficemojo_rankings.csv,2008,0.22146211647993308,0.7785378835200669
3847,A Beautiful Planet,25730120,15650615,10079505,2016_boxofficemojo_rankings.csv,2016,0.6082604744944835,0.3917395255055165
3848,The Outsiders,25697647,25697647,0,1983_boxofficemojo_rankings.csv,1983,1.0,0.0
3849,Other People's Money,25682090,25682090,0,1991_boxofficemojo_rankings.csv,1991,1.0,0.0
3850,Fireworks,25672406,525280,25147126,2017_boxofficemojo_rankings.csv,2017,0.020460879280266915,0.979539120719733
3851,Emma.,25643186,10055355,15587831,2020_boxofficemojo_rankings.csv,2020,0.39212580683227116,0.6078741931677288
3852,Freaky Friday,25642000,25642000,0,1977_boxofficemojo_rankings.csv,1977,1.0,0.0
3853,Agnes of God,25627836,25627836,0,1985_boxofficemojo_rankings.csv,1985,1.0,0.0
3854,Jonah: A VeggieTales Movie,25615231,25581229,34002,2002_boxofficemojo_rankings.csv,2002,0.9986725866341006,0.0013274133658993745
3855,Can't Hardly Wait,25605015,25605015,0,1998_boxofficemojo_rankings.csv,1998,1.0,0.0
3856,Father Figures,25601244,17501244,8100000,2017_boxofficemojo_rankings.csv,2017,0.6836091246191005,0.31639087538089944
3857,"Love, Rosie",25574387,20431,25553956,2014_boxofficemojo_rankings.csv,2014,0.0007988852284123173,0.9992011147715877
3858,Mr. Donkey,25537759,356255,25181504,2016_boxofficemojo_rankings.csv,2016,0.013950127730471574,0.9860498722695284
3859,Funny Farm,25537221,25537221,0,1988_boxofficemojo_rankings.csv,1988,1.0,0.0
3860,The Muppets Take Manhattan,25534703,25534703,0,1984_boxofficemojo_rankings.csv,1984,1.0,0.0
3861,Halloween II,25533818,25533818,0,1981_boxofficemojo_rankings.csv,1981,1.0,0.0
3862,Only When I Laugh,25524778,25524778,0,1981_boxofficemojo_rankings.csv,1981,1.0,0.0
3863,A Nightmare on Elm Street,25504513,25504513,0,1984_boxofficemojo_rankings.csv,1984,1.0,0.0
3864,Mimic,25480490,25480490,0,1997_boxofficemojo_rankings.csv,1997,1.0,0.0
3865,My Father the Hero,25479558,25479558,0,1994_boxofficemojo_rankings.csv,1994,1.0,0.0
3866,Escape from L.A.,25477365,25477365,0,1996_boxofficemojo_rankings.csv,1996,1.0,0.0
3867,The Tiger and the Snow,25460023,10167,25449856,2005_boxofficemojo_rankings.csv,2005,0.00039933192519111236,0.9996006680748089
3868,Grindhouse,25422088,25037897,384191,2007_boxofficemojo_rankings.csv,2007,0.9848875119935073,0.015112488006492621
3869,Ghost Dad,25421633,24707633,714000,1990_boxofficemojo_rankings.csv,1990,0.9719136846952358,0.028086315304764253
3870,Tin Men,25411386,25411386,0,1987_boxofficemojo_rankings.csv,1987,1.0,0.0
3871,Desperado,25405445,25405445,0,1995_boxofficemojo_rankings.csv,1995,1.0,0.0
3872,The Hitcher,25399945,16472961,8926984,2007_boxofficemojo_rankings.csv,2007,0.6485431759793181,0.35145682402068196
3873,In America,25382911,15539656,9843255,2003_boxofficemojo_rankings.csv,2003,0.6122093718880391,0.38779062811196086
3874,Keys To The Heart,25375866,75134,25300732,2018_boxofficemojo_rankings.csv,2018,0.0029608447648643795,0.9970391552351356
3875,In Love and War,25372294,14481231,10891063,1996_boxofficemojo_rankings.csv,1996,0.5707497713844873,0.42925022861551265
3876,Fantasia 1990 Re-release,25363371,25363371,0,1990_boxofficemojo_rankings.csv,1990,1.0,0.0
3877,A Haunted House 2,25358716,17329486,8029230,2014_boxofficemojo_rankings.csv,2014,0.6833739531607199,0.31662604683928003
3878,The Great Mouse Detective,25336794,25336794,0,1986_boxofficemojo_rankings.csv,1986,1.0,0.0
3879,Heartburn,25314189,25314189,0,1986_boxofficemojo_rankings.csv,1986,1.0,0.0
3880,And So It Goes,25312387,15160801,10151586,2014_boxofficemojo_rankings.csv,2014,0.5989478985130877,0.40105210148691234
3881,The Woman in Red,25308147,25308147,0,1984_boxofficemojo_rankings.csv,1984,1.0,0.0
3882,The Last Legion,25303038,5933494,19369544,2007_boxofficemojo_rankings.csv,2007,0.23449729633255895,0.765502703667441
3883,Enough Said,25288872,17550872,7738000,2013_boxofficemojo_rankings.csv,2013,0.6940156128751017,0.3059843871248983
3884,Corky Romano,25272752,23980304,1292448,2001_boxofficemojo_rankings.csv,2001,0.9488600212592597,0.05113997874074022
3885,Escape from New York,25244626,25244626,0,1981_boxofficemojo_rankings.csv,1981,1.0,0.0
3886,Fallen,25232289,25232289,0,1998_boxofficemojo_rankings.csv,1998,1.0,0.0
3887,Kabhi Alvida Naa Kehna,25229168,3275444,21953724,2006_boxofficemojo_rankings.csv,2006,0.12982766613627528,0.8701723338637247
3888,North Country,25211175,18337722,6873453,2005_boxofficemojo_rankings.csv,2005,0.7273648292870126,0.2726351707129874
3889,Black Widow,25205460,25205460,0,1987_boxofficemojo_rankings.csv,1987,1.0,0.0
3890,Don't Tell Mom the Babysitter's Dead,25196249,25196249,0,1991_boxofficemojo_rankings.csv,1991,1.0,0.0
3891,Biutiful,25147786,5101237,20046549,2010_boxofficemojo_rankings.csv,2010,0.20285034237208793,0.797149657627912
3892,The Morning After,25147055,25147055,0,1986_boxofficemojo_rankings.csv,1986,1.0,0.0
3893,Fly Away Home,25143818,25143818,0,1996_boxofficemojo_rankings.csv,1996,1.0,0.0
3894,On the Other Side of the Tracks,25109572,9572,25100000,2012_boxofficemojo_rankings.csv,2012,0.0003812092057961004,0.9996187907942039
3895,The Cutting Edge,25105517,25105517,0,1992_boxofficemojo_rankings.csv,1992,1.0,0.0
3896,Midnight in the Garden of Good and Evil,25105255,25105255,0,1997_boxofficemojo_rankings.csv,1997,1.0,0.0
3897,Only the Lonely,25092802,21830957,3261845,1991_boxofficemojo_rankings.csv,1991,0.8700087379639787,0.12999126203602132
3898,Born in China,25081168,13873211,11207957,2016_boxofficemojo_rankings.csv,2016,0.5531325734112542,0.4468674265887458
3899,Race,25070261,19206207,5864054,2016_boxofficemojo_rankings.csv,2016,0.7660952153629353,0.2339047846370646
3900,Navy Seals,25069101,25069101,0,1990_boxofficemojo_rankings.csv,1990,1.0,0.0
3901,Moscow on the Hudson,25068724,25068724,0,1984_boxofficemojo_rankings.csv,1984,1.0,0.0
3902,The Wood,25059640,25059640,0,1999_boxofficemojo_rankings.csv,1999,1.0,0.0
3903,Wyatt Earp,25052000,25052000,0,1994_boxofficemojo_rankings.csv,1994,1.0,0.0
3904,The Last Exorcism 2,25051865,15179302,9872563,2013_boxofficemojo_rankings.csv,2013,0.6059150486400913,0.39408495135990873
3905,Before the Devil Knows You're Dead,25037657,7084227,17953430,2007_boxofficemojo_rankings.csv,2007,0.2829428887854802,0.7170571112145198
3906,Free State of Jones,25035950,20810036,4225914,2016_boxofficemojo_rankings.csv,2016,0.8312061655339622,0.16879383446603785
3907,Ernest Goes to Jail,25029569,25029569,0,1990_boxofficemojo_rankings.csv,1990,1.0,0.0
3908,Cocoon: The Return,25024919,18924919,6100000,1988_boxofficemojo_rankings.csv,1988,0.756242967259954,0.24375703274004604
3909,Kingpin,25023434,25023434,0,1996_boxofficemojo_rankings.csv,1996,1.0,0.0
3910,Little Man Tate,25010896,25010896,0,1991_boxofficemojo_rankings.csv,1991,1.0,0.0
3911,Georgia Rule,25000167,19103072,5897095,2007_boxofficemojo_rankings.csv,2007,0.7641177756932583,0.23588222430674163
3912,Whiskey Tango Foxtrot,24972139,23083334,1888805,2016_boxofficemojo_rankings.csv,2016,0.924363507667485,0.07563649233251504
3913,A Single Man,24964890,9176000,15788890,2009_boxofficemojo_rankings.csv,2009,0.36755619592155225,0.6324438040784478
3914,The Way Home,24952738,445367,24507371,2002_boxofficemojo_rankings.csv,2002,0.017848422084983218,0.9821515779150167
3915,Invasion of the Body Snatchers,24946533,24946533,0,1978_boxofficemojo_rankings.csv,1978,1.0,0.0
3916,Pure Luck,24941969,22641969,2300000,1991_boxofficemojo_rankings.csv,1991,0.9077859490563877,0.09221405094361235
3917,Housefull 2,24922847,1791780,23131067,2012_boxofficemojo_rankings.csv,2012,0.07189307064317331,0.9281069293568267
3918,Fright Night,24922237,24922237,0,1985_boxofficemojo_rankings.csv,1985,1.0,0.0
3919,Booksmart,24863452,22680962,2182490,2019_boxofficemojo_rankings.csv,2019,0.9122209578943423,0.08777904210565773
3920,Seed of Chucky,24829644,17083732,7745912,2004_boxofficemojo_rankings.csv,2004,0.6880377342502373,0.31196226574976266
3921,Quiz Show,24822619,24822619,0,1994_boxofficemojo_rankings.csv,1994,1.0,0.0
3922,The Craft,24819936,24819936,0,1996_boxofficemojo_rankings.csv,1996,1.0,0.0
3923,Wild City,24817852,34866,24782986,2015_boxofficemojo_rankings.csv,2015,0.0014048758127818636,0.9985951241872182
3924,Elle s'appelait Sarah,24792815,7693187,17099628,2010_boxofficemojo_rankings.csv,2010,0.31029905236658284,0.6897009476334172
3925,The Man Without a Face,24760338,24760338,0,1993_boxofficemojo_rankings.csv,1993,1.0,0.0
3926,"Sex, Lies, and Videotape",24741667,24741667,0,1989_boxofficemojo_rankings.csv,1989,1.0,0.0
3927,Lottery Ticket,24719879,24719879,0,2010_boxofficemojo_rankings.csv,2010,1.0,0.0
3928,Big Miracle,24719215,20157300,4561915,2012_boxofficemojo_rankings.csv,2012,0.815450652458017,0.18454934754198302
3929,Bride & Prejudice,24716440,6605592,18110848,2004_boxofficemojo_rankings.csv,2004,0.26725499303297723,0.7327450069670227
3930,Super 30,24701637,2269878,22431759,2019_boxofficemojo_rankings.csv,2019,0.09189180457959123,0.9081081954204088
3931,The Shipping News,24690441,11434216,13256225,2001_boxofficemojo_rankings.csv,2001,0.4631029474119154,0.5368970525880846
3932,Summer Rental,24689703,24689703,0,1985_boxofficemojo_rankings.csv,1985,1.0,0.0
3933,Drug War,24676341,128195,24548146,2013_boxofficemojo_rankings.csv,2013,0.005195057079167451,0.9948049429208325
3934,Operation Dumbo Drop,24670346,24670346,0,1995_boxofficemojo_rankings.csv,1995,1.0,0.0
3935,Punch-Drunk Love,24665649,17844216,6821433,2002_boxofficemojo_rankings.csv,2002,0.7234440091156734,0.27655599088432664
3936,Ready,24663361,955148,23708213,2011_boxofficemojo_rankings.csv,2011,0.03872740621199195,0.961272593788008
3937,The Other Side of Midnight,24652021,24652021,0,1977_boxofficemojo_rankings.csv,1977,1.0,0.0
3938,The Death of Stalin,24646055,8047856,16598199,2017_boxofficemojo_rankings.csv,2017,0.32653728963925466,0.6734627103607453
3939,The Snow Queen 3: Fire and Ice,24644317,0,24644317,2016_boxofficemojo_rankings.csv,2016,0.0,1.0
3940,Sparkle,24637800,24397469,240331,2012_boxofficemojo_rankings.csv,2012,0.9902454358749564,0.009754564125043632
3941,The Players,24629152,10854,24618298,2012_boxofficemojo_rankings.csv,2012,0.00044069726801799754,0.999559302731982
3942,Capture the Flag,24604331,6690,24597641,2015_boxofficemojo_rankings.csv,2015,0.00027190334904858825,0.9997280966509514
3943,Joe Somebody,24516772,22771646,1745126,2001_boxofficemojo_rankings.csv,2001,0.9288190957602412,0.07118090423975881
3944,Race,24503269,1367024,23136245,2008_boxofficemojo_rankings.csv,2008,0.05578945405202873,0.9442105459479713
3945,The Corruptor,24493601,15164492,9329109,1999_boxofficemojo_rankings.csv,1999,0.6191205613253845,0.3808794386746155
3946,God's Not Dead 2,24487848,20774575,3713273,2016_boxofficemojo_rankings.csv,2016,0.8483626245964937,0.15163737540350627
3947,The Emerald Forest,24468550,24468550,0,1985_boxofficemojo_rankings.csv,1985,1.0,0.0
3948,Sling Blade,24444121,24444121,0,1996_boxofficemojo_rankings.csv,1996,1.0,0.0
3949,Stan & Ollie,24420923,5470235,18950688,2018_boxofficemojo_rankings.csv,2018,0.22399788083357866,0.7760021191664214
3950,Down to You,24419914,20069008,4350906,2000_boxofficemojo_rankings.csv,2000,0.8218295936668737,0.1781704063331263
3951,The Tale of The Princess Kaguya,24366656,703232,23663424,2013_boxofficemojo_rankings.csv,2013,0.02886042303055454,0.9711395769694454
3952,The Next Best Thing,24362772,14990582,9372190,2000_boxofficemojo_rankings.csv,2000,0.61530691170939,0.38469308829060994
3953,Dolores Claiborne,24361867,24361867,0,1995_boxofficemojo_rankings.csv,1995,1.0,0.0
3954,Renaissance Man,24332324,24332324,0,1994_boxofficemojo_rankings.csv,1994,1.0,0.0
3955,Nowhere in Africa,24322180,6180200,18141980,2001_boxofficemojo_rankings.csv,2001,0.25409728897656375,0.7459027110234362
3956,The Great Beauty,24271739,2852400,21419339,2013_boxofficemojo_rankings.csv,2013,0.11751939158541545,0.8824806084145845
3957,Lionheart,24271196,24078196,193000,1991_boxofficemojo_rankings.csv,1991,0.992048187489401,0.007951812510598984
3958,Jackie,24270399,13960394,10310005,2016_boxofficemojo_rankings.csv,2016,0.5752024925506993,0.42479750744930067
3959,Bronco Billy,24265659,24265659,0,1980_boxofficemojo_rankings.csv,1980,1.0,0.0
3960,Trance,24261569,2328743,21932826,2013_boxofficemojo_rankings.csv,2013,0.09598484747626998,0.90401515252373
3961,The Accidental Detective 2: In Action,24243825,179045,24064780,2018_boxofficemojo_rankings.csv,2018,0.0073851795250955655,0.9926148204749045
3962,Jolly LLB 2,24214186,1654254,22559932,2017_boxofficemojo_rankings.csv,2017,0.06831755566757437,0.9316824443324256
3963,The Gunman,24177137,10664749,13512388,2015_boxofficemojo_rankings.csv,2015,0.44110884593159233,0.5588911540684077
3964,The Railway Man,24174885,4438438,19736447,2013_boxofficemojo_rankings.csv,2013,0.18359706778336277,0.8164029322166372
3965,The Way Back,24172201,2701859,21470342,2010_boxofficemojo_rankings.csv,2010,0.11177546471668012,0.8882245352833199
3966,Iron Eagle,24159872,24159872,0,1986_boxofficemojo_rankings.csv,1986,1.0,0.0
3967,Dead Presidents,24147179,24147179,0,1995_boxofficemojo_rankings.csv,1995,1.0,0.0
3968,The Guru,24128852,3095506,21033346,2002_boxofficemojo_rankings.csv,2002,0.12829064557236292,0.8717093544276371
3969,The Founder,24121245,12786053,11335192,2016_boxofficemojo_rankings.csv,2016,0.5300743390318369,0.46992566096816313
3970,Guru,24108727,2096000,22012727,2007_boxofficemojo_rankings.csv,2007,0.08693947216707046,0.9130605278329296
3971,Striking Distance,24107867,24107867,0,1993_boxofficemojo_rankings.csv,1993,1.0,0.0
3972,The Adventures of Huck Finn,24103594,24103594,0,1993_boxofficemojo_rankings.csv,1993,1.0,0.0
3973,Bad Santa 2,24079268,17782178,6297090,2016_boxofficemojo_rankings.csv,2016,0.7384849904905747,0.2615150095094253
3974,Alien Adventure,24074680,8959784,15114896,1999_boxofficemojo_rankings.csv,1999,0.37216627593803947,0.6278337240619606
3975,Spring Break,24071666,24071666,0,1983_boxofficemojo_rankings.csv,1983,1.0,0.0
3976,Kung Fu Jungle,24070765,129784,23940981,2014_boxofficemojo_rankings.csv,2014,0.0053917688116684286,0.9946082311883315
3977,Body Heat,24058838,24058838,0,1981_boxofficemojo_rankings.csv,1981,1.0,0.0
3978,Virtuosity,24047675,24047675,0,1995_boxofficemojo_rankings.csv,1995,1.0,0.0
3979,I Can Speak,24024444,63239,23961205,2017_boxofficemojo_rankings.csv,2017,0.0026322773588433514,0.9973677226411567
3980,Partner,23968620,1062840,22905780,2007_boxofficemojo_rankings.csv,2007,0.04434297844431594,0.9556570215556841
3981,School for Scoundrels,23947685,17807569,6140116,2006_boxofficemojo_rankings.csv,2006,0.7436029411611185,0.25639705883888153
3982,Alex Rider: Operation Stormbreaker,23937870,677646,23260224,2006_boxofficemojo_rankings.csv,2006,0.028308533716659,0.971691466283341
3983,Harold & Kumar Go to White Castle,23936908,18250550,5686358,2004_boxofficemojo_rankings.csv,2004,0.7624439213285191,0.23755607867148087
3984,25th Hour,23928503,13084595,10843908,2002_boxofficemojo_rankings.csv,2002,0.5468204592656716,0.4531795407343284
3985,Birth,23925492,5095038,18830454,2004_boxofficemojo_rankings.csv,2004,0.21295436683182942,0.7870456331681706
3986,Tom and Huck,23920048,23920048,0,1995_boxofficemojo_rankings.csv,1995,1.0,0.0
3987,Mao's Last Dancer,23914731,4817770,19096961,2009_boxofficemojo_rankings.csv,2009,0.20145616523974283,0.7985438347602571
3988,Life as a House,23903791,15667270,8236521,2001_boxofficemojo_rankings.csv,2001,0.6554303457556168,0.34456965424438324
3989,American History X,23875127,6719864,17155263,1998_boxofficemojo_rankings.csv,1998,0.28145877506745826,0.7185412249325417
3990,The Flamingo Kid,23859382,23859382,0,1984_boxofficemojo_rankings.csv,1984,1.0,0.0
3991,Spirits' Homecoming,23857217,125616,23731601,2016_boxofficemojo_rankings.csv,2016,0.0052653249538703525,0.9947346750461297
3992,Silence,23834809,7100177,16734632,2016_boxofficemojo_rankings.csv,2016,0.2978910802264033,0.7021089197735967
3993,Lady Vengeance,23834149,211667,23622482,2005_boxofficemojo_rankings.csv,2005,0.00888082893163083,0.9911191710683692
3994,Eight Crazy Nights,23833131,23586598,246533,2002_boxofficemojo_rankings.csv,2002,0.9896558702253598,0.010344129774640184
3995,Wanderlust,23812816,17450535,6362281,2012_boxofficemojo_rankings.csv,2012,0.7328211413551425,0.26717885864485746
3996,Dickie Roberts: Former Child Star,23769505,22738671,1030834,2003_boxofficemojo_rankings.csv,2003,0.9566320796331266,0.04336792036687344
3997,The Dressmaker,23762417,2022115,21740302,2015_boxofficemojo_rankings.csv,2015,0.08509719360618913,0.9149028063938108
3998,Pokémon the Movie: The Power of Us,23740788,789170,22951618,2018_boxofficemojo_rankings.csv,2018,0.0332411038757433,0.9667588961242567
3999,The Peanut Butter Falcon,23728475,20457151,3271324,2019_boxofficemojo_rankings.csv,2019,0.8621350929632013,0.1378649070367986
4000,Russian Dolls,23727301,326095,23401206,2005_boxofficemojo_rankings.csv,2005,0.013743451056654105,0.9862565489433459
4001,In the Cut,23726793,4750602,18976191,2003_boxofficemojo_rankings.csv,2003,0.20022099067497237,0.7997790093250277
4002,Santa Claus: The Movie,23717291,23717291,0,1985_boxofficemojo_rankings.csv,1985,1.0,0.0
4003,Good Burger,23712993,23712993,0,1997_boxofficemojo_rankings.csv,1997,1.0,0.0
4004,Amy,23706049,8413144,15292905,2015_boxofficemojo_rankings.csv,2015,0.3548943984718837,0.6451056015281164
4005,Trolls World Tour,23705759,0,23705759,2020_boxofficemojo_rankings.csv,2020,0.0,1.0
4006,To the Arctic 3D,23695388,14560838,9134550,2012_boxofficemojo_rankings.csv,2012,0.6145009315736886,0.3854990684263115
4007,Sixteen Candles,23686027,23686027,0,1984_boxofficemojo_rankings.csv,1984,1.0,0.0
4008,Some Kind of Hero,23671186,23671186,0,1982_boxofficemojo_rankings.csv,1982,1.0,0.0
4009,Mad Max 2: The Road Warrior,23667907,23667907,0,1982_boxofficemojo_rankings.csv,1982,1.0,0.0
4010,Two of a Kind,23646952,23646952,0,1983_boxofficemojo_rankings.csv,1983,1.0,0.0
4011,Anywhere But Here,23631929,18670401,4961528,1999_boxofficemojo_rankings.csv,1999,0.7900498093067223,0.20995019069327772
4012,The Glass House,23619609,18150259,5469350,2001_boxofficemojo_rankings.csv,2001,0.7684402819707981,0.23155971802920192
4013,My Blue Heaven,23591472,23591472,0,1990_boxofficemojo_rankings.csv,1990,1.0,0.0
4014,What Now?,23591043,23591043,0,2016_boxofficemojo_rankings.csv,2016,1.0,0.0
4015,Hustle & Flow,23563727,22202809,1360918,2005_boxofficemojo_rankings.csv,2005,0.9422452144348812,0.057754785565118795
4016,Oscar,23562716,23562716,0,1991_boxofficemojo_rankings.csv,1991,1.0,0.0
4017,The Fox and the Hound 1988 Re-release,23556988,23556988,0,1988_boxofficemojo_rankings.csv,1988,1.0,0.0
4018,No manches Frida,23540937,11528613,12012324,2016_boxofficemojo_rankings.csv,2016,0.48972617360133114,0.5102738263986688
4019,Biker Boyz,23510621,22076772,1433849,2003_boxofficemojo_rankings.csv,2003,0.9390127125948736,0.06098728740512639
4020,Ernest Goes to Camp,23509382,23509382,0,1987_boxofficemojo_rankings.csv,1987,1.0,0.0
4021,Hoodlum,23499102,23499102,0,1997_boxofficemojo_rankings.csv,1997,1.0,0.0
4022,Henry & June,23472449,11567449,11905000,1990_boxofficemojo_rankings.csv,1990,0.4928096339670394,0.5071903660329606
4023,Youth,23469540,2703296,20766244,2015_boxofficemojo_rankings.csv,2015,0.11518316933352762,0.8848168306664723
4024,Wish Upon,23468586,14301505,9167081,2017_boxofficemojo_rankings.csv,2017,0.6093892917110558,0.39061070828894423
4025,Valley of the Wolves: Iraq,23465471,0,23465471,2006_boxofficemojo_rankings.csv,2006,0.0,1.0
4026,The Jungle Book 1984 Re-release,23456945,23456945,0,1984_boxofficemojo_rankings.csv,1984,1.0,0.0
4027,Boys on the Side,23440188,23440188,0,1995_boxofficemojo_rankings.csv,1995,1.0,0.0
4028,Tomcats,23430766,13558739,9872027,2001_boxofficemojo_rankings.csv,2001,0.5786724599614029,0.4213275400385971
4029,Only Cloud Knows,23410836,0,23410836,2019_boxofficemojo_rankings.csv,2019,0.0,1.0
4030,Kingdom Come,23396049,23249649,146400,2001_boxofficemojo_rankings.csv,2001,0.9937425331943868,0.006257466805613204
4031,Circle of Friends,23389975,23389975,0,1995_boxofficemojo_rankings.csv,1995,1.0,0.0
4032,The Avengers,23384939,23384939,0,1998_boxofficemojo_rankings.csv,1998,1.0,0.0
4033,Ghost Story,23371905,23371905,0,1981_boxofficemojo_rankings.csv,1981,1.0,0.0
4034,Leap of Faith,23369283,23369283,0,1992_boxofficemojo_rankings.csv,1992,1.0,0.0
4035,Antwone Fisher,23367586,21078145,2289441,2002_boxofficemojo_rankings.csv,2002,0.9020249246113826,0.09797507538861738
4036,Detroit,23355100,16790139,6564961,2017_boxofficemojo_rankings.csv,2017,0.7189067484189748,0.2810932515810251
4037,The Usual Suspects,23341568,23341568,0,1995_boxofficemojo_rankings.csv,1995,1.0,0.0
4038,Raging Bull,23334953,23334953,0,1980_boxofficemojo_rankings.csv,1980,1.0,0.0
4039,Paris,23328518,1010194,22318324,2008_boxofficemojo_rankings.csv,2008,0.04330296506619066,0.9566970349338093
4040,Middle School: The Worst Years of My Life,23316139,20007149,3308990,2016_boxofficemojo_rankings.csv,2016,0.8580815631610362,0.14191843683896377
4041,Under the Same Moon,23313049,12590147,10722902,2008_boxofficemojo_rankings.csv,2008,0.5400472070384272,0.4599527929615727
4042,Warrior,23308615,13657115,9651500,2011_boxofficemojo_rankings.csv,2011,0.5859256330760108,0.41407436692398925
4043,Toys,23278931,23278931,0,1992_boxofficemojo_rankings.csv,1992,1.0,0.0
4044,Benny & Joon,23261580,23261580,0,1993_boxofficemojo_rankings.csv,1993,1.0,0.0
4045,The Players Club,23261485,23047939,213546,1998_boxofficemojo_rankings.csv,1998,0.9908197606472674,0.00918023935273264
4046,The Remains of the Day,23237911,23237911,0,1993_boxofficemojo_rankings.csv,1993,1.0,0.0
4047,For the Boys,23202444,17860280,5342164,1991_boxofficemojo_rankings.csv,1991,0.7697585650890915,0.2302414349109085
4048,Jonas Brothers: The 3D Concert Experience,23186960,19162740,4024220,2009_boxofficemojo_rankings.csv,2009,0.8264446913265042,0.1735553086734958
4049,Super Troopers,23182223,18492362,4689861,2002_boxofficemojo_rankings.csv,2002,0.7976958033748532,0.2023041966251468
4050,Triple 9,23177948,12639297,10538651,2016_boxofficemojo_rankings.csv,2016,0.5453156163781194,0.4546843836218806
4051,Hoodwinked Too! Hood vs. Evil,23167844,10143779,13024065,2011_boxofficemojo_rankings.csv,2011,0.4378387130023838,0.5621612869976161
4052,The Iron Giant,23159305,23159305,0,1999_boxofficemojo_rankings.csv,1999,1.0,0.0
4053,Rock Dog,23157646,9420546,13737100,2016_boxofficemojo_rankings.csv,2016,0.40680067395451164,0.5931993260454884
4054,Air Bud,23144499,23144499,0,1997_boxofficemojo_rankings.csv,1997,1.0,0.0
4055,Being John Malkovich,23106667,22863596,243071,1999_boxofficemojo_rankings.csv,1999,0.9894804819751806,0.010519518024819418
4056,Blue Chips,23070663,23070663,0,1994_boxofficemojo_rankings.csv,1994,1.0,0.0
4057,The Choice,23064015,18730891,4333124,2016_boxofficemojo_rankings.csv,2016,0.8121262061267304,0.1878737938732697
4058,Snow Falling on Cedars,23049593,14417593,8632000,1999_boxofficemojo_rankings.csv,1999,0.6255031487974647,0.37449685120253534
4059,"OSS 117: Cairo, Nest of Spies",23041621,303543,22738078,2006_boxofficemojo_rankings.csv,2006,0.013173682528672787,0.9868263174713272
4060,The Program,23032565,23032565,0,1993_boxofficemojo_rankings.csv,1993,1.0,0.0
4061,Confidence,23014206,12251640,10762566,2003_boxofficemojo_rankings.csv,2003,0.5323511921288964,0.46764880787110363
4062,Buena Vista Social Club,23002182,7002182,16000000,1999_boxofficemojo_rankings.csv,1999,0.3044138160457995,0.6955861839542005
4063,Bambi 1982 Re-release,23000000,23000000,0,1982_boxofficemojo_rankings.csv,1982,1.0,0.0
4064,The Russia House,22997992,22997992,0,1990_boxofficemojo_rankings.csv,1990,1.0,0.0
4065,Padmaavat,22991060,11846060,11145000,2018_boxofficemojo_rankings.csv,2018,0.5152463609768319,0.48475363902316815
4066,Aquamarine,22989957,18597342,4392615,2006_boxofficemojo_rankings.csv,2006,0.8089333094446414,0.19106669055535858
4067,Imagine That,22985194,16123323,6861871,2009_boxofficemojo_rankings.csv,2009,0.7014656043364264,0.2985343956635737
4068,Days of Glory,22963701,320700,22643001,2006_boxofficemojo_rankings.csv,2006,0.013965518885653493,0.9860344811143466
4069,D3: The Mighty Ducks,22955097,22955097,0,1996_boxofficemojo_rankings.csv,1996,1.0,0.0
4070,The Human Stain,22954068,5381908,17572160,2003_boxofficemojo_rankings.csv,2003,0.23446423527193525,0.7655357647280647
4071,Domino,22944502,10169202,12775300,2005_boxofficemojo_rankings.csv,2005,0.4432086606194373,0.5567913393805627
4072,Armored,22942221,15988876,6953345,2009_boxofficemojo_rankings.csv,2009,0.6969192738575747,0.30308072614242537
4073,Young Adult,22939027,16311571,6627456,2011_boxofficemojo_rankings.csv,2011,0.7110838223434673,0.28891617765653266
4074,A Perfect Getaway,22938329,15515460,7422869,2009_boxofficemojo_rankings.csv,2009,0.6763988780525382,0.3236011219474618
4075,The Care Bears Movie,22934622,22934622,0,1985_boxofficemojo_rankings.csv,1985,1.0,0.0
4076,A Separation,22926076,7099055,15827021,2011_boxofficemojo_rankings.csv,2011,0.30964980662194436,0.6903501933780556
4077,Rounders,22912409,22912409,0,1998_boxofficemojo_rankings.csv,1998,1.0,0.0
4078,Crimes of the Heart,22905522,22905522,0,1986_boxofficemojo_rankings.csv,1986,1.0,0.0
4079,The Wind that Shakes the Barley,22899908,1836089,21063819,2006_boxofficemojo_rankings.csv,2006,0.08017888106799381,0.9198211189320062
4080,Baggage Claim,22871096,21569509,1301587,2013_boxofficemojo_rankings.csv,2013,0.9430903092707057,0.056909690729294304
4081,Guilty as Sin,22866222,22866222,0,1993_boxofficemojo_rankings.csv,1993,1.0,0.0
4082,Beloved,22852487,22852487,0,1998_boxofficemojo_rankings.csv,1998,1.0,0.0
4083,Won't You Be My Neighbor?,22844741,22835787,8954,2018_boxofficemojo_rankings.csv,2018,0.9996080498351897,0.0003919501648103605
4084,Dr. T & the Women,22844291,13113041,9731250,2000_boxofficemojo_rankings.csv,2000,0.5740182962999377,0.42598170370006233
4085,Kon-Tiki,22842887,1517410,21325477,2012_boxofficemojo_rankings.csv,2012,0.06642811830220935,0.9335718816977907
4086,Hunt for the Wilderpeople,22835917,5205468,17630449,2016_boxofficemojo_rankings.csv,2016,0.22795090733601808,0.7720490926639819
4087,Sweet Sixteen,22819702,34327,22785375,2016_boxofficemojo_rankings.csv,2016,0.001504270301163442,0.9984957296988366
4088,The Ruins,22818256,17432844,5385412,2008_boxofficemojo_rankings.csv,2008,0.763986695565165,0.23601330443483498
4089,Missing in Action,22812411,22812411,0,1984_boxofficemojo_rankings.csv,1984,1.0,0.0
4090,Scoob!,22800000,0,22800000,2020_boxofficemojo_rankings.csv,2020,0.0,1.0
4091,Captain Fantastic,22787526,5879835,16907691,2016_boxofficemojo_rankings.csv,2016,0.2580286688427695,0.7419713311572305
4092,Persepolis,22783978,4445756,18338222,2007_boxofficemojo_rankings.csv,2007,0.19512641734467967,0.8048735826553204
4093,Frankie and Johnny,22773535,22773535,0,1991_boxofficemojo_rankings.csv,1991,1.0,0.0
4094,Convoy,22765081,22765081,0,1978_boxofficemojo_rankings.csv,1978,1.0,0.0
4095,Xanadu,22762571,22762571,0,1980_boxofficemojo_rankings.csv,1980,1.0,0.0
4096,Extraordinary Mission,22757764,54174,22703590,2017_boxofficemojo_rankings.csv,2017,0.0023804623336457836,0.9976195376663543
4097,The Juror,22754725,22754725,0,1996_boxofficemojo_rankings.csv,1996,1.0,0.0
4098,Rudy,22750363,22750363,0,1993_boxofficemojo_rankings.csv,1993,1.0,0.0
4099,American Gigolo,22743674,22743674,0,1980_boxofficemojo_rankings.csv,1980,1.0,0.0
4100,Black and Blue,22741061,22055313,685748,2019_boxofficemojo_rankings.csv,2019,0.9698453823240701,0.030154617675929897
4101,U2 3D,22730842,10363341,12367501,2008_boxofficemojo_rankings.csv,2008,0.4559154033977272,0.5440845966022728
4102,The Accidental Husband,22707064,0,22707064,2008_boxofficemojo_rankings.csv,2008,0.0,1.0
4103,Fading Gigolo,22706304,3769873,18936431,2014_boxofficemojo_rankings.csv,2014,0.1660275930420028,0.8339724069579972
4104,Prelude to a Kiss,22697691,20006730,2690961,1992_boxofficemojo_rankings.csv,1992,0.8814434032078418,0.11855659679215828
4105,Cassandra's Dream,22686378,973018,21713360,2007_boxofficemojo_rankings.csv,2007,0.04288996683384188,0.9571100331661582
4106,Live by Night,22678555,10378555,12300000,2016_boxofficemojo_rankings.csv,2016,0.45763740238300016,0.5423625976169999
4107,The Farewell,22671661,17695781,4975880,2019_boxofficemojo_rankings.csv,2019,0.7805242412543131,0.21947575874568695
4108,Thunderheart,22660758,22660758,0,1992_boxofficemojo_rankings.csv,1992,1.0,0.0
4109,The Borrowers,22619589,22619589,0,1998_boxofficemojo_rankings.csv,1998,1.0,0.0
4110,Bulletproof,22611954,21576954,1035000,1996_boxofficemojo_rankings.csv,1996,0.9542277505075413,0.04577224949245872
4111,EuroTrip,22605153,17771387,4833766,2004_boxofficemojo_rankings.csv,2004,0.7861653048753973,0.2138346951246028
4112,Drive Me Crazy,22593409,17845337,4748072,1999_boxofficemojo_rankings.csv,1999,0.7898470301670721,0.21015296983292783
4113,My Tutor,22587834,22587834,0,1983_boxofficemojo_rankings.csv,1983,1.0,0.0
4114,Much Ado About Nothing,22549338,22549338,0,1993_boxofficemojo_rankings.csv,1993,1.0,0.0
4115,The Chamber,22540359,14551359,7989000,1996_boxofficemojo_rankings.csv,1996,0.6455690878747761,0.35443091212522393
4116,Captain Ron,22518097,22518097,0,1992_boxofficemojo_rankings.csv,1992,1.0,0.0
4117,Looking for Mr. Goodbar,22512655,22512655,0,1977_boxofficemojo_rankings.csv,1977,1.0,0.0
4118,Quest for Camelot,22510798,22510798,0,1998_boxofficemojo_rankings.csv,1998,1.0,0.0
4119,The Warriors,22490039,22490039,0,1979_boxofficemojo_rankings.csv,1979,1.0,0.0
4120,My Bodyguard,22482952,22482952,0,1980_boxofficemojo_rankings.csv,1980,1.0,0.0
4121,Doomsday,22472631,11008770,11463861,2008_boxofficemojo_rankings.csv,2008,0.48987455006937103,0.5101254499306289
4122,Julieta,22468044,1490948,20977096,2016_boxofficemojo_rankings.csv,2016,0.06635860246668557,0.9336413975333144
4123,Red Corner,22459274,22459274,0,1997_boxofficemojo_rankings.csv,1997,1.0,0.0
4124,Swimming Pool,22441497,10130108,12311389,2003_boxofficemojo_rankings.csv,2003,0.45140072429214506,0.5485992757078549
4125,License to Drive,22433275,22433275,0,1988_boxofficemojo_rankings.csv,1988,1.0,0.0
4126,The First Power,22424195,22424195,0,1990_boxofficemojo_rankings.csv,1990,1.0,0.0
4127,Two Can Play That Game,22391450,22235901,155549,2001_boxofficemojo_rankings.csv,2001,0.9930531966442548,0.006946803355745161
4128,Late Night,22386555,15499454,6887101,2019_boxofficemojo_rankings.csv,2019,0.6923554785450463,0.30764452145495363
4129,2 States,22386518,2238174,20148344,2014_boxofficemojo_rankings.csv,2014,0.09997865679691678,0.9000213432030832
4130,Dead Silence,22382047,16809076,5572971,2007_boxofficemojo_rankings.csv,2007,0.7510070906383138,0.24899290936168617
4131,Mojin: The Worm Valley,22381583,101516,22280067,2018_boxofficemojo_rankings.csv,2018,0.004535693476194244,0.9954643065238058
4132,At First Sight,22365133,22365133,0,1999_boxofficemojo_rankings.csv,1999,1.0,0.0
4133,The Contender,22361811,17872723,4489088,2000_boxofficemojo_rankings.csv,2000,0.7992520373238107,0.20074796267618933
4134,Solace,22354572,0,22354572,2015_boxofficemojo_rankings.csv,2015,0.0,1.0
4135,Muppets from Space,22323612,16625807,5697805,1999_boxofficemojo_rankings.csv,1999,0.7447633026411675,0.2552366973588324
4136,My Fellow Americans,22313201,22313201,0,1996_boxofficemojo_rankings.csv,1996,1.0,0.0
4137,I've Loved You So Long,22272176,3169305,19102871,2008_boxofficemojo_rankings.csv,2008,0.1422988485723173,0.8577011514276827
4138,Twenty,22271862,136125,22135737,2015_boxofficemojo_rankings.csv,2015,0.006111972137758397,0.9938880278622416
4139,Dark Waters,22270399,11136084,11134315,2019_boxofficemojo_rankings.csv,2019,0.5000397163966394,0.4999602836033607
4140,Fei chang xing yun,22259179,64432,22194747,2013_boxofficemojo_rankings.csv,2013,0.0028946260776284696,0.9971053739223715
4141,Benji the Hunted,22257624,22257624,0,1987_boxofficemojo_rankings.csv,1987,1.0,0.0
4142,NASCAR: The IMAX Experience,22248831,21583831,665000,2004_boxofficemojo_rankings.csv,2004,0.970110789191576,0.029889210808424046
4143,Pink Floyd: The Wall,22244207,22244207,0,1982_boxofficemojo_rankings.csv,1982,1.0,0.0
4144,Reign Over Me,22242388,19661987,2580401,2007_boxofficemojo_rankings.csv,2007,0.8839872319464979,0.11601276805350216
4145,Waitress,22240529,19074800,3165729,2007_boxofficemojo_rankings.csv,2007,0.8576594558519719,0.14234054414802813
4146,Empire of the Sun,22238696,22238696,0,1987_boxofficemojo_rankings.csv,1987,1.0,0.0
4147,Emma,22231658,22231658,0,1996_boxofficemojo_rankings.csv,1996,1.0,0.0
4148,Norma Rae,22228000,22228000,0,1979_boxofficemojo_rankings.csv,1979,1.0,0.0
4149,Fifty Shades of Black,22227514,11686940,10540574,2015_boxofficemojo_rankings.csv,2015,0.5257870943192298,0.47421290568077024
4150,Nowhere to Run,22189039,22189039,0,1993_boxofficemojo_rankings.csv,1993,1.0,0.0
4151,Upside Down,22187813,105095,22082718,2012_boxofficemojo_rankings.csv,2012,0.004736609236791386,0.9952633907632086
4152,Mr. Turner,22179785,3958500,18221285,2014_boxofficemojo_rankings.csv,2014,0.17847332604892246,0.8215266739510775
4153,Fanaa,22175908,2105352,20070556,2006_boxofficemojo_rankings.csv,2006,0.09493870555379288,0.9050612944462071
4154,A Nightmare on Elm Street 5: The Dream Child,22168359,22168359,0,1989_boxofficemojo_rankings.csv,1989,1.0,0.0
4155,The Marine,22165608,18844784,3320824,2006_boxofficemojo_rankings.csv,2006,0.8501812357233783,0.1498187642766217
4156,Ghosts of the Abyss,22141539,17040871,5100668,2003_boxofficemojo_rankings.csv,2003,0.7696335381203628,0.2303664618796372
4157,Sabotage,22126842,10508518,11618324,2014_boxofficemojo_rankings.csv,2014,0.4749217262906293,0.5250782737093708
4158,Lock Up,22099847,22099847,0,1989_boxofficemojo_rankings.csv,1989,1.0,0.0
4159,The Glass Castle,22088533,17273059,4815474,2017_boxofficemojo_rankings.csv,2017,0.7819921313923383,0.21800786860766172
4160,Gretel & Hansel,22051055,15347654,6703401,2020_boxofficemojo_rankings.csv,2020,0.6960054292186927,0.3039945707813073
4161,A Thousand Words,22044277,18450127,3594150,2010_boxofficemojo_rankings.csv,2010,0.8369576829396582,0.16304231706034178
4162,Little Black Book,22035509,20698668,1336841,2004_boxofficemojo_rankings.csv,2004,0.9393324202313639,0.06066757976863616
4163,Big Brother,22029250,85624,21943626,2018_boxofficemojo_rankings.csv,2018,0.0038868322798097984,0.9961131677201902
4164,Cousins,22026369,22026369,0,1989_boxofficemojo_rankings.csv,1989,1.0,0.0
4165,Reno 911! Miami,22021262,20342161,1679101,2007_boxofficemojo_rankings.csv,2007,0.9237509185440871,0.07624908145591293
4166,My Blueberry Nights,22007671,867275,21140396,2007_boxofficemojo_rankings.csv,2007,0.039407850108264524,0.9605921498917355
4167,Love Don't Cost a Thing,21964072,21924226,39846,2003_boxofficemojo_rankings.csv,2003,0.9981858555189584,0.0018141444810415846
4168,Unaccompanied Minors,21949234,16655224,5294010,2006_boxofficemojo_rankings.csv,2006,0.7588066171238596,0.24119338287614045
4169,Bullet to the Head,21947209,9489829,12457380,2013_boxofficemojo_rankings.csv,2013,0.4323934309824999,0.5676065690175002
4170,Friday the 13th: A New Beginning,21930418,21930418,0,1985_boxofficemojo_rankings.csv,1985,1.0,0.0
4171,Leap! 2017 Re-release,21929861,21858070,71791,2017_boxofficemojo_rankings.csv,2017,0.9967263358395204,0.003273664160479631
4172,OSS 117: Lost in Rio,21924245,89375,21834870,2009_boxofficemojo_rankings.csv,2009,0.004076537185202957,0.995923462814797
4173,Like Stars on Earth,21897373,1223869,20673504,2007_boxofficemojo_rankings.csv,2007,0.05589113360767065,0.9441088663923294
4174,Flicka,21893591,21000147,893444,2006_boxofficemojo_rankings.csv,2006,0.9591915277854601,0.04080847221453986
4175,First Strike,21890845,15318863,6571982,1997_boxofficemojo_rankings.csv,1997,0.6997839964606208,0.3002160035393791
4176,Il Postino,21848932,21848932,0,1995_boxofficemojo_rankings.csv,1995,1.0,0.0
4177,Mr 3000,21839377,21811187,28190,2004_boxofficemojo_rankings.csv,2004,0.9987092122637015,0.0012907877362985218
4178,Black or White,21833967,21571189,262778,2015_boxofficemojo_rankings.csv,2015,0.9879647157110754,0.012035284288924683
4179,Master Z: The Ip Man Legacy,21832649,209454,21623195,2018_boxofficemojo_rankings.csv,2018,0.009593613674639298,0.9904063863253607
4180,A Soldier's Story,21821347,21821347,0,1984_boxofficemojo_rankings.csv,1984,1.0,0.0
4181,The Barbarian Invasions 2003 Re-release,21815430,3435749,18379681,2003_boxofficemojo_rankings.csv,2003,0.1574916928064219,0.8425083071935782
4182,Welcome Back,21775694,1388365,20387329,2015_boxofficemojo_rankings.csv,2015,0.0637575546386719,0.9362424453613281
4183,Diana,21766271,335359,21430912,2013_boxofficemojo_rankings.csv,2013,0.015407278536594533,0.9845927214634055
4184,Ricochet,21756163,21756163,0,1991_boxofficemojo_rankings.csv,1991,1.0,0.0
4185,Legends of Oz: Dorothy's Return,21755418,8462347,13293071,2014_boxofficemojo_rankings.csv,2014,0.38897652989246173,0.6110234701075383
4186,Proud Mary,21753365,20877013,876352,2018_boxofficemojo_rankings.csv,2018,0.9597141867476595,0.0402858132523405
4187,Friday the 13th Part 2,21722776,21722776,0,1981_boxofficemojo_rankings.csv,1981,1.0,0.0
4188,The Player,21706101,21706101,0,1992_boxofficemojo_rankings.csv,1992,1.0,0.0
4189,22 Bullets,21695883,0,21695883,2010_boxofficemojo_rankings.csv,2010,0.0,1.0
4190,Against All Odds,21689062,21689062,0,1984_boxofficemojo_rankings.csv,1984,1.0,0.0
4191,White Oleander,21672284,16357770,5314514,2002_boxofficemojo_rankings.csv,2002,0.7547783150128523,0.24522168498714764
4192,Buck Rogers in the 25th Century,21671241,21671241,0,1979_boxofficemojo_rankings.csv,1979,1.0,0.0
4193,Class,21667789,21667789,0,1983_boxofficemojo_rankings.csv,1983,1.0,0.0
4194,Como agua para chocolate,21665468,21665468,0,1993_boxofficemojo_rankings.csv,1993,1.0,0.0
4195,The Rookie,21633874,21633874,0,1990_boxofficemojo_rankings.csv,1990,1.0,0.0
4196,Short Circuit 2,21630088,21630088,0,1988_boxofficemojo_rankings.csv,1988,1.0,0.0
4197,Consenting Adults,21591728,21591728,0,1992_boxofficemojo_rankings.csv,1992,1.0,0.0
4198,Project X,21589395,18532286,3057109,1987_boxofficemojo_rankings.csv,1987,0.858397653107,0.14160234689300003
4199,Just Wright,21584424,21540363,44061,2010_boxofficemojo_rankings.csv,2010,0.9979586668608807,0.0020413331391192094
4200,Man of the House,21577624,19699706,1877918,2005_boxofficemojo_rankings.csv,2005,0.91296919438396,0.08703080561604003
4201,Wicker Park,21568818,13001257,8567561,2004_boxofficemojo_rankings.csv,2004,0.6027802265288714,0.3972197734711286
4202,He Got Game,21567853,21567853,0,1998_boxofficemojo_rankings.csv,1998,1.0,0.0
4203,"Oh, God! You Devil",21538850,21538850,0,1984_boxofficemojo_rankings.csv,1984,1.0,0.0
4204,It Follows,21528593,14674076,6854517,2015_boxofficemojo_rankings.csv,2015,0.6816086866429218,0.3183913133570782
4205,Say Anything...,21515196,20781385,733811,1989_boxofficemojo_rankings.csv,1989,0.9658933620683725,0.034106637931627486
4206,Win a Date with Tad Hamilton!,21513434,17071962,4441472,2004_boxofficemojo_rankings.csv,2004,0.7935489053026124,0.20645109469738768
4207,Black Christmas,21510851,16273581,5237270,2006_boxofficemojo_rankings.csv,2006,0.7565289257965666,0.24347107420343342
4208,National Lampoon's Animal House 1979 Re-release,21508877,21508877,0,1979_boxofficemojo_rankings.csv,1979,1.0,0.0
4209,Chak De! India,21505244,1120404,20384840,2007_boxofficemojo_rankings.csv,2007,0.052099106617902124,0.9479008933820978
4210,The Star 2019 Re-release,21502695,43510,21459185,2019_boxofficemojo_rankings.csv,2019,0.002023467290960505,0.9979765327090395
4211,My Soul to Take,21500813,14744435,6756378,2010_boxofficemojo_rankings.csv,2010,0.6857617430559486,0.3142382569440514
4212,Winged Migration,21493351,924651,20568700,2001_boxofficemojo_rankings.csv,2001,0.04302032754222457,0.9569796724577754
4213,Married to the Mob,21486757,21486757,0,1988_boxofficemojo_rankings.csv,1988,1.0,0.0
4214,The Freshman,21460601,21460601,0,1990_boxofficemojo_rankings.csv,1990,1.0,0.0
4215,Tough Guys,21458229,21458229,0,1986_boxofficemojo_rankings.csv,1986,1.0,0.0
4216,Over Her Dead Body,21458111,7563670,13894441,2008_boxofficemojo_rankings.csv,2008,0.35248536089686555,0.6475146391031344
4217,A Very Brady Sequel,21440752,21440752,0,1996_boxofficemojo_rankings.csv,1996,1.0,0.0
4218,Raiders of the Lost Ark 1982 Re-release,21437879,21437879,0,1982_boxofficemojo_rankings.csv,1982,1.0,0.0
4219,Mr. Magoo,21437192,21437192,0,1997_boxofficemojo_rankings.csv,1997,1.0,0.0
4220,Rhinestone,21435321,21435321,0,1984_boxofficemojo_rankings.csv,1984,1.0,0.0
4221,The Merchant of Venice,21417725,3765585,17652140,2004_boxofficemojo_rankings.csv,2004,0.17581629234664278,0.8241837076533572
4222,The Adventures of Ford Fairlane,21413502,21413502,0,1990_boxofficemojo_rankings.csv,1990,1.0,0.0
4223,Quigley Down Under,21413105,21413105,0,1990_boxofficemojo_rankings.csv,1990,1.0,0.0
4224,Our Family Wedding,21409028,20255281,1153747,2010_boxofficemojo_rankings.csv,2010,0.9461093235993713,0.053890676400628744
4225,Love & Friendship,21401949,14016568,7385381,2016_boxofficemojo_rankings.csv,2016,0.6549201663829776,0.34507983361702244
4226,The Fog,21378361,21378361,0,1980_boxofficemojo_rankings.csv,1980,1.0,0.0
4227,Shaft,21360215,21360215,0,2019_boxofficemojo_rankings.csv,2019,1.0,0.0
4228,Intersection,21355893,21355893,0,1994_boxofficemojo_rankings.csv,1994,1.0,0.0
4229,Waist Deep,21353303,21344312,8991,2006_boxofficemojo_rankings.csv,2006,0.9995789410191014,0.000421058980898646
4230,Bears,21316745,17780194,3536551,2014_boxofficemojo_rankings.csv,2014,0.8340951679067324,0.16590483209326753
4231,Hotel Mumbai,21314816,9651611,11663205,2019_boxofficemojo_rankings.csv,2019,0.4528123067072219,0.5471876932927782
4232,High School High,21302121,21302121,0,1996_boxofficemojo_rankings.csv,1996,1.0,0.0
4233,Love Live! The School Idol Movie,21292009,115840,21176169,2015_boxofficemojo_rankings.csv,2015,0.005440538748598124,0.9945594612514018
4234,New York Minute,21289826,14071441,7218385,2004_boxofficemojo_rankings.csv,2004,0.6609467357788645,0.33905326422113546
4235,The Black Cauldron,21288692,21288692,0,1985_boxofficemojo_rankings.csv,1985,1.0,0.0
4236,To Die For,21284514,21284514,0,1995_boxofficemojo_rankings.csv,1995,1.0,0.0
4237,Coneheads,21274717,21274717,0,1993_boxofficemojo_rankings.csv,1993,1.0,0.0
4238,Michael Jordan to the Max,21268532,18650521,2618011,2000_boxofficemojo_rankings.csv,2000,0.8769068311813905,0.12309316881860957
4239,I'm So Excited!,21245677,1368119,19877558,2013_boxofficemojo_rankings.csv,2013,0.06439517083875464,0.9356048291612453
4240,The Rescuers 1989 Re-release,21215869,21215869,0,1989_boxofficemojo_rankings.csv,1989,1.0,0.0
4241,The Prison,21205329,207481,20997848,2017_boxofficemojo_rankings.csv,2017,0.009784380143312088,0.9902156198566879
4242,Fame,21202829,21202829,0,1980_boxofficemojo_rankings.csv,1980,1.0,0.0
4243,Straight Talk,21202099,21202099,0,1992_boxofficemojo_rankings.csv,1992,1.0,0.0
4244,The Right Stuff,21192102,21192102,0,1983_boxofficemojo_rankings.csv,1983,1.0,0.0
4245,Unplanned,21171090,19005109,2165981,2019_boxofficemojo_rankings.csv,2019,0.8976915690217179,0.10230843097828218
4246,ATL,21170563,21170563,0,2006_boxofficemojo_rankings.csv,2006,1.0,0.0
4247,Penelope,21156270,10011996,11144274,2007_boxofficemojo_rankings.csv,2007,0.47324013164891543,0.5267598683510846
4248,Cujo,21156152,21156152,0,1983_boxofficemojo_rankings.csv,1983,1.0,0.0
4249,The Prodigy,21150265,14856291,6293974,2018_boxofficemojo_rankings.csv,2018,0.7024163054221779,0.2975836945778221
4250,Mindhunters,21148829,4480744,16668085,2004_boxofficemojo_rankings.csv,2004,0.2118672386069224,0.7881327613930776
4251,Stir of Echoes,21142914,21142914,0,1999_boxofficemojo_rankings.csv,1999,1.0,0.0
4252,Kuffs,21142815,21142815,0,1992_boxofficemojo_rankings.csv,1992,1.0,0.0
4253,Things Are Tough All Over,21134374,21134374,0,1982_boxofficemojo_rankings.csv,1982,1.0,0.0
4254,The Jacket,21126225,6303762,14822463,2005_boxofficemojo_rankings.csv,2005,0.2983856320757731,0.7016143679242269
4255,Beasts of the Southern Wild,21107746,12795746,8312000,2012_boxofficemojo_rankings.csv,2012,0.6062109142302546,0.39378908576974536
4256,Night Shift,21095638,21095638,0,1982_boxofficemojo_rankings.csv,1982,1.0,0.0
4257,Tales from the Crypt: Demon Knight,21089146,21089146,0,1995_boxofficemojo_rankings.csv,1995,1.0,0.0
4258,F/X2,21082165,21082165,0,1991_boxofficemojo_rankings.csv,1991,1.0,0.0
4259,Multiplicity,21075014,21075014,0,1996_boxofficemojo_rankings.csv,1996,1.0,0.0
4260,Weekend Pass,21058033,21058033,0,1984_boxofficemojo_rankings.csv,1984,1.0,0.0
4261,The Wiz,21049053,21049053,0,1978_boxofficemojo_rankings.csv,1978,1.0,0.0
4262,Punchline,21042667,21042667,0,1988_boxofficemojo_rankings.csv,1988,1.0,0.0
4263,Gonjiam: Haunted Asylum,21041950,115252,20926698,2018_boxofficemojo_rankings.csv,2018,0.005477249019221127,0.9945227509807789
4264,A Room with a View,21040317,20966644,73673,1986_boxofficemojo_rankings.csv,1986,0.9964984843146613,0.003501515685338771
4265,Madhouse,21036771,21036771,0,1990_boxofficemojo_rankings.csv,1990,1.0,0.0
4266,Creepshow,21028755,21028755,0,1982_boxofficemojo_rankings.csv,1982,1.0,0.0
4267,Yves Saint Laurent,21026290,723593,20302697,2014_boxofficemojo_rankings.csv,2014,0.034413726815334514,0.9655862731846655
4268,My Hero Academia: Two Heroes,21022724,5754556,15268168,2018_boxofficemojo_rankings.csv,2018,0.27373027396449673,0.7262697260355033
4269,Christine,21017849,21017849,0,1983_boxofficemojo_rankings.csv,1983,1.0,0.0
4270,The Air Up There,21011318,21011318,0,1994_boxofficemojo_rankings.csv,1994,1.0,0.0
4271,The Infiltrator,21011110,15436808,5574302,2016_boxofficemojo_rankings.csv,2016,0.7346974053250875,0.26530259467491246
4272,Iron Will,21006361,21006361,0,1994_boxofficemojo_rankings.csv,1994,1.0,0.0
4273,The Rescuers 1983 Re-release,21000000,21000000,0,1983_boxofficemojo_rankings.csv,1983,1.0,0.0
4274,Before Midnight,20994648,8114627,12880021,2013_boxofficemojo_rankings.csv,2013,0.38650931418330997,0.6134906858166901
4275,71: Into the Fire,20967660,176638,20791022,2010_boxofficemojo_rankings.csv,2010,0.008424306765752593,0.9915756932342474
4276,Quest for Fire,20959585,20959585,0,1982_boxofficemojo_rankings.csv,1982,1.0,0.0
4277,Once,20936722,9439923,11496799,2007_boxofficemojo_rankings.csv,2007,0.45087874787657783,0.5491212521234222
4278,The Apple Dumpling Gang Rides Again,20931111,20931111,0,1979_boxofficemojo_rankings.csv,1979,1.0,0.0
4279,El nino,20918976,1237,20917739,2014_boxofficemojo_rankings.csv,2014,5.9132913580473535e-05,0.9999408670864195
4280,Super Mario Bros.,20915465,20915465,0,1993_boxofficemojo_rankings.csv,1993,1.0,0.0
4281,Amores Perros,20908467,5408467,15500000,2001_boxofficemojo_rankings.csv,2001,0.2586735316367288,0.7413264683632712
4282,The Devil's Rejects,20901859,17044981,3856878,2005_boxofficemojo_rankings.csv,2005,0.8154767956285611,0.18452320437143893
4283,Mr. Baseball,20883046,20883046,0,1992_boxofficemojo_rankings.csv,1992,1.0,0.0
4284,Oliver & Company 1996 Re-release,20872291,20872291,0,1996_boxofficemojo_rankings.csv,1996,1.0,0.0
4285,Pokémon Heroes,20867919,746381,20121538,2002_boxofficemojo_rankings.csv,2002,0.035766910921975495,0.9642330890780245
4286,Jason's Lyric,20851521,20851521,0,1994_boxofficemojo_rankings.csv,1994,1.0,0.0
4287,Fear,20831000,20831000,0,1996_boxofficemojo_rankings.csv,1996,1.0,0.0
4288,Love Nowadays,20794985,2430083,18364902,2009_boxofficemojo_rankings.csv,2009,0.11685908886205015,0.8831409111379499
4289,Best in Show,20789556,18715392,2074164,2000_boxofficemojo_rankings.csv,2000,0.900230481112728,0.09976951888727205
4290,SuperFly,20780685,20545116,235569,2018_boxofficemojo_rankings.csv,2018,0.9886640406704591,0.01133595932954087
4291,I Love You Phillip Morris,20768906,2037459,18731447,2009_boxofficemojo_rankings.csv,2009,0.09810141179318738,0.9018985882068127
4292,The Dead Zone,20766616,20766616,0,1983_boxofficemojo_rankings.csv,1983,1.0,0.0
4293,Julia,20714400,20714400,0,1977_boxofficemojo_rankings.csv,1977,1.0,0.0
4294,Hamlet,20710451,20710451,0,1990_boxofficemojo_rankings.csv,1990,1.0,0.0
4295,Bobby,20704591,11242801,9461790,2006_boxofficemojo_rankings.csv,2006,0.5430100502830507,0.45698994971694923
4296,The Photograph,20690779,20578185,112594,2020_boxofficemojo_rankings.csv,2020,0.9945582522533347,0.005441747746665314
4297,The Legend of 1900,20678716,167435,20511281,1999_boxofficemojo_rankings.csv,1999,0.008096972752079965,0.99190302724792
4298,Speechless,20667959,20667959,0,1994_boxofficemojo_rankings.csv,1994,1.0,0.0
4299,The Man from Snowy River,20659423,20659423,0,1982_boxofficemojo_rankings.csv,1982,1.0,0.0
4300,Keanu,20651333,20591853,59480,2016_boxofficemojo_rankings.csv,2016,0.9971197985137328,0.0028802014862672545
4301,Pandorum,20648328,10330853,10317475,2009_boxofficemojo_rankings.csv,2009,0.5003239487478115,0.49967605125218856
4302,Super Size Me,20645757,11536423,9109334,2004_boxofficemojo_rankings.csv,2004,0.5587793656585225,0.4412206343414775
4303,The Front Line,20629645,11018,20618627,2011_boxofficemojo_rankings.csv,2011,0.0005340857780150847,0.9994659142219849
4304,F/X,20603715,20603715,0,1986_boxofficemojo_rankings.csv,1986,1.0,0.0
4305,If Beale Street Could Talk,20596567,14915773,5680794,2018_boxofficemojo_rankings.csv,2018,0.7241873366566379,0.275812663343362
4306,The Best Offer,20596350,100035,20496315,2013_boxofficemojo_rankings.csv,2013,0.004856928533453743,0.9951430714665462
4307,Polisse,20590872,211440,20379432,2011_boxofficemojo_rankings.csv,2011,0.010268627768653994,0.989731372231346
4308,Walk Hard: The Dewey Cox Story,20576198,18317151,2259047,2007_boxofficemojo_rankings.csv,2007,0.8902106696290539,0.10978933037094608
4309,Child's Play 3,20560255,14960255,5600000,1991_boxofficemojo_rankings.csv,1991,0.727629837275851,0.2723701627241491
4310,The Man with the Iron Fists,20546518,15634090,4912428,2012_boxofficemojo_rankings.csv,2012,0.7609118975779741,0.23908810242202597
4311,Race 2,20531909,1579940,18951969,2013_boxofficemojo_rankings.csv,2013,0.07695046768422752,0.9230495323157725
4312,Country Strong,20529194,20218921,310273,2010_boxofficemojo_rankings.csv,2010,0.9848862551544888,0.015113744845511227
4313,Porky's Revenge,20518905,20518905,0,1985_boxofficemojo_rankings.csv,1985,1.0,0.0
4314,Cock and Bull,20490872,82778,20408094,2016_boxofficemojo_rankings.csv,2016,0.004039749992094041,0.995960250007906
4315,The Final Conflict,20471382,20471382,0,1981_boxofficemojo_rankings.csv,1981,1.0,0.0
4316,Top Secret!,20458340,20458340,0,1984_boxofficemojo_rankings.csv,1984,1.0,0.0
4317,My Life in Ruins,20455482,8665206,11790276,2009_boxofficemojo_rankings.csv,2009,0.4236128975107993,0.5763871024892007
4318,La Cage aux Folles,20424259,20424259,0,1979_boxofficemojo_rankings.csv,1979,1.0,0.0
4319,The Sapphires,20423628,2450867,17972761,2012_boxofficemojo_rankings.csv,2012,0.12000154918607017,0.8799984508139298
4320,Hello Again,20419446,20419446,0,1987_boxofficemojo_rankings.csv,1987,1.0,0.0
4321,That Demon Within,20415934,172343,20243591,2014_boxofficemojo_rankings.csv,2014,0.00844159272850314,0.9915584072714969
4322,F.I.S.T.,20388920,20388920,0,1978_boxofficemojo_rankings.csv,1978,1.0,0.0
4323,Beerfest,20387597,19185184,1202413,2006_boxofficemojo_rankings.csv,2006,0.9410223284284067,0.05897767157159326
4324,The Clan,20381995,201227,20180768,2015_boxofficemojo_rankings.csv,2015,0.009872782325773311,0.9901272176742267
4325,Sgt. Pepper's Lonely Hearts Club Band,20378470,20378470,0,1978_boxofficemojo_rankings.csv,1978,1.0,0.0
4326,Ladies in Lavender,20377075,6765081,13611994,2004_boxofficemojo_rankings.csv,2004,0.3319947048337409,0.6680052951662592
4327,The Namesake,20354321,13569248,6785073,2007_boxofficemojo_rankings.csv,2007,0.6666519605345715,0.3333480394654285
4328,The Glimmer Man,20351264,20351264,0,1996_boxofficemojo_rankings.csv,1996,1.0,0.0
4329,Showgirls,20350754,20350754,0,1995_boxofficemojo_rankings.csv,1995,1.0,0.0
4330,Burn the Stage: The Movie,20347513,4201819,16145694,2018_boxofficemojo_rankings.csv,2018,0.20650282911724888,0.7934971708827512
4331,Code of Silence,20345361,20345361,0,1985_boxofficemojo_rankings.csv,1985,1.0,0.0
4332,City Hall,20340204,20340204,0,1996_boxofficemojo_rankings.csv,1996,1.0,0.0
4333,The Presidio,20324096,20324096,0,1988_boxofficemojo_rankings.csv,1988,1.0,0.0
4334,Brahms: The Boy II,20311536,12611536,7700000,2020_boxofficemojo_rankings.csv,2020,0.6209050856616654,0.37909491433833464
4335,Vampires,20308772,20308772,0,1998_boxofficemojo_rankings.csv,1998,1.0,0.0
4336,Hot Dog... The Movie,20307325,20307325,0,1984_boxofficemojo_rankings.csv,1984,1.0,0.0
4337,Jetsons: The Movie,20305841,20305841,0,1990_boxofficemojo_rankings.csv,1990,1.0,0.0
4338,The People vs. Larry Flynt,20300385,20300385,0,1996_boxofficemojo_rankings.csv,1996,1.0,0.0
4339,Cold War 2018 Re-release,20296042,4580048,15715994,2018_boxofficemojo_rankings.csv,2018,0.22566212663533117,0.7743378733646689
4340,The Cowboy Way,20280016,20280016,0,1994_boxofficemojo_rankings.csv,1994,1.0,0.0
4341,Labor Day,20275812,13371528,6904284,2014_boxofficemojo_rankings.csv,2014,0.6594817509651402,0.3405182490348599
4342,The Incredible Shrinking Woman,20259961,20259961,0,1981_boxofficemojo_rankings.csv,1981,1.0,0.0
4343,Action Jackson,20256975,20256975,0,1988_boxofficemojo_rankings.csv,1988,1.0,0.0
4344,Mobsters,20246790,20246790,0,1991_boxofficemojo_rankings.csv,1991,1.0,0.0
4345,Critical Condition,20240502,20240502,0,1987_boxofficemojo_rankings.csv,1987,1.0,0.0
4346,Stella,20240128,20240128,0,1990_boxofficemojo_rankings.csv,1990,1.0,0.0
4347,Ong-Bak: The Thai Warrior,20235426,4563167,15672259,2003_boxofficemojo_rankings.csv,2003,0.22550387622182996,0.77449612377817
4348,Six Pack,20225989,20225989,0,1982_boxofficemojo_rankings.csv,1982,1.0,0.0
4349,Singh Is Bliing,20224851,919095,19305756,2015_boxofficemojo_rankings.csv,2015,0.045443845297055585,0.9545561547029444
4350,Another Stakeout,20208496,20208496,0,1993_boxofficemojo_rankings.csv,1993,1.0,0.0
4351,"Corrina, Corrina",20164171,20164171,0,1994_boxofficemojo_rankings.csv,1994,1.0,0.0
4352,Dracula,20158970,20158970,0,1979_boxofficemojo_rankings.csv,1979,1.0,0.0
4353,The NeverEnding Story,20158808,20158808,0,1984_boxofficemojo_rankings.csv,1984,1.0,0.0
4354,When a Stranger Calls,20149106,20149106,0,1979_boxofficemojo_rankings.csv,1979,1.0,0.0
4355,Juice,20146880,20146880,0,1992_boxofficemojo_rankings.csv,1992,1.0,0.0
4356,Serving Sara,20146150,16930185,3215965,2002_boxofficemojo_rankings.csv,2002,0.8403682589477394,0.1596317410522606
4357,Melinda and Melinda,20129327,3826280,16303047,2004_boxofficemojo_rankings.csv,2004,0.19008484486341745,0.8099151551365825
4358,My Favorite Year,20123620,20123620,0,1982_boxofficemojo_rankings.csv,1982,1.0,0.0
4359,Mulholland Drive,20117339,7220243,12897096,2001_boxofficemojo_rankings.csv,2001,0.35890646372266233,0.6410935362773377
4360,Don't Be a Menace to South Central While Drinking Your Juice in the Hood,20109115,20109115,0,1996_boxofficemojo_rankings.csv,1996,1.0,0.0
4361,Tess,20093330,20093330,0,1980_boxofficemojo_rankings.csv,1980,1.0,0.0
4362,Flipper,20080020,20080020,0,1996_boxofficemojo_rankings.csv,1996,1.0,0.0
4363,I Heart Huckabees,20072172,12785432,7286740,2004_boxofficemojo_rankings.csv,2004,0.6369730191630483,0.3630269808369518
4364,Only You,20059210,20059210,0,1994_boxofficemojo_rankings.csv,1994,1.0,0.0
4365,Booty Call,20050376,20050376,0,1997_boxofficemojo_rankings.csv,1997,1.0,0.0
4366,An Innocent Man,20047604,20047604,0,1989_boxofficemojo_rankings.csv,1989,1.0,0.0
4367,The Bling Ring,20045576,5845732,14199844,2013_boxofficemojo_rankings.csv,2013,0.29162205166865746,0.7083779483313425
4368,Evening,20016753,12492481,7524272,2007_boxofficemojo_rankings.csv,2007,0.6241012715698695,0.3758987284301305
4369,With Honors,20016254,20016254,0,1994_boxofficemojo_rankings.csv,1994,1.0,0.0
4370,Asterix & Obelix: Mission Cleopatra 2002 Re-release,20015611,3115188,16900423,2002_boxofficemojo_rankings.csv,2002,0.155637916824023,0.8443620831759769
4371,The Company You Keep,20014680,5133027,14881653,2012_boxofficemojo_rankings.csv,2012,0.25646310608013717,0.7435368939198628
4372,Taking Care of Business,20005435,20005435,0,1990_boxofficemojo_rankings.csv,1990,1.0,0.0
4373,Eyes of Laura Mars,20000000,20000000,0,1978_boxofficemojo_rankings.csv,1978,1.0,0.0
4374,The Wife,19978189,9601092,10377097,2018_boxofficemojo_rankings.csv,2018,0.48057869509593687,0.5194213049040631
4375,Himalaya 2001 Re-release,19960881,2487878,17473003,2001_boxofficemojo_rankings.csv,2001,0.12463768508013248,0.8753623149198675
4376,Crazy/Beautiful,19937988,16937988,3000000,2001_boxofficemojo_rankings.csv,2001,0.8495334634567941,0.15046653654320585
4377,The Babe,19930973,17530973,2400000,1992_boxofficemojo_rankings.csv,1992,0.8795844036314735,0.12041559636852651
4378,Unfaithfully Yours,19928200,19928200,0,1984_boxofficemojo_rankings.csv,1984,1.0,0.0
4379,Ballistic: Ecks vs. Sever,19924033,14307963,5616070,2002_boxofficemojo_rankings.csv,2002,0.7181258432968868,0.2818741567031133
4380,Breathless,19910002,19910002,0,1983_boxofficemojo_rankings.csv,1983,1.0,0.0
4381,Nighthawks,19905359,14905359,5000000,1981_boxofficemojo_rankings.csv,1981,0.7488113628093821,0.25118863719061785
4382,Get Over It,19900366,11576464,8323902,2001_boxofficemojo_rankings.csv,2001,0.5817211603042879,0.4182788396957121
4383,Mafia!,19889299,19889299,0,1998_boxofficemojo_rankings.csv,1998,1.0,0.0
4384,Fire in the Sky,19885552,19885552,0,1993_boxofficemojo_rankings.csv,1993,1.0,0.0
4385,Volunteers,19875740,19875740,0,1985_boxofficemojo_rankings.csv,1985,1.0,0.0
4386,Hard Rain,19870567,19870567,0,1998_boxofficemojo_rankings.csv,1998,1.0,0.0
4387,The Apostle,19868354,19868354,0,1997_boxofficemojo_rankings.csv,1997,1.0,0.0
4388,They Shall Not Grow Old,19866389,17956913,1909476,2018_boxofficemojo_rankings.csv,2018,0.9038840928766673,0.09611590712333277
4389,Altered States,19853892,19853892,0,1980_boxofficemojo_rankings.csv,1980,1.0,0.0
4390,Jaane Tu... Ya Jaane Na,19852786,604037,19248749,2008_boxofficemojo_rankings.csv,2008,0.030425805224516097,0.9695741947754839
4391,Blindness,19844979,3351751,16493228,2008_boxofficemojo_rankings.csv,2008,0.1688966765850445,0.8311033234149555
4392,The Rooftop,19833152,85755,19747397,2013_boxofficemojo_rankings.csv,2013,0.0043238210446831645,0.9956761789553168
4393,Song of the South,19800000,19800000,0,1980_boxofficemojo_rankings.csv,1980,1.0,0.0
4394,Cruising,19784223,19784223,0,1980_boxofficemojo_rankings.csv,1980,1.0,0.0
4395,The Diving Bell and the Butterfly,19780116,6003227,13776889,2007_boxofficemojo_rankings.csv,2007,0.3034980684643103,0.6965019315356897
4396,2 Days in Paris,19776159,4433994,15342165,2007_boxofficemojo_rankings.csv,2007,0.22420905899876714,0.7757909410012328
4397,Summer Catch,19772447,19753553,18894,2001_boxofficemojo_rankings.csv,2001,0.9990444278343494,0.0009555721656505136
4398,The Perfect Man,19770475,16535005,3235470,2005_boxofficemojo_rankings.csv,2005,0.8363483932480125,0.1636516067519875
4399,Gone,19767535,11682205,8085330,2012_boxofficemojo_rankings.csv,2012,0.590979350738471,0.4090206492615291
4400,Vampire in Brooklyn,19751736,19751736,0,1995_boxofficemojo_rankings.csv,1995,1.0,0.0
4401,Thomas and the Magic Railroad,19748009,15933506,3814503,2000_boxofficemojo_rankings.csv,2000,0.8068411352253283,0.1931588647746717
4402,Gone Fishin',19745922,19745922,0,1997_boxofficemojo_rankings.csv,1997,1.0,0.0
4403,Betsy's Wedding,19740070,19740070,0,1990_boxofficemojo_rankings.csv,1990,1.0,0.0
4404,Young Sherlock Holmes,19739575,19739575,0,1985_boxofficemojo_rankings.csv,1985,1.0,0.0
4405,It Comes at Night,19735344,13985117,5750227,2017_boxofficemojo_rankings.csv,2017,0.7086330494163162,0.2913669505836838
4406,The Principal,19734940,19734940,0,1987_boxofficemojo_rankings.csv,1987,1.0,0.0
4407,Color of Night,19726050,19726050,0,1994_boxofficemojo_rankings.csv,1994,1.0,0.0
4408,Another Year,19722766,3205706,16517060,2010_boxofficemojo_rankings.csv,2010,0.1625383579564854,0.8374616420435146
4409,Wes Craven's New Nightmare,19721741,18090181,1631560,1994_boxofficemojo_rankings.csv,1994,0.9172709954967971,0.08272900450320284
4410,"Same Time, Next Year",19703082,19703082,0,1979_boxofficemojo_rankings.csv,1979,1.0,0.0
4411,Brothers,19694450,613775,19080675,2015_boxofficemojo_rankings.csv,2015,0.031164871321615988,0.9688351286783841
4412,Skin Deep,19674852,19674852,0,1989_boxofficemojo_rankings.csv,1989,1.0,0.0
4413,Tucker: The Man and His Dream,19652638,19652638,0,1988_boxofficemojo_rankings.csv,1988,1.0,0.0
4414,Blackhat,19652057,8005980,11646077,2015_boxofficemojo_rankings.csv,2015,0.4073863616414302,0.5926136383585698
4415,Youth in Revolt,19651093,15281286,4369807,2010_boxofficemojo_rankings.csv,2010,0.7776303333356572,0.2223696666643428
4416,Amelia,19643086,14246488,5396598,2009_boxofficemojo_rankings.csv,2009,0.7252673027038623,0.2747326972961377
4417,Don,19640129,2223961,17416168,2006_boxofficemojo_rankings.csv,2006,0.11323555970533594,0.8867644402946641
4418,The Thing,19629760,19629760,0,1982_boxofficemojo_rankings.csv,1982,1.0,0.0
4419,8 Seconds,19623396,19623396,0,1994_boxofficemojo_rankings.csv,1994,1.0,0.0
4420,Shackleton's Antarctic Adventure,19613216,15553324,4059892,2001_boxofficemojo_rankings.csv,2001,0.7930022287013002,0.2069977712986998
4421,The Astronaut's Wife,19598588,10672566,8926022,1999_boxofficemojo_rankings.csv,1999,0.5445579038653193,0.45544209613468073
4422,The Seduction of Joe Tynan,19595168,19595168,0,1979_boxofficemojo_rankings.csv,1979,1.0,0.0
4423,The Serpent and the Rainbow,19595031,19595031,0,1988_boxofficemojo_rankings.csv,1988,1.0,0.0
4424,S1m0ne,19576023,9688676,9887347,2002_boxofficemojo_rankings.csv,2002,0.49492565471546496,0.5050743452845351
4425,The Guard,19561904,5360274,14201630,2011_boxofficemojo_rankings.csv,2011,0.27401596490811936,0.7259840350918806
4426,Puella Magi Madoka Magica the Movie Part III: The Rebellion Story,19544634,375627,19169007,2013_boxofficemojo_rankings.csv,2013,0.019218932418995412,0.9807810675810046
4427,View from the Top,19526014,15614000,3912014,2003_boxofficemojo_rankings.csv,2003,0.7996511730453537,0.20034882695464626
4428,Police Academy 5: Assignment: Miami Beach,19510371,19510371,0,1988_boxofficemojo_rankings.csv,1988,1.0,0.0
4429,Hero,19507345,19507345,0,1992_boxofficemojo_rankings.csv,1992,1.0,0.0
4430,Margin Call,19504039,5354039,14150000,2011_boxofficemojo_rankings.csv,2011,0.2745092439571106,0.7254907560428894
4431,Léon: The Professional,19501238,19501238,0,1994_boxofficemojo_rankings.csv,1994,1.0,0.0
4432,In This Corner of the World,19496308,172147,19324161,2016_boxofficemojo_rankings.csv,2016,0.008829723042947414,0.9911702769570526
4433,The Lion King 2002 IMAX Release,19486215,15686215,3800000,2002_boxofficemojo_rankings.csv,2002,0.8049903483051993,0.19500965169480067
4434,It Takes Two,19474589,19474589,0,1995_boxofficemojo_rankings.csv,1995,1.0,0.0
4435,Friday the 13th Part VI: Jason Lives,19472057,19472057,0,1986_boxofficemojo_rankings.csv,1986,1.0,0.0
4436,2046,19470239,1444588,18025651,2004_boxofficemojo_rankings.csv,2004,0.0741946721866126,0.9258053278133874
4437,Blue Is the Warmest Colour,19465835,2199787,17266048,2013_boxofficemojo_rankings.csv,2013,0.11300758482746823,0.8869924151725318
4438,Vanity Fair,19463185,16136476,3326709,2004_boxofficemojo_rankings.csv,2004,0.8290768443088836,0.17092315569111632
4439,House,19444631,19444631,0,1986_boxofficemojo_rankings.csv,1986,1.0,0.0
4440,Doug's 1st Movie,19440089,19440089,0,1999_boxofficemojo_rankings.csv,1999,1.0,0.0
4441,Buried,19439764,1044143,18395621,2010_boxofficemojo_rankings.csv,2010,0.05371171172654154,0.9462882882734585
4442,House Party 2,19438638,19438638,0,1991_boxofficemojo_rankings.csv,1991,1.0,0.0
4443,Get Carter,19412993,14967182,4445811,2000_boxofficemojo_rankings.csv,2000,0.7709878636436948,0.2290121363563053
4444,Monty Python's Life of Brian,19398164,19398164,0,1979_boxofficemojo_rankings.csv,1979,1.0,0.0
4445,The Edge of Seventeen,19370020,14431633,4938387,2016_boxofficemojo_rankings.csv,2016,0.7450499792979047,0.2549500207020953
4446,Tuck Everlasting,19344615,19161999,182616,2002_boxofficemojo_rankings.csv,2002,0.9905598534786038,0.009440146521396265
4447,Rock Star,19334145,17008282,2325863,2001_boxofficemojo_rankings.csv,2001,0.8797017918299465,0.12029820817005354
4448,Duplex,19322135,9692135,9630000,2003_boxofficemojo_rankings.csv,2003,0.5016078709728505,0.4983921290271494
4449,The White Ribbon,19319671,2222862,17096809,2009_boxofficemojo_rankings.csv,2009,0.115056928246863,0.884943071753137
4450,Little Giants,19306362,19306362,0,1994_boxofficemojo_rankings.csv,1994,1.0,0.0
4451,A Christmas Story,19294144,19294144,0,1983_boxofficemojo_rankings.csv,1983,1.0,0.0
4452,Deep Blue,19288261,132261,19156000,2003_boxofficemojo_rankings.csv,2003,0.006857072288683775,0.9931429277113162
4453,Summer of Sam,19288130,19288130,0,1999_boxofficemojo_rankings.csv,1999,1.0,0.0
4454,Deathtrap,19282134,19282134,0,1982_boxofficemojo_rankings.csv,1982,1.0,0.0
4455,House Party 3,19281235,19281235,0,1994_boxofficemojo_rankings.csv,1994,1.0,0.0
4456,Best Defense,19265302,19265302,0,1984_boxofficemojo_rankings.csv,1984,1.0,0.0
4457,The Lost City of Z,19263938,8580410,10683528,2017_boxofficemojo_rankings.csv,2017,0.44541308220572556,0.5545869177942745
4458,O,19260537,16025437,3235100,2001_boxofficemojo_rankings.csv,2001,0.8320347973683184,0.16796520263168155
4459,Half Past Dead,19233280,15567860,3665420,2002_boxofficemojo_rankings.csv,2002,0.809423041727672,0.19057695827232796
4460,Species II,19221939,19221939,0,1998_boxofficemojo_rankings.csv,1998,1.0,0.0
4461,Foxcatcher,19206513,12096300,7110213,2014_boxofficemojo_rankings.csv,2014,0.6298019843581185,0.3701980156418815
4462,The Replacement Killers,19204929,19204929,0,1998_boxofficemojo_rankings.csv,1998,1.0,0.0
4463,Martin Lawrence Live: Runteldat,19184820,19184820,0,2002_boxofficemojo_rankings.csv,2002,1.0,0.0
4464,Everybody Knows,19176163,2660165,16515998,2018_boxofficemojo_rankings.csv,2018,0.13872248582784782,0.8612775141721521
4465,Friday the 13th Part VII: The New Blood,19170001,19170001,0,1988_boxofficemojo_rankings.csv,1988,1.0,0.0
4466,My Annoying Brother,19162324,51996,19110328,2016_boxofficemojo_rankings.csv,2016,0.0027134495794977685,0.9972865504205022
4467,How to Lose Friends & Alienate People,19152009,2778752,16373257,2008_boxofficemojo_rankings.csv,2008,0.14508932196094937,0.8549106780390506
4468,Mother,19145198,19145198,0,1996_boxofficemojo_rankings.csv,1996,1.0,0.0
4469,Blaze,19131246,19131246,0,1989_boxofficemojo_rankings.csv,1989,1.0,0.0
4470,Oolong Courtyard: KungFu School,19129015,37727,19091288,2018_boxofficemojo_rankings.csv,2018,0.0019722395533695804,0.9980277604466304
4471,The Weather Man,19126398,12482775,6643623,2005_boxofficemojo_rankings.csv,2005,0.6526464104741521,0.347353589525848
4472,Shame,19123767,3909002,15214765,2011_boxofficemojo_rankings.csv,2011,0.20440543957683652,0.7955945604231635
4473,Norwegian Wood,19115721,13000,19102721,2010_boxofficemojo_rankings.csv,2010,0.000680068515333531,0.9993199314846665
4474,The Bad News Bears in Breaking Training,19104350,19104350,0,1977_boxofficemojo_rankings.csv,1977,1.0,0.0
4475,Les Misérables,19082469,330181,18752288,2013_boxofficemojo_rankings.csv,2013,0.01730284482579272,0.9826971551742073
4476,Johnny Mnemonic,19075720,19075720,0,1995_boxofficemojo_rankings.csv,1995,1.0,0.0
4477,Bhool Bhulaiyaa,19073095,1097797,17975298,2007_boxofficemojo_rankings.csv,2007,0.05755736025013245,0.9424426397498675
4478,Mommie Dearest,19032261,19032261,0,1981_boxofficemojo_rankings.csv,1981,1.0,0.0
4479,Always Miss You,19015465,91884,18923581,2019_boxofficemojo_rankings.csv,2019,0.0048320669518205316,0.9951679330481795
4480,Memoir of a Murderer,19015346,91335,18924011,2017_boxofficemojo_rankings.csv,2017,0.004803225773541013,0.995196774226459
4481,A Mighty Heart,19008745,9176787,9831958,2007_boxofficemojo_rankings.csv,2007,0.4827665897985375,0.5172334102014625
4482,One Hundred and One Dalmatians 1979 Re-release,19000000,19000000,0,1979_boxofficemojo_rankings.csv,1979,1.0,0.0
4483,Sniper,18994653,18994653,0,1993_boxofficemojo_rankings.csv,1993,1.0,0.0
4484,The Octagon,18971000,18971000,0,1980_boxofficemojo_rankings.csv,1980,1.0,0.0
4485,Jo Nesbø's Headhunters,18962444,1200010,17762434,2011_boxofficemojo_rankings.csv,2011,0.0632835092354129,0.9367164907645871
4486,Akeelah and the Bee,18948425,18848430,99995,2006_boxofficemojo_rankings.csv,2006,0.9947227803893991,0.005277219610600881
4487,Kazaam,18937262,18937262,0,1996_boxofficemojo_rankings.csv,1996,1.0,0.0
4488,The Man Who Wasn't There,18916623,7504257,11412366,2001_boxofficemojo_rankings.csv,2001,0.3967017263070687,0.6032982736929313
4489,The Curse of the Jade Scorpion,18914307,7517191,11397116,2001_boxofficemojo_rankings.csv,2001,0.3974341222229289,0.602565877777071
4490,The Odd Couple II,18912328,18912328,0,1998_boxofficemojo_rankings.csv,1998,1.0,0.0
4491,Feardotcom,18902015,13258249,5643766,2002_boxofficemojo_rankings.csv,2002,0.7014198750768106,0.2985801249231894
4492,Untamed Heart,18898806,18898806,0,1993_boxofficemojo_rankings.csv,1993,1.0,0.0
4493,The Seventh Sign,18875011,18875011,0,1988_boxofficemojo_rankings.csv,1988,1.0,0.0
4494,Above the Law,18869631,18869631,0,1988_boxofficemojo_rankings.csv,1988,1.0,0.0
4495,Getting Even with Dad,18869594,18869594,0,1994_boxofficemojo_rankings.csv,1994,1.0,0.0
4496,[Rec] 2,18853164,27766,18825398,2009_boxofficemojo_rankings.csv,2009,0.0014727501442198243,0.9985272498557802
4497,Paternity,18838812,18838812,0,1981_boxofficemojo_rankings.csv,1981,1.0,0.0
4498,Under the Rainbow,18826490,18826490,0,1981_boxofficemojo_rankings.csv,1981,1.0,0.0
4499,Mr. Nice Guy,18814720,12716953,6097767,1998_boxofficemojo_rankings.csv,1998,0.675904451408259,0.32409554859174095
4500,The Counterfeiters,18814713,5488570,13326143,2007_boxofficemojo_rankings.csv,2007,0.291716913247627,0.708283086752373
4501,Thrill Ride: The Science of Fun,18798590,18798590,0,1997_boxofficemojo_rankings.csv,1997,1.0,0.0
4502,Mortal Thoughts,18784957,18784957,0,1991_boxofficemojo_rankings.csv,1991,1.0,0.0
4503,Suspect,18782400,18782400,0,1987_boxofficemojo_rankings.csv,1987,1.0,0.0
4504,Sex Drive,18755936,8402485,10353451,2008_boxofficemojo_rankings.csv,2008,0.4479907054491975,0.5520092945508025
4505,The Believers,18753438,18753438,0,1987_boxofficemojo_rankings.csv,1987,1.0,0.0
4506,A Mighty Wind,18750246,17781006,969240,2003_boxofficemojo_rankings.csv,2003,0.948307878200638,0.051692121799361994
4507,Look at Me,18729751,1737308,16992443,2004_boxofficemojo_rankings.csv,2004,0.09275659884640218,0.9072434011535978
4508,3000 Miles to Graceland,18720175,15749959,2970216,2001_boxofficemojo_rankings.csv,2001,0.8413360986208729,0.15866390137912706
4509,The Turning,18714343,15472775,3241568,2020_boxofficemojo_rankings.csv,2020,0.8267869729650675,0.17321302703493252
4510,Year of the Dragon,18707466,18707466,0,1985_boxofficemojo_rankings.csv,1985,1.0,0.0
4511,Pina,18705853,3524826,15181027,2011_boxofficemojo_rankings.csv,2011,0.18843439002754914,0.8115656099724509
4512,Her Alibi,18699037,18699037,0,1989_boxofficemojo_rankings.csv,1989,1.0,0.0
4513,Happy-Go-Lucky,18696602,3512016,15184586,2008_boxofficemojo_rankings.csv,2008,0.1878424753332183,0.8121575246667817
4514,13 Assassins,18689058,802778,17886280,2010_boxofficemojo_rankings.csv,2010,0.042954438902164035,0.957045561097836
4515,Casualties of War,18671317,18671317,0,1989_boxofficemojo_rankings.csv,1989,1.0,0.0
4516,Glee: The 3D Concert Movie,18663238,11862398,6800840,2011_boxofficemojo_rankings.csv,2011,0.6356023536751768,0.3643976463248232
4517,The Drop,18658381,10724389,7933992,2014_boxofficemojo_rankings.csv,2014,0.5747759679684963,0.4252240320315037
4518,Greta,18653107,10532219,8120888,2019_boxofficemojo_rankings.csv,2019,0.56463617562479,0.43536382437521
4519,Peppa Celebrates Chinese New Year,18653040,131225,18521815,2019_boxofficemojo_rankings.csv,2019,0.0070350462980833155,0.9929649537019167
4520,Blame It on Rio,18644570,18644570,0,1984_boxofficemojo_rankings.csv,1984,1.0,0.0
4521,Waiting...,18637690,16124543,2513147,2005_boxofficemojo_rankings.csv,2005,0.8651578065736687,0.13484219342633127
4522,Admission,18637201,18007317,629884,2013_boxofficemojo_rankings.csv,2013,0.9662028649044457,0.03379713509555431
4523,The Quick and the Dead,18636537,18636537,0,1995_boxofficemojo_rankings.csv,1995,1.0,0.0
4524,Geronimo: An American Legend,18635620,18635620,0,1993_boxofficemojo_rankings.csv,1993,1.0,0.0
4525,Max Keeble's Big Move,18634654,17294293,1340361,2001_boxofficemojo_rankings.csv,2001,0.9280715917773413,0.07192840822265871
4526,Paradise,18634643,18634643,0,1991_boxofficemojo_rankings.csv,1991,1.0,0.0
4527,The Fan,18626419,18626419,0,1996_boxofficemojo_rankings.csv,1996,1.0,0.0
4528,An Unfinished Life,18618284,8586392,10031892,2005_boxofficemojo_rankings.csv,2005,0.46118063297347917,0.5388193670265208
4529,De-Lovely,18611951,13456633,5155318,2004_boxofficemojo_rankings.csv,2004,0.7230103388946167,0.2769896611053833
4530,Detective K: Secret of the Living Dead,18603476,104013,18499463,2018_boxofficemojo_rankings.csv,2018,0.005591051908793819,0.9944089480912062
4531,Fired Up!,18599102,17231291,1367811,2009_boxofficemojo_rankings.csv,2009,0.9264582236282161,0.07354177637178397
4532,Battle of the Sexes,18598607,12638526,5960081,2017_boxofficemojo_rankings.csv,2017,0.6795415377076358,0.32045846229236413
4533,Empire,18591272,17600423,990849,2002_boxofficemojo_rankings.csv,2002,0.9467035391661205,0.05329646083387947
4534,Prancer,18587135,18587135,0,1989_boxofficemojo_rankings.csv,1989,1.0,0.0
4535,Keeping Mum,18575768,1619466,16956302,2005_boxofficemojo_rankings.csv,2005,0.0871816443874622,0.9128183556125378
4536,Flight of the Navigator,18564613,18564613,0,1986_boxofficemojo_rankings.csv,1986,1.0,0.0
4537,See No Evil,18564467,15032800,3531667,2006_boxofficemojo_rankings.csv,2006,0.8097620039401078,0.19023799605989228
4538,The Thirteenth Floor,18564088,11916661,6647427,1999_boxofficemojo_rankings.csv,1999,0.6419200878599585,0.3580799121400416
4539,Some Kind of Wonderful,18553948,18553948,0,1987_boxofficemojo_rankings.csv,1987,1.0,0.0
4540,An Ideal Husband,18542974,18542974,0,1999_boxofficemojo_rankings.csv,1999,1.0,0.0
4541,Black Christmas,18529730,10429730,8100000,2019_boxofficemojo_rankings.csv,2019,0.5628646504833044,0.4371353495166956
4542,My Love,18513120,885574,17627546,2007_boxofficemojo_rankings.csv,2007,0.04783494084195425,0.9521650591580457
4543,Airpocalypse,18491089,105678,18385411,2018_boxofficemojo_rankings.csv,2018,0.005715077137966293,0.9942849228620337
4544,My Baby's Daddy,18490423,17669317,821106,2004_boxofficemojo_rankings.csv,2004,0.955592903418164,0.044407096581835906
4545,Motherless Brooklyn,18477736,9277736,9200000,2019_boxofficemojo_rankings.csv,2019,0.5021035044553077,0.4978964955446923
4546,Singles,18471850,18471850,0,1992_boxofficemojo_rankings.csv,1992,1.0,0.0
4547,Easy Virtue,18463793,2656784,15807009,2008_boxofficemojo_rankings.csv,2008,0.14389156117597288,0.8561084388240271
4548,Summer Wars,18434328,80768,18353560,2009_boxofficemojo_rankings.csv,2009,0.004381391065624958,0.995618608934375
4549,Ladyhawke,18432000,18432000,0,1985_boxofficemojo_rankings.csv,1985,1.0,0.0
4550,The Fabulous Baker Boys,18428904,18428904,0,1989_boxofficemojo_rankings.csv,1989,1.0,0.0
4551,Zero,18412196,1035388,17376808,2018_boxofficemojo_rankings.csv,2018,0.05623381371782051,0.9437661862821795
4552,Repo Men,18409891,13794835,4615056,2010_boxofficemojo_rankings.csv,2010,0.7493164951384014,0.25068350486159857
4553,Loser,18404706,15618626,2786080,2000_boxofficemojo_rankings.csv,2000,0.848621325437092,0.151378674562908
4554,Prophecy,18389402,18389402,0,1979_boxofficemojo_rankings.csv,1979,1.0,0.0
4555,Kabei: Our Mother,18385964,14416,18371548,2008_boxofficemojo_rankings.csv,2008,0.0007840763747824156,0.9992159236252176
4556,Bandidas,18381890,0,18381890,2006_boxofficemojo_rankings.csv,2006,0.0,1.0
4557,The Wasted Times,18345372,386540,17958832,2016_boxofficemojo_rankings.csv,2016,0.021070164180917127,0.9789298358190829
4558,Fabricated City,18307490,104874,18202616,2017_boxofficemojo_rankings.csv,2017,0.005728475066762292,0.9942715249332377
4559,That Darn Cat,18301610,18301610,0,1997_boxofficemojo_rankings.csv,1997,1.0,0.0
4560,Asura,18300843,175702,18125141,2016_boxofficemojo_rankings.csv,2016,0.009600759921277943,0.990399240078722
4561,The World's Fastest Indian,18297690,5128124,13169566,2005_boxofficemojo_rankings.csv,2005,0.28026073236567023,0.7197392676343298
4562,Posse,18289763,18289763,0,1993_boxofficemojo_rankings.csv,1993,1.0,0.0
4563,Love Affair,18272894,18272894,0,1994_boxofficemojo_rankings.csv,1994,1.0,0.0
4564,Chappaquiddick,18263470,17395520,867950,2018_boxofficemojo_rankings.csv,2018,0.9524761723812616,0.04752382761873839
4565,Crimes and Misdemeanors,18254702,18254702,0,1989_boxofficemojo_rankings.csv,1989,1.0,0.0
4566,Simon Birch,18253415,18253415,0,1998_boxofficemojo_rankings.csv,1998,1.0,0.0
4567,Friends with Money,18245244,13368437,4876807,2006_boxofficemojo_rankings.csv,2006,0.7327080416134747,0.26729195838652525
4568,Sugar Hill,18225518,18225518,0,1994_boxofficemojo_rankings.csv,1994,1.0,0.0
4569,The Visitor,18197518,9427089,8770429,2008_boxofficemojo_rankings.csv,2008,0.5180425704208673,0.48195742957913273
4570,Daddy Day Camp,18197398,13235267,4962131,2007_boxofficemojo_rankings.csv,2007,0.7273164548030439,0.2726835451969562
4571,Dead Men Don't Wear Plaid,18196170,18196170,0,1982_boxofficemojo_rankings.csv,1982,1.0,0.0
4572,Antitrust,18195610,11328094,6867516,2001_boxofficemojo_rankings.csv,2001,0.6225729173135718,0.3774270826864282
4573,My Boss's Daughter,18191005,15550605,2640400,2003_boxofficemojo_rankings.csv,2003,0.8548513399891869,0.14514866001081303
4574,The Case for Christ,18175663,14682684,3492979,2017_boxofficemojo_rankings.csv,2017,0.8078210957146378,0.19217890428536225
4575,Sorry to Bother You,18170707,17493096,677611,2018_boxofficemojo_rankings.csv,2018,0.9627086056695537,0.03729139433044625
4576,Soul Kitchen,18164139,276901,17887238,2009_boxofficemojo_rankings.csv,2009,0.01524437794711877,0.9847556220528813
4577,Hell Fest,18159691,11107431,7052260,2018_boxofficemojo_rankings.csv,2018,0.6116530837446518,0.3883469162553482
4578,Milk Money,18137661,18137661,0,1994_boxofficemojo_rankings.csv,1994,1.0,0.0
4579,The Sure Thing,18135531,18135531,0,1985_boxofficemojo_rankings.csv,1985,1.0,0.0
4580,All the Pretty Horses,18133495,15540353,2593142,2000_boxofficemojo_rankings.csv,2000,0.8569971205219954,0.14300287947800466
4581,DuckTales the Movie: Treasure of the Lost Lamp,18115724,18115724,0,1990_boxofficemojo_rankings.csv,1990,1.0,0.0
4582,The Lighthouse,18113964,10867104,7246860,2019_boxofficemojo_rankings.csv,2019,0.5999296454381824,0.4000703545618176
4583,Blinded by the Light,18096691,11901145,6195546,2019_boxofficemojo_rankings.csv,2019,0.6576420517983095,0.3423579482016906
4584,Dead Man Down,18074539,10895295,7179244,2013_boxofficemojo_rankings.csv,2013,0.6027979468798623,0.3972020531201377
4585,Krrish,18041250,1430721,16610529,2006_boxofficemojo_rankings.csv,2006,0.07930276449802535,0.9206972355019747
4586,"Jo Jo Dancer, Your Life Is Calling",18034150,18034150,0,1986_boxofficemojo_rankings.csv,1986,1.0,0.0
4587,The Country Bears,18012097,16990825,1021272,2002_boxofficemojo_rankings.csv,2002,0.9433007716980427,0.05669922830195729
4588,The Aristocats,18000000,18000000,0,1980_boxofficemojo_rankings.csv,1980,1.0,0.0
4589,Quills,17989227,7065332,10923895,2000_boxofficemojo_rankings.csv,2000,0.3927535074186345,0.6072464925813655
4590,Kalank,17987034,2729336,15257698,2019_boxofficemojo_rankings.csv,2019,0.15173908049542797,0.848260919504572
4591,Dope,17986781,17506470,480311,2015_boxofficemojo_rankings.csv,2015,0.9732964447612944,0.02670355523870558
4592,The Howling,17985893,17985893,0,1981_boxofficemojo_rankings.csv,1981,1.0,0.0
4593,Whiteout,17976667,10275638,7701029,2009_boxofficemojo_rankings.csv,2009,0.5716097427849112,0.4283902572150889
4594,Cantinflas,17966873,6382924,11583949,2014_boxofficemojo_rankings.csv,2014,0.3552607067462435,0.6447392932537566
4595,Used People,17957265,17957265,0,1992_boxofficemojo_rankings.csv,1992,1.0,0.0
4596,CB4,17953778,17953778,0,1993_boxofficemojo_rankings.csv,1993,1.0,0.0
4597,Born Yesterday,17952857,17952857,0,1993_boxofficemojo_rankings.csv,1993,1.0,0.0
4598,Night Watch 2005 Re-release,17939389,1502188,16437201,2005_boxofficemojo_rankings.csv,2005,0.08373685413700545,0.9162631458629945
4599,City of Ember,17929684,7873007,10056677,2008_boxofficemojo_rankings.csv,2008,0.43910461556377683,0.5608953844362232
4600,The Crow: City of Angels,17917287,17917287,0,1996_boxofficemojo_rankings.csv,1996,1.0,0.0
4601,Lage Raho Munna Bhai,17897527,2217562,15679965,2006_boxofficemojo_rankings.csv,2006,0.12390326328324577,0.8760967367167543
4602,We Have a Pope,17877523,548115,17329408,2011_boxofficemojo_rankings.csv,2011,0.030659448739067487,0.9693405512609325
4603,A Prophet,17874044,2087720,15786324,2009_boxofficemojo_rankings.csv,2009,0.11680177132830152,0.8831982286716985
4604,Dil Dhadakne Do,17870077,3066100,14803977,2015_boxofficemojo_rankings.csv,2015,0.17157732448494767,0.8284226755150523
4605,The Old Man & the Gun,17860397,11277120,6583277,2018_boxofficemojo_rankings.csv,2018,0.6314036580485864,0.3685963419514135
4606,Sibling Rivalry,17854933,17854933,0,1990_boxofficemojo_rankings.csv,1990,1.0,0.0
4607,Gekijouban Fate/Stay Night: Heaven's Feel - III. Spring Song,17850900,0,17850900,2020_boxofficemojo_rankings.csv,2020,0.0,1.0
4608,The Quiet Ones,17835162,8509867,9325295,2014_boxofficemojo_rankings.csv,2014,0.4771398768343119,0.5228601231656881
4609,Flyboys,17834865,13090630,4744235,2006_boxofficemojo_rankings.csv,2006,0.7339909777842445,0.2660090222157555
4610,Honeysuckle Rose,17815212,17815212,0,1980_boxofficemojo_rankings.csv,1980,1.0,0.0
4611,The Edge of Heaven,17804565,742349,17062216,2007_boxofficemojo_rankings.csv,2007,0.04169430704990546,0.9583056929500945
4612,Friendship,17779520,1243910,16535610,2008_boxofficemojo_rankings.csv,2008,0.06996308111805043,0.9300369188819496
4613,Deception,17772506,4598506,13174000,2008_boxofficemojo_rankings.csv,2008,0.258742689410261,0.741257310589739
4614,The Delta Force,17768900,17768900,0,1986_boxofficemojo_rankings.csv,1986,1.0,0.0
4615,Halloween 4: The Return of Michael Myers,17768757,17768757,0,1988_boxofficemojo_rankings.csv,1988,1.0,0.0
4616,Unforgettable,17768012,11368012,6400000,2017_boxofficemojo_rankings.csv,2017,0.6398021343074284,0.36019786569257156
4617,The Rage: Carrie 2,17762705,17762705,0,1999_boxofficemojo_rankings.csv,1999,1.0,0.0
4618,The Big Green,17736619,17736619,0,1995_boxofficemojo_rankings.csv,1995,1.0,0.0
4619,For the Love of Benji,17732000,17732000,0,1977_boxofficemojo_rankings.csv,1977,1.0,0.0
4620,Reign of Government,17722998,1009065,16713933,2008_boxofficemojo_rankings.csv,2008,0.05693534468604014,0.9430646553139599
4621,The Last Kiss,17720347,1048950,16671397,2002_boxofficemojo_rankings.csv,2002,0.05919466475458974,0.9408053352454102
4622,Joyeux Noel,17709155,1054361,16654794,2005_boxofficemojo_rankings.csv,2005,0.059537623336630124,0.9404623766633698
4623,The Children Act,17696794,547750,17149044,2018_boxofficemojo_rankings.csv,2018,0.03095193400567357,0.9690480659943265
4624,Memories of Tomorrow,17696020,140200,17555820,2006_boxofficemojo_rankings.csv,2006,0.007922685440002894,0.9920773145599971
4625,Heavyweights,17689177,17689177,0,1995_boxofficemojo_rankings.csv,1995,1.0,0.0
4626,The Big Easy,17685307,17685307,0,1987_boxofficemojo_rankings.csv,1987,1.0,0.0
4627,Regression,17671101,55039,17616062,2015_boxofficemojo_rankings.csv,2015,0.0031146333213759574,0.996885366678624
4628,Before I Go to Sleep,17669776,3242457,14427319,2014_boxofficemojo_rankings.csv,2014,0.18350300535784947,0.8164969946421505
4629,Song of the South 1986 Re-release,17659346,17659346,0,1986_boxofficemojo_rankings.csv,1986,1.0,0.0
4630,Kit Kittredge: An American Girl,17657973,17657973,0,2008_boxofficemojo_rankings.csv,2008,1.0,0.0
4631,The Oxford Murders,17646627,4803,17641824,2008_boxofficemojo_rankings.csv,2008,0.0002721766601628742,0.9997278233398371
4632,Frantic,17637950,17637950,0,1988_boxofficemojo_rankings.csv,1988,1.0,0.0
4633,Swing Vote,17634313,16289867,1344446,2008_boxofficemojo_rankings.csv,2008,0.9237596610653332,0.07624033893466675
4634,The Postman,17626234,17626234,0,1997_boxofficemojo_rankings.csv,1997,1.0,0.0
4635,Neerja,17618280,1585687,16032593,2015_boxofficemojo_rankings.csv,2015,0.09000237253579804,0.909997627464202
4636,Max Dugan Returns,17613720,17613720,0,1983_boxofficemojo_rankings.csv,1983,1.0,0.0
4637,Operation Finale,17612099,17612099,0,2018_boxofficemojo_rankings.csv,2018,1.0,0.0
4638,Eye of the Beholder,17589705,16500786,1088919,1999_boxofficemojo_rankings.csv,1999,0.938093390423546,0.061906609576453955
4639,Eye of the Needle,17583634,17583634,0,1981_boxofficemojo_rankings.csv,1981,1.0,0.0
4640,Avenue Montaigne,17574836,2044858,15529978,2006_boxofficemojo_rankings.csv,2006,0.11635146979465413,0.8836485302053458
4641,Deliver Us from Eva,17573594,17573594,0,2003_boxofficemojo_rankings.csv,2003,1.0,0.0
4642,Little Boy,17572289,6485961,11086328,2015_boxofficemojo_rankings.csv,2015,0.3691016577293943,0.6308983422706057
4643,Take This Job and Shove It,17569027,17569027,0,1981_boxofficemojo_rankings.csv,1981,1.0,0.0
4644,Toilet: A Love Story,17567417,1830715,15736702,2017_boxofficemojo_rankings.csv,2017,0.10421082393615408,0.8957891760638459
4645,In the Land of Women,17562071,11052958,6509113,2007_boxofficemojo_rankings.csv,2007,0.6293652952433685,0.3706347047566315
4646,Johnny Be Good,17550399,17550399,0,1988_boxofficemojo_rankings.csv,1988,1.0,0.0
4647,Invasion U.S.A.,17536256,17536256,0,1985_boxofficemojo_rankings.csv,1985,1.0,0.0
4648,Loving Pablo,17535962,22017,17513945,2018_boxofficemojo_rankings.csv,2018,0.0012555341988081407,0.9987444658011918
4649,Addicted,17534314,17390770,143544,2014_boxofficemojo_rankings.csv,2014,0.9918135377295056,0.0081864622704943
4650,Home for the Holidays,17519169,17519169,0,1995_boxofficemojo_rankings.csv,1995,1.0,0.0
4651,Disturbing Behavior,17514980,17514980,0,1998_boxofficemojo_rankings.csv,1998,1.0,0.0
4652,For Keeps?,17514553,17514553,0,1988_boxofficemojo_rankings.csv,1988,1.0,0.0
4653,Lassiter,17513452,17513452,0,1984_boxofficemojo_rankings.csv,1984,1.0,0.0
4654,Roll Bounce,17500866,17380866,120000,2005_boxofficemojo_rankings.csv,2005,0.9931431964566781,0.006856803543321799
4655,Annapolis,17496992,17127992,369000,2006_boxofficemojo_rankings.csv,2006,0.9789106607581464,0.021089339241853685
4656,Machete Kills,17496820,8008161,9488659,2013_boxofficemojo_rankings.csv,2013,0.45769236924195367,0.5423076307580463
4657,Rebound,17492014,16809014,683000,2005_boxofficemojo_rankings.csv,2005,0.9609536100302687,0.03904638996973133
4658,Angel,17488564,17488564,0,1984_boxofficemojo_rankings.csv,1984,1.0,0.0
4659,White Palace,17487531,17487531,0,1990_boxofficemojo_rankings.csv,1990,1.0,0.0
4660,"Paris, je t'aime",17471727,4899278,12572449,2006_boxofficemojo_rankings.csv,2006,0.2804117761226466,0.7195882238773534
4661,Half Baked,17460020,17460020,0,1998_boxofficemojo_rankings.csv,1998,1.0,0.0
4662,The Aristocats 1987 Re-release,17452658,17452658,0,1987_boxofficemojo_rankings.csv,1987,1.0,0.0
4663,Capitalism: A Love Story,17436509,14363397,3073112,2009_boxofficemojo_rankings.csv,2009,0.8237541700577793,0.17624582994222066
4664,A Guy Thing,17432163,15545431,1886732,2003_boxofficemojo_rankings.csv,2003,0.8917671891893163,0.10823281081068367
4665,Frailty,17423030,13110448,4312582,2002_boxofficemojo_rankings.csv,2002,0.7524780706914929,0.2475219293085072
4666,Fate/Stay Night: Heaven's Feel - I. Presage Flower,17422935,193833,17229102,2017_boxofficemojo_rankings.csv,2017,0.011125163469874622,0.9888748365301254
4667,Stolen,17415418,304318,17111100,2012_boxofficemojo_rankings.csv,2012,0.017474056608919753,0.9825259433910802
4668,Kapoor & Sons,17412627,2607036,14805591,2016_boxofficemojo_rankings.csv,2016,0.14972100418851217,0.8502789958114878
4669,Billy and Buddy,17400053,894,17399159,2013_boxofficemojo_rankings.csv,2013,5.1379153845106106e-05,0.9999486208461549
4670,Fruitvale Station,17385830,16101339,1284491,2013_boxofficemojo_rankings.csv,2013,0.9261185114544431,0.07388148854555693
4671,Firehouse Dog,17384424,13932383,3452041,2007_boxofficemojo_rankings.csv,2007,0.8014290838741623,0.19857091612583772
4672,Murder in the First,17381942,17381942,0,1995_boxofficemojo_rankings.csv,1995,1.0,0.0
4673,Extreme Measures,17380126,17380126,0,1996_boxofficemojo_rankings.csv,1996,1.0,0.0
4674,Outland,17374595,17374595,0,1981_boxofficemojo_rankings.csv,1981,1.0,0.0
4675,The NeverEnding Story II: The Next Chapter,17373527,17373527,0,1991_boxofficemojo_rankings.csv,1991,1.0,0.0
4676,My Girl 2,17359799,17359799,0,1994_boxofficemojo_rankings.csv,1994,1.0,0.0
4677,Born in East L.A.,17355263,17355263,0,1987_boxofficemojo_rankings.csv,1987,1.0,0.0
4678,The Matador,17347231,12594698,4752533,2005_boxofficemojo_rankings.csv,2005,0.7260350657692862,0.27396493423071383
4679,Valley Girl,17343596,17343596,0,1983_boxofficemojo_rankings.csv,1983,1.0,0.0
4680,Masters of the Universe,17336370,17336370,0,1987_boxofficemojo_rankings.csv,1987,1.0,0.0
4681,The Phantom,17323326,17323326,0,1996_boxofficemojo_rankings.csv,1996,1.0,0.0
4682,To Live and Die in L.A.,17307019,17307019,0,1985_boxofficemojo_rankings.csv,1985,1.0,0.0
4683,Fate/stay night [Heaven's Feel] II. lost butterfly,17295864,420595,16875269,2019_boxofficemojo_rankings.csv,2019,0.024317663459888447,0.9756823365401116
4684,The Importance of Being Earnest,17290970,8384929,8906041,2002_boxofficemojo_rankings.csv,2002,0.4849310940913089,0.515068905908691
4685,A Bronx Tale,17287898,17287898,0,1993_boxofficemojo_rankings.csv,1993,1.0,0.0
4686,While We're Young,17287309,7587485,9699824,2015_boxofficemojo_rankings.csv,2015,0.4389049215236449,0.5610950784763551
4687,12 Rounds,17280326,12234694,5045632,2009_boxofficemojo_rankings.csv,2009,0.7080129159600346,0.2919870840399654
4688,Legend of the Naga Pearls,17274695,13588,17261107,2017_boxofficemojo_rankings.csv,2017,0.0007865840757246365,0.9992134159242754
4689,All the Right Moves,17233166,17233166,0,1983_boxofficemojo_rankings.csv,1983,1.0,0.0
4690,Hudson Hawk,17218080,17218080,0,1991_boxofficemojo_rankings.csv,1991,1.0,0.0
4691,The Mission,17218023,17218023,0,1986_boxofficemojo_rankings.csv,1986,1.0,0.0
4692,Peter Pan 1982 Re-release,17200000,17200000,0,1982_boxofficemojo_rankings.csv,1982,1.0,0.0
4693,Fled,17193231,17193231,0,1996_boxofficemojo_rankings.csv,1996,1.0,0.0
4694,Angel Heart,17185632,17185632,0,1987_boxofficemojo_rankings.csv,1987,1.0,0.0
4695,Sidekicks,17180393,17180393,0,1993_boxofficemojo_rankings.csv,1993,1.0,0.0
4696,Adventureland,17164820,16044025,1120795,2009_boxofficemojo_rankings.csv,2009,0.9347039467934998,0.06529605320650027
4697,Mother,17149348,551509,16597839,2009_boxofficemojo_rankings.csv,2009,0.03215918179513297,0.967840818204867
4698,The Falcon and the Snowman,17130087,17130087,0,1985_boxofficemojo_rankings.csv,1985,1.0,0.0
4699,Freejack,17129026,17129026,0,1992_boxofficemojo_rankings.csv,1992,1.0,0.0
4700,Johnny Dangerously,17124395,17124395,0,1984_boxofficemojo_rankings.csv,1984,1.0,0.0
4701,My Afternoons with Margueritte,17107143,666557,16440586,2010_boxofficemojo_rankings.csv,2010,0.03896366564539736,0.9610363343546027
4702,Rushmore,17105219,17105219,0,1998_boxofficemojo_rankings.csv,1998,1.0,0.0
4703,Diabolique,17100266,17100266,0,1996_boxofficemojo_rankings.csv,1996,1.0,0.0
4704,Pet Sematary II,17092453,17092453,0,1992_boxofficemojo_rankings.csv,1992,1.0,0.0
4705,Firestarter,17080167,17080167,0,1984_boxofficemojo_rankings.csv,1984,1.0,0.0
4706,Kinsey,17050017,10254979,6795038,2004_boxofficemojo_rankings.csv,2004,0.6014644442876509,0.39853555571234917
4707,Melancholia,17039814,3030848,14008966,2011_boxofficemojo_rankings.csv,2011,0.17786860819020678,0.8221313918097932
4708,The Guardian,17037887,17037887,0,1990_boxofficemojo_rankings.csv,1990,1.0,0.0
4709,Beyond Outrage,17027515,3878,17023637,2012_boxofficemojo_rankings.csv,2012,0.0002277490285576022,0.9997722509714424
4710,Jury Duty,17014653,17014653,0,1995_boxofficemojo_rankings.csv,1995,1.0,0.0
4711,Kiss of the Spider Woman,17005229,17005229,0,1985_boxofficemojo_rankings.csv,1985,1.0,0.0
4712,Herbie Goes Bananas,17000000,17000000,0,1980_boxofficemojo_rankings.csv,1980,1.0,0.0
4713,Kung Pow: Enter the Fist,16994625,16037962,956663,2002_boxofficemojo_rankings.csv,2002,0.9437079076472709,0.056292092352729174
4714,Micmacs,16979882,1262079,15717803,2009_boxofficemojo_rankings.csv,2009,0.07432790168977617,0.9256720983102238
4715,Death Sentence,16974459,9534258,7440201,2007_boxofficemojo_rankings.csv,2007,0.5616825844051937,0.4383174155948063
4716,Chinese Puzzle,16968297,338523,16629774,2013_boxofficemojo_rankings.csv,2013,0.019950322651707476,0.9800496773482925
4717,Jason X,16951798,13121555,3830243,2001_boxofficemojo_rankings.csv,2001,0.7740509295828089,0.22594907041719114
4718,Catch That Kid,16951702,16703799,247903,2004_boxofficemojo_rankings.csv,2004,0.9853759227244556,0.014624077275544368
4719,Rachel Getting Married,16937968,12796841,4141127,2008_boxofficemojo_rankings.csv,2008,0.7555121724164315,0.24448782758356846
4720,The War,16928556,16928556,0,1994_boxofficemojo_rankings.csv,1994,1.0,0.0
4721,The One and Only,16928137,16928137,0,1978_boxofficemojo_rankings.csv,1978,1.0,0.0
4722,The Nutcracker in 3D,16918946,195459,16723487,2010_boxofficemojo_rankings.csv,2010,0.011552670006748648,0.9884473299932514
4723,Sugar & Spice,16908947,13305101,3603846,2001_boxofficemojo_rankings.csv,2001,0.7868675086627216,0.21313249133727843
4724,Material Girls,16907725,11449638,5458087,2006_boxofficemojo_rankings.csv,2006,0.677183831650917,0.32281616834908305
4725,Zapped!,16897768,16897768,0,1982_boxofficemojo_rankings.csv,1982,1.0,0.0
4726,They Call Me Bruce,16894678,16894678,0,1982_boxofficemojo_rankings.csv,1982,1.0,0.0
4727,Calvary,16887741,3600006,13287735,2014_boxofficemojo_rankings.csv,2014,0.21317273873397277,0.7868272612660272
4728,Life or Something Like It,16872671,14448589,2424082,2002_boxofficemojo_rankings.csv,2002,0.8563308678276249,0.1436691321723751
4729,The Last Godfather,16863629,164247,16699382,2010_boxofficemojo_rankings.csv,2010,0.009739718538637206,0.9902602814613628
4730,The Cold Light of Day,16863583,3763583,13100000,2012_boxofficemojo_rankings.csv,2012,0.2231781348008902,0.7768218651991098
4731,The Pyramid,16861137,2756333,14104804,2014_boxofficemojo_rankings.csv,2014,0.16347254636505237,0.8365274536349476
4732,The Good Girl,16856124,14018296,2837828,2002_boxofficemojo_rankings.csv,2002,0.8316440956414417,0.16835590435855835
4733,Death Warrant,16853487,16853487,0,1990_boxofficemojo_rankings.csv,1990,1.0,0.0
4734,Monkey Kingdom,16839663,16432322,407341,2015_boxofficemojo_rankings.csv,2015,0.9758106204381881,0.024189379561811896
4735,Femme Fatale,16838910,6630252,10208658,2002_boxofficemojo_rankings.csv,2002,0.3937459134825235,0.6062540865174765
4736,House of 1000 Corpses,16829545,12634962,4194583,2003_boxofficemojo_rankings.csv,2003,0.7507607603176437,0.24923923968235623
4737,Baby's Day Out,16827402,16827402,0,1994_boxofficemojo_rankings.csv,1994,1.0,0.0
4738,Lightning Jack,16821273,16821273,0,1994_boxofficemojo_rankings.csv,1994,1.0,0.0
4739,Andre,16820893,16820893,0,1994_boxofficemojo_rankings.csv,1994,1.0,0.0
4740,Hit and Run,16816647,13749300,3067347,2012_boxofficemojo_rankings.csv,2012,0.8176005597310807,0.18239944026891924
4741,Hardcore Henry,16810562,9252038,7558524,2016_boxofficemojo_rankings.csv,2016,0.5503705349053768,0.44962946509462326
4742,Hollywoodland,16800438,14426251,2374187,2006_boxofficemojo_rankings.csv,2006,0.8586830295733956,0.14131697042660435
4743,Bringing Out the Dead,16797191,16797191,0,1999_boxofficemojo_rankings.csv,1999,1.0,0.0
4744,Paparazzi,16796512,15714234,1082278,2004_boxofficemojo_rankings.csv,2004,0.9355653126077604,0.06443468739223954
4745,The Birth of a Nation,16779212,15861566,917646,2016_boxofficemojo_rankings.csv,2016,0.9453105425928225,0.05468945740717741
4746,House of Sand and Fog,16763804,13040288,3723516,2003_boxofficemojo_rankings.csv,2003,0.7778835877584825,0.22211641224151749
4747,102 Not Out,16758596,1343797,15414799,2018_boxofficemojo_rankings.csv,2018,0.08018553582889641,0.9198144641711036
4748,54,16757163,16757163,0,1998_boxofficemojo_rankings.csv,1998,1.0,0.0
4749,Baaghi 3,16726319,721439,16004880,2020_boxofficemojo_rankings.csv,2020,0.04313196466000678,0.9568680353399932
4750,Miss Pettigrew Lives for a Day,16724933,12313694,4411239,2008_boxofficemojo_rankings.csv,2008,0.7362477326516046,0.26375226734839535
4751,Love Is All You Need,16722143,1631709,15090434,2012_boxofficemojo_rankings.csv,2012,0.09757774467064419,0.9024222553293558
4752,Delhi Belly,16706074,1532594,15173480,2011_boxofficemojo_rankings.csv,2011,0.09173872927894369,0.9082612707210563
4753,Pride,16699029,1446634,15252395,2014_boxofficemojo_rankings.csv,2014,0.08662982739894637,0.9133701726010536
4754,Blink,16696219,16696219,0,1994_boxofficemojo_rankings.csv,1994,1.0,0.0
4755,Whip It,16691303,13043363,3647940,2009_boxofficemojo_rankings.csv,2009,0.7814466611743852,0.21855333882561476
4756,Dogville,16680836,1535286,15145550,2003_boxofficemojo_rankings.csv,2003,0.0920389121984054,0.9079610878015946
4757,Tremors,16667084,16667084,0,1990_boxofficemojo_rankings.csv,1990,1.0,0.0
4758,Rough Cut,16656125,16656125,0,1980_boxofficemojo_rankings.csv,1980,1.0,0.0
4759,American Dreamz,16656103,7191830,9464273,2006_boxofficemojo_rankings.csv,2006,0.4317834730008574,0.5682165269991426
4760,CyberWorld,16653900,11253900,5400000,2000_boxofficemojo_rankings.csv,2000,0.6757516257453209,0.32424837425467906
4761,Mai wei,16653488,70177,16583311,2011_boxofficemojo_rankings.csv,2011,0.004213952056169854,0.9957860479438302
4762,Extreme,16653175,12475172,4178003,1999_boxofficemojo_rankings.csv,1999,0.7491167299929293,0.2508832700070707
4763,True Crime,16649768,16649768,0,1999_boxofficemojo_rankings.csv,1999,1.0,0.0
4764,The Final Countdown,16647800,16647800,0,1980_boxofficemojo_rankings.csv,1980,1.0,0.0
4765,Digimon: The Movie,16643191,9631153,7012038,2000_boxofficemojo_rankings.csv,2000,0.5786842799556888,0.4213157200443112
4766,Deep Cover,16639799,16639799,0,1992_boxofficemojo_rankings.csv,1992,1.0,0.0
4767,Beautiful Boy,16636604,7649973,8986631,2018_boxofficemojo_rankings.csv,2018,0.45982779899070747,0.5401722010092925
4768,Everyone's Hero,16627188,14523101,2104087,2006_boxofficemojo_rankings.csv,2006,0.8734550303996081,0.12654496960039183
4769,Buffy the Vampire Slayer,16624456,16624456,0,1992_boxofficemojo_rankings.csv,1992,1.0,0.0
4770,Nothing to Lose 2,16610713,1150551,15460162,2019_boxofficemojo_rankings.csv,2019,0.06926559985715243,0.9307344001428476
4771,Belle,16607575,10726630,5880945,2014_boxofficemojo_rankings.csv,2014,0.6458877951778029,0.3541122048221971
4772,Beat Street,16595791,16595791,0,1984_boxofficemojo_rankings.csv,1984,1.0,0.0
4773,Upgrade,16593554,11977130,4616424,2018_boxofficemojo_rankings.csv,2018,0.7217941376512832,0.27820586234871686
4774,Heart and Souls,16589540,16589540,0,1993_boxofficemojo_rankings.csv,1993,1.0,0.0
4775,Sunshine Cleaning,16580250,12062558,4517692,2009_boxofficemojo_rankings.csv,2009,0.7275257007584325,0.2724742992415675
4776,The Dish,16575074,2552992,14022082,2000_boxofficemojo_rankings.csv,2000,0.1540259790092038,0.8459740209907962
4777,That Old Feeling,16574176,16574176,0,1997_boxofficemojo_rankings.csv,1997,1.0,0.0
4778,Tazza: One-Eyed Jack,16572611,97655,16474956,2019_boxofficemojo_rankings.csv,2019,0.005892553683906537,0.9941074463160935
4779,Shocker,16554699,16554699,0,1989_boxofficemojo_rankings.csv,1989,1.0,0.0
4780,Battle of the Year,16549477,8888355,7661122,2013_boxofficemojo_rankings.csv,2013,0.5370776973798024,0.4629223026201976
4781,The Boxer,16534578,5980578,10554000,1997_boxofficemojo_rankings.csv,1997,0.3617012783755352,0.6382987216244648
4782,"Tomorrow, When the War Began",16533595,4936,16528659,2010_boxofficemojo_rankings.csv,2010,0.00029854366216179845,0.9997014563378382
4783,Silent House,16527747,12754783,3772964,2012_boxofficemojo_rankings.csv,2012,0.7717194001094039,0.2282805998905961
4784,Krull,16519460,16519460,0,1983_boxofficemojo_rankings.csv,1983,1.0,0.0
4785,A Secret,16494522,623558,15870964,2007_boxofficemojo_rankings.csv,2007,0.03780394484908384,0.9621960551509162
4786,Trainspotting,16491080,16491080,0,1996_boxofficemojo_rankings.csv,1996,1.0,0.0
4787,Terminal Velocity,16487349,16487349,0,1994_boxofficemojo_rankings.csv,1994,1.0,0.0
4788,Spacehunter: Adventures in the Forbidden Zone,16478265,16478265,0,1983_boxofficemojo_rankings.csv,1983,1.0,0.0
4789,The Fountain,16468343,10144010,6324333,2006_boxofficemojo_rankings.csv,2006,0.6159702891784559,0.3840297108215441
4790,Omkara,16466144,1244576,15221568,2006_boxofficemojo_rankings.csv,2006,0.07558393756303844,0.9244160624369616
4791,Pride and Prejudice and Zombies,16457494,10938134,5519360,2016_boxofficemojo_rankings.csv,2016,0.6646293779599738,0.33537062204002627
4792,Monkey Trouble,16453258,16453258,0,1994_boxofficemojo_rankings.csv,1994,1.0,0.0
4793,They,16446271,12840842,3605429,2002_boxofficemojo_rankings.csv,2002,0.7807752894257914,0.2192247105742086
4794,Everybody's Fine,16443609,9208876,7234733,2009_boxofficemojo_rankings.csv,2009,0.5600276678921275,0.4399723321078724
4795,The Powerpuff Girls Movie,16426471,11412414,5014057,2002_boxofficemojo_rankings.csv,2002,0.6947575045181646,0.3052424954818354
4796,Breaking Away,16424918,16424918,0,1979_boxofficemojo_rankings.csv,1979,1.0,0.0
4797,Poms,16418218,13631124,2787094,2019_boxofficemojo_rankings.csv,2019,0.8302438181780751,0.1697561818219249
4798,"New York, New York",16400000,16400000,0,1977_boxofficemojo_rankings.csv,1977,1.0,0.0
4799,Return from Witch Mountain,16393000,16393000,0,1978_boxofficemojo_rankings.csv,1978,1.0,0.0
4800,Forever My Girl,16376066,16376066,0,2018_boxofficemojo_rankings.csv,2018,1.0,0.0
4801,Before I Fall,16373843,12241122,4132721,2017_boxofficemojo_rankings.csv,2017,0.7476022580648904,0.25239774193510955
4802,The Magdalene Sisters,16373112,306989,16066123,2002_boxofficemojo_rankings.csv,2002,0.018749581631152343,0.9812504183688476
4803,Defending Your Life,16371128,16371128,0,1991_boxofficemojo_rankings.csv,1991,1.0,0.0
4804,The Single Moms Club,16365451,15973881,391570,2014_boxofficemojo_rankings.csv,2014,0.9760733755519478,0.02392662444805218
4805,Little Q,16360233,1652,16358581,2019_boxofficemojo_rankings.csv,2019,0.0001009765569964682,0.9998990234430035
4806,Italian for Beginners,16349568,4544753,11804815,2000_boxofficemojo_rankings.csv,2000,0.27797388897370257,0.7220261110262974
4807,Playmobil: The Movie,16349303,1115008,15234295,2019_boxofficemojo_rankings.csv,2019,0.068199115277269,0.931800884722731
4808,Burglar,16337355,16337355,0,1987_boxofficemojo_rankings.csv,1987,1.0,0.0
4809,Tales from the Darkside,16324573,16324573,0,1990_boxofficemojo_rankings.csv,1990,1.0,0.0
4810,Macbeth,16322067,1110707,15211360,2015_boxofficemojo_rankings.csv,2015,0.06804940820301743,0.9319505917969826
4811,The Emperor's Club,16318449,14118751,2199698,2002_boxofficemojo_rankings.csv,2002,0.865201772545908,0.13479822745409198
4812,A Simple Plan,16316273,16316273,0,1998_boxofficemojo_rankings.csv,1998,1.0,0.0
4813,Two Lovers,16303643,3149034,13154609,2008_boxofficemojo_rankings.csv,2008,0.19314910170690072,0.8068508982930993
4814,Evangelion: 1.0 You Are (Not) Alone,16283819,107797,16176022,2007_boxofficemojo_rankings.csv,2007,0.0066198844386565585,0.9933801155613434
4815,Chances Are,16278590,16278590,0,1989_boxofficemojo_rankings.csv,1989,1.0,0.0
4816,The Hunter,16274150,16274150,0,1980_boxofficemojo_rankings.csv,1980,1.0,0.0
4817,Supercop,16270600,16270600,0,1996_boxofficemojo_rankings.csv,1996,1.0,0.0
4818,Crossing Delancey,16262415,16262415,0,1988_boxofficemojo_rankings.csv,1988,1.0,0.0
4819,Men at Work,16247964,16247964,0,1990_boxofficemojo_rankings.csv,1990,1.0,0.0
4820,Fire Down Below,16228448,16228448,0,1997_boxofficemojo_rankings.csv,1997,1.0,0.0
4821,Rabbit-Proof Fence,16217411,6199600,10017811,2002_boxofficemojo_rankings.csv,2002,0.38228050087649623,0.6177194991235038
4822,Raw Deal,16209459,16209459,0,1986_boxofficemojo_rankings.csv,1986,1.0,0.0
4823,Caché,16197824,3647381,12550443,2005_boxofficemojo_rankings.csv,2005,0.22517722133540902,0.774822778664591
4824,Above the Rim,16192320,16192320,0,1994_boxofficemojo_rankings.csv,1994,1.0,0.0
4825,Gangnam 1970,16191434,18022,16173412,2015_boxofficemojo_rankings.csv,2015,0.0011130576822287637,0.9988869423177712
4826,In the House,16190771,389757,15801014,2012_boxofficemojo_rankings.csv,2012,0.024072788133437252,0.9759272118665627
4827,I Love You to Death,16186793,16186793,0,1990_boxofficemojo_rankings.csv,1990,1.0,0.0
4828,Just Visiting,16176732,4781539,11395193,2001_boxofficemojo_rankings.csv,2001,0.2955812706793931,0.7044187293206069
4829,Birthday Girl,16171098,5142576,11028522,2002_boxofficemojo_rankings.csv,2002,0.31801031692467635,0.6819896830753236
4830,Catch and Release,16161742,15539051,622691,2007_boxofficemojo_rankings.csv,2007,0.9614712943691343,0.03852870563086578
4831,Richard Pryor... Here and Now,16156776,16156776,0,1983_boxofficemojo_rankings.csv,1983,1.0,0.0
4832,Iris,16153953,5594617,10559336,2001_boxofficemojo_rankings.csv,2001,0.3463311426002044,0.6536688573997956
4833,Mo' Better Blues,16153593,16153593,0,1990_boxofficemojo_rankings.csv,1990,1.0,0.0
4834,Devil in a Blue Dress,16140822,16140822,0,1995_boxofficemojo_rankings.csv,1995,1.0,0.0
4835,Scouts Guide to the Zombie Apocalypse,16137046,3703046,12434000,2015_boxofficemojo_rankings.csv,2015,0.22947483696830262,0.7705251630316974
4836,D.C. Cab,16134627,16134627,0,1983_boxofficemojo_rankings.csv,1983,1.0,0.0
4837,"Bright Lights, Big City",16118077,16118077,0,1988_boxofficemojo_rankings.csv,1988,1.0,0.0
4838,Death Wish 3,16116878,16116878,0,1985_boxofficemojo_rankings.csv,1985,1.0,0.0
4839,The Prophecy,16115878,16115878,0,1995_boxofficemojo_rankings.csv,1995,1.0,0.0
4840,Death Wish II,16100000,16100000,0,1982_boxofficemojo_rankings.csv,1982,1.0,0.0
4841,No Holds Barred,16093651,16093651,0,1989_boxofficemojo_rankings.csv,1989,1.0,0.0
4842,The Space Between Us,16080475,7885294,8195181,2017_boxofficemojo_rankings.csv,2017,0.4903644948299102,0.5096355051700898
4843,A Midsummer Night's Dream,16071990,16071990,0,1999_boxofficemojo_rankings.csv,1999,1.0,0.0
4844,To Be and to Have,16063920,777129,15286791,2002_boxofficemojo_rankings.csv,2002,0.04837729520565341,0.9516227047943466
4845,Over the Top,16057580,16057580,0,1987_boxofficemojo_rankings.csv,1987,1.0,0.0
4846,She's Having a Baby,16031707,16031707,0,1988_boxofficemojo_rankings.csv,1988,1.0,0.0
4847,Unfriended: Dark Web,16024987,8866745,7158242,2018_boxofficemojo_rankings.csv,2018,0.5533074691417846,0.44669253085821536
4848,Across the Sea of Time,16015639,16015639,0,1995_boxofficemojo_rankings.csv,1995,1.0,0.0
4849,Sea Rex 3D: Journey to a Prehistoric World,16004150,6096582,9907568,2010_boxofficemojo_rankings.csv,2010,0.38093756931795814,0.6190624306820418
4850,The Devil and Max Devlin,16000000,16000000,0,1981_boxofficemojo_rankings.csv,1981,1.0,0.0
4851,What the #$*! Do We (K)now!?,15998178,10942306,5055872,2004_boxofficemojo_rankings.csv,2004,0.6839720123129022,0.3160279876870979
4852,The Kitchen,15980032,12180032,3800000,2019_boxofficemojo_rankings.csv,2019,0.762203229630579,0.23779677036942104
4853,Caveman,15965924,15965924,0,1981_boxofficemojo_rankings.csv,1981,1.0,0.0
4854,The Words,15950164,11494838,4455326,2012_boxofficemojo_rankings.csv,2012,0.7206720883873043,0.27932791161269566
4855,Armed and Dangerous,15945534,15945534,0,1986_boxofficemojo_rankings.csv,1986,1.0,0.0
4856,Next of Kin,15942628,15942628,0,1989_boxofficemojo_rankings.csv,1989,1.0,0.0
4857,Before Sunset,15936507,5820649,10115858,2004_boxofficemojo_rankings.csv,2004,0.3652399487541404,0.6347600512458595
4858,Jason Goes to Hell: The Final Friday,15935068,15935068,0,1993_boxofficemojo_rankings.csv,1993,1.0,0.0
4859,Hero at Large,15934737,15934737,0,1980_boxofficemojo_rankings.csv,1980,1.0,0.0
4860,Dance with Me,15923122,15923122,0,1998_boxofficemojo_rankings.csv,1998,1.0,0.0
4861,Drowning Mona,15906764,15506764,400000,2000_boxofficemojo_rankings.csv,2000,0.974853464853065,0.025146535146934976
4862,The Nightmare Before Christmas 2008 3D Release,15894421,14486897,1407524,2007_boxofficemojo_rankings.csv,2007,0.9114454059068903,0.08855459409310978
4863,Wonder Wheel,15889124,1404061,14485063,2017_boxofficemojo_rankings.csv,2017,0.08836616795236792,0.911633832047632
4864,The Next Karate Kid,15876353,8914777,6961576,1994_boxofficemojo_rankings.csv,1994,0.5615128990896083,0.4384871009103917
4865,Gorky Park,15856028,15856028,0,1983_boxofficemojo_rankings.csv,1983,1.0,0.0
4866,Masquerade,15855828,15855828,0,1988_boxofficemojo_rankings.csv,1988,1.0,0.0
4867,The Last Kiss,15852401,11614790,4237611,2006_boxofficemojo_rankings.csv,2006,0.7326833329537904,0.2673166670462096
4868,Highlander: Endgame,15843608,12811858,3031750,2000_boxofficemojo_rankings.csv,2000,0.8086452277789251,0.1913547722210749
4869,The Hunt,15843274,613308,15229966,2012_boxofficemojo_rankings.csv,2012,0.038710938155838245,0.9612890618441617
4870,"I Love You, Beth Cooper",15821907,14800725,1021182,2009_boxofficemojo_rankings.csv,2009,0.9354577169490378,0.06454228305096218
4871,The Long Riders,15795189,15795189,0,1980_boxofficemojo_rankings.csv,1980,1.0,0.0
4872,"I, Daniel Blake",15793051,260354,15532697,2016_boxofficemojo_rankings.csv,2016,0.01648535169043651,0.9835146483095635
4873,The Great Yokai War,15787492,0,15787492,2005_boxofficemojo_rankings.csv,2005,0.0,1.0
4874,Kiss Kiss Bang Bang,15785148,4243756,11541392,2005_boxofficemojo_rankings.csv,2005,0.26884486607284264,0.7311551339271574
4875,Kiss Me Goodbye,15782759,15782759,0,1982_boxofficemojo_rankings.csv,1982,1.0,0.0
4876,Away We Go,15779455,9451946,6327509,2009_boxofficemojo_rankings.csv,2009,0.5990033242592979,0.4009966757407021
4877,The Gospel,15778152,15778152,0,2005_boxofficemojo_rankings.csv,2005,1.0,0.0
4878,Finding Your Feet,15775555,1418682,14356873,2018_boxofficemojo_rankings.csv,2018,0.08992913403046676,0.9100708659695332
4879,Shine a Light,15773351,5505267,10268084,2008_boxofficemojo_rankings.csv,2008,0.3490232988538707,0.6509767011461293
4880,Black Sunday,15769322,15769322,0,1977_boxofficemojo_rankings.csv,1977,1.0,0.0
4881,Lantana,15747450,4623189,11124261,2001_boxofficemojo_rankings.csv,2001,0.2935833420649058,0.7064166579350942
4882,Avalon,15740796,15740796,0,1990_boxofficemojo_rankings.csv,1990,1.0,0.0
4883,Wishmaster,15738769,15738769,0,1997_boxofficemojo_rankings.csv,1997,1.0,0.0
4884,I Hate Luv Storys,15719212,847993,14871219,2010_boxofficemojo_rankings.csv,2010,0.053946279240969584,0.9460537207590304
4885,The Island,15716828,15716828,0,1980_boxofficemojo_rankings.csv,1980,1.0,0.0
4886,The Brand New Testament,15709652,127910,15581742,2015_boxofficemojo_rankings.csv,2015,0.008142128164264873,0.9918578718357351
4887,Enigma 2001 Re-release,15705007,4301582,11403425,2001_boxofficemojo_rankings.csv,2001,0.27389876362360105,0.7261012363763989
4888,Leviathan,15704614,15704614,0,1989_boxofficemojo_rankings.csv,1989,1.0,0.0
4889,Feng Shui,15702302,64147,15638155,2018_boxofficemojo_rankings.csv,2018,0.004085197189558576,0.9959148028104414
4890,Close Encounters of the Third Kind 1980 Special Edition,15693175,15693175,0,1980_boxofficemojo_rankings.csv,1980,1.0,0.0
4891,Judy Moody and the Not Bummer Summer,15691640,15013650,677990,2011_boxofficemojo_rankings.csv,2011,0.956792916482917,0.04320708351708298
4892,The Bonfire of the Vanities,15691192,15691192,0,1990_boxofficemojo_rankings.csv,1990,1.0,0.0
4893,Superman IV: The Quest for Peace,15681020,15681020,0,1987_boxofficemojo_rankings.csv,1987,1.0,0.0
4894,Larry the Cable Guy: Health Inspector,15680099,15680099,0,2006_boxofficemojo_rankings.csv,2006,1.0,0.0
4895,Out of the Furnace,15660668,11330849,4329819,2013_boxofficemojo_rankings.csv,2013,0.723522713079672,0.276477286920328
4896,I Still Believe,15647958,9868521,5779437,2020_boxofficemojo_rankings.csv,2020,0.6306587095900947,0.36934129040990527
4897,Revenge,15645616,15645616,0,1990_boxofficemojo_rankings.csv,1990,1.0,0.0
4898,The Divine Move 2: The Wrathful,15642991,67578,15575413,2019_boxofficemojo_rankings.csv,2019,0.004320017827792652,0.9956799821722073
4899,Vampire Academy,15642346,7791979,7850367,2014_boxofficemojo_rankings.csv,2014,0.4981336559106927,0.5018663440893073
4900,Tully,15636462,9369755,6266707,2018_boxofficemojo_rankings.csv,2018,0.5992247479001324,0.4007752520998676
4901,The Conspirator,15623183,11538204,4084979,2011_boxofficemojo_rankings.csv,2011,0.7385309382857513,0.2614690617142486
4902,Living Out Loud,15610299,12905901,2704398,1998_boxofficemojo_rankings.csv,1998,0.8267555285135794,0.1732444714864206
4903,Continental Divide,15578237,15578237,0,1981_boxofficemojo_rankings.csv,1981,1.0,0.0
4904,Billy Bathgate,15565363,15565363,0,1991_boxofficemojo_rankings.csv,1991,1.0,0.0
4905,Highlander II: The Quickening,15556340,15556340,0,1991_boxofficemojo_rankings.csv,1991,1.0,0.0
4906,Switch,15545943,15545943,0,1991_boxofficemojo_rankings.csv,1991,1.0,0.0
4907,Still Smokin,15543710,15543710,0,1983_boxofficemojo_rankings.csv,1983,1.0,0.0
4908,Facing Windows,15530077,543354,14986723,2003_boxofficemojo_rankings.csv,2003,0.03498720579427906,0.965012794205721
4909,Corvette Summer,15514367,15514367,0,1978_boxofficemojo_rankings.csv,1978,1.0,0.0
4910,Legend,15502112,15502112,0,1986_boxofficemojo_rankings.csv,1986,1.0,0.0
4911,Paranoia,15500644,7388654,8111990,2013_boxofficemojo_rankings.csv,2013,0.47666755007082284,0.5233324499291772
4912,Muriel's Wedding,15482277,15119639,362638,1995_boxofficemojo_rankings.csv,1995,0.9765772179376457,0.023422782062354264
4913,Star Wars: Episode IV - A New Hope 1982 Re-release,15476785,15476785,0,1982_boxofficemojo_rankings.csv,1982,1.0,0.0
4914,With a Friend Like Harry...,15472186,3830441,11641745,2001_boxofficemojo_rankings.csv,2001,0.24756947725421605,0.7524305227457839
4915,Bait,15471969,15325127,146842,2000_boxofficemojo_rankings.csv,2000,0.9905091588536663,0.009490841146333735
4916,Zelary,15461305,330033,15131272,2003_boxofficemojo_rankings.csv,2003,0.02134574022050532,0.9786542597794947
4917,Chronicles of Evil,15460494,105057,15355437,2015_boxofficemojo_rankings.csv,2015,0.006795190373606432,0.9932048096263936
4918,Mad Love,15453274,15453274,0,1995_boxofficemojo_rankings.csv,1995,1.0,0.0
4919,Youngblood,15448384,15448384,0,1986_boxofficemojo_rankings.csv,1986,1.0,0.0
4920,RocketMan,15448043,15448043,0,1997_boxofficemojo_rankings.csv,1997,1.0,0.0
4921,Reversal of Fortune,15445131,15445131,0,1990_boxofficemojo_rankings.csv,1990,1.0,0.0
4922,The Greatest Game Ever Played,15431177,15337393,93784,2005_boxofficemojo_rankings.csv,2005,0.9939224337845389,0.006077566215461076
4923,A Kiss Before Dying,15429177,15429177,0,1991_boxofficemojo_rankings.csv,1991,1.0,0.0
4924,The Haunting of Molly Hartley,15418749,13559812,1858937,2008_boxofficemojo_rankings.csv,2008,0.8794365872354495,0.12056341276455049
4925,Our Little Sister,15407615,64441,15343174,2015_boxofficemojo_rankings.csv,2015,0.004182412398025262,0.9958175876019747
4926,Anonymous,15395087,4463292,10931795,2011_boxofficemojo_rankings.csv,2011,0.2899166467847827,0.7100833532152173
4927,Miss Bala,15383580,15006824,376756,2019_boxofficemojo_rankings.csv,2019,0.9755092117699521,0.024490788230047883
4928,Mr. Destiny,15379253,15379253,0,1990_boxofficemojo_rankings.csv,1990,1.0,0.0
4929,Spaced Invaders,15369573,15369573,0,1990_boxofficemojo_rankings.csv,1990,1.0,0.0
4930,Alex & Emma,15368897,14218698,1150199,2003_boxofficemojo_rankings.csv,2003,0.9251606019612207,0.07483939803877923
4931,When Harry Met Sejal,15360368,1664648,13695720,2017_boxofficemojo_rankings.csv,2017,0.10837292439868629,0.8916270756013137
4932,She-Devil,15351421,15351421,0,1989_boxofficemojo_rankings.csv,1989,1.0,0.0
4933,Apollo 11,15342353,9039891,6302462,2019_boxofficemojo_rankings.csv,2019,0.5892115114285273,0.4107884885714727
4934,No Escape,15339030,15339030,0,1994_boxofficemojo_rankings.csv,1994,1.0,0.0
4935,The Dead Don't Die,15322395,6563605,8758790,2019_boxofficemojo_rankings.csv,2019,0.42836677947540186,0.5716332205245982
4936,Thinner,15315484,15315484,0,1996_boxofficemojo_rankings.csv,1996,1.0,0.0
4937,"The Goods: Live Hard, Sell Hard",15300885,15122676,178209,2009_boxofficemojo_rankings.csv,2009,0.9883530266386552,0.011646973361344785
4938,Primeval,15291277,10597734,4693543,2007_boxofficemojo_rankings.csv,2007,0.6930574863041197,0.3069425136958803
4939,Hair,15284643,15284643,0,1979_boxofficemojo_rankings.csv,1979,1.0,0.0
4940,Namastey London,15273747,1207007,14066740,2007_boxofficemojo_rankings.csv,2007,0.07902494391192941,0.9209750560880706
4941,Quick Change,15260154,15260154,0,1990_boxofficemojo_rankings.csv,1990,1.0,0.0
4942,Brother,15250594,450594,14800000,2001_boxofficemojo_rankings.csv,2001,0.029545996700194106,0.9704540032998059
4943,Hey Arnold! The Movie,15249308,13728902,1520406,2002_boxofficemojo_rankings.csv,2002,0.9002967216610748,0.09970327833892528
4944,Ta Ra Rum Pum,15242548,872643,14369905,2007_boxofficemojo_rankings.csv,2007,0.0572504675727444,0.9427495324272556
4945,Bad Girls,15240435,15240435,0,1994_boxofficemojo_rankings.csv,1994,1.0,0.0
4946,The Madness of King George,15238689,15238689,0,1994_boxofficemojo_rankings.csv,1994,1.0,0.0
4947,The Negotiation,15229193,110986,15118207,2018_boxofficemojo_rankings.csv,2018,0.0072877138007247004,0.9927122861992753
4948,First Family,15198912,15198912,0,1980_boxofficemojo_rankings.csv,1980,1.0,0.0
4949,Attack on Titan Part 2,15186410,305934,14880476,2015_boxofficemojo_rankings.csv,2015,0.020145248284485932,0.9798547517155141
4950,Needful Things,15185672,15185672,0,1993_boxofficemojo_rankings.csv,1993,1.0,0.0
4951,Grease 2,15171476,15171476,0,1982_boxofficemojo_rankings.csv,1982,1.0,0.0
4952,Pure Country,15164458,15164458,0,1992_boxofficemojo_rankings.csv,1992,1.0,0.0
4953,Spectacle,15159762,2065487,13094275,2015_boxofficemojo_rankings.csv,2015,0.13624798331266677,0.8637520166873333
4954,Transamerica,15151744,9015303,6136441,2005_boxofficemojo_rankings.csv,2005,0.5950010111047283,0.40499898889527175
4955,Flowers in the Attic,15151736,15151736,0,1987_boxofficemojo_rankings.csv,1987,1.0,0.0
4956,Extraordinary Measures,15134293,12068313,3065980,2010_boxofficemojo_rankings.csv,2010,0.7974150493848638,0.2025849506151361
4957,Irreplaceable,15130912,8494,15122418,2016_boxofficemojo_rankings.csv,2016,0.0005613673518159382,0.9994386326481841
4958,Surviving Christmas,15125687,11663156,3462531,2004_boxofficemojo_rankings.csv,2004,0.7710827283415292,0.22891727165847078
4959,Big Top Pee-wee,15122324,15122324,0,1988_boxofficemojo_rankings.csv,1988,1.0,0.0
4960,Three,15121228,119550,15001678,2016_boxofficemojo_rankings.csv,2016,0.007906103922247585,0.9920938960777524
4961,The Dreamers,15121165,2532228,12588937,2003_boxofficemojo_rankings.csv,2003,0.1674624937959476,0.8325375062040524
4962,Sleeping Beauty 1986 Re-release,15120195,15120195,0,1986_boxofficemojo_rankings.csv,1986,1.0,0.0
4963,Halloween: The Curse of Michael Myers,15116634,15116634,0,1995_boxofficemojo_rankings.csv,1995,1.0,0.0
4964,The Science of Sleep,15116179,4670644,10445535,2006_boxofficemojo_rankings.csv,2006,0.3089831100835734,0.6910168899164266
4965,Shipwrecked,15104156,15104156,0,1991_boxofficemojo_rankings.csv,1991,1.0,0.0
4966,Breakin' 2: Electric Boogaloo,15101131,15101131,0,1984_boxofficemojo_rankings.csv,1984,1.0,0.0
4967,The Adventures of Pinocchio,15094530,15094530,0,1996_boxofficemojo_rankings.csv,1996,1.0,0.0
4968,War of the Buttons,15082409,47771,15034638,2011_boxofficemojo_rankings.csv,2011,0.003167332221265184,0.9968326677787348
4969,Toy Soldiers,15073942,15073942,0,1991_boxofficemojo_rankings.csv,1991,1.0,0.0
4970,Dead Man on Campus,15064946,15064946,0,1998_boxofficemojo_rankings.csv,1998,1.0,0.0
4971,Ip Man 2,15061802,205675,14856127,2010_boxofficemojo_rankings.csv,2010,0.013655404579080245,0.9863445954209198
4972,King Solomon's Mines,15057465,15057465,0,1985_boxofficemojo_rankings.csv,1985,1.0,0.0
4973,Twilight,15055091,15055091,0,1998_boxofficemojo_rankings.csv,1998,1.0,0.0
4974,Wings of Courage,15054636,15054636,0,1995_boxofficemojo_rankings.csv,1995,1.0,0.0
4975,Hanyo,15038301,157961,14880340,2010_boxofficemojo_rankings.csv,2010,0.01050391264279123,0.9894960873572087
4976,Boat Trip,15020293,8600126,6420167,2002_boxofficemojo_rankings.csv,2002,0.5725671263536604,0.42743287364633964
4977,Change of Plans,15016366,46714,14969652,2009_boxofficemojo_rankings.csv,2009,0.0031108724973805246,0.9968891275026195
4978,More American Graffiti,15014674,15014674,0,1979_boxofficemojo_rankings.csv,1979,1.0,0.0
4979,The Assassination of Jesse James by the Coward Robert Ford,15001776,3909149,11092627,2007_boxofficemojo_rankings.csv,2007,0.26057908077017017,0.7394209192298299
4980,Journey to the South Pacific,14994876,7653913,7340963,2013_boxofficemojo_rankings.csv,2013,0.510435231341693,0.489564768658307
4981,Oldboy,14980005,707481,14272524,2003_boxofficemojo_rankings.csv,2003,0.0472283553977452,0.9527716446022548
4982,Baby: Secret of the Lost Legend,14972297,14972297,0,1985_boxofficemojo_rankings.csv,1985,1.0,0.0
4983,Undisputed,14946150,12764657,2181493,2002_boxofficemojo_rankings.csv,2002,0.8540431482354988,0.14595685176450124
4984,Kiss of Death,14942422,14942422,0,1995_boxofficemojo_rankings.csv,1995,1.0,0.0
4985,The Meaning of Life,14929552,14929552,0,1983_boxofficemojo_rankings.csv,1983,1.0,0.0
4986,The Night the Lights Went Out in Georgia,14923752,14923752,0,1981_boxofficemojo_rankings.csv,1981,1.0,0.0
4987,Ragtime,14920781,14920781,0,1981_boxofficemojo_rankings.csv,1981,1.0,0.0
4988,The Commitments,14919570,14919570,0,1991_boxofficemojo_rankings.csv,1991,1.0,0.0
4989,Indian Summer,14904910,14904910,0,1993_boxofficemojo_rankings.csv,1993,1.0,0.0
4990,Election,14902041,14902041,0,1999_boxofficemojo_rankings.csv,1999,1.0,0.0
4991,Elegy,14894347,3581642,11312705,2008_boxofficemojo_rankings.csv,2008,0.24046989102644112,0.7595301089735589
4992,Blue Valentine,14892418,9706328,5186090,2010_boxofficemojo_rankings.csv,2010,0.651763064936802,0.3482369350631979
4993,Gold,14880939,7227038,7653901,2017_boxofficemojo_rankings.csv,2017,0.4856573903031254,0.5143426096968746
4994,School of Life,14880497,6300,14874197,2017_boxofficemojo_rankings.csv,2017,0.00042337295588984697,0.9995766270441101
4995,Raise Your Voice,14867514,10411980,4455534,2004_boxofficemojo_rankings.csv,2004,0.7003174841469798,0.2996825158530202
4996,S.O.B.,14867086,14867086,0,1981_boxofficemojo_rankings.csv,1981,1.0,0.0
4997,Josie and the Pussycats,14866015,14271015,595000,2001_boxofficemojo_rankings.csv,2001,0.9599758240523771,0.040024175947622816
4998,Music of the Heart,14859394,14859394,0,1999_boxofficemojo_rankings.csv,1999,1.0,0.0
4999,Emperor,14858240,3346265,11511975,2013_boxofficemojo_rankings.csv,2013,0.22521274390506546,0.7747872560949345
5000,The Take,14857808,50269,14807539,2016_boxofficemojo_rankings.csv,2016,0.0033833389151347224,0.9966166610848652
5001,Once Around,14851083,14851083,0,1991_boxofficemojo_rankings.csv,1991,1.0,0.0
5002,Eve's Bayou,14842388,14842388,0,1997_boxofficemojo_rankings.csv,1997,1.0,0.0
5003,The Wizard of Oz 1998 Re-release,14836984,14836984,0,1998_boxofficemojo_rankings.csv,1998,1.0,0.0
5004,Supernova,14828081,14230455,597626,2000_boxofficemojo_rankings.csv,2000,0.9596963356215817,0.040303664378418216
5005,Soul Plane,14821824,14190750,631074,2004_boxofficemojo_rankings.csv,2004,0.9574226491962123,0.04257735080378771
5006,Little Children,14821658,5463019,9358639,2006_boxofficemojo_rankings.csv,2006,0.3685835282395532,0.6314164717604468
5007,The Substitute,14818176,14818176,0,1996_boxofficemojo_rankings.csv,1996,1.0,0.0
5008,Possession,14815898,10113733,4702165,2002_boxofficemojo_rankings.csv,2002,0.6826270672219801,0.3173729327780199
5009,Threesome,14815317,14815317,0,1994_boxofficemojo_rankings.csv,1994,1.0,0.0
5010,All I Want for Christmas,14812144,14812144,0,1991_boxofficemojo_rankings.csv,1991,1.0,0.0
5011,Ladybugs,14796494,14796494,0,1992_boxofficemojo_rankings.csv,1992,1.0,0.0
5012,Prom Night,14796236,14796236,0,1980_boxofficemojo_rankings.csv,1980,1.0,0.0
5013,Radio Days,14792779,14792779,0,1987_boxofficemojo_rankings.csv,1987,1.0,0.0
5014,Not Without My Daughter,14789113,14789113,0,1991_boxofficemojo_rankings.csv,1991,1.0,0.0
5015,Somewhere,14788642,1785645,13002997,2010_boxofficemojo_rankings.csv,2010,0.12074435232119352,0.8792556476788065
5016,Dabangg 3,14784628,202000,14582628,2019_boxofficemojo_rankings.csv,2019,0.013662839538471985,0.986337160461528
5017,Out Cold,14782676,13906394,876282,2001_boxofficemojo_rankings.csv,2001,0.940722369887563,0.059277630112437016
5018,Seondal: The Man Who Sells the River,14777982,97477,14680505,2016_boxofficemojo_rankings.csv,2016,0.006596096814842514,0.9934039031851575
5019,The Secret of the Grain,14776783,86356,14690427,2007_boxofficemojo_rankings.csv,2007,0.005844032493405364,0.9941559675065946
5020,The Triplets of Belleville,14776760,7007149,7769611,2003_boxofficemojo_rankings.csv,2003,0.47420063667542817,0.5257993633245718
5021,The Sixth Man,14772788,14772788,0,1997_boxofficemojo_rankings.csv,1997,1.0,0.0
5022,Katyn,14768451,118095,14650356,2007_boxofficemojo_rankings.csv,2007,0.007996437811927602,0.9920035621880724
5023,Fire Birds,14760451,14760451,0,1990_boxofficemojo_rankings.csv,1990,1.0,0.0
5024,Elite Squad,14759148,8744,14750404,2007_boxofficemojo_rankings.csv,2007,0.0005924461222287356,0.9994075538777712
5025,A Royal Affair,14758997,1546761,13212236,2012_boxofficemojo_rankings.csv,2012,0.10480122734627563,0.8951987726537244
5026,Made in India,14751915,790628,13961287,2018_boxofficemojo_rankings.csv,2018,0.053594940046766806,0.9464050599532332
5027,My Left Foot,14743391,14743391,0,1989_boxofficemojo_rankings.csv,1989,1.0,0.0
5028,Bhagam Bhag,14730896,789963,13940933,2006_boxofficemojo_rankings.csv,2006,0.053626269576541714,0.9463737304234583
5029,Orca,14717854,14717854,0,1977_boxofficemojo_rankings.csv,1977,1.0,0.0
5030,School Ties,14715067,14715067,0,1992_boxofficemojo_rankings.csv,1992,1.0,0.0
5031,Sword Master,14714624,75526,14639098,2016_boxofficemojo_rankings.csv,2016,0.005132716948798691,0.9948672830512013
5032,Inherent Vice,14710975,8110975,6600000,2014_boxofficemojo_rankings.csv,2014,0.5513553656368799,0.4486446343631201
5033,Flirting with Disaster,14702438,14702438,0,1996_boxofficemojo_rankings.csv,1996,1.0,0.0
5034,Turistas,14697742,7027762,7669980,2006_boxofficemojo_rankings.csv,2006,0.47815249444438473,0.5218475055556153
5035,Kickboxer,14697005,14697005,0,1989_boxofficemojo_rankings.csv,1989,1.0,0.0
5036,The Hedgehog,14695775,707945,13987830,2009_boxofficemojo_rankings.csv,2009,0.04817336955689645,0.9518266304431036
5037,Iron Monkey,14694904,14694904,0,2001_boxofficemojo_rankings.csv,2001,1.0,0.0
5038,The Way Back,14690514,13590514,1100000,2020_boxofficemojo_rankings.csv,2020,0.9251217486331655,0.0748782513668344
5039,My Best Friend,14687738,1426784,13260954,2006_boxofficemojo_rankings.csv,2006,0.09714116632527078,0.9028588336747292
5040,Together with You,14687167,1151941,13535226,2003_boxofficemojo_rankings.csv,2003,0.07843180376447002,0.92156819623553
5041,City of Joy,14683921,14683921,0,1992_boxofficemojo_rankings.csv,1992,1.0,0.0
5042,Desert Flower 2009 Re-release,14682943,44348,14638595,2009_boxofficemojo_rankings.csv,2009,0.003020375411114788,0.9969796245888852
5043,Arthur 2: On the Rocks,14681192,14681192,0,1988_boxofficemojo_rankings.csv,1988,1.0,0.0
5044,The Greek Tycoon,14672713,14672713,0,1978_boxofficemojo_rankings.csv,1978,1.0,0.0
5045,The Secret of NIMH,14665733,14665733,0,1982_boxofficemojo_rankings.csv,1982,1.0,0.0
5046,The Nude Bomb,14662035,14662035,0,1980_boxofficemojo_rankings.csv,1980,1.0,0.0
5047,"Hello, My Name Is Doris",14659448,14444999,214449,2016_boxofficemojo_rankings.csv,2016,0.985371277281382,0.014628722718618054
5048,Freedomland,14655628,12512886,2142742,2006_boxofficemojo_rankings.csv,2006,0.8537939145289442,0.1462060854710559
5049,Educating Rita,14648076,14648076,0,1983_boxofficemojo_rankings.csv,1983,1.0,0.0
5050,Clue,14643997,14643997,0,1985_boxofficemojo_rankings.csv,1985,1.0,0.0
5051,Beyond the Lights,14618727,14618727,0,2014_boxofficemojo_rankings.csv,2014,1.0,0.0
5052,Welcome to Mooseport,14615099,14470947,144152,2004_boxofficemojo_rankings.csv,2004,0.9901367756728846,0.009863224327115403
5053,Trial and Error,14598571,13602831,995740,1997_boxofficemojo_rankings.csv,1997,0.9317919541577049,0.06820804584229512
5054,Soldier,14594226,14594226,0,1998_boxofficemojo_rankings.csv,1998,1.0,0.0
5055,Flight of the Intruder,14587732,14587732,0,1991_boxofficemojo_rankings.csv,1991,1.0,0.0
5056,The Band's Visit,14587587,3054457,11533130,2007_boxofficemojo_rankings.csv,2007,0.2093874058814525,0.7906125941185475
5057,Together,14572229,1034829,13537400,2001_boxofficemojo_rankings.csv,2001,0.07101377558642538,0.9289862244135746
5058,Hollywood Ending,14569744,4850753,9718991,2002_boxofficemojo_rankings.csv,2002,0.33293330342660793,0.6670666965733921
5059,Children of the Corn,14568989,14568989,0,1984_boxofficemojo_rankings.csv,1984,1.0,0.0
5060,Hellraiser,14564027,14564027,0,1987_boxofficemojo_rankings.csv,1987,1.0,0.0
5061,Wild at Heart,14560247,14560247,0,1990_boxofficemojo_rankings.csv,1990,1.0,0.0
5062,Death on the Nile,14560084,14560084,0,1978_boxofficemojo_rankings.csv,1978,1.0,0.0
5063,School Daze,14545844,14545844,0,1988_boxofficemojo_rankings.csv,1988,1.0,0.0
5064,The Vanishing,14543394,14543394,0,1993_boxofficemojo_rankings.csv,1993,1.0,0.0
5065,Excess Baggage,14515490,14515490,0,1997_boxofficemojo_rankings.csv,1997,1.0,0.0
5066,Megan Leavey,14510490,13406883,1103607,2017_boxofficemojo_rankings.csv,2017,0.9239441948548947,0.07605580514510536
5067,"Oh, God! Book II",14504277,14504277,0,1980_boxofficemojo_rankings.csv,1980,1.0,0.0
5068,Maximum Risk,14502483,14502483,0,1996_boxofficemojo_rankings.csv,1996,1.0,0.0
5069,Envy,14494036,13562325,931711,2004_boxofficemojo_rankings.csv,2004,0.9357176289613189,0.06428237103868101
5070,Malena,14493284,3448233,11045051,2000_boxofficemojo_rankings.csv,2000,0.23791937010273173,0.7620806298972683
5071,Rich and Famous,14492125,14492125,0,1981_boxofficemojo_rankings.csv,1981,1.0,0.0
5072,Psycho III,14481606,14481606,0,1986_boxofficemojo_rankings.csv,1986,1.0,0.0
5073,A United Kingdom,14459330,3902185,10557145,2016_boxofficemojo_rankings.csv,2016,0.269873154565253,0.7301268454347469
5074,Serenity,14454622,8547045,5907577,2019_boxofficemojo_rankings.csv,2019,0.5913018687033117,0.40869813129668836
5075,America: Imagine the World Without Her,14444502,14444502,0,2014_boxofficemojo_rankings.csv,2014,1.0,0.0
5076,RBG,14441292,14017361,423931,2018_boxofficemojo_rankings.csv,2018,0.9706445240495103,0.02935547595048975
5077,Unfinished Business,14431253,10219501,4211752,2015_boxofficemojo_rankings.csv,2015,0.7081506366772171,0.29184936332278283
5078,45 Years,14430249,4247285,10182964,2015_boxofficemojo_rankings.csv,2015,0.2943320659262359,0.705667934073764
5079,Night of the Comet,14418922,14418922,0,1984_boxofficemojo_rankings.csv,1984,1.0,0.0
5080,Do You Believe?,14410698,12985600,1425098,2015_boxofficemojo_rankings.csv,2015,0.9011083293814082,0.09889167061859183
5081,Woodlawn,14401617,14394097,7520,2015_boxofficemojo_rankings.csv,2015,0.9994778364123973,0.0005221635876026977
5082,Tea with Mussolini,14401563,14401563,0,1999_boxofficemojo_rankings.csv,1999,1.0,0.0
5083,I Dreamed of Africa,14400327,6651522,7748805,2000_boxofficemojo_rankings.csv,2000,0.4619007610035522,0.5380992389964477
5084,Halloween III: Season of the Witch,14400000,14400000,0,1982_boxofficemojo_rankings.csv,1982,1.0,0.0
5085,Remo Williams: The Adventure Begins,14393902,14393902,0,1985_boxofficemojo_rankings.csv,1985,1.0,0.0
5086,How to Deal,14390329,14195227,195102,2003_boxofficemojo_rankings.csv,2003,0.986442144581962,0.013557855418038044
5087,Ishtar,14375181,14375181,0,1987_boxofficemojo_rankings.csv,1987,1.0,0.0
5088,Bright Star,14374652,4444637,9930015,2009_boxofficemojo_rankings.csv,2009,0.30919962445003885,0.6908003755499611
5089,The Buddy Holly Story,14363400,14363400,0,1978_boxofficemojo_rankings.csv,1978,1.0,0.0
5090,Memoirs of an Invisible Man,14358033,14358033,0,1992_boxofficemojo_rankings.csv,1992,1.0,0.0
5091,Rapid Fire,14356479,14356479,0,1992_boxofficemojo_rankings.csv,1992,1.0,0.0
5092,Hot Rod,14353654,13938332,415322,2007_boxofficemojo_rankings.csv,2007,0.971065068170098,0.028934931829901988
5093,Eighth Grade,14347433,13539709,807724,2018_boxofficemojo_rankings.csv,2018,0.9437025424687469,0.056297457531253155
5094,Friday the 13th Part VIII: Jason Takes Manhattan,14343976,14343976,0,1989_boxofficemojo_rankings.csv,1989,1.0,0.0
5095,Being Julia,14339171,7739049,6600122,2004_boxofficemojo_rankings.csv,2004,0.5397138370133113,0.4602861629866887
5096,Freddy Got Fingered,14333252,14254993,78259,2001_boxofficemojo_rankings.csv,2001,0.9945400387853364,0.005459961214663637
5097,The Other Side of the Door,14332467,3000342,11332125,2016_boxofficemojo_rankings.csv,2016,0.20933883887540086,0.7906611611245992
5098,Beginners,14311701,5790894,8520807,2011_boxofficemojo_rankings.csv,2011,0.4046265360071455,0.5953734639928545
5099,The Mosquito Coast,14302779,14302779,0,1986_boxofficemojo_rankings.csv,1986,1.0,0.0
5100,The Beauty Inside,14301869,108083,14193786,2015_boxofficemojo_rankings.csv,2015,0.007557264019129248,0.9924427359808707
5101,Supergirl,14296438,14296438,0,1984_boxofficemojo_rankings.csv,1984,1.0,0.0
5102,Unsane,14293601,7732899,6560702,2018_boxofficemojo_rankings.csv,2018,0.5410042577794077,0.45899574222059225
5103,The Competition,14287755,14287755,0,1980_boxofficemojo_rankings.csv,1980,1.0,0.0
5104,The Wizard,14278900,14278900,0,1989_boxofficemojo_rankings.csv,1989,1.0,0.0
5105,Stealing Harvard,14277032,14036406,240626,2002_boxofficemojo_rankings.csv,2002,0.9831459367745341,0.01685406322546591
5106,Colette,14273033,5137622,9135411,2018_boxofficemojo_rankings.csv,2018,0.35995306673781247,0.6400469332621875
5107,The Ice Pirates,14255801,14255801,0,1984_boxofficemojo_rankings.csv,1984,1.0,0.0
5108,Caramel,14248749,1055580,13193169,2007_boxofficemojo_rankings.csv,2007,0.07408229311920647,0.9259177068807936
5109,The Return of the Living Dead,14237880,14237880,0,1985_boxofficemojo_rankings.csv,1985,1.0,0.0
5110,Scanners,14225876,14225876,0,1981_boxofficemojo_rankings.csv,1981,1.0,0.0
5111,La Belle Époque,14223716,0,14223716,2019_boxofficemojo_rankings.csv,2019,0.0,1.0
5112,Sweet Liberty,14205021,14205021,0,1986_boxofficemojo_rankings.csv,1986,1.0,0.0
5113,A Chorus Line,14202899,14202899,0,1985_boxofficemojo_rankings.csv,1985,1.0,0.0
5114,Proof,14189860,7535331,6654529,2005_boxofficemojo_rankings.csv,2005,0.5310363174830478,0.46896368251695225
5115,Prince of Darkness,14182492,14182492,0,1987_boxofficemojo_rankings.csv,1987,1.0,0.0
5116,Wholly Moses!,14155617,14155617,0,1980_boxofficemojo_rankings.csv,1980,1.0,0.0
5117,What Planet Are You From?,14145677,6291602,7854075,2000_boxofficemojo_rankings.csv,2000,0.4447720671128006,0.5552279328871994
5118,Ernest Scared Stupid,14143280,14143280,0,1991_boxofficemojo_rankings.csv,1991,1.0,0.0
5119,Ya veremos,14134723,4165949,9968774,2018_boxofficemojo_rankings.csv,2018,0.2947315628328903,0.7052684371671096
5120,Shaandaar,14120808,521794,13599014,2015_boxofficemojo_rankings.csv,2015,0.03695213475036273,0.9630478652496373
5121,Poltergeist III,14114488,14114488,0,1988_boxofficemojo_rankings.csv,1988,1.0,0.0
5122,Cool World,14110589,14110589,0,1992_boxofficemojo_rankings.csv,1992,1.0,0.0
5123,Dragonslayer,14110013,14110013,0,1981_boxofficemojo_rankings.csv,1981,1.0,0.0
5124,Red Lights,14107313,52624,14054689,2012_boxofficemojo_rankings.csv,2012,0.0037302638709440982,0.9962697361290559
5125,District 13: Ultimatum,14103752,36136,14067616,2009_boxofficemojo_rankings.csv,2009,0.002562155091779833,0.9974378449082202
5126,Tomboy,14100000,14100000,0,1985_boxofficemojo_rankings.csv,1985,1.0,0.0
5127,Diner,14099953,14099953,0,1982_boxofficemojo_rankings.csv,1982,1.0,0.0
5128,Les Misérables,14096321,14096321,0,1998_boxofficemojo_rankings.csv,1998,1.0,0.0
5129,Seeking Justice,14089528,411746,13677782,2011_boxofficemojo_rankings.csv,2011,0.02922354815576505,0.970776451844235
5130,Island of Lemurs: Madagascar,14066534,11272213,2794321,2014_boxofficemojo_rankings.csv,2014,0.8013497141513325,0.19865028584866748
5131,The Arrival,14063331,14063331,0,1996_boxofficemojo_rankings.csv,1996,1.0,0.0
5132,The Perfect Weapon,14061361,14061361,0,1991_boxofficemojo_rankings.csv,1991,1.0,0.0
5133,FairyTale: A True Story,14059077,14059077,0,1997_boxofficemojo_rankings.csv,1997,1.0,0.0
5134,The Beastmaster,14056528,14056528,0,1982_boxofficemojo_rankings.csv,1982,1.0,0.0
5135,Blues Brothers 2000,14051384,14051384,0,1998_boxofficemojo_rankings.csv,1998,1.0,0.0
5136,Private School,14049540,14049540,0,1983_boxofficemojo_rankings.csv,1983,1.0,0.0
5137,Osmosis Jones,14026418,13596911,429507,2001_boxofficemojo_rankings.csv,2001,0.9693787109438775,0.030621289056122526
5138,In Too Deep,14011454,14011454,0,1999_boxofficemojo_rankings.csv,1999,1.0,0.0
5139,Ghosts of Mars,14010832,8709640,5301192,2001_boxofficemojo_rankings.csv,2001,0.621636174068749,0.3783638259312509
5140,How to Be a Player,14009368,14009368,0,1997_boxofficemojo_rankings.csv,1997,1.0,0.0
5141,Creepshow 2,14000000,14000000,0,1987_boxofficemojo_rankings.csv,1987,1.0,0.0
5142,Missing,14000000,14000000,0,1982_boxofficemojo_rankings.csv,1982,1.0,0.0
5143,Mary Poppins 1980 Re-release,14000000,14000000,0,1980_boxofficemojo_rankings.csv,1980,1.0,0.0
5144,The Survivors,14000000,14000000,0,1983_boxofficemojo_rankings.csv,1983,1.0,0.0
5145,Kedarnath,13999297,901131,13098166,2018_boxofficemojo_rankings.csv,2018,0.06436973228012807,0.9356302677198719
5146,Stand and Deliver,13994920,13994920,0,1988_boxofficemojo_rankings.csv,1988,1.0,0.0
5147,Lord of the Flies,13985225,13985225,0,1990_boxofficemojo_rankings.csv,1990,1.0,0.0
5148,Follow That Bird,13961370,13961370,0,1985_boxofficemojo_rankings.csv,1985,1.0,0.0
5149,Candyman: Farewell to the Flesh,13940383,13940383,0,1995_boxofficemojo_rankings.csv,1995,1.0,0.0
5150,Tenacious D in the Pick of Destiny,13924254,8334575,5589679,2006_boxofficemojo_rankings.csv,2006,0.5985652804092773,0.4014347195907228
5151,Heyy Babyy,13921302,1443521,12477781,2007_boxofficemojo_rankings.csv,2007,0.10369152253144139,0.8963084774685586
5152,Dirty Pretty Things,13904766,8112414,5792352,2002_boxofficemojo_rankings.csv,2002,0.5834268624153761,0.4165731375846239
5153,Touching the Void,13885802,4593598,9292204,2003_boxofficemojo_rankings.csv,2003,0.33081258108102074,0.6691874189189793
5154,Drop Dead Fred,13878334,13878334,0,1991_boxofficemojo_rankings.csv,1991,1.0,0.0
5155,My Stepmother Is an Alien,13854000,13854000,0,1988_boxofficemojo_rankings.csv,1988,1.0,0.0
5156,Hamburger Hill,13839404,13839404,0,1987_boxofficemojo_rankings.csv,1987,1.0,0.0
5157,The Quake,13837294,6235,13831059,2018_boxofficemojo_rankings.csv,2018,0.0004505938805665327,0.9995494061194334
5158,The Milagro Beanfield War,13825794,13825794,0,1988_boxofficemojo_rankings.csv,1988,1.0,0.0
5159,House of the Dead,13818181,10249719,3568462,2003_boxofficemojo_rankings.csv,2003,0.7417560241829225,0.25824397581707753
5160,Desperate Measures,13806137,13806137,0,1998_boxofficemojo_rankings.csv,1998,1.0,0.0
5161,Juwanna Mann,13802599,13670733,131866,2002_boxofficemojo_rankings.csv,2002,0.9904462920352899,0.009553707964710124
5162,Winter's Bone,13796834,6531503,7265331,2010_boxofficemojo_rankings.csv,2010,0.47340592776574686,0.5265940722342531
5163,The Ladies Man,13743212,13616610,126602,2000_boxofficemojo_rankings.csv,2000,0.9907880341218632,0.009211965878136785
5164,Great Balls of Fire!,13741060,13741060,0,1989_boxofficemojo_rankings.csv,1989,1.0,0.0
5165,One Night with the King,13728450,13395961,332489,2006_boxofficemojo_rankings.csv,2006,0.9757810240777364,0.02421897592226362
5166,Pulling Strings,13725819,5842961,7882858,2013_boxofficemojo_rankings.csv,2013,0.4256912465478381,0.5743087534521619
5167,The Man Who Knew Too Little,13717039,13717039,0,1997_boxofficemojo_rankings.csv,1997,1.0,0.0
5168,The Wings of the Dove,13692848,13692848,0,1997_boxofficemojo_rankings.csv,1997,1.0,0.0
5169,Return to Snowy River,13687027,13687027,0,1988_boxofficemojo_rankings.csv,1988,1.0,0.0
5170,Tees Maar Khan,13681934,1076443,12605491,2010_boxofficemojo_rankings.csv,2010,0.0786762310065229,0.9213237689934771
5171,Nixon,13681765,13681765,0,1995_boxofficemojo_rankings.csv,1995,1.0,0.0
5172,American Outlaws,13678913,13342790,336123,2001_boxofficemojo_rankings.csv,2001,0.9754276527674385,0.024572347232561534
5173,One Magic Christmas,13677222,13677222,0,1985_boxofficemojo_rankings.csv,1985,1.0,0.0
5174,Phantom,13676590,489984,13186606,2015_boxofficemojo_rankings.csv,2015,0.03582647428927825,0.9641735257107218
5175,The Pagemaster,13670688,13670688,0,1994_boxofficemojo_rankings.csv,1994,1.0,0.0
5176,The Bride of Humpty Sharma,13669988,380011,13289977,2014_boxofficemojo_rankings.csv,2014,0.027798927109519044,0.972201072890481
5177,Vice Versa,13664060,13664060,0,1988_boxofficemojo_rankings.csv,1988,1.0,0.0
5178,Chloe,13657649,3075255,10582394,2010_boxofficemojo_rankings.csv,2010,0.2251672304655069,0.7748327695344931
5179,Crooklyn,13642861,13642861,0,1994_boxofficemojo_rankings.csv,1994,1.0,0.0
5180,Religulous,13639115,13011160,627955,2008_boxofficemojo_rankings.csv,2008,0.9539592561540833,0.046040743845916686
5181,All Is Lost,13627519,6263670,7363849,2013_boxofficemojo_rankings.csv,2013,0.45963392162579264,0.5403660783742074
5182,Sing Street,13624522,3237118,10387404,2016_boxofficemojo_rankings.csv,2016,0.23759497764398635,0.7624050223560137
5183,Sydney White,13620075,11892415,1727660,2007_boxofficemojo_rankings.csv,2007,0.8731534150876555,0.12684658491234446
5184,Do It Like An Hombre,13610252,2534252,11076000,2017_boxofficemojo_rankings.csv,2017,0.18620169560416663,0.8137983043958333
5185,The Crush,13609396,13609396,0,1993_boxofficemojo_rankings.csv,1993,1.0,0.0
5186,Love Forecast,13608637,32211,13576426,2015_boxofficemojo_rankings.csv,2015,0.0023669526933520232,0.9976330473066479
5187,Strange Magic,13603453,12429583,1173870,2015_boxofficemojo_rankings.csv,2015,0.9137079387123255,0.08629206128767454
5188,Anything Else,13585075,3212310,10372765,2003_boxofficemojo_rankings.csv,2003,0.23645876080919687,0.7635412391908032
5189,Hush,13583690,13583690,0,1998_boxofficemojo_rankings.csv,1998,1.0,0.0
5190,The Two Faces of January,13551951,507463,13044488,2014_boxofficemojo_rankings.csv,2014,0.03744575227581623,0.9625542477241837
5191,The Last Station,13550772,6617867,6932905,2009_boxofficemojo_rankings.csv,2009,0.48837564383785664,0.5116243561621434
5192,Nymphomaniac: Vol. I,13545832,785896,12759936,2013_boxofficemojo_rankings.csv,2013,0.05801755108139537,0.9419824489186046
5193,The Gate,13539458,13539458,0,1987_boxofficemojo_rankings.csv,1987,1.0,0.0
5194,The Comebacks,13539154,13349927,189227,2007_boxofficemojo_rankings.csv,2007,0.9860237205367485,0.013976279463251544
5195,Phantom of the Theatre,13526843,43955,13482888,2016_boxofficemojo_rankings.csv,2016,0.0032494647864250363,0.9967505352135749
5196,Africa's Elephant Kingdom,13485455,13485455,0,1998_boxofficemojo_rankings.csv,1998,1.0,0.0
5197,The Man,13485145,8330720,5154425,2005_boxofficemojo_rankings.csv,2005,0.6177701463350969,0.38222985366490314
5198,One Night at McCool's,13473370,6290673,7182697,2001_boxofficemojo_rankings.csv,2001,0.46689677489744585,0.5331032251025541
5199,Brideshead Revisited,13451186,6432256,7018930,2008_boxofficemojo_rankings.csv,2008,0.4781924805738319,0.5218075194261681
5200,Three Identical Strangers,13448497,12320845,1127652,2018_boxofficemojo_rankings.csv,2018,0.9161503326356841,0.08384966736431587
5201,The Grifters,13446769,13446769,0,1990_boxofficemojo_rankings.csv,1990,1.0,0.0
5202,Made in China,13439480,921738,12517742,2009_boxofficemojo_rankings.csv,2009,0.06858434998973174,0.9314156500102683
5203,One Crazy Summer,13431806,13431806,0,1986_boxofficemojo_rankings.csv,1986,1.0,0.0
5204,Bio-Dome,13427615,13427615,0,1996_boxofficemojo_rankings.csv,1996,1.0,0.0
5205,Extremities,13418091,13418091,0,1986_boxofficemojo_rankings.csv,1986,1.0,0.0
5206,Secrets & Lies,13417292,13417292,0,1996_boxofficemojo_rankings.csv,1996,1.0,0.0
5207,Trapped,13414416,7073251,6341165,2002_boxofficemojo_rankings.csv,2002,0.5272872855590582,0.47271271444094176
5208,Lords of Dogtown,13411957,11273517,2138440,2005_boxofficemojo_rankings.csv,2005,0.8405571983268363,0.15944280167316374
5209,The Third Murder,13411936,89315,13322621,2017_boxofficemojo_rankings.csv,2017,0.006659366701421778,0.9933406332985782
5210,The History Boys,13407101,2706659,10700442,2006_boxofficemojo_rankings.csv,2006,0.20188249495547173,0.7981175050445283
5211,A Kid in King Arthur's Court,13406717,13406717,0,1995_boxofficemojo_rankings.csv,1995,1.0,0.0
5212,Solarmax,13400161,13400161,0,2000_boxofficemojo_rankings.csv,2000,1.0,0.0
5213,Our President,13392049,507268,12884781,2017_boxofficemojo_rankings.csv,2017,0.03787829629356942,0.9621217037064306
5214,Ratchet & Clank,13385737,8821329,4564408,2016_boxofficemojo_rankings.csv,2016,0.6590095860989947,0.3409904139010052
5215,Bullets Over Broadway,13383747,13383747,0,1994_boxofficemojo_rankings.csv,1994,1.0,0.0
5216,I Think I Love My Wife,13369768,12550605,819163,2007_boxofficemojo_rankings.csv,2007,0.9387302008531487,0.061269799146851316
5217,Mr. Saturday Night,13351357,13351357,0,1992_boxofficemojo_rankings.csv,1992,1.0,0.0
5218,Ghosts of Mississippi,13323144,13323144,0,1996_boxofficemojo_rankings.csv,1996,1.0,0.0
5219,RRRrrrr!!!,13315054,54361,13260693,2004_boxofficemojo_rankings.csv,2004,0.004082672139369469,0.9959173278606306
5220,Hotel Artemis,13313581,6708147,6605434,2018_boxofficemojo_rankings.csv,2018,0.5038574520258674,0.4961425479741326
5221,Lord of Illusions,13294422,13294422,0,1995_boxofficemojo_rankings.csv,1995,1.0,0.0
5222,The Pick-up Artist,13290368,13290368,0,1987_boxofficemojo_rankings.csv,1987,1.0,0.0
5223,The Great Mouse Detective 1992 Re-release,13288756,13288756,0,1992_boxofficemojo_rankings.csv,1992,1.0,0.0
5224,The Entity,13277558,13277558,0,1983_boxofficemojo_rankings.csv,1983,1.0,0.0
5225,Star Wars: Episode V - The Empire Strikes Back 1982 Re-release,13276241,13276241,0,1982_boxofficemojo_rankings.csv,1982,1.0,0.0
5226,Body of Evidence,13273595,13273595,0,1993_boxofficemojo_rankings.csv,1993,1.0,0.0
5227,Class Act,13272113,13272113,0,1992_boxofficemojo_rankings.csv,1992,1.0,0.0
5228,Vera Drake,13267869,3775283,9492586,2004_boxofficemojo_rankings.csv,2004,0.2845432827230959,0.7154567172769041
5229,The Mod Squad,13263993,13263993,0,1999_boxofficemojo_rankings.csv,1999,1.0,0.0
5230,Visiting Hours,13258670,13258670,0,1982_boxofficemojo_rankings.csv,1982,1.0,0.0
5231,Roller Boogie,13253715,13253715,0,1979_boxofficemojo_rankings.csv,1979,1.0,0.0
5232,Vice Squad,13253583,13253583,0,1982_boxofficemojo_rankings.csv,1982,1.0,0.0
5233,Trespass,13249535,13249535,0,1992_boxofficemojo_rankings.csv,1992,1.0,0.0
5234,The Pirates Who Don't Do Anything: A VeggieTales Movie,13247725,12981269,266456,2008_boxofficemojo_rankings.csv,2008,0.9798866597849819,0.02011334021501805
5235,Bhootnath,13236817,476032,12760785,2008_boxofficemojo_rankings.csv,2008,0.035962724271250406,0.9640372757287496
5236,Crazy People,13236513,13236513,0,1990_boxofficemojo_rankings.csv,1990,1.0,0.0
5237,Paris Can Wait,13203541,5617731,7585810,2017_boxofficemojo_rankings.csv,2017,0.42547154585273755,0.5745284541472625
5238,Kal ho naa ho,13200241,1991922,11208319,2003_boxofficemojo_rankings.csv,2003,0.15090042674220872,0.8490995732577913
5239,Enchanted April,13200170,13200170,0,1992_boxofficemojo_rankings.csv,1992,1.0,0.0
5240,The Well Digger's Daughter,13194167,386368,12807799,2011_boxofficemojo_rankings.csv,2011,0.029283243117962657,0.9707167568820373
5241,The Honeymooners,13183426,12843849,339577,2005_boxofficemojo_rankings.csv,2005,0.9742421279567238,0.025757872043276155
5242,Revenge of the Ninja,13168027,13168027,0,1983_boxofficemojo_rankings.csv,1983,1.0,0.0
5243,Critters,13167232,13167232,0,1986_boxofficemojo_rankings.csv,1986,1.0,0.0
5244,Mommy,13156856,3494070,9662786,2014_boxofficemojo_rankings.csv,2014,0.2655702851805933,0.7344297148194067
5245,The Sisters Brothers,13143056,3143056,10000000,2018_boxofficemojo_rankings.csv,2018,0.23914194689576002,0.76085805310424
5246,Greedy,13137484,13137484,0,1994_boxofficemojo_rankings.csv,1994,1.0,0.0
5247,Rosewood,13130349,13130349,0,1997_boxofficemojo_rankings.csv,1997,1.0,0.0
5248,Head Over Heels,13127022,10424470,2702552,2001_boxofficemojo_rankings.csv,2001,0.7941229930139524,0.20587700698604755
5249,Delhi-6,13125579,879913,12245666,2009_boxofficemojo_rankings.csv,2009,0.06703803314124276,0.9329619668587572
5250,Author! Author!,13111101,13111101,0,1982_boxofficemojo_rankings.csv,1982,1.0,0.0
5251,Back to the Beach,13110903,13110903,0,1987_boxofficemojo_rankings.csv,1987,1.0,0.0
5252,The Crew,13105853,13023075,82778,2000_boxofficemojo_rankings.csv,2000,0.9936838907013531,0.006316109298646948
5253,The Evil That Men Do,13102025,13102025,0,1984_boxofficemojo_rankings.csv,1984,1.0,0.0
5254,Hillary's America: The Secret History of the Democratic Party,13099931,13099931,0,2016_boxofficemojo_rankings.csv,2016,1.0,0.0
5255,How to Eat Fried Worms,13098996,13040527,58469,2006_boxofficemojo_rankings.csv,2006,0.9955363754596154,0.004463624540384622
5256,In the Name of the King: A Dungeon Siege Tale,13097915,4775656,8322259,2007_boxofficemojo_rankings.csv,2007,0.364611924875066,0.635388075124934
5257,The Angels' Share,13090471,346669,12743802,2012_boxofficemojo_rankings.csv,2012,0.026482545967979304,0.9735174540320207
5258,True Romance,13088778,12281551,807227,1993_boxofficemojo_rankings.csv,1993,0.9383267865036752,0.06167321349632487
5259,American Me,13086430,13086430,0,1992_boxofficemojo_rankings.csv,1992,1.0,0.0
5260,Cat's Eye,13086298,13086298,0,1985_boxofficemojo_rankings.csv,1985,1.0,0.0
5261,Shut In,13082071,6900335,6181736,2016_boxofficemojo_rankings.csv,2016,0.5274650321038619,0.47253496789613814
5262,Hot Tub Time Machine 2,13081651,12314651,767000,2015_boxofficemojo_rankings.csv,2015,0.94136825695778,0.05863174304221998
5263,Clockers,13071518,13071518,0,1995_boxofficemojo_rankings.csv,1995,1.0,0.0
5264,The Way of the Gun,13069740,6055661,7014079,2000_boxofficemojo_rankings.csv,2000,0.4633344657200526,0.5366655342799475
5265,The Personal History of David Copperfield,13069190,1874133,11195057,2020_boxofficemojo_rankings.csv,2020,0.14340085345763587,0.8565991465423641
5266,The Barbarian Invasions,13065317,5109226,7956091,2003_boxofficemojo_rankings.csv,2003,0.39105258601838744,0.6089474139816126
5267,The Big Fix,13062708,13062708,0,1978_boxofficemojo_rankings.csv,1978,1.0,0.0
5268,Welcome to Marwen,13061491,10763520,2297971,2018_boxofficemojo_rankings.csv,2018,0.8240651852074162,0.1759348147925838
5269,Angela's Ashes,13042112,13042112,0,1999_boxofficemojo_rankings.csv,1999,1.0,0.0
5270,To Be or Not to Be,13030214,13030214,0,1983_boxofficemojo_rankings.csv,1983,1.0,0.0
5271,I'm Gonna Git You Sucka,13030057,13030057,0,1988_boxofficemojo_rankings.csv,1988,1.0,0.0
5272,The Great Train Robbery,13027857,13027857,0,1979_boxofficemojo_rankings.csv,1979,1.0,0.0
5273,"Roman J. Israel, Esq.",13025860,11962778,1063082,2017_boxofficemojo_rankings.csv,2017,0.9183868090091556,0.08161319099084437
5274,Friends with Kids,13019073,7251073,5768000,2012_boxofficemojo_rankings.csv,2012,0.5569577035169861,0.4430422964830138
5275,The Vatican Tapes,13015764,1784763,11231001,2015_boxofficemojo_rankings.csv,2015,0.13712318385613015,0.8628768161438698
5276,The Concorde... Airport '79,13015688,13015688,0,1979_boxofficemojo_rankings.csv,1979,1.0,0.0
5277,Thirst,13008937,318574,12690363,2009_boxofficemojo_rankings.csv,2009,0.02448885716027374,0.9755111428397263
5278,They Live,13008928,13008928,0,1988_boxofficemojo_rankings.csv,1988,1.0,0.0
5279,In a Better World,13004504,1008098,11996406,2010_boxofficemojo_rankings.csv,2010,0.07751914259859508,0.922480857401405
5280,Stroker Ace,13000000,13000000,0,1983_boxofficemojo_rankings.csv,1983,1.0,0.0
5281,Vision Quest,12993175,12993175,0,1985_boxofficemojo_rankings.csv,1985,1.0,0.0
5282,The Divorce,12991996,9081057,3910939,2003_boxofficemojo_rankings.csv,2003,0.6989731985754922,0.30102680142450783
5283,Pyaar Ka Punchnama 2,12983721,222856,12760865,2015_boxofficemojo_rankings.csv,2015,0.017164262848839713,0.9828357371511602
5284,The Wave,12975143,177404,12797739,2015_boxofficemojo_rankings.csv,2015,0.013672604610215086,0.9863273953897849
5285,Man's Best Friend,12974636,12974636,0,1993_boxofficemojo_rankings.csv,1993,1.0,0.0
5286,I Saw the Devil,12966357,129210,12837147,2010_boxofficemojo_rankings.csv,2010,0.00996501947308716,0.9900349805269129
5287,Le Havre,12959706,611709,12347997,2011_boxofficemojo_rankings.csv,2011,0.04720083927829844,0.9527991607217016
5288,Loving,12957265,7751969,5205296,2016_boxofficemojo_rankings.csv,2016,0.5982720118790501,0.4017279881209499
5289,Real Genius,12952019,12952019,0,1985_boxofficemojo_rankings.csv,1985,1.0,0.0
5290,Child 44,12951093,1224330,11726763,2015_boxofficemojo_rankings.csv,2015,0.09453487825313277,0.9054651217468672
5291,Black Dog,12951088,12951088,0,1998_boxofficemojo_rankings.csv,1998,1.0,0.0
5292,April Fool's Day,12947763,12947763,0,1986_boxofficemojo_rankings.csv,1986,1.0,0.0
5293,Paris 36,12940622,851540,12089082,2008_boxofficemojo_rankings.csv,2008,0.06580363756858056,0.9341963624314195
5294,Godzilla 2000,12924063,10037390,2886673,2000_boxofficemojo_rankings.csv,2000,0.7766435369434519,0.22335646305654808
5295,Gods and Generals,12923936,12882934,41002,2003_boxofficemojo_rankings.csv,2003,0.9968274370903725,0.0031725629096275316
5296,Perfect,12918858,12918858,0,1985_boxofficemojo_rankings.csv,1985,1.0,0.0
5297,Take Point,12908032,112386,12795646,2018_boxofficemojo_rankings.csv,2018,0.008706671938836221,0.9912933280611638
5298,Labyrinth,12906759,12729917,176842,1986_boxofficemojo_rankings.csv,1986,0.9862984967798655,0.013701503220134505
5299,Mubarakan,12899968,758868,12141100,2017_boxofficemojo_rankings.csv,2017,0.05882712267193221,0.9411728773280678
5300,My Brother Is an Only Child,12894062,255620,12638442,2007_boxofficemojo_rankings.csv,2007,0.019824629352643102,0.9801753706473569
5301,A Far Off Place,12890752,12890752,0,1993_boxofficemojo_rankings.csv,1993,1.0,0.0
5302,Formula 51,12881605,5204007,7677598,2001_boxofficemojo_rankings.csv,2001,0.4039874689528207,0.5960125310471793
5303,Senseless,12874899,12874899,0,1998_boxofficemojo_rankings.csv,1998,1.0,0.0
5304,Cherry Blossoms,12861658,104589,12757069,2008_boxofficemojo_rankings.csv,2008,0.00813184427699757,0.9918681557230025
5305,In the Mood for Love,12854953,2738980,10115973,2000_boxofficemojo_rankings.csv,2000,0.21306806800460493,0.7869319319953951
5306,Earth: One Amazing Day,12851540,81345,12770195,2017_boxofficemojo_rankings.csv,2017,0.006329591628707532,0.9936704083712925
5307,True Confessions,12850276,12850276,0,1981_boxofficemojo_rankings.csv,1981,1.0,0.0
5308,The Associate,12844057,12844057,0,1996_boxofficemojo_rankings.csv,1996,1.0,0.0
5309,The Last Married Couple in America,12835544,12835544,0,1980_boxofficemojo_rankings.csv,1980,1.0,0.0
5310,Slither,12834936,7802450,5032486,2006_boxofficemojo_rankings.csv,2006,0.607907199537263,0.39209280046273703
5311,Mr. Wrong,12825141,12825141,0,1996_boxofficemojo_rankings.csv,1996,1.0,0.0
5312,The Girl from Paris,12812396,183266,12629130,2001_boxofficemojo_rankings.csv,2001,0.014303803909901006,0.985696196090099
5313,Knockaround Guys,12806614,11715637,1090977,2002_boxofficemojo_rankings.csv,2002,0.9148114404010302,0.08518855959896972
5314,Marvin's Room,12803305,12803305,0,1996_boxofficemojo_rankings.csv,1996,1.0,0.0
5315,Mystic Pizza,12793213,12793213,0,1988_boxofficemojo_rankings.csv,1988,1.0,0.0
5316,Love Jones,12782749,12479335,303414,1997_boxofficemojo_rankings.csv,1997,0.9762637911453945,0.02373620885460553
5317,Aliens of the Deep,12770637,8968684,3801953,2005_boxofficemojo_rankings.csv,2005,0.7022894785906137,0.29771052140938625
5318,The Evening Star,12767815,12767815,0,1996_boxofficemojo_rankings.csv,1996,1.0,0.0
5319,Street Fighter: The Legend of Chun-Li,12764201,8742261,4021940,2009_boxofficemojo_rankings.csv,2009,0.6849046798933988,0.31509532010660124
5320,Suburbicon,12751667,5775178,6976489,2017_boxofficemojo_rankings.csv,2017,0.4528959233330042,0.5471040766669958
5321,Elle,12748594,2341534,10407060,2016_boxofficemojo_rankings.csv,2016,0.18366997960716294,0.8163300203928371
5322,Weekend at Bernie's II,12741891,12741891,0,1993_boxofficemojo_rankings.csv,1993,1.0,0.0
5323,Bon Cop Bad Cop,12735126,12665721,69405,2006_boxofficemojo_rankings.csv,2006,0.9945501128139603,0.00544988718603962
5324,Atlantic City,12729675,12729675,0,1981_boxofficemojo_rankings.csv,1981,1.0,0.0
5325,D.O.A.,12706478,12706478,0,1988_boxofficemojo_rankings.csv,1988,1.0,0.0
5326,Populaire,12698385,179091,12519294,2012_boxofficemojo_rankings.csv,2012,0.014103447013143797,0.9858965529868562
5327,The Past,12673462,1331747,11341715,2013_boxofficemojo_rankings.csv,2013,0.10508154756766541,0.8949184524323346
5328,"Remember Me, My Love",12671306,227986,12443320,2003_boxofficemojo_rankings.csv,2003,0.01799230481846149,0.9820076951815385
5329,Redemption,12671109,36895,12634214,2013_boxofficemojo_rankings.csv,2013,0.0029117419793326695,0.9970882580206674
5330,The Green Inferno,12666449,7192291,5474158,2015_boxofficemojo_rankings.csv,2015,0.5678222049447323,0.43217779505526766
5331,Chasing Papi,12661189,6130049,6531140,2003_boxofficemojo_rankings.csv,2003,0.4841606108241493,0.5158393891758507
5332,The Spitfire Grill,12658486,12658486,0,1996_boxofficemojo_rankings.csv,1996,1.0,0.0
5333,Idlewild,12643027,12571185,71842,2006_boxofficemojo_rankings.csv,2006,0.9943176582633257,0.005682341736674295
5334,The Bedroom Window,12640385,12640385,0,1987_boxofficemojo_rankings.csv,1987,1.0,0.0
5335,Everybody's All-American,12638294,12638294,0,1988_boxofficemojo_rankings.csv,1988,1.0,0.0
5336,Winged Migration 2003 Re-release,12634963,10764402,1870561,2003_boxofficemojo_rankings.csv,2003,0.8519535830852849,0.14804641691471515
5337,Narc,12633747,10465659,2168088,2002_boxofficemojo_rankings.csv,2002,0.8283891548564333,0.17161084514356667
5338,Made in Dagenham,12629471,1095369,11534102,2010_boxofficemojo_rankings.csv,2010,0.08673118612806506,0.9132688138719349
5339,Luis and the Aliens,12627729,169710,12458019,2018_boxofficemojo_rankings.csv,2018,0.013439471182823135,0.9865605288171768
5340,Bad Influence,12626043,12626043,0,1990_boxofficemojo_rankings.csv,1990,1.0,0.0
5341,The Legend of the Lone Ranger,12617845,12617845,0,1981_boxofficemojo_rankings.csv,1981,1.0,0.0
5342,The Omega Code,12614346,12614346,0,1999_boxofficemojo_rankings.csv,1999,1.0,0.0
5343,Their Finest,12597262,3603484,8993778,2017_boxofficemojo_rankings.csv,2017,0.2860529534116223,0.7139470465883777
5344,Maria Full of Grace,12594630,6529624,6065006,2004_boxofficemojo_rankings.csv,2004,0.5184450833410748,0.48155491665892525
5345,Gossip,12591270,5108820,7482450,2000_boxofficemojo_rankings.csv,2000,0.4057430267161295,0.5942569732838705
5346,People Like Us,12558931,12434778,124153,2012_boxofficemojo_rankings.csv,2012,0.9901143656255457,0.009885634374454322
5347,A Tribute to Love,12552605,1852050,10700555,2007_boxofficemojo_rankings.csv,2007,0.14754307970337632,0.8524569202966237
5348,Breakin' All the Rules,12544254,12264319,279935,2004_boxofficemojo_rankings.csv,2004,0.9776842050551591,0.022315794944840883
5349,Apocalypse Now Redux,12543269,4626290,7916979,2001_boxofficemojo_rankings.csv,2001,0.36882649969477654,0.6311735003052235
5350,Hellraiser III: Hell on Earth,12534961,12534961,0,1992_boxofficemojo_rankings.csv,1992,1.0,0.0
5351,Amityville II: The Possession,12534817,12534817,0,1982_boxofficemojo_rankings.csv,1982,1.0,0.0
5352,Gattaca,12532777,12532777,0,1997_boxofficemojo_rankings.csv,1997,1.0,0.0
5353,Compromising Positions,12531831,12531831,0,1985_boxofficemojo_rankings.csv,1985,1.0,0.0
5354,Judgment Night,12526677,12526677,0,1993_boxofficemojo_rankings.csv,1993,1.0,0.0
5355,The Clearing,12520799,5763875,6756924,2004_boxofficemojo_rankings.csv,2004,0.46034402437096866,0.5396559756290313
5356,Sorority Boys,12517488,10200032,2317456,2002_boxofficemojo_rankings.csv,2002,0.8148625347194262,0.18513746528057387
5357,Zoom,12506362,11989328,517034,2006_boxofficemojo_rankings.csv,2006,0.9586583212608111,0.041341678739188904
5358,Black Mask,12504289,12504289,0,1999_boxofficemojo_rankings.csv,1999,1.0,0.0
5359,Seducing Doctor Lewis,12504038,9354342,3149696,2003_boxofficemojo_rankings.csv,2003,0.7481056919372766,0.2518943080627234
5360,First Monday in October,12480249,12480249,0,1981_boxofficemojo_rankings.csv,1981,1.0,0.0
5361,Why Do Fools Fall in Love,12461773,12461773,0,1998_boxofficemojo_rankings.csv,1998,1.0,0.0
5362,The Marrying Man,12454768,12454768,0,1991_boxofficemojo_rankings.csv,1991,1.0,0.0
5363,Ready to Rumble,12452362,12394327,58035,2000_boxofficemojo_rankings.csv,2000,0.9953394384133709,0.004660561586629107
5364,The Promise,12448676,8224288,4224388,2017_boxofficemojo_rankings.csv,2017,0.6606556392021128,0.33934436079788727
5365,Can You Ever Forgive Me?,12442161,8803865,3638296,2018_boxofficemojo_rankings.csv,2018,0.707583272712835,0.292416727287165
5366,Life with Mikey,12440858,12440858,0,1993_boxofficemojo_rankings.csv,1993,1.0,0.0
5367,The Fourth Protocol,12423831,12423831,0,1987_boxofficemojo_rankings.csv,1987,1.0,0.0
5368,Irreconcilable Differences,12414210,12414210,0,1984_boxofficemojo_rankings.csv,1984,1.0,0.0
5369,Nine Queens,12413888,1222889,11190999,2002_boxofficemojo_rankings.csv,2002,0.09850974972546876,0.9014902502745312
5370,Lone Star,12408986,12408986,0,1996_boxofficemojo_rankings.csv,1996,1.0,0.0
5371,Monsignor,12408066,12408066,0,1982_boxofficemojo_rankings.csv,1982,1.0,0.0
5372,Less Than Zero,12396383,12396383,0,1987_boxofficemojo_rankings.csv,1987,1.0,0.0
5373,Mary Reilly,12379402,5707094,6672308,1996_boxofficemojo_rankings.csv,1996,0.4610153220648299,0.53898467793517
5374,The Postman Always Rings Twice,12376625,12376625,0,1981_boxofficemojo_rankings.csv,1981,1.0,0.0
5375,Monsieur Ibrahim,12364836,2823890,9540946,2003_boxofficemojo_rankings.csv,2003,0.22838070800130306,0.7716192919986969
5376,Silver Bullet,12361866,12361866,0,1985_boxofficemojo_rankings.csv,1985,1.0,0.0
5377,Rampant,12359573,167937,12191636,2018_boxofficemojo_rankings.csv,2018,0.013587605332320138,0.9864123946676798
5378,Tall Tales from the Magical Garden of Antoon Krings 2018 Re-release,12353849,220,12353629,2018_boxofficemojo_rankings.csv,2018,1.7808215075317822e-05,0.9999821917849246
5379,Casshern,12353768,0,12353768,2004_boxofficemojo_rankings.csv,2004,0.0,1.0
5380,Soul Men,12331637,12082391,249246,2008_boxofficemojo_rankings.csv,2008,0.9797880849071376,0.020211915092862368
5381,Undercover Blues,12324660,12324660,0,1993_boxofficemojo_rankings.csv,1993,1.0,0.0
5382,Say It Isn't So,12320393,5520393,6800000,2001_boxofficemojo_rankings.csv,2001,0.4480695542747703,0.5519304457252298
5383,Chasing Liberty,12313323,12195626,117697,2004_boxofficemojo_rankings.csv,2004,0.990441491707803,0.009558508292196996
5384,Club Paradise,12308521,12308521,0,1986_boxofficemojo_rankings.csv,1986,1.0,0.0
5385,No Mercy,12303904,12303904,0,1986_boxofficemojo_rankings.csv,1986,1.0,0.0
5386,Enemy Mine,12303411,12303411,0,1985_boxofficemojo_rankings.csv,1985,1.0,0.0
5387,Highlander: The Final Dimension,12303080,12303080,0,1995_boxofficemojo_rankings.csv,1995,1.0,0.0
5388,Abandon,12302219,10727683,1574536,2002_boxofficemojo_rankings.csv,2002,0.8720120329511286,0.12798796704887141
5389,Marrowbone,12294931,1377,12293554,2017_boxofficemojo_rankings.csv,2017,0.00011199737517843735,0.9998880026248216
5390,The Beatles: Eight Days a Week - The Touring Years,12283800,2930414,9353386,2016_boxofficemojo_rankings.csv,2016,0.23855924062586495,0.761440759374135
5391,A Stranger Among Us,12282994,12282994,0,1992_boxofficemojo_rankings.csv,1992,1.0,0.0
5392,Casual Sex?,12277096,12277096,0,1988_boxofficemojo_rankings.csv,1988,1.0,0.0
5393,Little Big League,12267790,12267790,0,1994_boxofficemojo_rankings.csv,1994,1.0,0.0
5394,The Man Who Knew Infinity,12252684,3866794,8385890,2016_boxofficemojo_rankings.csv,2016,0.3155875071943421,0.684412492805658
5395,Lone Wolf McQuade,12232628,12232628,0,1983_boxofficemojo_rankings.csv,1983,1.0,0.0
5396,Bandslam,12225023,5210988,7014035,2009_boxofficemojo_rankings.csv,2009,0.42625588516275187,0.5737441148372482
5397,Gainsbourg: A Heroic Life,12220456,233007,11987449,2010_boxofficemojo_rankings.csv,2010,0.0190669644406068,0.9809330355593932
5398,Barney's Great Adventure,12218638,12218638,0,1998_boxofficemojo_rankings.csv,1998,1.0,0.0
5399,The Guillotines,12217440,5290,12212150,2012_boxofficemojo_rankings.csv,2012,0.0004329875980565487,0.9995670124019435
5400,The Current War: Director's Cut,12217160,5979540,6237620,2019_boxofficemojo_rankings.csv,2019,0.48943780714994317,0.5105621928500568
5401,I'll Be Home for Christmas,12214338,12214338,0,1998_boxofficemojo_rankings.csv,1998,1.0,0.0
5402,Hideaway,12201255,12201255,0,1995_boxofficemojo_rankings.csv,1995,1.0,0.0
5403,Family Business,12195695,12195695,0,1989_boxofficemojo_rankings.csv,1989,1.0,0.0
5404,I Married an Anti-Fan,12194083,89408,12104675,2016_boxofficemojo_rankings.csv,2016,0.007332080649278835,0.9926679193507212
5405,Koi... Mil Gaya,12168232,671372,11496860,2003_boxofficemojo_rankings.csv,2003,0.05517416170237385,0.9448258382976261
5406,Little Women,12165890,1379497,10786393,2018_boxofficemojo_rankings.csv,2018,0.11339055342436928,0.8866094465756307
5407,The Eye,12165016,512049,11652967,2002_boxofficemojo_rankings.csv,2002,0.04209192984209803,0.957908070157902
5408,My Big Fat Independent Movie,12155249,4655,12150594,2005_boxofficemojo_rankings.csv,2005,0.0003829621260740936,0.9996170378739259
5409,Dark Blue,12150301,9250301,2900000,2003_boxofficemojo_rankings.csv,2003,0.7613227853367583,0.23867721466324168
5410,Miss & Mrs. Cops,12147170,104578,12042592,2019_boxofficemojo_rankings.csv,2019,0.008609248080005466,0.9913907519199945
5411,Dreamscape,12145169,12145169,0,1984_boxofficemojo_rankings.csv,1984,1.0,0.0
5412,Pink Cadillac,12143484,12143484,0,1989_boxofficemojo_rankings.csv,1989,1.0,0.0
5413,Bachelorette,12128575,447954,11680621,2012_boxofficemojo_rankings.csv,2012,0.03693377004305947,0.9630662299569406
5414,End of the Spear,12128105,11967000,161105,2006_boxofficemojo_rankings.csv,2006,0.9867163913900812,0.013283608609918863
5415,Barney's Version,12104765,4439201,7665564,2011_boxofficemojo_rankings.csv,2011,0.3667316961543657,0.6332683038456344
5416,Roommates,12096881,12096881,0,1995_boxofficemojo_rankings.csv,1995,1.0,0.0
5417,Bye Bye Love,12096673,12096673,0,1995_boxofficemojo_rankings.csv,1995,1.0,0.0
5418,Hellbound: Hellraiser II,12090735,12090735,0,1988_boxofficemojo_rankings.csv,1988,1.0,0.0
5419,Bella,12083296,8070537,4012759,2007_boxofficemojo_rankings.csv,2007,0.6679085739520078,0.3320914260479922
5420,Stoker,12077441,1714221,10363220,2012_boxofficemojo_rankings.csv,2012,0.14193577927642123,0.8580642207235788
5421,Don't Move,12071007,337265,11733742,2004_boxofficemojo_rankings.csv,2004,0.027940088179884248,0.9720599118201158
5422,Holy Man,12069719,12069719,0,1998_boxofficemojo_rankings.csv,1998,1.0,0.0
5423,She's Out of Control,12065892,12065892,0,1989_boxofficemojo_rankings.csv,1989,1.0,0.0
5424,The Connection,12062441,190980,11871461,2014_boxofficemojo_rankings.csv,2014,0.01583261630046522,0.9841673836995348
5425,The Bookshop,12055868,1588150,10467718,2017_boxofficemojo_rankings.csv,2017,0.13173253058178805,0.868267469418212
5426,Dave Chappelle's Block Party,12051924,11718595,333329,2006_boxofficemojo_rankings.csv,2006,0.9723422583813174,0.027657741618682626
5427,The Black Stallion Returns,12049108,12049108,0,1983_boxofficemojo_rankings.csv,1983,1.0,0.0
5428,Fatal Beauty,12046526,12046526,0,1987_boxofficemojo_rankings.csv,1987,1.0,0.0
5429,Three Burials,12045362,5027684,7017678,2005_boxofficemojo_rankings.csv,2005,0.41739584082238457,0.5826041591776154
5430,Tamara Drewe,12037973,560391,11477582,2010_boxofficemojo_rankings.csv,2010,0.04655194026436178,0.9534480597356382
5431,Spread,12035862,250618,11785244,2009_boxofficemojo_rankings.csv,2009,0.020822604978355516,0.9791773950216445
5432,Chasing Amy,12021272,12021272,0,1997_boxofficemojo_rankings.csv,1997,1.0,0.0
5433,In Dreams,12017369,12017369,0,1999_boxofficemojo_rankings.csv,1999,1.0,0.0
5434,I Am Love,12014663,5005465,7009198,2010_boxofficemojo_rankings.csv,2010,0.4166130169443787,0.5833869830556213
5435,The Cookout,12009070,11814019,195051,2004_boxofficemojo_rankings.csv,2004,0.9837580262251782,0.016241973774821863
5436,Big Night,12008376,12008376,0,1996_boxofficemojo_rankings.csv,1996,1.0,0.0
5437,A Most Violent Year,12007070,5749134,6257936,2014_boxofficemojo_rankings.csv,2014,0.47881239969451334,0.5211876003054867
5438,Blow Out,12000000,12000000,0,1981_boxofficemojo_rankings.csv,1981,1.0,0.0
5439,The Sword in the Stone,12000000,12000000,0,1983_boxofficemojo_rankings.csv,1983,1.0,0.0
5440,The King and I,11993021,11993021,0,1999_boxofficemojo_rankings.csv,1999,1.0,0.0
5441,The Return,11992014,7749851,4242163,2006_boxofficemojo_rankings.csv,2006,0.6462509967049739,0.3537490032950262
5442,The Assassin,11991669,632542,11359127,2015_boxofficemojo_rankings.csv,2015,0.052748453947486375,0.9472515460525136
5443,Cinema Paradiso,11990401,11990401,0,1990_boxofficemojo_rankings.csv,1990,1.0,0.0
5444,Phantasm,11988469,11988469,0,1979_boxofficemojo_rankings.csv,1979,1.0,0.0
5445,Mere Brother Ki Dulhan,11983381,496172,11487209,2011_boxofficemojo_rankings.csv,2011,0.041405009153927426,0.9585949908460726
5446,Brighton Beach Memoirs,11957943,11957943,0,1986_boxofficemojo_rankings.csv,1986,1.0,0.0
5447,Firewalker,11949484,11949484,0,1986_boxofficemojo_rankings.csv,1986,1.0,0.0
5448,This Must Be the Place,11928909,143979,11784930,2011_boxofficemojo_rankings.csv,2011,0.012069754241565594,0.9879302457584344
5449,Deathstalker,11919250,11919250,0,1983_boxofficemojo_rankings.csv,1983,1.0,0.0
5450,The Polar Express 2005 IMAX Release,11910480,10900597,1009883,2005_boxofficemojo_rankings.csv,2005,0.9152105540666707,0.08478944593332931
5451,Keep Dancing,11905018,695157,11209861,2007_boxofficemojo_rankings.csv,2007,0.05839193187276155,0.9416080681272384
5452,Making Love,11897978,11897978,0,1982_boxofficemojo_rankings.csv,1982,1.0,0.0
5453,The Warring States,11868961,68961,11800000,2011_boxofficemojo_rankings.csv,2011,0.005810196865589161,0.9941898031344109
5454,Viceroy's House,11868221,1105717,10762504,2017_boxofficemojo_rankings.csv,2017,0.09316619567498785,0.9068338043250121
5455,Boy Erased,11853081,6788692,5064389,2018_boxofficemojo_rankings.csv,2018,0.5727364893566491,0.4272635106433509
5456,Layer Cake,11850214,2339957,9510257,2004_boxofficemojo_rankings.csv,2004,0.1974611597731484,0.8025388402268516
5457,Unstoppable,11845347,101417,11743930,2018_boxofficemojo_rankings.csv,2018,0.008561758469380424,0.9914382415306195
5458,Kites,11844500,1643486,10201014,2010_boxofficemojo_rankings.csv,2010,0.13875520283675968,0.8612447971632403
5459,Smart People,11843604,9511289,2332315,2008_boxofficemojo_rankings.csv,2008,0.8030738785254894,0.19692612147451063
5460,Sliding Doors,11841544,11841544,0,1998_boxofficemojo_rankings.csv,1998,1.0,0.0
5461,Most Wanted,11838218,6391946,5446272,1997_boxofficemojo_rankings.csv,1997,0.5399415689084286,0.4600584310915714
5462,Wo zhi nv ren xin,11838177,123526,11714651,2011_boxofficemojo_rankings.csv,2011,0.010434545791974559,0.9895654542080254
5463,Tales from the Hood,11837928,11837928,0,1995_boxofficemojo_rankings.csv,1995,1.0,0.0
5464,Last Letter,11834622,180946,11653676,2018_boxofficemojo_rankings.csv,2018,0.015289546214488303,0.9847104537855117
5465,Hoop Dreams,11830611,7830611,4000000,1994_boxofficemojo_rankings.csv,1994,0.6618940475686336,0.3381059524313664
5466,Alaska,11829959,11829959,0,1996_boxofficemojo_rankings.csv,1996,1.0,0.0
5467,The Rules of Attraction,11819244,6532619,5286625,2002_boxofficemojo_rankings.csv,2002,0.5527103933212649,0.44728960667873513
5468,Ash Is Purest White,11813509,422814,11390695,2018_boxofficemojo_rankings.csv,2018,0.03579072060638376,0.9642092793936162
5469,Back Roads,11809387,11809387,0,1981_boxofficemojo_rankings.csv,1981,1.0,0.0
5470,Getaway,11806432,10501938,1304494,2013_boxofficemojo_rankings.csv,2013,0.8895098874918349,0.11049011250816504
5471,Bloodsport,11806119,11806119,0,1988_boxofficemojo_rankings.csv,1988,1.0,0.0
5472,Ballon,11799591,34222,11765369,2018_boxofficemojo_rankings.csv,2018,0.002900270017833669,0.9970997299821663
5473,The Divine Fury,11799556,102982,11696574,2019_boxofficemojo_rankings.csv,2019,0.0087276165306559,0.9912723834693441
5474,3 Ninjas Kick Back,11798854,11798854,0,1994_boxofficemojo_rankings.csv,1994,1.0,0.0
5475,Zelig,11798616,11798616,0,1983_boxofficemojo_rankings.csv,1983,1.0,0.0
5476,Caddyshack II,11798302,11798302,0,1988_boxofficemojo_rankings.csv,1988,1.0,0.0
5477,Win Win,11789613,10179275,1610338,2011_boxofficemojo_rankings.csv,2011,0.8634104444310429,0.1365895555689572
5478,Chill Factor,11788676,11263966,524710,1999_boxofficemojo_rankings.csv,1999,0.9554903366586714,0.044509663341328574
5479,The Lords of Discipline,11787127,11787127,0,1983_boxofficemojo_rankings.csv,1983,1.0,0.0
5480,Toni Erdmann,11784207,1479387,10304820,2016_boxofficemojo_rankings.csv,2016,0.12553980085380373,0.8744601991461962
5481,The Interview,11782625,6105175,5677450,2014_boxofficemojo_rankings.csv,2014,0.5181506667656826,0.4818493332343175
5482,Millions,11782282,6584159,5198123,2005_boxofficemojo_rankings.csv,2005,0.5588186566914627,0.44118134330853737
5483,The Hoax,11772461,7164995,4607466,2006_boxofficemojo_rankings.csv,2006,0.60862337959752,0.39137662040248
5484,The Longshots,11767866,11537046,230820,2008_boxofficemojo_rankings.csv,2008,0.9803855686324097,0.019614431367590352
5485,The Son's Room,11767402,1016340,10751062,2001_boxofficemojo_rankings.csv,2001,0.08636910679179652,0.9136308932082035
5486,C'est Si Bon,11750035,164167,11585868,2015_boxofficemojo_rankings.csv,2015,0.013971617956882681,0.9860283820431173
5487,Strictly Ballroom,11738022,11738022,0,1993_boxofficemojo_rankings.csv,1993,1.0,0.0
5488,Used Cars,11715321,11715321,0,1980_boxofficemojo_rankings.csv,1980,1.0,0.0
5489,Up the Creek,11708269,11708269,0,1984_boxofficemojo_rankings.csv,1984,1.0,0.0
5490,Beyond Borders,11705002,4430101,7274901,2003_boxofficemojo_rankings.csv,2003,0.3784793031218619,0.621520696878138
5491,The Adventures of Elmo in Grouchland,11683047,11683047,0,1999_boxofficemojo_rankings.csv,1999,1.0,0.0
5492,Seeking a Friend for the End of the World,11681781,7078738,4603043,2012_boxofficemojo_rankings.csv,2012,0.6059639364922181,0.3940360635077819
5493,Shopgirl,11675161,10284523,1390638,2005_boxofficemojo_rankings.csv,2005,0.8808891800292946,0.11911081997070533
5494,A Sound of Thunder,11665465,1900451,9765014,2005_boxofficemojo_rankings.csv,2005,0.16291257999573955,0.8370874200042604
5495,I'm Not There,11664116,4017609,7646507,2007_boxofficemojo_rankings.csv,2007,0.3444417905308898,0.6555582094691103
5496,Rock-A-Doodle,11657385,11657385,0,1992_boxofficemojo_rankings.csv,1992,1.0,0.0
5497,Far from Home: The Adventures of Yellow Dog,11642946,11642946,0,1995_boxofficemojo_rankings.csv,1995,1.0,0.0
5498,Halloween 5: The Revenge of Michael Myers,11642254,11642254,0,1989_boxofficemojo_rankings.csv,1989,1.0,0.0
5499,Bring the Soul: The Movie,11641119,4809800,6831319,2019_boxofficemojo_rankings.csv,2019,0.41317333840501075,0.5868266615949893
5500,After the Wedding,11632723,1534584,10098139,2006_boxofficemojo_rankings.csv,2006,0.13191958580978846,0.8680804141902115
5501,Back to Burgundy,11625884,257610,11368274,2017_boxofficemojo_rankings.csv,2017,0.02215831501501305,0.9778416849849869
5502,The Lunchbox 2013 Re-release,11621581,4235151,7386430,2013_boxofficemojo_rankings.csv,2013,0.36442124354681177,0.6355787564531883
5503,The Muse,11614954,11614954,0,1999_boxofficemojo_rankings.csv,1999,1.0,0.0
5504,The Promise,11606005,11606005,0,1979_boxofficemojo_rankings.csv,1979,1.0,0.0
5505,Gross Anatomy,11604598,11604598,0,1989_boxofficemojo_rankings.csv,1989,1.0,0.0
5506,Lifeforce,11603545,11603545,0,1985_boxofficemojo_rankings.csv,1985,1.0,0.0
5507,Delicacy,11597420,498584,11098836,2011_boxofficemojo_rankings.csv,2011,0.042990941088621434,0.9570090589113786
5508,So I Married an Axe Murderer,11585483,11585483,0,1993_boxofficemojo_rankings.csv,1993,1.0,0.0
5509,Graveyard Shift,11582891,11582891,0,1990_boxofficemojo_rankings.csv,1990,1.0,0.0
5510,Wing Commander,11578059,11578059,0,1999_boxofficemojo_rankings.csv,1999,1.0,0.0
5511,Police Academy 6: City Under Siege,11567217,11567217,0,1989_boxofficemojo_rankings.csv,1989,1.0,0.0
5512,The Other Side of the Mountain: Part II,11565678,11565678,0,1978_boxofficemojo_rankings.csv,1978,1.0,0.0
5513,Looking for Eric,11562239,55804,11506435,2009_boxofficemojo_rankings.csv,2009,0.0048264008381075675,0.9951735991618924
5514,The Order,11560806,7660806,3900000,2002_boxofficemojo_rankings.csv,2002,0.6626532786727846,0.33734672132721544
5515,The Legend of Drunken Master,11555430,11555430,0,2000_boxofficemojo_rankings.csv,2000,1.0,0.0
5516,Pump Up the Volume,11541758,11541758,0,1990_boxofficemojo_rankings.csv,1990,1.0,0.0
5517,Boys Don't Cry,11540607,11540607,0,1999_boxofficemojo_rankings.csv,1999,1.0,0.0
5518,Turbulence,11538235,11538235,0,1997_boxofficemojo_rankings.csv,1997,1.0,0.0
5519,Young Einstein,11536599,11536599,0,1989_boxofficemojo_rankings.csv,1989,1.0,0.0
5520,Fair Game,11534477,11534477,0,1995_boxofficemojo_rankings.csv,1995,1.0,0.0
5521,Just One of the Guys,11528900,11528900,0,1985_boxofficemojo_rankings.csv,1985,1.0,0.0
5522,Mulholland Falls,11526099,11526099,0,1996_boxofficemojo_rankings.csv,1996,1.0,0.0
5523,Shattered,11511031,11511031,0,1991_boxofficemojo_rankings.csv,1991,1.0,0.0
5524,Haute Cuisine,11509942,217883,11292059,2012_boxofficemojo_rankings.csv,2012,0.01892998244474212,0.9810700175552579
5525,Army of Darkness,11502976,11502976,0,1993_boxofficemojo_rankings.csv,1993,1.0,0.0
5526,Thief,11492915,11492915,0,1981_boxofficemojo_rankings.csv,1981,1.0,0.0
5527,Wedding Daze,11492406,0,11492406,2007_boxofficemojo_rankings.csv,2007,0.0,1.0
5528,The River,11489982,11489982,0,1984_boxofficemojo_rankings.csv,1984,1.0,0.0
5529,The Beautician and the Beast,11486880,11486880,0,1997_boxofficemojo_rankings.csv,1997,1.0,0.0
5530,Something New,11483669,11468568,15101,2006_boxofficemojo_rankings.csv,2006,0.9986850021539283,0.0013149978460716694
5531,Fists of Legend,11478881,134213,11344668,2013_boxofficemojo_rankings.csv,2013,0.011692167555356658,0.9883078324446434
5532,Double Dhamaal,11445869,543646,10902223,2011_boxofficemojo_rankings.csv,2011,0.0474971363030627,0.9525028636969373
5533,Moon Over Parador,11444204,11444204,0,1988_boxofficemojo_rankings.csv,1988,1.0,0.0
5534,The Ref,11439193,11439193,0,1994_boxofficemojo_rankings.csv,1994,1.0,0.0
5535,Double Team,11438337,11438337,0,1997_boxofficemojo_rankings.csv,1997,1.0,0.0
5536,Trumbo,11430025,7857741,3572284,2015_boxofficemojo_rankings.csv,2015,0.6874649005579603,0.3125350994420397
5537,Seasons,11425100,150092,11275008,2016_boxofficemojo_rankings.csv,2016,0.013137040376014214,0.9868629596239857
5538,Fun Size,11417362,9409538,2007824,2012_boxofficemojo_rankings.csv,2012,0.8241429149745799,0.17585708502542005
5539,Suspect Zero,11416075,8725813,2690262,2004_boxofficemojo_rankings.csv,2004,0.7643444003302361,0.2356555996697639
5540,Cops and Robbersons,11391093,11391093,0,1994_boxofficemojo_rankings.csv,1994,1.0,0.0
5541,Jennifer 8,11390479,11390479,0,1992_boxofficemojo_rankings.csv,1992,1.0,0.0
5542,Watch Out Ladies,11386430,702166,10684264,2008_boxofficemojo_rankings.csv,2008,0.061666914037147726,0.9383330859628523
5543,The King's Case Note,11383493,90959,11292534,2017_boxofficemojo_rankings.csv,2017,0.007990429651074587,0.9920095703489255
5544,The Seduction,11378339,11378339,0,1982_boxofficemojo_rankings.csv,1982,1.0,0.0
5545,Raiders of the Lost Ark 1983 Re-release,11374454,11374454,0,1983_boxofficemojo_rankings.csv,1983,1.0,0.0
5546,Thumbelina,11373501,11373501,0,1994_boxofficemojo_rankings.csv,1994,1.0,0.0
5547,The Legacy,11364985,11364985,0,1979_boxofficemojo_rankings.csv,1979,1.0,0.0
5548,Opportunity Knocks,11359129,11359129,0,1990_boxofficemojo_rankings.csv,1990,1.0,0.0
5549,King of Thieves,11353515,7518,11345997,2018_boxofficemojo_rankings.csv,2018,0.0006621737849467764,0.9993378262150532
5550,Bajirao Mastani,11350917,6557047,4793870,2015_boxofficemojo_rankings.csv,2015,0.577666720671114,0.4223332793288859
5551,The Apparition,11350665,4936819,6413846,2012_boxofficemojo_rankings.csv,2012,0.4349365433655209,0.5650634566344791
5552,Balto,11348324,11348324,0,1995_boxofficemojo_rankings.csv,1995,1.0,0.0
5553,Snow Flower and the Secret Fan,11348205,1348205,10000000,2011_boxofficemojo_rankings.csv,2011,0.11880337022463024,0.8811966297753697
5554,Connie and Carla,11341016,8085771,3255245,2004_boxofficemojo_rankings.csv,2004,0.7129670745548723,0.28703292544512765
5555,Career Opportunities,11336986,11336986,0,1991_boxofficemojo_rankings.csv,1991,1.0,0.0
5556,Manhattan Murder Mystery,11330911,11330911,0,1993_boxofficemojo_rankings.csv,1993,1.0,0.0
5557,Kabhi Khushi Kabhie Gham...,11329690,2902000,8427690,2001_boxofficemojo_rankings.csv,2001,0.2561411653805179,0.7438588346194821
5558,Quiet Chaos,11326121,11434,11314687,2008_boxofficemojo_rankings.csv,2008,0.0010095247967066572,0.9989904752032933
5559,Extreme Prejudice,11307844,11307844,0,1987_boxofficemojo_rankings.csv,1987,1.0,0.0
5560,Tank,11302884,11302884,0,1984_boxofficemojo_rankings.csv,1984,1.0,0.0
5561,"It's Not You, It's Me",11301956,1339911,9962045,2010_boxofficemojo_rankings.csv,2010,0.11855567301801564,0.8814443269819844
5562,Ready to Wear,11300653,11300653,0,1994_boxofficemojo_rankings.csv,1994,1.0,0.0
5563,Who's the Man?,11299730,11299730,0,1993_boxofficemojo_rankings.csv,1993,1.0,0.0
5564,Lars and the Real Girl,11293663,5972884,5320779,2007_boxofficemojo_rankings.csv,2007,0.5288703939545566,0.47112960604544335
5565,Tashan,11283337,457380,10825957,2008_boxofficemojo_rankings.csv,2008,0.040535880475784776,0.9594641195242152
5566,Tomorrow,11277905,62510,11215395,2015_boxofficemojo_rankings.csv,2015,0.00554269609470908,0.994457303905291
5567,One Good Cop,11276846,11276846,0,1991_boxofficemojo_rankings.csv,1991,1.0,0.0
5568,Il Divo,11260366,240159,11020207,2008_boxofficemojo_rankings.csv,2008,0.021327814744209913,0.9786721852557901
5569,Star Wars: Episode VI - Return of the Jedi 1985 Re-release,11252123,11252123,0,1985_boxofficemojo_rankings.csv,1985,1.0,0.0
5570,You Can Count on Me,11242521,9416804,1825717,2000_boxofficemojo_rankings.csv,2000,0.8376060849697323,0.16239391503026768
5571,At Eternity's Gate,11235662,2294915,8940747,2018_boxofficemojo_rankings.csv,2018,0.20425276232054684,0.7957472376794531
5572,The Smurfs and the Magic Flute,11234220,11234220,0,1983_boxofficemojo_rankings.csv,1983,1.0,0.0
5573,Let the Right One In,11227336,2122065,9105271,2008_boxofficemojo_rankings.csv,2008,0.18900877287363627,0.8109912271263637
5574,"The Adventures of Priscilla, Queen of the Desert",11220670,11220670,0,1994_boxofficemojo_rankings.csv,1994,1.0,0.0
5575,Stop-Loss,11212953,10915744,297209,2008_boxofficemojo_rankings.csv,2008,0.9734941366471437,0.02650586335285629
5576,Q & A,11207891,11207891,0,1990_boxofficemojo_rankings.csv,1990,1.0,0.0
5577,Deep Rising,11203026,11203026,0,1998_boxofficemojo_rankings.csv,1998,1.0,0.0
5578,Waltz with Bashir,11179372,2283849,8895523,2008_boxofficemojo_rankings.csv,2008,0.20429135017602063,0.7957086498239794
5579,Rudo y Cursi,11169232,1827660,9341572,2008_boxofficemojo_rankings.csv,2008,0.16363345304314567,0.8363665469568543
5580,Straw Dogs,11168712,10324441,844271,2010_boxofficemojo_rankings.csv,2010,0.9244074876315191,0.0755925123684808
5581,Genghis Khan: To the Ends of the Earth and Sea,11167501,3892,11163609,2007_boxofficemojo_rankings.csv,2007,0.0003485112739188472,0.9996514887260811
5582,Ida,11156836,3827060,7329776,2013_boxofficemojo_rankings.csv,2013,0.343023774840824,0.656976225159176
5583,Shadow of the Vampire,11155214,8293784,2861430,2000_boxofficemojo_rankings.csv,2000,0.7434894570377583,0.2565105429622417
5584,For Love or Money,11146270,11146270,0,1993_boxofficemojo_rankings.csv,1993,1.0,0.0
5585,Gloria Bell,11145006,5611123,5533883,2019_boxofficemojo_rankings.csv,2019,0.5034652291797779,0.49653477082022207
5586,Return to Oz,11137801,11137801,0,1985_boxofficemojo_rankings.csv,1985,1.0,0.0
5587,2 Days in the Valley,11132210,11132210,0,1996_boxofficemojo_rankings.csv,1996,1.0,0.0
5588,The Astronaut Farmer,11130889,11003643,127246,2007_boxofficemojo_rankings.csv,2007,0.9885682087028269,0.01143179129717312
5589,Falling in Love,11129057,11129057,0,1984_boxofficemojo_rankings.csv,1984,1.0,0.0
5590,V.I. Warshawski,11128309,11128309,0,1991_boxofficemojo_rankings.csv,1991,1.0,0.0
5591,Whispers in the Dark,11124511,11124511,0,1992_boxofficemojo_rankings.csv,1992,1.0,0.0
5592,Bicycling with Molière,11123929,59874,11064055,2013_boxofficemojo_rankings.csv,2013,0.0053824507509891515,0.9946175492490108
5593,We Are Your Friends,11122090,3591417,7530673,2015_boxofficemojo_rankings.csv,2015,0.32290846414657676,0.6770915358534232
5594,Hard to Hold,11113806,11113806,0,1984_boxofficemojo_rankings.csv,1984,1.0,0.0
5595,The Nightmare Before Christmas 2006 3D Release,11111265,8700869,2410396,2006_boxofficemojo_rankings.csv,2006,0.7830673645170014,0.21693263548299857
5596,Conviction 2010 Re-release,11104555,6783129,4321426,2010_boxofficemojo_rankings.csv,2010,0.6108420373441349,0.3891579626558651
5597,The Warrior's Way,11103434,5666340,5437094,2010_boxofficemojo_rankings.csv,2010,0.510323202713683,0.489676797286317
5598,Big Trouble in Little China,11100000,11100000,0,1986_boxofficemojo_rankings.csv,1986,1.0,0.0
5599,The Squid and the Whale,11098131,7372734,3725397,2005_boxofficemojo_rankings.csv,2005,0.6643221277528621,0.33567787224713785
5600,Michael Collins,11092559,11092559,0,1996_boxofficemojo_rankings.csv,1996,1.0,0.0
5601,The Belko Experiment,11084630,10166820,917810,2017_boxofficemojo_rankings.csv,2017,0.9171997621932352,0.08280023780676486
5602,Mad Dog and Glory,11081586,11081586,0,1993_boxofficemojo_rankings.csv,1993,1.0,0.0
5603,My Family,11079373,11079373,0,1995_boxofficemojo_rankings.csv,1995,1.0,0.0
5604,Dhamaal,11077541,166339,10911202,2007_boxofficemojo_rankings.csv,2007,0.015015877621215755,0.9849841223787843
5605,Action Jackson,11060963,256872,10804091,2014_boxofficemojo_rankings.csv,2014,0.023223294391274973,0.976776705608725
5606,Wild Orchid,11060485,11060485,0,1990_boxofficemojo_rankings.csv,1990,1.0,0.0
5607,Krush Groove,11052713,11052713,0,1985_boxofficemojo_rankings.csv,1985,1.0,0.0
5608,Tall Tale,11047627,8247627,2800000,1995_boxofficemojo_rankings.csv,1995,0.7465519065768603,0.2534480934231397
5609,Promised Land,11039031,7597898,3441133,2012_boxofficemojo_rankings.csv,2012,0.6882758097155448,0.3117241902844552
5610,Head-On,11030861,435395,10595466,2004_boxofficemojo_rankings.csv,2004,0.039470626998200774,0.9605293730017992
5611,Last Night,11027222,99000,10928222,2010_boxofficemojo_rankings.csv,2010,0.008977782436954657,0.9910222175630453
5612,La boda de Valentina,11021794,2783739,8238055,2018_boxofficemojo_rankings.csv,2018,0.2525667781488204,0.7474332218511796
5613,The Wild Life,11020375,11020375,0,1984_boxofficemojo_rankings.csv,1984,1.0,0.0
5614,Kismat Konnection,11019454,490154,10529300,2008_boxofficemojo_rankings.csv,2008,0.04448078824958115,0.9555192117504189
5615,The Loft,11016443,6002684,5013759,2014_boxofficemojo_rankings.csv,2014,0.5448840428802655,0.45511595711973457
5616,Adrenaline Rush: The Science of Risk,11011932,10994028,17904,2002_boxofficemojo_rankings.csv,2002,0.9983741272648614,0.0016258727351385752
5617,The Couch Trip,11005304,11005304,0,1988_boxofficemojo_rankings.csv,1988,1.0,0.0
5618,Gringo,11001627,4969853,6031774,2018_boxofficemojo_rankings.csv,2018,0.4517380020246096,0.5482619979753903
5619,The Super,11000863,11000863,0,1991_boxofficemojo_rankings.csv,1991,1.0,0.0
5620,The Last Flight of Noah's Ark,11000000,11000000,0,1980_boxofficemojo_rankings.csv,1980,1.0,0.0
5621,The Mirror Crack'd,11000000,11000000,0,1980_boxofficemojo_rankings.csv,1980,1.0,0.0
5622,[REC] 3: Genesis,10998667,9600,10989067,2012_boxofficemojo_rankings.csv,2012,0.0008728330442225408,0.9991271669557774
5623,The Beat That My Heart Skipped,10988397,1023424,9964973,2005_boxofficemojo_rankings.csv,2005,0.09313678783174652,0.9068632121682535
5624,Who's Harry Crumb?,10982364,10982364,0,1989_boxofficemojo_rankings.csv,1989,1.0,0.0
5625,Hyde Park on Hudson,10980481,6376145,4604336,2012_boxofficemojo_rankings.csv,2012,0.5806799356057353,0.41932006439426467
5626,Justin Bieber's Believe,10980157,6206566,4773591,2013_boxofficemojo_rankings.csv,2013,0.5652529376401448,0.43474706235985516
5627,Roving Mars,10978976,10407978,570998,2006_boxofficemojo_rankings.csv,2006,0.9479916888423838,0.05200831115761616
5628,District B13,10976892,1200216,9776676,2004_boxofficemojo_rankings.csv,2004,0.10934023947762263,0.8906597605223774
5629,Friend Request,10975390,3759078,7216312,2016_boxofficemojo_rankings.csv,2016,0.3425006309570776,0.6574993690429224
5630,The Florida Project,10971298,5904366,5066932,2017_boxofficemojo_rankings.csv,2017,0.538164764096281,0.46183523590371894
5631,The Man Who Loved Women,10964231,10964231,0,1983_boxofficemojo_rankings.csv,1983,1.0,0.0
5632,Moment by Moment,10963824,10963824,0,1978_boxofficemojo_rankings.csv,1978,1.0,0.0
5633,Extreme Ops,10959475,4842259,6117216,2002_boxofficemojo_rankings.csv,2002,0.441833117006061,0.558166882993939
5634,Nuns on the Run,10959015,10959015,0,1990_boxofficemojo_rankings.csv,1990,1.0,0.0
5635,U Me Aur Hum,10948019,1028191,9919828,2008_boxofficemojo_rankings.csv,2008,0.09391571205713106,0.9060842879428689
5636,De Dana Dan,10932289,944979,9987310,2009_boxofficemojo_rankings.csv,2009,0.086439262628348,0.913560737371652
5637,Leave It to Beaver,10925060,10925060,0,1997_boxofficemojo_rankings.csv,1997,1.0,0.0
5638,Captivity,10921200,2626800,8294400,2007_boxofficemojo_rankings.csv,2007,0.24052301944841226,0.7594769805515877
5639,Cookie's Fortune,10920544,10920544,0,1999_boxofficemojo_rankings.csv,1999,1.0,0.0
5640,Das Boot,10915250,10915250,0,1982_boxofficemojo_rankings.csv,1982,1.0,0.0
5641,Black Snake Moan,10907485,9396870,1510615,2007_boxofficemojo_rankings.csv,2007,0.8615065709464648,0.13849342905353526
5642,The Englishman Who Went Up a Hill But Came Down a Mountain,10904930,10904930,0,1995_boxofficemojo_rankings.csv,1995,1.0,0.0
5643,Jonah Hex,10903312,10547117,356195,2010_boxofficemojo_rankings.csv,2010,0.9673314860658853,0.0326685139341147
5644,One Chance,10900434,101196,10799238,2013_boxofficemojo_rankings.csv,2013,0.009283667053990695,0.9907163329460094
5645,A Bag of Marbles,10898998,411318,10487680,2017_boxofficemojo_rankings.csv,2017,0.037739065554466565,0.9622609344455334
5646,The Perfect Score,10898337,10391003,507334,2004_boxofficemojo_rankings.csv,2004,0.9534484940225284,0.04655150597747161
5647,The Darkness,10898293,10753574,144719,2016_boxofficemojo_rankings.csv,2016,0.9867209479502891,0.013279052049710905
5648,The Hunt,10890815,5812500,5078315,2020_boxofficemojo_rankings.csv,2020,0.5337066142432867,0.46629338575671336
5649,Lucky Numbers,10890222,10042516,847706,2000_boxofficemojo_rankings.csv,2000,0.9221589789445982,0.0778410210554018
5650,Molière,10878867,635733,10243134,2007_boxofficemojo_rankings.csv,2007,0.05843742735341833,0.9415625726465817
5651,Narrow Margin,10873237,10873237,0,1990_boxofficemojo_rankings.csv,1990,1.0,0.0
5652,Here on Earth,10873148,10522168,350980,2000_boxofficemojo_rankings.csv,2000,0.9677204798463149,0.03227952015368502
5653,Son of Rambow,10871449,1785505,9085944,2008_boxofficemojo_rankings.csv,2008,0.1642379962413474,0.8357620037586526
5654,Steamboy,10870198,468867,10401331,2004_boxofficemojo_rankings.csv,2004,0.043133252954545995,0.956866747045454
5655,Only You,10857889,61565,10796324,2015_boxofficemojo_rankings.csv,2015,0.005670070858156682,0.9943299291418434
5656,Victory,10853418,10853418,0,1981_boxofficemojo_rankings.csv,1981,1.0,0.0
5657,The Libertine,10852064,4835065,6016999,2005_boxofficemojo_rankings.csv,2005,0.44554335470192585,0.5544566452980741
5658,Rollover,10851261,10851261,0,1981_boxofficemojo_rankings.csv,1981,1.0,0.0
5659,Extract,10848783,10823158,25625,2009_boxofficemojo_rankings.csv,2009,0.997637983910269,0.0023620160897309863
5660,I'm Always Here,10836270,1747060,9089210,2004_boxofficemojo_rankings.csv,2004,0.16122337298719946,0.8387766270128005
5661,Danny Collins,10835752,5637066,5198686,2015_boxofficemojo_rankings.csv,2015,0.5202284068516887,0.47977159314831125
5662,"Where'd You Go, Bernadette",10834213,9198356,1635857,2019_boxofficemojo_rankings.csv,2019,0.8490100757664631,0.15098992423353685
5663,The End of the Affair,10827816,10827816,0,1999_boxofficemojo_rankings.csv,1999,1.0,0.0
5664,Office Space,10827810,10827810,0,1999_boxofficemojo_rankings.csv,1999,1.0,0.0
5665,Moving,10815378,10815378,0,1988_boxofficemojo_rankings.csv,1988,1.0,0.0
5666,Flying Monsters 3D with David Attenborough,10813862,5705874,5107988,2011_boxofficemojo_rankings.csv,2011,0.5276444252756324,0.4723555747243677
5667,Gotcha!,10806919,10806919,0,1985_boxofficemojo_rankings.csv,1985,1.0,0.0
5668,Sophie Scholl: The Final Days,10804315,680331,10123984,2005_boxofficemojo_rankings.csv,2005,0.06296845288201983,0.9370315471179802
5669,Carandiru,10781635,216335,10565300,2004_boxofficemojo_rankings.csv,2004,0.02006513854345839,0.9799348614565416
5670,Dracula: Dead and Loving It,10772144,10772144,0,1995_boxofficemojo_rankings.csv,1995,1.0,0.0
5671,Gettysburg,10769960,10769960,0,1993_boxofficemojo_rankings.csv,1993,1.0,0.0
5672,The Great Raid,10769311,10167373,601938,2005_boxofficemojo_rankings.csv,2005,0.9441061735518642,0.05589382644813582
5673,New York Stories,10763469,10763469,0,1989_boxofficemojo_rankings.csv,1989,1.0,0.0
5674,Missing in Action 2: The Beginning,10755447,10755447,0,1985_boxofficemojo_rankings.csv,1985,1.0,0.0
5675,Stay Tuned,10736401,10736401,0,1992_boxofficemojo_rankings.csv,1992,1.0,0.0
5676,Golden Slumber,10733326,94450,10638876,2018_boxofficemojo_rankings.csv,2018,0.008799695453208073,0.991200304546792
5677,Not Easily Broken,10726909,10572742,154167,2009_boxofficemojo_rankings.csv,2009,0.985628012692193,0.014371987307806937
5678,Glengarry Glen Ross,10725228,10725228,0,1992_boxofficemojo_rankings.csv,1992,1.0,0.0
5679,Our Kind of Traitor,10711027,3153157,7557870,2016_boxofficemojo_rankings.csv,2016,0.2943841893032293,0.7056158106967707
5680,Prom,10702246,10130219,572027,2011_boxofficemojo_rankings.csv,2011,0.9465507520570916,0.05344924794290843
5681,The Fiendish Plot of Dr. Fu Manchu,10697276,10697276,0,1980_boxofficemojo_rankings.csv,1980,1.0,0.0
5682,RoboCop 3,10696210,10696210,0,1993_boxofficemojo_rankings.csv,1993,1.0,0.0
5683,Impractical Jokers: The Movie,10691091,10691091,0,2020_boxofficemojo_rankings.csv,2020,1.0,0.0
5684,City of Life and Death,10687316,122558,10564758,2009_boxofficemojo_rankings.csv,2009,0.011467612635389465,0.9885323873646106
5685,Deconstructing Harry,10686841,10686841,0,1997_boxofficemojo_rankings.csv,1997,1.0,0.0
5686,Fear and Loathing in Las Vegas,10680275,10680275,0,1998_boxofficemojo_rankings.csv,1998,1.0,0.0
5687,Hercules,10676194,10676194,0,1983_boxofficemojo_rankings.csv,1983,1.0,0.0
5688,Universal Soldier: The Return,10667893,10667893,0,1999_boxofficemojo_rankings.csv,1999,1.0,0.0
5689,Island of the Sharks,10658505,10658505,0,1999_boxofficemojo_rankings.csv,1999,1.0,0.0
5690,Two If by Sea,10658278,10658278,0,1996_boxofficemojo_rankings.csv,1996,1.0,0.0
5691,The Sessions,10656155,6002451,4653704,2012_boxofficemojo_rankings.csv,2012,0.563284880897472,0.4367151191025281
5692,The Savages,10653221,6623082,4030139,2007_boxofficemojo_rankings.csv,2007,0.6216976067613729,0.3783023932386271
5693,Red Joan,10647493,1579730,9067763,2018_boxofficemojo_rankings.csv,2018,0.14836638070576802,0.851633619294232
5694,The Package,10647219,10647219,0,1989_boxofficemojo_rankings.csv,1989,1.0,0.0
5695,The Night Listener,10639686,7836393,2803293,2006_boxofficemojo_rankings.csv,2006,0.7365248372931307,0.2634751627068694
5696,Only God Forgives,10635126,779188,9855938,2013_boxofficemojo_rankings.csv,2013,0.07326551655335348,0.9267344834466466
5697,The Purple Rose of Cairo,10631333,10631333,0,1985_boxofficemojo_rankings.csv,1985,1.0,0.0
5698,The Boondock Saints II: All Saints Day,10629321,10273188,356133,2009_boxofficemojo_rankings.csv,2009,0.9664952258004063,0.033504774199593745
5699,Moving Violations,10627754,10627754,0,1985_boxofficemojo_rankings.csv,1985,1.0,0.0
5700,Wolfen,10626725,10626725,0,1981_boxofficemojo_rankings.csv,1981,1.0,0.0
5701,The Dark Half,10611160,10611160,0,1993_boxofficemojo_rankings.csv,1993,1.0,0.0
5702,Irina Palm,10610594,44383,10566211,2007_boxofficemojo_rankings.csv,2007,0.004182894944430067,0.99581710505557
5703,After Hours,10609321,10609321,0,1985_boxofficemojo_rankings.csv,1985,1.0,0.0
5704,My Old Lady,10606667,4013786,6592881,2014_boxofficemojo_rankings.csv,2014,0.37842104404710736,0.6215789559528927
5705,The House on Sorority Row,10604986,10604986,0,1983_boxofficemojo_rankings.csv,1983,1.0,0.0
5706,Broadway Danny Rose,10600497,10600497,0,1984_boxofficemojo_rankings.csv,1984,1.0,0.0
5707,Beautiful Girls,10597759,10597759,0,1996_boxofficemojo_rankings.csv,1996,1.0,0.0
5708,Bad Lieutenant: Port of Call New Orleans,10593928,1702112,8891816,2009_boxofficemojo_rankings.csv,2009,0.1606686396207337,0.8393313603792664
5709,First Daughter,10592180,9055921,1536259,2004_boxofficemojo_rankings.csv,2004,0.8549629065971311,0.1450370934028689
5710,Drop Dead Gorgeous,10571408,10571408,0,1999_boxofficemojo_rankings.csv,1999,1.0,0.0
5711,Three to Tango,10570375,10570375,0,1999_boxofficemojo_rankings.csv,1999,1.0,0.0
5712,Pollock,10558970,8598593,1960377,2000_boxofficemojo_rankings.csv,2000,0.814340129766445,0.18565987023355499
5713,Husbands and Wives,10555619,10555619,0,1992_boxofficemojo_rankings.csv,1992,1.0,0.0
5714,We're No Angels,10555348,10555348,0,1989_boxofficemojo_rankings.csv,1989,1.0,0.0
5715,The Phone,10551318,40516,10510802,2015_boxofficemojo_rankings.csv,2015,0.0038398994324690054,0.996160100567531
5716,Mad City,10541523,10541523,0,1997_boxofficemojo_rankings.csv,1997,1.0,0.0
5717,Moms' Night Out,10536956,10429707,107249,2014_boxofficemojo_rankings.csv,2014,0.9898216334964292,0.01017836650357086
5718,Where the Boys Are,10530000,10530000,0,1984_boxofficemojo_rankings.csv,1984,1.0,0.0
5719,Get Low,10522511,9176933,1345578,2010_boxofficemojo_rankings.csv,2010,0.8721238685329006,0.12787613146709945
5720,Anatomie,10501958,9660,10492298,2000_boxofficemojo_rankings.csv,2000,0.0009198284738902974,0.9990801715261097
5721,American Ninja,10499694,10499694,0,1985_boxofficemojo_rankings.csv,1985,1.0,0.0
5722,Iron Eagle II,10497324,10497324,0,1988_boxofficemojo_rankings.csv,1988,1.0,0.0
5723,Home Fries,10493366,10493366,0,1998_boxofficemojo_rankings.csv,1998,1.0,0.0
5724,Silent Rage,10490791,10490791,0,1982_boxofficemojo_rankings.csv,1982,1.0,0.0
5725,Light of Day,10489617,10489617,0,1987_boxofficemojo_rankings.csv,1987,1.0,0.0
5726,Intimate Strangers,10484574,2110589,8373985,2004_boxofficemojo_rankings.csv,2004,0.20130422084864869,0.7986957791513513
5727,Camp Nowhere,10475705,10475705,0,1994_boxofficemojo_rankings.csv,1994,1.0,0.0
5728,The Leisure Seeker,10472180,3226443,7245737,2017_boxofficemojo_rankings.csv,2017,0.308096594978314,0.691903405021686
5729,The Cooler,10464788,8291572,2173216,2003_boxofficemojo_rankings.csv,2003,0.7923306234201782,0.2076693765798218
5730,The Newton Boys,10452012,10452012,0,1998_boxofficemojo_rankings.csv,1998,1.0,0.0
5731,Alone in the Dark,10442808,5178569,5264239,2005_boxofficemojo_rankings.csv,2005,0.49589813391187504,0.5041018660881249
5732,A Rage in Harlem,10438504,10438504,0,1991_boxofficemojo_rankings.csv,1991,1.0,0.0
5733,Mood Indigo,10435322,303187,10132135,2013_boxofficemojo_rankings.csv,2013,0.029053918987837653,0.9709460810121624
5734,Thief of Hearts,10435015,10435015,0,1984_boxofficemojo_rankings.csv,1984,1.0,0.0
5735,Furious,10433259,9996,10423263,2017_boxofficemojo_rankings.csv,2017,0.0009580898931005164,0.9990419101068995
5736,Interiors,10432366,10432366,0,1978_boxofficemojo_rankings.csv,1978,1.0,0.0
5737,The Brothers McMullen,10426506,10426506,0,1995_boxofficemojo_rankings.csv,1995,1.0,0.0
5738,I'll Do Anything,10424645,10424645,0,1994_boxofficemojo_rankings.csv,1994,1.0,0.0
5739,Every Day,10421847,6102076,4319771,2018_boxofficemojo_rankings.csv,2018,0.5855081157879213,0.4144918842120787
5740,The Perfect Match,10414738,9669521,745217,2016_boxofficemojo_rankings.csv,2016,0.9284459196189093,0.07155408038109072
5741,Savannah Smiles,10413170,10413170,0,1982_boxofficemojo_rankings.csv,1982,1.0,0.0
5742,The Virgin Suicides,10409377,4906229,5503148,2000_boxofficemojo_rankings.csv,2000,0.4713278229811448,0.5286721770188552
5743,Operation Condor,10405394,10405394,0,1997_boxofficemojo_rankings.csv,1997,1.0,0.0
5744,Fiddler on the Roof 1979 Re-release,10404330,10404330,0,1979_boxofficemojo_rankings.csv,1979,1.0,0.0
5745,Swing Kids,10397408,222001,10175407,2018_boxofficemojo_rankings.csv,2018,0.0213515714685814,0.9786484285314186
5746,Stardust Memories,10389003,10389003,0,1980_boxofficemojo_rankings.csv,1980,1.0,0.0
5747,The Scarlet Letter,10382407,10382407,0,1995_boxofficemojo_rankings.csv,1995,1.0,0.0
5748,Doctor Detroit,10375893,10375893,0,1983_boxofficemojo_rankings.csv,1983,1.0,0.0
5749,Lobster Cop,10373129,85693,10287436,2018_boxofficemojo_rankings.csv,2018,0.008261056042010082,0.9917389439579899
5750,Town & Country,10372291,6719973,3652318,2001_boxofficemojo_rankings.csv,2001,0.6478774072189066,0.35212259278109337
5751,Harry Brown,10371451,1818681,8552770,2009_boxofficemojo_rankings.csv,2009,0.1753545381451448,0.8246454618548552
5752,Deal of the Century,10369581,10369581,0,1983_boxofficemojo_rankings.csv,1983,1.0,0.0
5753,Queen of Katwe,10367161,8874389,1492772,2016_boxofficemojo_rankings.csv,2016,0.8560095671322168,0.14399043286778318
5754,Wasabi,10366360,97220,10269140,2001_boxofficemojo_rankings.csv,2001,0.009378412480369195,0.9906215875196308
5755,The Witches,10360553,10360553,0,1990_boxofficemojo_rankings.csv,1990,1.0,0.0
5756,The Man with Two Brains,10353438,10353438,0,1983_boxofficemojo_rankings.csv,1983,1.0,0.0
5757,The Adventures of Milo and Otis 1990 Re-release,10351534,10351534,0,1990_boxofficemojo_rankings.csv,1990,1.0,0.0
5758,Disorderlies,10348437,10348437,0,1987_boxofficemojo_rankings.csv,1987,1.0,0.0
5759,Look Who's Talking Now,10340263,10340263,0,1993_boxofficemojo_rankings.csv,1993,1.0,0.0
5760,I'm Your Hero,10338463,274579,10063884,2014_boxofficemojo_rankings.csv,2014,0.026558976900144634,0.9734410230998554
5761,Code Name: The Cleaner,10337477,8135024,2202453,2007_boxofficemojo_rankings.csv,2007,0.7869448222230627,0.21305517777693725
5762,Knock Off,10319915,10319915,0,1998_boxofficemojo_rankings.csv,1998,1.0,0.0
5763,I Got the Hook Up,10317779,10317779,0,1998_boxofficemojo_rankings.csv,1998,1.0,0.0
5764,Kin,10313019,5718096,4594923,2018_boxofficemojo_rankings.csv,2018,0.5544541321993104,0.4455458678006896
5765,The Babadook,10312540,964413,9348127,2014_boxofficemojo_rankings.csv,2014,0.09351847362531442,0.9064815263746856
5766,3-D Sex and Zen: Extreme Ecstasy,10306807,153215,10153592,2011_boxofficemojo_rankings.csv,2011,0.014865418553000944,0.9851345814469991
5767,Stone,10300416,1810078,8490338,2010_boxofficemojo_rankings.csv,2010,0.17572863076598072,0.8242713692340193
5768,English Vinglish,10299150,1862086,8437064,2012_boxofficemojo_rankings.csv,2012,0.18079996892947475,0.8192000310705252
5769,Better Off Dead...,10297601,10297601,0,1985_boxofficemojo_rankings.csv,1985,1.0,0.0
5770,White Squall,10292300,10292300,0,1996_boxofficemojo_rankings.csv,1996,1.0,0.0
5771,The Year of Living Dangerously,10278575,10278575,0,1983_boxofficemojo_rankings.csv,1983,1.0,0.0
5772,Someone to Watch Over Me,10278549,10278549,0,1987_boxofficemojo_rankings.csv,1987,1.0,0.0
5773,Saved!,10275509,8940582,1334927,2004_boxofficemojo_rankings.csv,2004,0.8700865329396335,0.12991346706036655
5774,Girls vs Gangsters,10265819,37115,10228704,2018_boxofficemojo_rankings.csv,2018,0.0036153959075257416,0.9963846040924743
5775,Facing the Giants,10243159,10178331,64828,2006_boxofficemojo_rankings.csv,2006,0.9936710930680662,0.006328906931933791
5776,Chennai Express,10234653,5307960,4926693,2013_boxofficemojo_rankings.csv,2013,0.5186262787805312,0.4813737212194688
5777,The Collector,10234475,7712114,2522361,2009_boxofficemojo_rankings.csv,2009,0.7535427073689661,0.24645729263103383
5778,The Miracle Season,10230620,10230620,0,2018_boxofficemojo_rankings.csv,2018,1.0,0.0
5779,The Wash,10229331,10097538,131793,2001_boxofficemojo_rankings.csv,2001,0.9871161662478221,0.012883833752177928
5780,Air Bud: Golden Receiver,10224116,10224116,0,1998_boxofficemojo_rankings.csv,1998,1.0,0.0
5781,In the Mix,10223896,10223896,0,2005_boxofficemojo_rankings.csv,2005,1.0,0.0
5782,Brainstorm,10219460,10219460,0,1983_boxofficemojo_rankings.csv,1983,1.0,0.0
5783,Babies,10219306,7320323,2898983,2010_boxofficemojo_rankings.csv,2010,0.7163229088159215,0.28367709118407847
5784,The Best of Enemies,10209813,10205616,4197,2019_boxofficemojo_rankings.csv,2019,0.9995889248902012,0.0004110751097987789
5785,My Spy,10200000,0,10200000,2020_boxofficemojo_rankings.csv,2020,0.0,1.0
5786,Senna,10197661,1612430,8585231,2010_boxofficemojo_rankings.csv,2010,0.15811763109207103,0.841882368907929
5787,BTS World Tour: Love Yourself in Seoul,10195760,3509917,6685843,2019_boxofficemojo_rankings.csv,2019,0.34425261088923237,0.6557473891107676
5788,Woman on Top,10194274,5020111,5174163,2000_boxofficemojo_rankings.csv,2000,0.492444189748088,0.507555810251912
5789,Flame & Citron,10186084,148089,10037995,2008_boxofficemojo_rankings.csv,2008,0.01453836430172773,0.9854616356982723
5790,Martin Lawrence: You So Crazy,10184701,10184701,0,1994_boxofficemojo_rankings.csv,1994,1.0,0.0
5791,Lost in America,10179000,10179000,0,1985_boxofficemojo_rankings.csv,1985,1.0,0.0
5792,"4 Months, 3 Weeks and 2 Days",10174839,1198208,8976631,2007_boxofficemojo_rankings.csv,2007,0.11776186335724821,0.8822381366427517
5793,For Greater Glory: The True Story of Cristiada,10173682,5672846,4500836,2012_boxofficemojo_rankings.csv,2012,0.557600090114867,0.44239990988513306
5794,Next Day Air,10172519,10027047,145472,2009_boxofficemojo_rankings.csv,2009,0.985699510612858,0.014300489387141966
5795,Lovesick,10171304,10171304,0,1983_boxofficemojo_rankings.csv,1983,1.0,0.0
5796,Cyborg,10166459,10166459,0,1989_boxofficemojo_rankings.csv,1989,1.0,0.0
5797,Sunset Park,10163782,10163782,0,1996_boxofficemojo_rankings.csv,1996,1.0,0.0
5798,Punisher: War Zone,10161493,8050977,2110516,2008_boxofficemojo_rankings.csv,2008,0.7923025681363949,0.2076974318636051
5799,Henry V,10161099,10161099,0,1989_boxofficemojo_rankings.csv,1989,1.0,0.0
5800,The Ice Harvest,10156968,9016782,1140186,2005_boxofficemojo_rankings.csv,2005,0.8877434683263745,0.11225653167362544
5801,Bats,10155690,10155690,0,1999_boxofficemojo_rankings.csv,1999,1.0,0.0
5802,Sleepover,10143022,9436390,706632,2004_boxofficemojo_rankings.csv,2004,0.9303331886690179,0.06966681133098203
5803,Let's Talk About the Rain,10134366,111844,10022522,2008_boxofficemojo_rankings.csv,2008,0.011036112175147415,0.9889638878248526
5804,Ben Is Back,10134204,3703184,6431020,2018_boxofficemojo_rankings.csv,2018,0.36541439268441805,0.634585607315582
5805,Thirteen,10128960,4601043,5527917,2003_boxofficemojo_rankings.csv,2003,0.4542463392095536,0.5457536607904464
5806,A Family Thing,10125417,10125417,0,1996_boxofficemojo_rankings.csv,1996,1.0,0.0
5807,Trespass,10117966,24094,10093872,2011_boxofficemojo_rankings.csv,2011,0.00238130865432835,0.9976186913456716
5808,Marshall,10116816,10051659,65157,2017_boxofficemojo_rankings.csv,2017,0.9935595349366836,0.006440465063316364
5809,Brokedown Palace,10115013,10115013,0,1999_boxofficemojo_rankings.csv,1999,1.0,0.0
5810,Buddy,10113400,10113400,0,1997_boxofficemojo_rankings.csv,1997,1.0,0.0
5811,Iron Sky,10109659,122082,9987577,2012_boxofficemojo_rankings.csv,2012,0.012075778223578065,0.9879242217764219
5812,Bernie,10090641,9206470,884171,2012_boxofficemojo_rankings.csv,2012,0.9123771225237326,0.08762287747626736
5813,Under the Cherry Moon,10090429,10090429,0,1986_boxofficemojo_rankings.csv,1986,1.0,0.0
5814,Pulse: A Stomp Odyssey,10086514,10086514,0,2002_boxofficemojo_rankings.csv,2002,1.0,0.0
5815,A Little Chaos,10084623,558173,9526450,2015_boxofficemojo_rankings.csv,2015,0.05534892082728328,0.9446510791727167
5816,Mrs. Winterbourne,10082005,10082005,0,1996_boxofficemojo_rankings.csv,1996,1.0,0.0
5817,Gladiators of Rome,10079201,8201,10071000,2012_boxofficemojo_rankings.csv,2012,0.000813655764975815,0.9991863442350242
5818,Shakedown,10068039,10068039,0,1988_boxofficemojo_rankings.csv,1988,1.0,0.0
5819,Papillon,10060903,2335896,7725007,2018_boxofficemojo_rankings.csv,2018,0.23217558105867833,0.7678244189413217
5820,Boiling Point,10058318,10058318,0,1993_boxofficemojo_rankings.csv,1993,1.0,0.0
5821,A Day Without a Mexican,10057021,4179890,5877131,2004_boxofficemojo_rankings.csv,2004,0.4156190983393591,0.5843809016606408
5822,Class Reunion,10054150,10054150,0,1982_boxofficemojo_rankings.csv,1982,1.0,0.0
5823,Sexy Beast,10045677,6946056,3099621,2001_boxofficemojo_rankings.csv,2001,0.6914472762761534,0.30855272372384657
5824,What's Eating Gilbert Grape,10032765,10032765,0,1993_boxofficemojo_rankings.csv,1993,1.0,0.0
5825,The Deep End,10031529,8823109,1208420,2001_boxofficemojo_rankings.csv,2001,0.8795378052538152,0.12046219474618475
5826,Dirty Work,10023282,10023282,0,1998_boxofficemojo_rankings.csv,1998,1.0,0.0
5827,Hope and Glory,10021120,10021120,0,1987_boxofficemojo_rankings.csv,1987,1.0,0.0
5828,The Red Violin,10019109,10019109,0,1998_boxofficemojo_rankings.csv,1998,1.0,0.0
5829,Cutthroat Island,10017322,10017322,0,1995_boxofficemojo_rankings.csv,1995,1.0,0.0
5830,The King's Choice,10017316,113231,9904085,2016_boxofficemojo_rankings.csv,2016,0.01130352681297066,0.9886964731870294
5831,A Little Princess,10015449,10015449,0,1995_boxofficemojo_rankings.csv,1995,1.0,0.0
5832,Kissing Jessica Stein,10013424,7025722,2987702,2002_boxofficemojo_rankings.csv,2002,0.7016303314430709,0.2983696685569292
5833,Elephant,10012022,1266955,8745067,2003_boxofficemojo_rankings.csv,2003,0.12654336956111362,0.8734566304388863
5834,Moonlight Mile,10011050,6835856,3175194,2002_boxofficemojo_rankings.csv,2002,0.6828310716658093,0.3171689283341907
5835,The Unbearable Lightness of Being,10006806,10006806,0,1988_boxofficemojo_rankings.csv,1988,1.0,0.0
5836,The Two Jakes,10005969,10005969,0,1990_boxofficemojo_rankings.csv,1990,1.0,0.0
5837,Terror in the Aisles,10004817,10004817,0,1984_boxofficemojo_rankings.csv,1984,1.0,0.0
5838,The Hollywood Knights,10000000,10000000,0,1980_boxofficemojo_rankings.csv,1980,1.0,0.0
5839,Once Bitten,10000000,10000000,0,1985_boxofficemojo_rankings.csv,1985,1.0,0.0
5840,Thank You for Your Service,9995692,9536300,459392,2017_boxofficemojo_rankings.csv,2017,0.9540410008631719,0.045958999136828146
5841,Angel-A,9995168,202647,9792521,2005_boxofficemojo_rankings.csv,2005,0.02027449663677489,0.9797255033632251
5842,Lassie,9979683,9979683,0,1994_boxofficemojo_rankings.csv,1994,1.0,0.0
5843,Alan Partridge,9979601,153426,9826175,2013_boxofficemojo_rankings.csv,2013,0.015373961343745106,0.9846260386562549
5844,Returner,9978256,73060,9905196,2002_boxofficemojo_rankings.csv,2002,0.007321920784553934,0.992678079215446
5845,Taking Woodstock,9975737,7460204,2515533,2009_boxofficemojo_rankings.csv,2009,0.7478348717493254,0.2521651282506746
5846,Criminal Law,9974446,9974446,0,1989_boxofficemojo_rankings.csv,1989,1.0,0.0
5847,Dudley Do-Right,9974410,9974410,0,1999_boxofficemojo_rankings.csv,1999,1.0,0.0
5848,Kinky Boots,9950133,1822428,8127705,2005_boxofficemojo_rankings.csv,2005,0.18315614474700992,0.8168438552529901
5849,Murphy's Law,9947631,9947631,0,1986_boxofficemojo_rankings.csv,1986,1.0,0.0
5850,Cyrus,9933873,7468936,2464937,2010_boxofficemojo_rankings.csv,2010,0.7518654607321837,0.24813453926781628
5851,The Goldfinch,9932621,5332621,4600000,2019_boxofficemojo_rankings.csv,2019,0.5368795406569927,0.4631204593430073
5852,The Collection,9929706,6842058,3087648,2012_boxofficemojo_rankings.csv,2012,0.6890494038796314,0.3109505961203685
5853,Brazil,9929135,9929135,0,1985_boxofficemojo_rankings.csv,1985,1.0,0.0
5854,Portrait of a Lady on Fire,9919850,3759854,6159996,2019_boxofficemojo_rankings.csv,2019,0.37902327152124277,0.6209767284787573
5855,Immortal Beloved,9914409,9914409,0,1994_boxofficemojo_rankings.csv,1994,1.0,0.0
5856,Never Let Me Go,9904795,2434652,7470143,2010_boxofficemojo_rankings.csv,2010,0.24580539021756634,0.7541946097824337
5857,Whatever It Takes,9902115,8745680,1156435,2000_boxofficemojo_rankings.csv,2000,0.8832133337170898,0.11678666628291026
5858,Straight Time,9900000,9900000,0,1978_boxofficemojo_rankings.csv,1978,1.0,0.0
5859,The Princess and the Matchmaker,9899017,78900,9820117,2018_boxofficemojo_rankings.csv,2018,0.007970488382836398,0.9920295116171636
5860,Very Bad Things,9898412,9898412,0,1998_boxofficemojo_rankings.csv,1998,1.0,0.0
5861,Tsotsi,9891303,2912606,6978697,2005_boxofficemojo_rankings.csv,2005,0.29446130605846366,0.7055386939415363
5862,The Onion Field,9890597,9890597,0,1979_boxofficemojo_rankings.csv,1979,1.0,0.0
5863,Night Falls on Manhattan,9889670,9889670,0,1997_boxofficemojo_rankings.csv,1997,1.0,0.0
5864,Miami Blues,9888167,9888167,0,1990_boxofficemojo_rankings.csv,1990,1.0,0.0
5865,Arctic Dogs,9877855,5801249,4076606,2019_boxofficemojo_rankings.csv,2019,0.5872984570030639,0.41270154299693607
5866,Explorers,9873044,9873044,0,1985_boxofficemojo_rankings.csv,1985,1.0,0.0
5867,Dunston Checks In,9871065,9871065,0,1996_boxofficemojo_rankings.csv,1996,1.0,0.0
5868,Serial,9870727,9870727,0,1980_boxofficemojo_rankings.csv,1980,1.0,0.0
5869,Maid to Order,9868521,9868521,0,1987_boxofficemojo_rankings.csv,1987,1.0,0.0
5870,Mostly Martha,9852022,4160475,5691547,2002_boxofficemojo_rankings.csv,2002,0.4222965600361022,0.5777034399638977
5871,Jade,9851610,9851610,0,1995_boxofficemojo_rankings.csv,1995,1.0,0.0
5872,Mondays in the Sun,9832663,153256,9679407,2002_boxofficemojo_rankings.csv,2002,0.015586418450423857,0.9844135815495761
5873,3 Strikes,9832166,9832166,0,2000_boxofficemojo_rankings.csv,2000,1.0,0.0
5874,Hanky Panky,9823934,9823934,0,1982_boxofficemojo_rankings.csv,1982,1.0,0.0
5875,The Express,9808124,9793406,14718,2008_boxofficemojo_rankings.csv,2008,0.9984994072260913,0.0015005927739086496
5876,"He Said, She Said",9804775,9804775,0,1991_boxofficemojo_rankings.csv,1991,1.0,0.0
5877,Bad Dreams,9797098,9797098,0,1988_boxofficemojo_rankings.csv,1988,1.0,0.0
5878,Ghost in the Shell 2: Innocence,9789651,1043896,8745755,2004_boxofficemojo_rankings.csv,2004,0.10663260620833163,0.8933673937916684
5879,The Swan Princess,9771658,9771658,0,1994_boxofficemojo_rankings.csv,1994,1.0,0.0
5880,Moon,9760107,5010163,4749944,2009_boxofficemojo_rankings.csv,2009,0.5133307452469528,0.4866692547530473
5881,Everyone Says I Love You,9759200,9759200,0,1996_boxofficemojo_rankings.csv,1996,1.0,0.0
5882,Young & Beautiful,9757417,61067,9696350,2013_boxofficemojo_rankings.csv,2013,0.0062585210819625725,0.9937414789180374
5883,Tamjung Hong Gil-dong: Sarajin Ma-eul,9754195,67054,9687141,2016_boxofficemojo_rankings.csv,2016,0.006874375589169583,0.9931256244108304
5884,The Hidden,9747988,9747988,0,1987_boxofficemojo_rankings.csv,1987,1.0,0.0
5885,Amos & Andrew,9745803,9745803,0,1993_boxofficemojo_rankings.csv,1993,1.0,0.0
5886,Maudie,9733932,6170998,3562934,2017_boxofficemojo_rankings.csv,2017,0.6339676504828675,0.3660323495171324
5887,My Life Without Me,9726954,400948,9326006,2003_boxofficemojo_rankings.csv,2003,0.041220303910144945,0.958779696089855
5888,Cloak and Dagger,9719952,9719952,0,1984_boxofficemojo_rankings.csv,1984,1.0,0.0
5889,Bread and Tulips,9719848,5318679,4401169,2000_boxofficemojo_rankings.csv,2000,0.547197754532787,0.4528022454672131
5890,Somewhere in Time,9709597,9709597,0,1980_boxofficemojo_rankings.csv,1980,1.0,0.0
5891,Flesh and Bone,9709451,9709451,0,1993_boxofficemojo_rankings.csv,1993,1.0,0.0
5892,The Journey of Natty Gann,9708373,9708373,0,1985_boxofficemojo_rankings.csv,1985,1.0,0.0
5893,SpaceCamp,9697739,9697739,0,1986_boxofficemojo_rankings.csv,1986,1.0,0.0
5894,The Butcher's Wife,9689816,9689816,0,1991_boxofficemojo_rankings.csv,1991,1.0,0.0
5895,The Baby-Sitters Club,9685976,9685976,0,1995_boxofficemojo_rankings.csv,1995,1.0,0.0
5896,Popstar: Never Stop Never Stopping,9680029,9639125,40904,2016_boxofficemojo_rankings.csv,2016,0.9957743928246496,0.0042256071753504045
5897,I Know Who Killed Me,9669758,7498716,2171042,2007_boxofficemojo_rankings.csv,2007,0.7754812478244026,0.22451875217559736
5898,Tod@s Caen,9667157,2670925,6996232,2019_boxofficemojo_rankings.csv,2019,0.2762885717072765,0.7237114282927235
5899,In Darkness,9661759,1041455,8620304,2012_boxofficemojo_rankings.csv,2012,0.10779144874137307,0.892208551258627
5900,Overdrive,9650552,7793,9642759,2017_boxofficemojo_rankings.csv,2017,0.0008075185751032687,0.9991924814248967
5901,Country,9640000,9640000,0,1984_boxofficemojo_rankings.csv,1984,1.0,0.0
5902,Belly,9639390,9639390,0,1998_boxofficemojo_rankings.csv,1998,1.0,0.0
5903,The Young Black Stallion,9638389,6751389,2887000,2003_boxofficemojo_rankings.csv,2003,0.7004686156576582,0.29953138434234183
5904,Without a Trace,9632062,9632062,0,1983_boxofficemojo_rankings.csv,1983,1.0,0.0
5905,Wrongfully Accused,9623329,9623329,0,1998_boxofficemojo_rankings.csv,1998,1.0,0.0
5906,On the Road,9617377,744296,8873081,2012_boxofficemojo_rankings.csv,2012,0.07739074801788472,0.9226092519821153
5907,Turbo: A Power Rangers Movie,9615840,8363899,1251941,1997_boxofficemojo_rankings.csv,1997,0.8698043020682541,0.13019569793174596
5908,Scoundrel,9610033,1291827,8318206,2009_boxofficemojo_rankings.csv,2009,0.13442482455575336,0.8655751754442467
5909,Private,9595697,15811,9579886,2005_boxofficemojo_rankings.csv,2005,0.0016477177218080145,0.998352282278192
5910,Paterson,9588282,2152738,7435544,2016_boxofficemojo_rankings.csv,2016,0.22451759345417668,0.7754824065458233
5911,Comes a Horseman,9585769,9585769,0,1978_boxofficemojo_rankings.csv,1978,1.0,0.0
5912,The Spanish Prisoner,9584314,9584314,0,1998_boxofficemojo_rankings.csv,1998,1.0,0.0
5913,Hysteria,9584256,1804139,7780117,2011_boxofficemojo_rankings.csv,2011,0.1882398592024253,0.8117601407975746
5914,I Could Never Be Your Woman,9576495,0,9576495,2007_boxofficemojo_rankings.csv,2007,0.0,1.0
5915,Carbon Copy,9566593,9566593,0,1981_boxofficemojo_rankings.csv,1981,1.0,0.0
5916,The Man Without a Past,9564237,921847,8642390,2002_boxofficemojo_rankings.csv,2002,0.0963847926394965,0.9036152073605035
5917,Scenes from a Mall,9563393,9563393,0,1991_boxofficemojo_rankings.csv,1991,1.0,0.0
5918,God of War,9559524,53000,9506524,2017_boxofficemojo_rankings.csv,2017,0.005544209104972172,0.9944557908950278
5919,She's the One,9538948,9538948,0,1996_boxofficemojo_rankings.csv,1996,1.0,0.0
5920,Matinee,9532895,9532895,0,1993_boxofficemojo_rankings.csv,1993,1.0,0.0
5921,Mid-August Lunch,9520933,675299,8845634,2008_boxofficemojo_rankings.csv,2008,0.07092781768341401,0.929072182316586
5922,Agent Vinod,9520886,698210,8822676,2012_boxofficemojo_rankings.csv,2012,0.07333456151034683,0.9266654384896532
5923,From the Hip,9518342,9518342,0,1987_boxofficemojo_rankings.csv,1987,1.0,0.0
5924,Traffik,9515914,9186156,329758,2018_boxofficemojo_rankings.csv,2018,0.9653466813592473,0.034653318640752745
5925,Shall We Dance?,9499091,9499091,0,1997_boxofficemojo_rankings.csv,1997,1.0,0.0
5926,The Young and Prodigious T.S. Spivet,9494789,173564,9321225,2013_boxofficemojo_rankings.csv,2013,0.01827992175497528,0.9817200782450247
5927,The Square,9493791,1502347,7991444,2017_boxofficemojo_rankings.csv,2017,0.15824521521487042,0.8417547847851296
5928,Chaplin,9493259,9493259,0,1992_boxofficemojo_rankings.csv,1992,1.0,0.0
5929,Point Blank,9487445,708215,8779230,2010_boxofficemojo_rankings.csv,2010,0.07464760006513872,0.9253523999348613
5930,Our Time Will Come,9484714,114560,9370154,2017_boxofficemojo_rankings.csv,2017,0.012078382120957996,0.987921617879042
5931,Guilty by Suspicion,9480198,9480198,0,1991_boxofficemojo_rankings.csv,1991,1.0,0.0
5932,The Mayor 2017 Re-release,9476194,96777,9379417,2017_boxofficemojo_rankings.csv,2017,0.010212644443539252,0.9897873555564608
5933,Official Secrets,9473603,1988546,7485057,2019_boxofficemojo_rankings.csv,2019,0.20990387712045777,0.7900961228795422
5934,Promare,9467336,2313596,7153740,2019_boxofficemojo_rankings.csv,2019,0.2443766651991648,0.7556233348008352
5935,Peepli [Live],9460931,757951,8702980,2010_boxofficemojo_rankings.csv,2010,0.08011378584200646,0.9198862141579935
5936,All the King's Men,9451623,7221458,2230165,2006_boxofficemojo_rankings.csv,2006,0.7640442281711829,0.23595577182881713
5937,Superbabies: Baby Geniuses 2,9448644,9219388,229256,2004_boxofficemojo_rankings.csv,2004,0.9757366242182476,0.024263375781752385
5938,Goya's Ghosts,9448082,1000626,8447456,2006_boxofficemojo_rankings.csv,2006,0.10590784457628544,0.8940921554237146
5939,Veronica Guerin,9439660,1571504,7868156,2003_boxofficemojo_rankings.csv,2003,0.1664788774171951,0.8335211225828049
5940,Village of the Damned,9418365,9418365,0,1995_boxofficemojo_rankings.csv,1995,1.0,0.0
5941,The Big Bad Fox and Other Tales,9399067,35787,9363280,2017_boxofficemojo_rankings.csv,2017,0.0038075055747554517,0.9961924944252446
5942,Angie,9398308,9398308,0,1994_boxofficemojo_rankings.csv,1994,1.0,0.0
5943,Ghostbusters 1985 Re-release,9389135,9389135,0,1985_boxofficemojo_rankings.csv,1985,1.0,0.0
5944,Fierce Creatures,9381260,9381260,0,1997_boxofficemojo_rankings.csv,1997,1.0,0.0
5945,Ghost Dog: The Way of the Samurai,9380473,3308029,6072444,2000_boxofficemojo_rankings.csv,2000,0.3526505539752633,0.6473494460247367
5946,Running Scared,9380029,6855137,2524892,2006_boxofficemojo_rankings.csv,2006,0.7308225806124906,0.26917741938750933
5947,Bel Ami,9374932,120462,9254470,2012_boxofficemojo_rankings.csv,2012,0.01284937320078695,0.9871506267992131
5948,Tuff Turf,9369329,9369329,0,1985_boxofficemojo_rankings.csv,1985,1.0,0.0
5949,Chéri,9368242,2715657,6652585,2009_boxofficemojo_rankings.csv,2009,0.2898790402724439,0.7101209597275562
5950,You Were Never Really Here,9360514,2528078,6832436,2017_boxofficemojo_rankings.csv,2017,0.2700789721590075,0.7299210278409924
5951,Journey of a Woman,9354562,675102,8679460,2007_boxofficemojo_rankings.csv,2007,0.0721682105479658,0.9278317894520342
5952,Martian Child,9351744,7500310,1851434,2007_boxofficemojo_rankings.csv,2007,0.8020225959992061,0.19797740400079386
5953,The Frisco Kid,9346177,9346177,0,1979_boxofficemojo_rankings.csv,1979,1.0,0.0
5954,Jexi,9341824,6546159,2795665,2019_boxofficemojo_rankings.csv,2019,0.7007367083772933,0.29926329162270665
5955,Hellraiser: Bloodline,9336886,9336886,0,1996_boxofficemojo_rankings.csv,1996,1.0,0.0
5956,Miracle at St. Anna,9333654,7919117,1414537,2008_boxofficemojo_rankings.csv,2008,0.8484476711907255,0.1515523288092745
5957,Saving Private Perez,9330465,1400726,7929739,2011_boxofficemojo_rankings.csv,2011,0.15012392201246133,0.8498760779875387
5958,Replicas,9330075,4046429,5283646,2018_boxofficemojo_rankings.csv,2018,0.4336973711358162,0.5663026288641838
5959,Seraphine,9329376,884613,8444763,2008_boxofficemojo_rankings.csv,2008,0.09482016803696196,0.9051798319630381
5960,The Story of the Weeping Camel,9328652,1763052,7565600,2004_boxofficemojo_rankings.csv,2004,0.18899322217186362,0.8110067778281363
5961,MacGruber,9322895,8525600,797295,2010_boxofficemojo_rankings.csv,2010,0.9144798906348296,0.08552010936517036
5962,We're Back! A Dinosaur's Story,9317021,9317021,0,1993_boxofficemojo_rankings.csv,1993,1.0,0.0
5963,Peeples,9307166,9177065,130101,2013_boxofficemojo_rankings.csv,2013,0.9860214161861945,0.013978583813805406
5964,Mad Love,9306362,280046,9026316,2001_boxofficemojo_rankings.csv,2001,0.030091887678557958,0.969908112321442
5965,Secretary,9304609,4059680,5244929,2002_boxofficemojo_rankings.csv,2002,0.4363085004431675,0.5636914995568325
5966,Mid90s,9303022,7362439,1940583,2018_boxofficemojo_rankings.csv,2018,0.7914029441185886,0.20859705588141145
5967,Bobby Deerfield,9300000,9300000,0,1977_boxofficemojo_rankings.csv,1977,1.0,0.0
5968,Shootout at Lokhandwala,9291694,289232,9002462,2007_boxofficemojo_rankings.csv,2007,0.03112801605390793,0.9688719839460921
5969,Hello Greetings,9289939,1413283,7876656,2005_boxofficemojo_rankings.csv,2005,0.15213049299893142,0.8478695070010686
5970,Lost in Yonkers,9285189,9285189,0,1993_boxofficemojo_rankings.csv,1993,1.0,0.0
5971,The Page Turner,9284027,209659,9074368,2006_boxofficemojo_rankings.csv,2006,0.02258276500057572,0.9774172349994242
5972,Jerusalem,9279456,8020721,1258735,2013_boxofficemojo_rankings.csv,2013,0.8643525008362559,0.13564749916374408
5973,Ringmaster,9257103,9257103,0,1998_boxofficemojo_rankings.csv,1998,1.0,0.0
5974,Celtic Pride,9255027,9255027,0,1996_boxofficemojo_rankings.csv,1996,1.0,0.0
5975,Le Chef,9245235,342667,8902568,2012_boxofficemojo_rankings.csv,2012,0.03706417413943507,0.9629358258605649
5976,Havana,9243140,9243140,0,1990_boxofficemojo_rankings.csv,1990,1.0,0.0
5977,We Need to Talk About Kevin,9232318,1738692,7493626,2011_boxofficemojo_rankings.csv,2011,0.1883267019181965,0.8116732980818036
5978,Mrs. Brown,9229808,9229808,0,1997_boxofficemojo_rankings.csv,1997,1.0,0.0
5979,Gladiator,9223441,9223441,0,1992_boxofficemojo_rankings.csv,1992,1.0,0.0
5980,Shoot the Moon,9217530,9217530,0,1982_boxofficemojo_rankings.csv,1982,1.0,0.0
5981,The Aftermath,9215591,1618497,7597094,2019_boxofficemojo_rankings.csv,2019,0.17562595822666174,0.8243740417733383
5982,State and Main,9206279,6944471,2261808,2000_boxofficemojo_rankings.csv,2000,0.7543189816428548,0.24568101835714515
5983,Return of the Living Dead II,9205924,9205924,0,1988_boxofficemojo_rankings.csv,1988,1.0,0.0
5984,Tulip Fever,9204549,2455635,6748914,2017_boxofficemojo_rankings.csv,2017,0.2667849342754327,0.7332150657245673
5985,My Cousin Rachel,9200168,2716368,6483800,2017_boxofficemojo_rankings.csv,2017,0.2952519997460916,0.7047480002539084
5986,Away from Her,9194283,4571521,4622762,2007_boxofficemojo_rankings.csv,2007,0.49721343143342445,0.5027865685665756
5987,Bad Boys,9190819,9190819,0,1983_boxofficemojo_rankings.csv,1983,1.0,0.0
5988,Body Parts,9188150,9188150,0,1991_boxofficemojo_rankings.csv,1991,1.0,0.0
5989,Less Sugar,9178465,697369,8481096,2007_boxofficemojo_rankings.csv,2007,0.07597882652491457,0.9240211734750854
5990,Pennies from Heaven,9171289,9171289,0,1981_boxofficemojo_rankings.csv,1981,1.0,0.0
5991,A Hologram for the King,9169507,4212494,4957013,2016_boxofficemojo_rankings.csv,2016,0.4594024520620356,0.5405975479379644
5992,Unfinished Song,9166865,1702668,7464197,2013_boxofficemojo_rankings.csv,2013,0.18574158122760617,0.8142584187723938
5993,Ulee's Gold,9161691,9161691,0,1997_boxofficemojo_rankings.csv,1997,1.0,0.0
5994,Stone Cold,9151887,9151887,0,1991_boxofficemojo_rankings.csv,1991,1.0,0.0
5995,The Raid: Redemption,9148519,4105187,5043332,2012_boxofficemojo_rankings.csv,2012,0.4487269469517416,0.5512730530482585
5996,Switching Channels,9129999,9129999,0,1988_boxofficemojo_rankings.csv,1988,1.0,0.0
5997,Ruby Sparks,9128263,2540106,6588157,2012_boxofficemojo_rankings.csv,2012,0.2782682751362444,0.7217317248637556
5998,My Piece of the Pie,9123187,6850,9116337,2011_boxofficemojo_rankings.csv,2011,0.0007508341109307526,0.9992491658890692
5999,Searching for Sugar Man,9122406,3696196,5426210,2012_boxofficemojo_rankings.csv,2012,0.40517775683301094,0.5948222431669891
6000,City Of Rock,9118873,312537,8806336,2017_boxofficemojo_rankings.csv,2017,0.034273643245168565,0.9657263567548314
6001,Tap,9114702,9114702,0,1989_boxofficemojo_rankings.csv,1989,1.0,0.0
6002,Human Capital,9113941,158549,8955392,2014_boxofficemojo_rankings.csv,2014,0.017396316258795178,0.9826036837412048
6003,Miss Sloane,9101546,3500605,5600941,2016_boxofficemojo_rankings.csv,2016,0.3846165255880704,0.6153834744119295
6004,Inception 10th Anniversary re-release,9100000,0,9100000,2020_boxofficemojo_rankings.csv,2020,0.0,1.0
6005,Meet the Blacks,9097072,9097072,0,2016_boxofficemojo_rankings.csv,2016,1.0,0.0
6006,Warlock,9094451,9094451,0,1991_boxofficemojo_rankings.csv,1991,1.0,0.0
6007,Tolkien,9090040,4535154,4554886,2019_boxofficemojo_rankings.csv,2019,0.4989146362392245,0.5010853637607755
6008,Sweet Dreams,9085049,9085049,0,1985_boxofficemojo_rankings.csv,1985,1.0,0.0
6009,Rear Window 1983 Re-release,9084873,9084420,453,1983_boxofficemojo_rankings.csv,1983,0.9999501368923924,4.986310760755819e-05
6010,Mad Hot Ballroom,9079042,8117961,961081,2005_boxofficemojo_rankings.csv,2005,0.8941429062669828,0.1058570937330172
6011,Murder 2,9078349,59000,9019349,2011_boxofficemojo_rankings.csv,2011,0.006498979054451421,0.9935010209455486
6012,A Midsummer Night's Sex Comedy,9077269,9077269,0,1982_boxofficemojo_rankings.csv,1982,1.0,0.0
6013,Twice Born,9075131,18295,9056836,2012_boxofficemojo_rankings.csv,2012,0.002015948860683113,0.9979840511393169
6014,Me and Earl and the Dying Girl,9074749,6758416,2316333,2015_boxofficemojo_rankings.csv,2015,0.7447496343976016,0.2552503656023985
6015,Monsieur Lazhar,9074711,2009517,7065194,2012_boxofficemojo_rankings.csv,2012,0.22144143212935377,0.7785585678706463
6016,Anjaana Anjaani,9062995,854757,8208238,2010_boxofficemojo_rankings.csv,2010,0.09431286235951802,0.905687137640482
6017,The Fifth Estate,9058564,3255008,5803556,2013_boxofficemojo_rankings.csv,2013,0.3593293594878835,0.6406706405121165
6018,Frances Ha,9058065,4069826,4988239,2013_boxofficemojo_rankings.csv,2013,0.4493041284203635,0.5506958715796365
6019,Trail of the Pink Panther,9056073,9056073,0,1982_boxofficemojo_rankings.csv,1982,1.0,0.0
6020,The Love Letter,9041804,8302478,739326,1999_boxofficemojo_rankings.csv,1999,0.9182324677686001,0.08176753223139983
6021,El Crimen Perfecto (The Perfect Crime),9040997,418843,8622154,2004_boxofficemojo_rankings.csv,2004,0.04632708096242041,0.9536729190375796
6022,Incarnate,9037058,4799774,4237284,2016_boxofficemojo_rankings.csv,2016,0.5311213007596056,0.4688786992403944
6023,Like Crazy,9029150,107362,8921788,2016_boxofficemojo_rankings.csv,2016,0.011890598782831163,0.9881094012171688
6024,Truman,9027600,210840,8816760,2015_boxofficemojo_rankings.csv,2015,0.02335504453010767,0.9766449554698924
6025,Target,9023199,9023199,0,1985_boxofficemojo_rankings.csv,1985,1.0,0.0
6026,Trippin',9017070,9017070,0,1999_boxofficemojo_rankings.csv,1999,1.0,0.0
6027,"Two Days, One Night",9016922,1436243,7580679,2014_boxofficemojo_rankings.csv,2014,0.15928306799149422,0.8407169320085058
6028,Renegades,9015164,9015164,0,1989_boxofficemojo_rankings.csv,1989,1.0,0.0
6029,White Sands,9011574,9011574,0,1992_boxofficemojo_rankings.csv,1992,1.0,0.0
6030,Saturn 3,9000000,9000000,0,1980_boxofficemojo_rankings.csv,1980,1.0,0.0
6031,Tribute,9000000,9000000,0,1980_boxofficemojo_rankings.csv,1980,1.0,0.0
6032,Deadly Friend,8988731,8988731,0,1986_boxofficemojo_rankings.csv,1986,1.0,0.0
6033,Comedy of Power,8987781,80550,8907231,2006_boxofficemojo_rankings.csv,2006,0.00896216763626083,0.9910378323637392
6034,Breaking and Entering,8974829,930469,8044360,2006_boxofficemojo_rankings.csv,2006,0.10367540150347154,0.8963245984965285
6035,Champion,8974547,97472,8877075,2018_boxofficemojo_rankings.csv,2018,0.010860938162115592,0.9891390618378844
6036,The Lobster 2016 Re-release,8952351,8700374,251977,2016_boxofficemojo_rankings.csv,2016,0.9718535388078506,0.028146461192149416
6037,Teaching Mrs. Tingle,8951935,8951935,0,1999_boxofficemojo_rankings.csv,1999,1.0,0.0
6038,Ong Bak 2,8936663,102458,8834205,2008_boxofficemojo_rankings.csv,2008,0.011464905860274691,0.9885350941397253
6039,In the Mouth of Madness,8924549,8924549,0,1995_boxofficemojo_rankings.csv,1995,1.0,0.0
6040,Bolero,8914881,8914881,0,1984_boxofficemojo_rankings.csv,1984,1.0,0.0
6041,Kandahar,8914751,1418314,7496437,2001_boxofficemojo_rankings.csv,2001,0.15909743300738294,0.8409025669926171
6042,Late for Dinner,8906823,8906823,0,1991_boxofficemojo_rankings.csv,1991,1.0,0.0
6043,Downhill,8899195,8287061,612134,2020_boxofficemojo_rankings.csv,2020,0.9312146772826081,0.06878532271739185
6044,The Formula,8894289,8894289,0,1980_boxofficemojo_rankings.csv,1980,1.0,0.0
6045,Salsa,8892589,8892589,0,1988_boxofficemojo_rankings.csv,1988,1.0,0.0
6046,"Mystery, Alaska",8891623,8891623,0,1999_boxofficemojo_rankings.csv,1999,1.0,0.0
6047,Cadillac Records,8883644,8195551,688093,2008_boxofficemojo_rankings.csv,2008,0.9225438344895406,0.07745616551045945
6048,Hannah Arendt,8880936,717205,8163731,2013_boxofficemojo_rankings.csv,2013,0.08075781651843905,0.919242183481561
6049,The Inkwell,8880705,8880705,0,1994_boxofficemojo_rankings.csv,1994,1.0,0.0
6050,White Fang 2: Myth of the White Wolf,8878839,8878839,0,1994_boxofficemojo_rankings.csv,1994,1.0,0.0
6051,Apt Pupil,8863193,8863193,0,1998_boxofficemojo_rankings.csv,1998,1.0,0.0
6052,Nightbreed,8862354,8862354,0,1990_boxofficemojo_rankings.csv,1990,1.0,0.0
6053,Bluebeard,8855737,43144,8812593,2017_boxofficemojo_rankings.csv,2017,0.0048718700656986535,0.9951281299343013
6054,Après Vous,8852763,830292,8022471,2003_boxofficemojo_rankings.csv,2003,0.09378902383357603,0.906210976166424
6055,Rang De Basanti,8846694,2197694,6649000,2006_boxofficemojo_rankings.csv,2006,0.24841980518372173,0.7515801948162782
6056,All Together,8835903,43180,8792723,2012_boxofficemojo_rankings.csv,2012,0.004886880265661585,0.9951131197343385
6057,Morgan,8809407,3915251,4894156,2016_boxofficemojo_rankings.csv,2016,0.4444397903286793,0.5555602096713207
6058,The Rocker,8808935,6409528,2399407,2008_boxofficemojo_rankings.csv,2008,0.727616675568613,0.272383324431387
6059,Dolphins and Whales 3D: Tribes of the Ocean,8808659,7714996,1093663,2008_boxofficemojo_rankings.csv,2008,0.8758422820091004,0.12415771799089964
6060,Captive State,8808611,5958315,2850296,2019_boxofficemojo_rankings.csv,2019,0.6764193582847511,0.32358064171524886
6061,Body Double,8801940,8801940,0,1984_boxofficemojo_rankings.csv,1984,1.0,0.0
6062,Scandal,8800000,8800000,0,1989_boxofficemojo_rankings.csv,1989,1.0,0.0
6063,Before and After,8797839,8797839,0,1996_boxofficemojo_rankings.csv,1996,1.0,0.0
6064,Oxford Blues,8793152,8793152,0,1984_boxofficemojo_rankings.csv,1984,1.0,0.0
6065,18 Years Later,8785730,25611,8760119,2003_boxofficemojo_rankings.csv,2003,0.0029150679567890203,0.997084932043211
6066,The Traitor,8780535,296027,8484508,2019_boxofficemojo_rankings.csv,2019,0.03371400489833478,0.9662859951016652
6067,Son of the Bride,8772695,624757,8147938,2001_boxofficemojo_rankings.csv,2001,0.07121608582083384,0.9287839141791662
6068,7 Days in Entebbe,8771432,3326885,5444547,2018_boxofficemojo_rankings.csv,2018,0.379286415262639,0.620713584737361
6069,Sorry We Missed You,8766149,28273,8737876,2019_boxofficemojo_rankings.csv,2019,0.0032252474832449233,0.9967747525167551
6070,Ghost World,8764007,6217849,2546158,2001_boxofficemojo_rankings.csv,2001,0.7094755857680168,0.29052441423198316
6071,Marguerite,8754356,506677,8247679,2015_boxofficemojo_rankings.csv,2015,0.0578771299682124,0.9421228700317876
6072,La folle histoire de Max et Léon,8750678,543,8750135,2016_boxofficemojo_rankings.csv,2016,6.205233468766649e-05,0.9999379476653123
6073,The Five Heartbeats,8750400,8750400,0,1991_boxofficemojo_rankings.csv,1991,1.0,0.0
6074,Mad Max,8750000,8750000,0,1980_boxofficemojo_rankings.csv,1980,1.0,0.0
6075,True Believer,8742750,8742750,0,1989_boxofficemojo_rankings.csv,1989,1.0,0.0
6076,Big Stan,8742330,0,8742330,2008_boxofficemojo_rankings.csv,2008,0.0,1.0
6077,The Villainess,8737458,27741,8709717,2017_boxofficemojo_rankings.csv,2017,0.003174950883884077,0.9968250491161159
6078,Delta Farce,8729473,8130530,598943,2007_boxofficemojo_rankings.csv,2007,0.9313884125651113,0.06861158743488868
6079,Reservation,8726551,651096,8075455,2011_boxofficemojo_rankings.csv,2011,0.07461092016765845,0.9253890798323415
6080,Code Geass: Lelouch of the Re;Surrection 2019 Re-release,8715612,522805,8192807,2019_boxofficemojo_rankings.csv,2019,0.05998488689032967,0.9400151131096703
6081,Infernal Affairs,8708932,169659,8539273,2002_boxofficemojo_rankings.csv,2002,0.019481033954565265,0.9805189660454348
6082,The Royal Guard,8707875,1290212,7417663,2007_boxofficemojo_rankings.csv,2007,0.14816611400600033,0.8518338859939997
6083,The Forsaken,8704851,7288451,1416400,2001_boxofficemojo_rankings.csv,2001,0.8372861293088187,0.16271387069118126
6084,If You Could See What I Hear,8693512,8693512,0,1982_boxofficemojo_rankings.csv,1982,1.0,0.0
6085,Mischief,8692426,8692426,0,1985_boxofficemojo_rankings.csv,1985,1.0,0.0
6086,Mardaani 2,8680109,0,8680109,2019_boxofficemojo_rankings.csv,2019,0.0,1.0
6087,The Station Agent,8679814,5739376,2940438,2003_boxofficemojo_rankings.csv,2003,0.661232602449776,0.338767397550224
6088,Play It to the Bone,8678812,8434146,244666,1999_boxofficemojo_rankings.csv,1999,0.9718088143861164,0.02819118561388356
6089,Clean and Sober,8674093,8674093,0,1988_boxofficemojo_rankings.csv,1988,1.0,0.0
6090,Once Upon a Crime...,8669847,8669847,0,1992_boxofficemojo_rankings.csv,1992,1.0,0.0
6091,Corpus Christi,8669555,127240,8542315,2019_boxofficemojo_rankings.csv,2019,0.014676647186620305,0.9853233528133797
6092,Bingo,8667684,8667684,0,1991_boxofficemojo_rankings.csv,1991,1.0,0.0
6093,How She Move,8659212,7070641,1588571,2008_boxofficemojo_rankings.csv,2008,0.8165455471005907,0.18345445289940931
6094,Fashion,8658713,191442,8467271,2008_boxofficemojo_rankings.csv,2008,0.022109752338482638,0.9778902476615173
6095,Le Week-end,8652213,2225098,6427115,2013_boxofficemojo_rankings.csv,2013,0.257170968860799,0.7428290311392011
6096,The Puppet Masters,8647042,8647042,0,1994_boxofficemojo_rankings.csv,1994,1.0,0.0
6097,The Man with One Red Shoe,8645411,8645411,0,1985_boxofficemojo_rankings.csv,1985,1.0,0.0
6098,Himmatwala,8644563,270880,8373683,2013_boxofficemojo_rankings.csv,2013,0.03133530289501042,0.9686646971049896
6099,The Condemned,8642858,7371706,1271152,2007_boxofficemojo_rankings.csv,2007,0.8529245765694635,0.1470754234305365
6100,That Was Then... This Is Now,8630068,8630068,0,1985_boxofficemojo_rankings.csv,1985,1.0,0.0
6101,Secret Admirer,8622757,8622757,0,1985_boxofficemojo_rankings.csv,1985,1.0,0.0
6102,Manhunter,8620929,8620929,0,1986_boxofficemojo_rankings.csv,1986,1.0,0.0
6103,All Dogs Go to Heaven 2,8620678,8620678,0,1996_boxofficemojo_rankings.csv,1996,1.0,0.0
6104,The Bounty,8613462,8613462,0,1984_boxofficemojo_rankings.csv,1984,1.0,0.0
6105,Pope Francis: A Man of His Word,8608385,2008385,6600000,2018_boxofficemojo_rankings.csv,2018,0.23330566651003642,0.7666943334899635
6106,U2: Rattle and Hum,8600823,8600823,0,1988_boxofficemojo_rankings.csv,1988,1.0,0.0
6107,Things We Lost in the Fire,8591255,3287315,5303940,2007_boxofficemojo_rankings.csv,2007,0.38263501665356225,0.6173649833464377
6108,High Spirits,8578231,8578231,0,1988_boxofficemojo_rankings.csv,1988,1.0,0.0
6109,Strange Brew,8571374,8571374,0,1983_boxofficemojo_rankings.csv,1983,1.0,0.0
6110,Love Me If You Dare,8561371,553504,8007867,2003_boxofficemojo_rankings.csv,2003,0.06465132745678233,0.9353486725432176
6111,Leprechaun,8556940,8556940,0,1993_boxofficemojo_rankings.csv,1993,1.0,0.0
6112,Blue Velvet,8551228,8551228,0,1986_boxofficemojo_rankings.csv,1986,1.0,0.0
6113,Willard,8546666,6886089,1660577,2003_boxofficemojo_rankings.csv,2003,0.8057047040331282,0.19429529596687176
6114,The Rich Man's Wife,8543587,8543587,0,1996_boxofficemojo_rankings.csv,1996,1.0,0.0
6115,Care Bears Movie II: A New Generation,8540346,8540346,0,1986_boxofficemojo_rankings.csv,1986,1.0,0.0
6116,Without a Clue,8539181,8539181,0,1988_boxofficemojo_rankings.csv,1988,1.0,0.0
6117,Ski Patrol,8533973,8533973,0,1990_boxofficemojo_rankings.csv,1990,1.0,0.0
6118,Space Dogs,8530226,14408,8515818,2010_boxofficemojo_rankings.csv,2010,0.0016890525526521807,0.9983109474473478
6119,Battle Creek Brawl,8527743,8527743,0,1980_boxofficemojo_rankings.csv,1980,1.0,0.0
6120,Our Brand Is Crisis,8527658,7002261,1525397,2015_boxofficemojo_rankings.csv,2015,0.8211235722633342,0.1788764277366658
6121,Before Night Falls,8527517,4242892,4284625,2000_boxofficemojo_rankings.csv,2000,0.49755303917893096,0.502446960821069
6122,What If,8526288,3493000,5033288,2014_boxofficemojo_rankings.csv,2014,0.40967417474052015,0.5903258252594799
6123,Troop Beverly Hills,8508843,8508843,0,1989_boxofficemojo_rankings.csv,1989,1.0,0.0
6124,Stronger,8503658,4211129,4292529,2017_boxofficemojo_rankings.csv,2017,0.495213824450607,0.504786175549393
6125,Big Trouble,8493890,7267307,1226583,2002_boxofficemojo_rankings.csv,2002,0.8555923140045374,0.1444076859954626
6126,Piranha 3DD,8493728,376512,8117216,2012_boxofficemojo_rankings.csv,2012,0.044328238436644074,0.9556717615633559
6127,La mujer de mi hermano,8492178,2808241,5683937,2005_boxofficemojo_rankings.csv,2005,0.3306856026804902,0.6693143973195098
6128,Stick,8489518,8489518,0,1985_boxofficemojo_rankings.csv,1985,1.0,0.0
6129,A Girl Cut in Two,8488537,409658,8078879,2007_boxofficemojo_rankings.csv,2007,0.048260141883106594,0.9517398581168934
6130,Star Wars: Episode II - Attack of the Clones 2002 IMAX Release,8485488,8485488,0,2002_boxofficemojo_rankings.csv,2002,1.0,0.0
6131,Stay,8483797,3626883,4856914,2005_boxofficemojo_rankings.csv,2005,0.4275070466679012,0.5724929533320988
6132,Amityville: The Awakening,8481997,742,8481255,2017_boxofficemojo_rankings.csv,2017,8.747939901417083e-05,0.9999125206009858
6133,Nothing But Trouble,8479793,8479793,0,1991_boxofficemojo_rankings.csv,1991,1.0,0.0
6134,Wise Guys,8475466,8475466,0,1986_boxofficemojo_rankings.csv,1986,1.0,0.0
6135,A-X-L,8467697,6501381,1966316,2018_boxofficemojo_rankings.csv,2018,0.767786211528353,0.232213788471647
6136,Lucky You,8461686,5758950,2702736,2007_boxofficemojo_rankings.csv,2007,0.6805913147805296,0.31940868521947047
6137,The Outrage,8457741,44745,8412996,2010_boxofficemojo_rankings.csv,2010,0.005290419746833109,0.9947095802531669
6138,Beyond the Sea,8447615,6318709,2128906,2004_boxofficemojo_rankings.csv,2004,0.7479873313355307,0.2520126686644692
6139,Casa de mi Padre,8446952,5909483,2537469,2012_boxofficemojo_rankings.csv,2012,0.6995994531518588,0.3004005468481412
6140,A Street Cat Named Bob,8446262,82703,8363559,2016_boxofficemojo_rankings.csv,2016,0.009791668787920621,0.9902083312120794
6141,Princesas,8446185,29472,8416713,2005_boxofficemojo_rankings.csv,2005,0.003489386036417625,0.9965106139635824
6142,Then She Found Me,8443998,3735717,4708281,2008_boxofficemojo_rankings.csv,2008,0.442410929040959,0.557589070959041
6143,Tender Mercies,8443124,8443124,0,1983_boxofficemojo_rankings.csv,1983,1.0,0.0
6144,Bébé's Kids,8442162,8442162,0,1992_boxofficemojo_rankings.csv,1992,1.0,0.0
6145,The Way 2010 Re-release,8437872,4430765,4007107,2010_boxofficemojo_rankings.csv,2010,0.5251045524274367,0.4748954475725633
6146,Condorito: The Movie,8431194,447719,7983475,2017_boxofficemojo_rankings.csv,2017,0.053102680355830975,0.946897319644169
6147,1984,8430492,8430492,0,1984_boxofficemojo_rankings.csv,1984,1.0,0.0
6148,Raees,8428190,3262954,5165236,2017_boxofficemojo_rankings.csv,2017,0.38714765566509535,0.6128523443349047
6149,Amen.,8419052,274299,8144753,2002_boxofficemojo_rankings.csv,2002,0.032580746620878454,0.9674192533791215
6150,The Awakening,8415112,8415112,0,1980_boxofficemojo_rankings.csv,1980,1.0,0.0
6151,Pushing Tin,8408835,8408835,0,1999_boxofficemojo_rankings.csv,1999,1.0,0.0
6152,Dr. Giggles,8403433,8403433,0,1992_boxofficemojo_rankings.csv,1992,1.0,0.0
6153,Twice in a Lifetime,8402424,8402424,0,1985_boxofficemojo_rankings.csv,1985,1.0,0.0
6154,Something Wicked This Way Comes,8400000,8400000,0,1983_boxofficemojo_rankings.csv,1983,1.0,0.0
6155,Meteor,8400000,8400000,0,1979_boxofficemojo_rankings.csv,1979,1.0,0.0
6156,Malang,8397569,0,8397569,2020_boxofficemojo_rankings.csv,2020,0.0,1.0
6157,Death Defying Acts,8394639,5665,8388974,2008_boxofficemojo_rankings.csv,2008,0.000674835451530435,0.9993251645484695
6158,Go for Zucker,8394115,87490,8306625,2005_boxofficemojo_rankings.csv,2005,0.01042277833934846,0.9895772216606515
6159,Death to Smoochy,8382938,8364691,18247,2002_boxofficemojo_rankings.csv,2002,0.997823316837128,0.0021766831628720145
6160,Bones,8378853,7316658,1062195,2001_boxofficemojo_rankings.csv,2001,0.8732290684655764,0.12677093153442362
6161,Filth,8377987,34411,8343576,2013_boxofficemojo_rankings.csv,2013,0.004107311219270214,0.9958926887807298
6162,The Last Temptation of Christ,8373585,8373585,0,1988_boxofficemojo_rankings.csv,1988,1.0,0.0
6163,Easy Money,8369756,205741,8164015,2010_boxofficemojo_rankings.csv,2010,0.024581481228365558,0.9754185187716344
6164,Smoke,8367636,8367636,0,1995_boxofficemojo_rankings.csv,1995,1.0,0.0
6165,The Love Punch,8366493,266588,8099905,2014_boxofficemojo_rankings.csv,2014,0.031863768965084895,0.9681362310349151
6166,Something Wild,8362969,8362969,0,1986_boxofficemojo_rankings.csv,1986,1.0,0.0
6167,Twin Dragons,8359717,8359717,0,1999_boxofficemojo_rankings.csv,1999,1.0,0.0
6168,Venus in Fur,8350026,373605,7976421,2013_boxofficemojo_rankings.csv,2013,0.04474297445301368,0.9552570255469863
6169,Mr. Jones,8345845,8345845,0,1993_boxofficemojo_rankings.csv,1993,1.0,0.0
6170,I Am Not Your Negro,8345298,7123919,1221379,2017_boxofficemojo_rankings.csv,2017,0.8536446511556568,0.14635534884434326
6171,My Life as a Dog,8345266,8345266,0,1987_boxofficemojo_rankings.csv,1987,1.0,0.0
6172,A Simple Wish,8345056,8345056,0,1997_boxofficemojo_rankings.csv,1997,1.0,0.0
6173,Return to Paradise,8341087,8341087,0,1998_boxofficemojo_rankings.csv,1998,1.0,0.0
6174,Bordertown,8329799,0,8329799,2007_boxofficemojo_rankings.csv,2007,0.0,1.0
6175,Khatta Meetha,8319469,541904,7777565,2010_boxofficemojo_rankings.csv,2010,0.06513684947921557,0.9348631505207844
6176,Larger Than Life,8315693,8315693,0,1996_boxofficemojo_rankings.csv,1996,1.0,0.0
6177,Time Renegades,8312361,59425,8252936,2016_boxofficemojo_rankings.csv,2016,0.007148991724493198,0.9928510082755068
6178,London Boulevard,8307227,16075,8291152,2010_boxofficemojo_rankings.csv,2010,0.0019350620850977108,0.9980649379149023
6179,The Office,8290521,63675,8226846,2015_boxofficemojo_rankings.csv,2015,0.007680458200395367,0.9923195417996047
6180,Reckless,8289916,8289916,0,1984_boxofficemojo_rankings.csv,1984,1.0,0.0
6181,The Fish That Saved Pittsburgh,8281246,8281246,0,1979_boxofficemojo_rankings.csv,1979,1.0,0.0
6182,Deadly Blessing,8279042,8279042,0,1981_boxofficemojo_rankings.csv,1981,1.0,0.0
6183,Redline,8267379,6881022,1386357,2007_boxofficemojo_rankings.csv,2007,0.8323099739349074,0.1676900260650927
6184,Cry-Baby,8266343,8266343,0,1990_boxofficemojo_rankings.csv,1990,1.0,0.0
6185,Satisfaction,8253123,8253123,0,1988_boxofficemojo_rankings.csv,1988,1.0,0.0
6186,Christopher Columbus: The Discovery,8251071,8251071,0,1992_boxofficemojo_rankings.csv,1992,1.0,0.0
6187,The Blob,8247943,8247943,0,1988_boxofficemojo_rankings.csv,1988,1.0,0.0
6188,My Worst Nightmare,8226544,21952,8204592,2011_boxofficemojo_rankings.csv,2011,0.0026684352505742387,0.9973315647494257
6189,Hoot,8224998,8117637,107361,2006_boxofficemojo_rankings.csv,2006,0.9869469877074742,0.013053012292525786
6190,Bloodline,8218695,8218695,0,1979_boxofficemojo_rankings.csv,1979,1.0,0.0
6191,Blue Steel,8217997,8217997,0,1990_boxofficemojo_rankings.csv,1990,1.0,0.0
6192,Black Robe,8211952,8211952,0,1991_boxofficemojo_rankings.csv,1991,1.0,0.0
6193,It Runs in the Family,8211508,7491839,719669,2003_boxofficemojo_rankings.csv,2003,0.912358485189322,0.08764151481067789
6194,Whose Life Is It Anyway?,8206145,8206145,0,1981_boxofficemojo_rankings.csv,1981,1.0,0.0
6195,The Machinist,8203235,1082715,7120520,2004_boxofficemojo_rankings.csv,2004,0.13198634441168636,0.8680136555883137
6196,Lucas,8200000,8200000,0,1986_boxofficemojo_rankings.csv,1986,1.0,0.0
6197,Santa vs. the Snowman 3D,8198286,1934053,6264233,2002_boxofficemojo_rankings.csv,2002,0.23590943277655843,0.7640905672234416
6198,Fantasia 1985 Re-release,8194726,8194726,0,1985_boxofficemojo_rankings.csv,1985,1.0,0.0
6199,Cave of Forgotten Dreams,8183347,5304920,2878427,2011_boxofficemojo_rankings.csv,2011,0.6482579805060203,0.35174201949397965
6200,The Big Year,8179416,7204138,975278,2011_boxofficemojo_rankings.csv,2011,0.880764347968119,0.11923565203188101
6201,This Is England,8176544,329379,7847165,2007_boxofficemojo_rankings.csv,2007,0.0402834009087458,0.9597165990912542
6202,Nick of Time,8175346,8175346,0,1995_boxofficemojo_rankings.csv,1995,1.0,0.0
6203,Water 2006 Re-release,8172058,3278815,4893243,2006_boxofficemojo_rankings.csv,2006,0.4012226785468238,0.5987773214531762
6204,Woo,8165984,8064972,101012,1998_boxofficemojo_rankings.csv,1998,0.9876301496549589,0.012369850345041088
6205,Firestorm,8165212,8165212,0,1998_boxofficemojo_rankings.csv,1998,1.0,0.0
6206,Control,8159508,872252,7287256,2007_boxofficemojo_rankings.csv,2007,0.1069000728965521,0.8930999271034479
6207,Cheetah,8153677,8153677,0,1989_boxofficemojo_rankings.csv,1989,1.0,0.0
6208,The Edukators,8152859,175493,7977366,2004_boxofficemojo_rankings.csv,2004,0.02152533240179917,0.9784746675982008
6209,Impostor,8145549,6285176,1860373,2002_boxofficemojo_rankings.csv,2002,0.7716086417256836,0.22839135827431645
6210,DeepStar Six,8143225,8143225,0,1989_boxofficemojo_rankings.csv,1989,1.0,0.0
6211,Mangal Pandey: The Rising,8142076,954108,7187968,2005_boxofficemojo_rankings.csv,2005,0.11718239918173202,0.882817600818268
6212,Funny About Love,8141292,8141292,0,1990_boxofficemojo_rankings.csv,1990,1.0,0.0
6213,Dead Bang,8125592,8125592,0,1989_boxofficemojo_rankings.csv,1989,1.0,0.0
6214,Prince of the City,8124257,8124257,0,1981_boxofficemojo_rankings.csv,1981,1.0,0.0
6215,Walk of Shame,8122990,59209,8063781,2014_boxofficemojo_rankings.csv,2014,0.0072890647409389895,0.992710935259061
6216,Spartan,8112712,4434432,3678280,2004_boxofficemojo_rankings.csv,2004,0.5466029115787667,0.4533970884212332
6217,Ernest & Celestine,8111137,262075,7849062,2012_boxofficemojo_rankings.csv,2012,0.03231051331027943,0.9676894866897205
6218,The Philadelphia Experiment,8103330,8103330,0,1984_boxofficemojo_rankings.csv,1984,1.0,0.0
6219,The New Year's Eve of Old Lee,8099301,25358,8073943,2016_boxofficemojo_rankings.csv,2016,0.0031308874679432212,0.9968691125320568
6220,The Man Who Invented Christmas,8096007,5676486,2419521,2017_boxofficemojo_rankings.csv,2017,0.7011463799376656,0.29885362006233446
6221,"New York, I Love You",8095596,1588015,6507581,2009_boxofficemojo_rankings.csv,2009,0.19615788633721346,0.8038421136627866
6222,Fresh,8094616,8094616,0,1994_boxofficemojo_rankings.csv,1994,1.0,0.0
6223,Streets of Fire,8089290,8089290,0,1984_boxofficemojo_rankings.csv,1984,1.0,0.0
6224,The Company Men,8087000,4441272,3645728,2011_boxofficemojo_rankings.csv,2011,0.5491865957709905,0.4508134042290095
6225,The Adventures of Baron Munchausen,8083123,8083123,0,1989_boxofficemojo_rankings.csv,1989,1.0,0.0
6226,My Giant,8072007,8072007,0,1998_boxofficemojo_rankings.csv,1998,1.0,0.0
6227,Bug,8059140,7025810,1033330,2007_boxofficemojo_rankings.csv,2007,0.8717816044888165,0.12821839551118358
6228,The Hidden Blade,8043781,38147,8005634,2004_boxofficemojo_rankings.csv,2004,0.004742421505508417,0.9952575784944916
6229,Aspen Extreme,8041049,8041049,0,1993_boxofficemojo_rankings.csv,1993,1.0,0.0
6230,Dead Ringers,8038508,8038508,0,1988_boxofficemojo_rankings.csv,1988,1.0,0.0
6231,The Ice Storm,8038061,8038061,0,1997_boxofficemojo_rankings.csv,1997,1.0,0.0
6232,Heroine,8036853,598668,7438185,2012_boxofficemojo_rankings.csv,2012,0.07449035088734358,0.9255096491126564
6233,Billu,8034797,754928,7279869,2009_boxofficemojo_rankings.csv,2009,0.09395732088813195,0.9060426791118681
6234,Haunted Honeymoon,8033397,8033397,0,1986_boxofficemojo_rankings.csv,1986,1.0,0.0
6235,Counter Investigation,8029345,11846,8017499,2007_boxofficemojo_rankings.csv,2007,0.001475338274790783,0.9985246617252093
6236,The Texas Chainsaw Massacre 2,8025872,8025872,0,1986_boxofficemojo_rankings.csv,1986,1.0,0.0
6237,The Meteor Man,8016708,8016708,0,1993_boxofficemojo_rankings.csv,1993,1.0,0.0
6238,Me and You and Everyone We Know,8012838,3885134,4127704,2005_boxofficemojo_rankings.csv,2005,0.48486366503353745,0.5151363349664626
6239,The Great White Hype,8008255,8008255,0,1996_boxofficemojo_rankings.csv,1996,1.0,0.0
6240,My King,8003331,54114,7949217,2015_boxofficemojo_rankings.csv,2015,0.0067614347076236135,0.9932385652923764
6241,Disobedience,8003180,3498782,4504398,2018_boxofficemojo_rankings.csv,2018,0.4371739733455951,0.5628260266544048
6242,Night Crossing,8000000,8000000,0,1982_boxofficemojo_rankings.csv,1982,1.0,0.0
6243,Life Itself,7997774,4102648,3895126,2018_boxofficemojo_rankings.csv,2018,0.5129737349417476,0.48702626505825247
6244,Denial,7994527,4073489,3921038,2016_boxofficemojo_rankings.csv,2016,0.5095347104337755,0.4904652895662245
6245,Dazed and Confused,7993039,7993039,0,1993_boxofficemojo_rankings.csv,1993,1.0,0.0
6246,American Splendor,7986084,6010990,1975094,2003_boxofficemojo_rankings.csv,2003,0.7526830421518231,0.2473169578481769
6247,The Pirate Movie,7983086,7983086,0,1982_boxofficemojo_rankings.csv,1982,1.0,0.0
6248,Metallica Through the Never,7975812,3419967,4555845,2013_boxofficemojo_rankings.csv,2013,0.42879232860553884,0.5712076713944612
6249,Merci pour le Chocolat,7972251,443238,7529013,2002_boxofficemojo_rankings.csv,2002,0.05559759721564211,0.9444024027843579
6250,Silk,7965682,1103075,6862607,2007_boxofficemojo_rankings.csv,2007,0.1384784127711852,0.8615215872288148
6251,My Mom's New Boyfriend,7963718,0,7963718,2008_boxofficemojo_rankings.csv,2008,0.0,1.0
6252,Strange Days,7959291,7959291,0,1995_boxofficemojo_rankings.csv,1995,1.0,0.0
6253,Fanfan,7949963,32686,7917277,2003_boxofficemojo_rankings.csv,2003,0.0041114656760037754,0.9958885343239963
6254,Chasing Mavericks,7942116,6002756,1939360,2012_boxofficemojo_rankings.csv,2012,0.7558131863095428,0.2441868136904573
6255,Suspiria,7942093,2483472,5458621,2018_boxofficemojo_rankings.csv,2018,0.3126974211961507,0.6873025788038493
6256,Blankman,7941977,7941977,0,1994_boxofficemojo_rankings.csv,1994,1.0,0.0
6257,Funny Games,7938872,1294919,6643953,2008_boxofficemojo_rankings.csv,2008,0.16311120773832857,0.8368887922616715
6258,A Thousand Acres,7936780,7936780,0,1997_boxofficemojo_rankings.csv,1997,1.0,0.0
6259,American Hot Wax,7932571,7932571,0,1978_boxofficemojo_rankings.csv,1978,1.0,0.0
6260,Unstrung Heroes,7929434,7929434,0,1995_boxofficemojo_rankings.csv,1995,1.0,0.0
6261,Coffee and Cigarettes,7929307,2198924,5730383,2004_boxofficemojo_rankings.csv,2004,0.2773160378328144,0.7226839621671856
6262,The Chase,7924955,7924955,0,1994_boxofficemojo_rankings.csv,1994,1.0,0.0
6263,Bushwhacked,7919823,7919823,0,1995_boxofficemojo_rankings.csv,1995,1.0,0.0
6264,El cantante,7911532,7556712,354820,2007_boxofficemojo_rankings.csv,2007,0.955151543342048,0.04484845665795196
6265,The Brink's Job,7909950,7909950,0,1978_boxofficemojo_rankings.csv,1978,1.0,0.0
6266,The Ark of Mr Chow,7894075,54075,7840000,2015_boxofficemojo_rankings.csv,2015,0.006850074264559179,0.9931499257354408
6267,Just the Way You Are,7889694,7889694,0,1984_boxofficemojo_rankings.csv,1984,1.0,0.0
6268,Teen Wolf Too,7888703,7888703,0,1987_boxofficemojo_rankings.csv,1987,1.0,0.0
6269,The Funhouse,7886857,7886857,0,1981_boxofficemojo_rankings.csv,1981,1.0,0.0
6270,Gardener,7885479,1058803,6826676,2003_boxofficemojo_rankings.csv,2003,0.13427250265963553,0.8657274973403645
6271,Pavarotti,7885016,4600249,3284767,2019_boxofficemojo_rankings.csv,2019,0.5834165713804512,0.4165834286195488
6272,The Battle of Jangsari,7883200,70853,7812347,2019_boxofficemojo_rankings.csv,2019,0.008987847574589,0.991012152425411
6273,City Island,7878856,6671036,1207820,2009_boxofficemojo_rankings.csv,2009,0.8467010946766891,0.1532989053233109
6274,Inside Job,7871522,4312735,3558787,2010_boxofficemojo_rankings.csv,2010,0.5478908653243935,0.4521091346756066
6275,Goal II: Living the Dream,7864905,225067,7639838,2007_boxofficemojo_rankings.csv,2007,0.028616620289755566,0.9713833797102445
6276,Will You Marry Me?,7862911,915728,6947183,2004_boxofficemojo_rankings.csv,2004,0.11646170228812204,0.883538297711878
6277,For a Few Bullets,7860447,30142,7830305,2016_boxofficemojo_rankings.csv,2016,0.0038346419739233657,0.9961653580260766
6278,Salut d'Amour,7858183,22480,7835703,2015_boxofficemojo_rankings.csv,2015,0.0028607122028082065,0.9971392877971917
6279,Pele: Birth of a Legend,7846608,57046,7789562,2016_boxofficemojo_rankings.csv,2016,0.007270147814189265,0.9927298521858108
6280,D.A.R.Y.L.,7840873,7840873,0,1985_boxofficemojo_rankings.csv,1985,1.0,0.0
6281,Fatal Instinct,7839327,7839327,0,1993_boxofficemojo_rankings.csv,1993,1.0,0.0
6282,Summer Hours,7835857,1657001,6178856,2008_boxofficemojo_rankings.csv,2008,0.21146391517864607,0.788536084821354
6283,The Lady,7832142,355391,7476751,2011_boxofficemojo_rankings.csv,2011,0.04537596483822689,0.9546240351617731
6284,The Little Drummer Girl,7828841,7828841,0,1984_boxofficemojo_rankings.csv,1984,1.0,0.0
6285,Dead Calm,7825009,7825009,0,1989_boxofficemojo_rankings.csv,1989,1.0,0.0
6286,Serial Mom,7820688,7820688,0,1994_boxofficemojo_rankings.csv,1994,1.0,0.0
6287,Renoir,7816573,2293798,5522775,2013_boxofficemojo_rankings.csv,2013,0.2934531539589024,0.7065468460410975
6288,Dongju: The Portrait of a Poet,7809531,56550,7752981,2016_boxofficemojo_rankings.csv,2016,0.007241151869427242,0.9927588481305728
6289,Tupac: Resurrection,7808524,7718961,89563,2003_boxofficemojo_rankings.csv,2003,0.9885300986460437,0.011469901353956266
6290,Qué León,7807916,2607916,5200000,2018_boxofficemojo_rankings.csv,2018,0.33400922858288945,0.6659907714171105
6291,Bad Words,7804337,7779614,24723,2014_boxofficemojo_rankings.csv,2014,0.9968321460234226,0.0031678539765773828
6292,House II: The Second Story,7800000,7800000,0,1987_boxofficemojo_rankings.csv,1987,1.0,0.0
6293,Amazing Grace,7796112,4450456,3345656,2018_boxofficemojo_rankings.csv,2018,0.5708558317274046,0.4291441682725954
6294,The Best of Times,7790931,7790931,0,1986_boxofficemojo_rankings.csv,1986,1.0,0.0
6295,If Looks Could Kill,7788597,7788597,0,1991_boxofficemojo_rankings.csv,1991,1.0,0.0
6296,In the Loop,7787487,2388804,5398683,2009_boxofficemojo_rankings.csv,2009,0.30674901929210285,0.6932509807078971
6297,The Children of Huang Shi,7785317,1031872,6753445,2008_boxofficemojo_rankings.csv,2008,0.13254078157639568,0.8674592184236043
6298,Real Women Have Curves,7777790,5853194,1924596,2002_boxofficemojo_rankings.csv,2002,0.7525523317034788,0.24744766829652126
6299,Sirens,7770731,7770731,0,1994_boxofficemojo_rankings.csv,1994,1.0,0.0
6300,P2,7766240,3995018,3771222,2007_boxofficemojo_rankings.csv,2007,0.5144082593378521,0.48559174066214794
6301,By the Grace of God,7755652,67059,7688593,2019_boxofficemojo_rankings.csv,2019,0.00864646840781407,0.991353531592186
6302,"Enemies, A Love Story",7754571,7754571,0,1989_boxofficemojo_rankings.csv,1989,1.0,0.0
6303,The Beast Within,7742572,7742572,0,1982_boxofficemojo_rankings.csv,1982,1.0,0.0
6304,3 idiotas,7738470,1249233,6489237,2017_boxofficemojo_rankings.csv,2017,0.16143152328561072,0.8385684767143893
6305,Certified Copy,7736632,1373975,6362657,2010_boxofficemojo_rankings.csv,2010,0.17759342825146654,0.8224065717485335
6306,Butterfly,7733894,2092682,5641212,2000_boxofficemojo_rankings.csv,2000,0.27058581356299943,0.7294141864370005
6307,Love Live! Sunshine!! The School Idol Movie: Over The Rainbow,7733048,34135,7698913,2019_boxofficemojo_rankings.csv,2019,0.004414171488396296,0.9955858285116037
6308,Explosion,7731410,122700,7608710,2017_boxofficemojo_rankings.csv,2017,0.015870326369963564,0.9841296736300365
6309,Cedar Rapids,7728936,6861102,867834,2011_boxofficemojo_rankings.csv,2011,0.8877162393374716,0.11228376066252845
6310,Surviving the Game,7727256,7727256,0,1994_boxofficemojo_rankings.csv,1994,1.0,0.0
6311,"The Cook, the Thief, His Wife & Her Lover",7724701,7724701,0,1990_boxofficemojo_rankings.csv,1990,1.0,0.0
6312,Spirited Away Studio Ghibli Fest 2020,7724266,0,7724266,2020_boxofficemojo_rankings.csv,2020,0.0,1.0
6313,My Mother,7723656,303002,7420654,2015_boxofficemojo_rankings.csv,2015,0.03923038519581918,0.9607696148041808
6314,Disorganized Crime,7723506,7723506,0,1989_boxofficemojo_rankings.csv,1989,1.0,0.0
6315,A New Life,7721852,7721852,0,1988_boxofficemojo_rankings.csv,1988,1.0,0.0
6316,Expelled: No Intelligence Allowed,7720487,7720487,0,2008_boxofficemojo_rankings.csv,2008,1.0,0.0
6317,Summer in Berlin,7718317,8340,7709977,2006_boxofficemojo_rankings.csv,2006,0.0010805464455528324,0.9989194535544472
6318,The Sweeney,7708312,26650,7681662,2012_boxofficemojo_rankings.csv,2012,0.0034573068656276497,0.9965426931343724
6319,Kevin Hart: Laugh at My Pain,7706436,7706436,0,2011_boxofficemojo_rankings.csv,2011,1.0,0.0
6320,Roger & Me,7706368,6706368,1000000,1989_boxofficemojo_rankings.csv,1989,0.8702371856625586,0.12976281433744144
6321,BPM (Beats Per Minute),7704369,125189,7579180,2017_boxofficemojo_rankings.csv,2017,0.01624909191135575,0.9837509080886443
6322,Penguins,7699452,7699452,0,2019_boxofficemojo_rankings.csv,2019,1.0,0.0
6323,No,7699095,2343664,5355431,2012_boxofficemojo_rankings.csv,2012,0.30440772584310233,0.6955922741568976
6324,Mr. & Mrs. Bridge,7698010,7698010,0,1990_boxofficemojo_rankings.csv,1990,1.0,0.0
6325,Declaration of War,7691610,59100,7632510,2011_boxofficemojo_rankings.csv,2011,0.007683696911309856,0.9923163030886901
6326,Finding Fanny,7685784,615691,7070093,2014_boxofficemojo_rankings.csv,2014,0.08010776779571219,0.9198922322042878
6327,Runaway Train,7683620,7683620,0,1985_boxofficemojo_rankings.csv,1985,1.0,0.0
6328,Strictly Business,7683267,7683267,0,1991_boxofficemojo_rankings.csv,1991,1.0,0.0
6329,Leave No Trace,7682928,6046104,1636824,2018_boxofficemojo_rankings.csv,2018,0.7869530991309563,0.21304690086904368
6330,Princess Mononoke Studio Ghibli Fest 2020,7673132,0,7673132,2020_boxofficemojo_rankings.csv,2020,0.0,1.0
6331,Lolo,7663798,24134,7639664,2015_boxofficemojo_rankings.csv,2015,0.0031490913513117125,0.9968509086486883
6332,Steal,7662206,220944,7441262,2002_boxofficemojo_rankings.csv,2002,0.02883555988967146,0.9711644401103285
6333,He-Man and She-Ra: The Secret of the Sword,7660857,7660857,0,1985_boxofficemojo_rankings.csv,1985,1.0,0.0
6334,A Scanner Darkly,7659918,5501616,2158302,2006_boxofficemojo_rankings.csv,2006,0.7182343205240578,0.28176567947594217
6335,Fatso,7653061,7653061,0,1980_boxofficemojo_rankings.csv,1980,1.0,0.0
6336,The Prisoner of Zenda,7650600,7650600,0,1979_boxofficemojo_rankings.csv,1979,1.0,0.0
6337,The Hunting Party,7644409,969869,6674540,2007_boxofficemojo_rankings.csv,2007,0.1268729865186439,0.8731270134813561
6338,Sex and Lucía,7640680,1594779,6045901,2001_boxofficemojo_rankings.csv,2001,0.2087221294439762,0.7912778705560238
6339,Pandas,7635778,7574012,61766,2018_boxofficemojo_rankings.csv,2018,0.9919109748869074,0.008089025113092601
6340,Quicksilver,7634909,7634909,0,1986_boxofficemojo_rankings.csv,1986,1.0,0.0
6341,Just Getting Started,7634022,6069605,1564417,2017_boxofficemojo_rankings.csv,2017,0.7950730296559271,0.2049269703440729
6342,Thoda Pyaar Thoda Magic,7631012,365401,7265611,2008_boxofficemojo_rankings.csv,2008,0.04788368829717474,0.9521163117028253
6343,The White Crow,7622595,1828784,5793811,2019_boxofficemojo_rankings.csv,2019,0.23991619651837728,0.7600838034816227
6344,Monkeybone,7622365,5411999,2210366,2001_boxofficemojo_rankings.csv,2001,0.7100157234664044,0.28998427653359554
6345,Fullmetal Alchemist: The Sacred Star of Milos,7621364,177802,7443562,2011_boxofficemojo_rankings.csv,2011,0.023329419773153465,0.9766705802268465
6346,Ninja III: The Domination,7610785,7610785,0,1984_boxofficemojo_rankings.csv,1984,1.0,0.0
6347,ABCD (Any Body Can Dance),7610738,222098,7388640,2013_boxofficemojo_rankings.csv,2013,0.029182189690408474,0.9708178103095916
6348,Only Lovers Left Alive,7609187,1879534,5729653,2013_boxofficemojo_rankings.csv,2013,0.24700851746710917,0.7529914825328908
6349,Sunshine,7607860,5096267,2511593,1999_boxofficemojo_rankings.csv,1999,0.6698686621467798,0.33013133785322024
6350,Losing Isaiah,7603766,7603766,0,1995_boxofficemojo_rankings.csv,1995,1.0,0.0
6351,Kidnap,7601003,0,7601003,2008_boxofficemojo_rankings.csv,2008,0.0,1.0
6352,The Flower of Evil,7587959,182163,7405796,2003_boxofficemojo_rankings.csv,2003,0.024006850854096602,0.9759931491459034
6353,Man on the Train,7585989,2542020,5043969,2002_boxofficemojo_rankings.csv,2002,0.33509407936130675,0.6649059206386932
6354,Klovn Forever,7585569,5700,7579869,2015_boxofficemojo_rankings.csv,2015,0.0007514268211125625,0.9992485731788875
6355,Burning,7576345,718991,6857354,2018_boxofficemojo_rankings.csv,2018,0.0948994534963759,0.9051005465036241
6356,Sprung,7575028,7575028,0,1997_boxofficemojo_rankings.csv,1997,1.0,0.0
6357,Miss You Already,7573997,1162653,6411344,2015_boxofficemojo_rankings.csv,2015,0.15350587015019942,0.8464941298498005
6358,Krippendorf's Tribe,7571115,7571115,0,1998_boxofficemojo_rankings.csv,1998,1.0,0.0
6359,Club Dread,7565807,5001708,2564099,2004_boxofficemojo_rankings.csv,2004,0.6610937868227408,0.3389062131772592
6360,Guzaarish,7564310,1017335,6546975,2010_boxofficemojo_rankings.csv,2010,0.13449144733624085,0.8655085526637591
6361,Hackers,7563728,7563728,0,1995_boxofficemojo_rankings.csv,1995,1.0,0.0
6362,Into the Night,7562164,7562164,0,1985_boxofficemojo_rankings.csv,1985,1.0,0.0
6363,The Jerky Boys,7557877,7557877,0,1995_boxofficemojo_rankings.csv,1995,1.0,0.0
6364,Partir,7556034,176113,7379921,2009_boxofficemojo_rankings.csv,2009,0.023307597610068984,0.976692402389931
6365,Hippocrates: Diary of a French Doctor,7555591,23050,7532541,2014_boxofficemojo_rankings.csv,2014,0.003050720982647155,0.9969492790173529
6366,Wanted: Dead or Alive,7555000,7555000,0,1987_boxofficemojo_rankings.csv,1987,1.0,0.0
6367,The Girl from Monaco,7553160,602992,6950168,2008_boxofficemojo_rankings.csv,2008,0.07983307648719211,0.9201669235128079
6368,"Kiki, Love to Love",7551282,12450,7538832,2016_boxofficemojo_rankings.csv,2016,0.001648726666544833,0.9983512733334552
6369,The Advocate: A Missing Body,7550177,50162,7500015,2015_boxofficemojo_rankings.csv,2015,0.006643817754206292,0.9933561822457937
6370,Take Me Home Tonight,7550073,6928068,622005,2011_boxofficemojo_rankings.csv,2011,0.9176160283483352,0.08238397165166482
6371,A Bigger Splash,7545758,2024099,5521659,2015_boxofficemojo_rankings.csv,2015,0.2682432964322471,0.7317567035677529
6372,12,7537453,125120,7412333,2007_boxofficemojo_rankings.csv,2007,0.016599771832739786,0.9834002281672602
6373,Damage,7532911,7532911,0,1992_boxofficemojo_rankings.csv,1992,1.0,0.0
6374,Albert Nobbs,7532259,3014696,4517563,2011_boxofficemojo_rankings.csv,2011,0.4002379631396106,0.5997620368603894
6375,Nothing Like the Holidays,7519490,7503736,15754,2008_boxofficemojo_rankings.csv,2008,0.9979049111043435,0.0020950888956564875
6376,DOA: Dead or Alive,7516532,480813,7035719,2006_boxofficemojo_rankings.csv,2006,0.06396739879508262,0.9360326012049174
6377,Beirut,7509436,5019226,2490210,2018_boxofficemojo_rankings.csv,2018,0.6683892105878524,0.3316107894121476
6378,Where Do We Go Now?,7507008,531997,6975011,2011_boxofficemojo_rankings.csv,2011,0.07086671547439406,0.929133284525606
6379,The Amazing Panda Adventure,7506759,7506759,0,1995_boxofficemojo_rankings.csv,1995,1.0,0.0
6380,The Whistleblower,7505141,280851,7224290,2019_boxofficemojo_rankings.csv,2019,0.037421149049698066,0.9625788509503019
6381,How to Become a Detective,7500000,7500000,0,1980_boxofficemojo_rankings.csv,1980,1.0,0.0
6382,How to Beat the High Cost of Living,7500000,7500000,0,1980_boxofficemojo_rankings.csv,1980,1.0,0.0
6383,Agatha,7500000,7500000,0,1979_boxofficemojo_rankings.csv,1979,1.0,0.0
6384,The Trip to Bountiful,7491903,7491903,0,1985_boxofficemojo_rankings.csv,1985,1.0,0.0
6385,Open Season 3,7487555,0,7487555,2010_boxofficemojo_rankings.csv,2010,0.0,1.0
6386,Cash,7481601,0,7481601,2007_boxofficemojo_rankings.csv,2007,0.0,1.0
6387,Frantz,7478354,880883,6597471,2016_boxofficemojo_rankings.csv,2016,0.11779102727685799,0.882208972723142
6388,Foxes,7470348,7470348,0,1980_boxofficemojo_rankings.csv,1980,1.0,0.0
6389,Stealing Home,7467504,7467504,0,1988_boxofficemojo_rankings.csv,1988,1.0,0.0
6390,The Tall Man,7462847,0,7462847,2012_boxofficemojo_rankings.csv,2012,0.0,1.0
6391,Running with Scissors,7460797,7022827,437970,2006_boxofficemojo_rankings.csv,2006,0.9412971563225752,0.05870284367742481
6392,Spellbound,7457710,5728581,1729129,2003_boxofficemojo_rankings.csv,2003,0.7681420972389648,0.2318579027610352
6393,Big Game,7455398,24752,7430646,2015_boxofficemojo_rankings.csv,2015,0.0033200105480619547,0.996679989451938
6394,Black Nativity,7454185,7018189,435996,2013_boxofficemojo_rankings.csv,2013,0.941509903497163,0.058490096502837
6395,I'll See You in My Dreams,7452512,7449681,2831,2015_boxofficemojo_rankings.csv,2015,0.999620128085671,0.00037987191432902086
6396,Yu-Gi-Oh!: The Dark Side of Dimensions,7445186,1015339,6429847,2016_boxofficemojo_rankings.csv,2016,0.13637523629362652,0.8636247637063735
6397,Five Times Two,7444906,128752,7316154,2004_boxofficemojo_rankings.csv,2004,0.017293972549821315,0.9827060274501787
6398,Brittany Runs a Marathon,7442106,7189808,252298,2019_boxofficemojo_rankings.csv,2019,0.9660985747851482,0.033901425214851816
6399,Goin' South,7435671,7435671,0,1978_boxofficemojo_rankings.csv,1978,1.0,0.0
6400,Mayday Life,7435496,85912,7349584,2019_boxofficemojo_rankings.csv,2019,0.011554306531803662,0.9884456934681963
6401,Genius,7435006,1361045,6073961,2016_boxofficemojo_rankings.csv,2016,0.1830590318286226,0.8169409681713774
6402,Harley Davidson and the Marlboro Man,7434726,7434726,0,1991_boxofficemojo_rankings.csv,1991,1.0,0.0
6403,Maximum Overdrive,7433663,7433663,0,1986_boxofficemojo_rankings.csv,1986,1.0,0.0
6404,Mere Baap Pehle Aap,7433423,113576,7319847,2008_boxofficemojo_rankings.csv,2008,0.015279098202806433,0.9847209017971935
6405,Beatriz at Dinner,7425391,7115854,309537,2017_boxofficemojo_rankings.csv,2017,0.958313710348721,0.04168628965127897
6406,Dhan Dhana Dhan Goal,7415972,125547,7290425,2007_boxofficemojo_rankings.csv,2007,0.016929271038240167,0.9830707289617598
6407,God's Not Dead: A Light in Darkness,7414178,5728940,1685238,2018_boxofficemojo_rankings.csv,2018,0.7727006284445828,0.2272993715554172
6408,Antichrist,7413863,404122,7009741,2009_boxofficemojo_rankings.csv,2009,0.05450896516431447,0.9454910348356855
6409,Kids,7412216,7412216,0,1995_boxofficemojo_rankings.csv,1995,1.0,0.0
6410,Clifford,7408745,7408745,0,1994_boxofficemojo_rankings.csv,1994,1.0,0.0
6411,Phat Girlz,7403491,7061128,342363,2006_boxofficemojo_rankings.csv,2006,0.9537565453918969,0.04624345460810313
6412,Goodbye Christopher Robin,7401949,1735251,5666698,2017_boxofficemojo_rankings.csv,2017,0.23443163415473411,0.7655683658452659
6413,The Innocents,7400324,1065665,6334659,2016_boxofficemojo_rankings.csv,2016,0.14400247881038722,0.8559975211896128
6414,Tex,7400000,7400000,0,1982_boxofficemojo_rankings.csv,1982,1.0,0.0
6415,Ironweed,7393346,7393346,0,1987_boxofficemojo_rankings.csv,1987,1.0,0.0
6416,Requiem for a Dream,7390108,3635482,3754626,2000_boxofficemojo_rankings.csv,2000,0.49193895407211913,0.5080610459278809
6417,Lemon Tree,7387488,569672,6817816,2008_boxofficemojo_rankings.csv,2008,0.07711308634274601,0.922886913657254
6418,It's a Boy Girl Thing,7385679,848,7384831,2006_boxofficemojo_rankings.csv,2006,0.00011481679612666621,0.9998851832038733
6419,Witchboard,7369373,7369373,0,1986_boxofficemojo_rankings.csv,1986,1.0,0.0
6420,Return of the Hero,7362730,37108,7325622,2018_boxofficemojo_rankings.csv,2018,0.005039978377585488,0.9949600216224145
6421,A Christmas Tale,7356393,1060922,6295471,2008_boxofficemojo_rankings.csv,2008,0.1442176892941962,0.8557823107058038
6422,Clean Slate,7355425,7355425,0,1994_boxofficemojo_rankings.csv,1994,1.0,0.0
6423,I'm Not Scared,7354418,1615328,5739090,2003_boxofficemojo_rankings.csv,2003,0.21964049364613217,0.7803595063538679
6424,Compadres,7353544,3127773,4225771,2016_boxofficemojo_rankings.csv,2016,0.4253422567404234,0.5746577432595766
6425,Trust the Man,7353118,1530535,5822583,2006_boxofficemojo_rankings.csv,2006,0.20814775446280068,0.7918522455371994
6426,The Crucible,7343114,7343114,0,1996_boxofficemojo_rankings.csv,1996,1.0,0.0
6427,Iceman,7343032,7343032,0,1984_boxofficemojo_rankings.csv,1984,1.0,0.0
6428,Wild America,7342923,7342923,0,1997_boxofficemojo_rankings.csv,1997,1.0,0.0
6429,B*A*P*S,7338279,7246735,91544,1997_boxofficemojo_rankings.csv,1997,0.9875251404314281,0.012474859568571868
6430,Alice,7331647,7331647,0,1990_boxofficemojo_rankings.csv,1990,1.0,0.0
6431,The Young Messiah,7330338,6490401,839937,2016_boxofficemojo_rankings.csv,2016,0.8854163341444828,0.11458366585551717
6432,King of the Gypsies,7325177,7325177,0,1978_boxofficemojo_rankings.csv,1978,1.0,0.0
6433,I Served the King of England,7319210,617403,6701807,2006_boxofficemojo_rankings.csv,2006,0.08435377588564887,0.9156462241143511
6434,Even the Rain,7313485,518017,6795468,2011_boxofficemojo_rankings.csv,2011,0.07083039070976423,0.9291696092902357
6435,Dhoom,7312209,245756,7066453,2004_boxofficemojo_rankings.csv,2004,0.033608995585328594,0.9663910044146714
6436,Mean Machine,7310206,92770,7217436,2001_boxofficemojo_rankings.csv,2001,0.012690476848395244,0.9873095231516048
6437,Respiro,7309845,1072834,6237011,2002_boxofficemojo_rankings.csv,2002,0.14676562909336655,0.8532343709066335
6438,Mississippi Masala,7308786,7308786,0,1992_boxofficemojo_rankings.csv,1992,1.0,0.0
6439,Sarafina!,7306242,7306242,0,1992_boxofficemojo_rankings.csv,1992,1.0,0.0
6440,Who's That Girl,7305209,7305209,0,1987_boxofficemojo_rankings.csv,1987,1.0,0.0
6441,Outside Providence,7302522,7302522,0,1999_boxofficemojo_rankings.csv,1999,1.0,0.0
6442,Wild Hearts Can't Be Broken,7294835,7294835,0,1991_boxofficemojo_rankings.csv,1991,1.0,0.0
6443,The Beaver,7294800,970816,6323984,2011_boxofficemojo_rankings.csv,2011,0.13308329220814827,0.8669167077918517
6444,Eat Drink Man Woman,7294403,7294403,0,1994_boxofficemojo_rankings.csv,1994,1.0,0.0
6445,Lorenzo's Oil,7286388,7286388,0,1993_boxofficemojo_rankings.csv,1993,1.0,0.0
6446,The Midwife,7286136,603582,6682554,2017_boxofficemojo_rankings.csv,2017,0.08283979327314231,0.9171602067268577
6447,Phantasm II,7282851,7282851,0,1988_boxofficemojo_rankings.csv,1988,1.0,0.0
6448,She's So Lovely,7281450,7281450,0,1997_boxofficemojo_rankings.csv,1997,1.0,0.0
6449,Krazzy 4,7274081,487215,6786866,2008_boxofficemojo_rankings.csv,2008,0.06697959508561975,0.9330204049143802
6450,Run Lola Run,7267585,7267585,0,1999_boxofficemojo_rankings.csv,1999,1.0,0.0
6451,Barcelona,7266973,7266973,0,1994_boxofficemojo_rankings.csv,1994,1.0,0.0
6452,Searching for Bobby Fischer,7266383,7266383,0,1993_boxofficemojo_rankings.csv,1993,1.0,0.0
6453,Gigli,7266209,6087542,1178667,2003_boxofficemojo_rankings.csv,2003,0.8377879028803052,0.16221209711969475
6454,Venus,7261490,3347411,3914079,2006_boxofficemojo_rankings.csv,2006,0.460981286209855,0.539018713790145
6455,Buddy Buddy,7258543,7258543,0,1981_boxofficemojo_rankings.csv,1981,1.0,0.0
6456,A Long Way Down,7257942,13347,7244595,2014_boxofficemojo_rankings.csv,2014,0.0018389510414935804,0.9981610489585064
6457,The Life Before Her Eyes,7248490,303439,6945051,2008_boxofficemojo_rankings.csv,2008,0.041862374094466574,0.9581376259055334
6458,Where the Money Is,7243669,5661798,1581871,2000_boxofficemojo_rankings.csv,2000,0.7816201982724501,0.21837980172754995
6459,Off Limits,7242035,7242035,0,1988_boxofficemojo_rankings.csv,1988,1.0,0.0
6460,Rush,7241350,7241350,0,1991_boxofficemojo_rankings.csv,1991,1.0,0.0
6461,The Missionary,7241180,7241180,0,1982_boxofficemojo_rankings.csv,1982,1.0,0.0
6462,Johnny Handsome,7237794,7237794,0,1989_boxofficemojo_rankings.csv,1989,1.0,0.0
6463,Let There Be Light,7233471,7233471,0,2017_boxofficemojo_rankings.csv,2017,1.0,0.0
6464,Zeus and Roxanne,7233324,7233324,0,1997_boxofficemojo_rankings.csv,1997,1.0,0.0
6465,Force 10 from Navarone,7230000,7230000,0,1978_boxofficemojo_rankings.csv,1978,1.0,0.0
6466,Golden Door,7226020,1070769,6155251,2006_boxofficemojo_rankings.csv,2006,0.14818240193080007,0.8518175980691999
6467,Birth of the Dragon,7215027,6901965,313062,2017_boxofficemojo_rankings.csv,2017,0.95660972578481,0.043390274215190046
6468,20th Century Women,7214806,5664764,1550042,2016_boxofficemojo_rankings.csv,2016,0.785158187205588,0.21484181279441195
6469,Animal Kingdom,7208231,1044039,6164192,2010_boxofficemojo_rankings.csv,2010,0.14483983657016541,0.8551601634298346
6470,The Big Red One,7206220,7206220,0,1980_boxofficemojo_rankings.csv,1980,1.0,0.0
6471,Grandma,7205073,6980524,224549,2015_boxofficemojo_rankings.csv,2015,0.9688345975120585,0.03116540248794148
6472,Screwed,7201701,7027345,174356,2000_boxofficemojo_rankings.csv,2000,0.9757896085938585,0.02421039140614141
6473,Transylvania 6-5000,7196872,7196872,0,1985_boxofficemojo_rankings.csv,1985,1.0,0.0
6474,La veuve de Saint-Pierre,7193889,3193889,4000000,2000_boxofficemojo_rankings.csv,2000,0.44397251611749916,0.5560274838825008
6475,1492: Conquest of Paradise,7191399,7191399,0,1992_boxofficemojo_rankings.csv,1992,1.0,0.0
6476,Paradise Alley,7185518,7185518,0,1978_boxofficemojo_rankings.csv,1978,1.0,0.0
6477,North,7182747,7182747,0,1994_boxofficemojo_rankings.csv,1994,1.0,0.0
6478,Timbuktu,7179391,1076075,6103316,2014_boxofficemojo_rankings.csv,2014,0.1498838829087314,0.8501161170912686
6479,Women on the Verge of a Nervous Breakdown,7179298,7179298,0,1988_boxofficemojo_rankings.csv,1988,1.0,0.0
6480,The Boy Who Could Fly,7177431,7177431,0,1986_boxofficemojo_rankings.csv,1986,1.0,0.0
6481,Rescue Dawn,7177143,5490423,1686720,2007_boxofficemojo_rankings.csv,2007,0.7649872658242981,0.23501273417570195
6482,10 to Midnight,7175592,7175592,0,1983_boxofficemojo_rankings.csv,1983,1.0,0.0
6483,The Jane Austen Book Club,7163566,3575227,3588339,2007_boxofficemojo_rankings.csv,2007,0.49908481334575544,0.5009151866542445
6484,Blade of the Immortal,7162617,150532,7012085,2017_boxofficemojo_rankings.csv,2017,0.021016340815095937,0.978983659184904
6485,The Flock,7155358,0,7155358,2007_boxofficemojo_rankings.csv,2007,0.0,1.0
6486,The Name of the Rose,7153487,7153487,0,1986_boxofficemojo_rankings.csv,1986,1.0,0.0
6487,Dear God,7138523,7138523,0,1996_boxofficemojo_rankings.csv,1996,1.0,0.0
6488,She's Gotta Have It,7137502,7137502,0,1986_boxofficemojo_rankings.csv,1986,1.0,0.0
6489,Wild Rose,7123449,1635117,5488332,2019_boxofficemojo_rankings.csv,2019,0.22954007251262695,0.770459927487373
6490,Baar Baar Dekho,7122579,981947,6140632,2016_boxofficemojo_rankings.csv,2016,0.13786396753198527,0.8621360324680147
6491,Hardbodies,7121719,7121719,0,1984_boxofficemojo_rankings.csv,1984,1.0,0.0
6492,Jet Lag,7121171,250000,6871171,2002_boxofficemojo_rankings.csv,2002,0.03510658570058211,0.9648934142994179
6493,The Adventures of Pluto Nash,7103973,4420080,2683893,2002_boxofficemojo_rankings.csv,2002,0.6221983107199309,0.3778016892800691
6494,Postman Pat: The Movie,7102455,1519,7100936,2014_boxofficemojo_rankings.csv,2014,0.00021386971124773055,0.9997861302887523
6495,Incendies,7099598,2071334,5028264,2011_boxofficemojo_rankings.csv,2011,0.2917537021110209,0.7082462978889791
6496,Young@Heart,7097002,3992189,3104813,2008_boxofficemojo_rankings.csv,2008,0.562517665910197,0.43748233408980297
6497,Pride,7094650,7057600,37050,2007_boxofficemojo_rankings.csv,2007,0.9947777550689604,0.005222244931039587
6498,The Truth About Charlie,7093284,5350371,1742913,2002_boxofficemojo_rankings.csv,2002,0.7542868719199739,0.24571312808002613
6499,The Bad News Bears Go to Japan,7092495,7092495,0,1978_boxofficemojo_rankings.csv,1978,1.0,0.0
6500,One Piece: Episode of Alabasta - The Desert Princess and the Pirates,7090891,6587,7084304,2007_boxofficemojo_rankings.csv,2007,0.0009289382674194258,0.9990710617325805
6501,In Safe Hands,7086596,1737,7084859,2018_boxofficemojo_rankings.csv,2018,0.0002451106285725897,0.9997548893714274
6502,Croupier,7075068,6201143,873925,2000_boxofficemojo_rankings.csv,2000,0.8764782190079304,0.12352178099206962
6503,The Stunt Man,7063886,7063886,0,1980_boxofficemojo_rankings.csv,1980,1.0,0.0
6504,The Map Against the World,7035812,34034,7001778,2016_boxofficemojo_rankings.csv,2016,0.004837252615618496,0.9951627473843815
6505,Alphabet City,7035585,7035585,0,1984_boxofficemojo_rankings.csv,1984,1.0,0.0
6506,Outlander,7034698,166003,6868695,2008_boxofficemojo_rankings.csv,2008,0.02359774364158916,0.9764022563584108
6507,House Arrest,7032782,7032782,0,1996_boxofficemojo_rankings.csv,1996,1.0,0.0
6508,The Joneses,7031729,1475746,5555983,2010_boxofficemojo_rankings.csv,2010,0.2098695783071276,0.7901304216928724
6509,Cosmopolis,7029095,763556,6265539,2012_boxofficemojo_rankings.csv,2012,0.10862792436295142,0.8913720756370486
6510,Star Kid,7029025,7029025,0,1998_boxofficemojo_rankings.csv,1998,1.0,0.0
6511,Three Wishes,7027517,7027517,0,1995_boxofficemojo_rankings.csv,1995,1.0,0.0
6512,The Killing of a Sacred Deer,7027336,2291901,4735435,2017_boxofficemojo_rankings.csv,2017,0.3261408021474994,0.6738591978525006
6513,BASEketball,7027290,7027290,0,1998_boxofficemojo_rankings.csv,1998,1.0,0.0
6514,Last of the Dogmen,7024389,7024389,0,1995_boxofficemojo_rankings.csv,1995,1.0,0.0
6515,Hard Candy,7022209,1024640,5997569,2006_boxofficemojo_rankings.csv,2006,0.14591419879414014,0.8540858012058599
6516,Hiding Out,7019441,7019441,0,1987_boxofficemojo_rankings.csv,1987,1.0,0.0
6517,Innocent Voices,7015131,837878,6177253,2005_boxofficemojo_rankings.csv,2005,0.11943868190059459,0.8805613180994054
6518,An American Carol,7013191,7013191,0,2008_boxofficemojo_rankings.csv,2008,1.0,0.0
6519,The Kid with a Bike,7011798,1470000,5541798,2011_boxofficemojo_rankings.csv,2011,0.20964665553685374,0.7903533444631463
6520,Crossover,7009668,7009668,0,2006_boxofficemojo_rankings.csv,2006,1.0,0.0
6521,International Velvet,7009238,7009238,0,1978_boxofficemojo_rankings.csv,1978,1.0,0.0
6522,Cat People,7000000,7000000,0,1982_boxofficemojo_rankings.csv,1982,1.0,0.0
6523,Jessabelle,6998359,0,6998359,2014_boxofficemojo_rankings.csv,2014,0.0,1.0
6524,Fearless,6995302,6995302,0,1993_boxofficemojo_rankings.csv,1993,1.0,0.0
6525,Lawrence of Arabia 1989 Re-release,6986278,6986278,0,1989_boxofficemojo_rankings.csv,1989,1.0,0.0
6526,Relentless,6985999,6985999,0,1989_boxofficemojo_rankings.csv,1989,1.0,0.0
6527,Goon,6985158,4168528,2816630,2012_boxofficemojo_rankings.csv,2012,0.5967693214670305,0.40323067853296946
6528,Children of the Corn II: The Final Sacrifice,6980986,6980986,0,1993_boxofficemojo_rankings.csv,1993,1.0,0.0
6529,Trial by Jury,6971777,6971777,0,1994_boxofficemojo_rankings.csv,1994,1.0,0.0
6530,I Ought to Be in Pictures,6968359,6968359,0,1982_boxofficemojo_rankings.csv,1982,1.0,0.0
6531,Days and Clouds,6966224,112102,6854122,2007_boxofficemojo_rankings.csv,2007,0.01609221868260337,0.9839077813173966
6532,The Princess of Montpensier,6965201,352428,6612773,2010_boxofficemojo_rankings.csv,2010,0.05059839622718713,0.9494016037728129
6533,Strange Wilderness,6964734,6575282,389452,2008_boxofficemojo_rankings.csv,2008,0.9440822865596877,0.055917713440312294
6534,11-11-11,6963872,32771,6931101,2011_boxofficemojo_rankings.csv,2011,0.004705859039339034,0.9952941409606609
6535,"Spring, Summer, Fall, Winter... and Spring",6959791,2380788,4579003,2003_boxofficemojo_rankings.csv,2003,0.34207751353453,0.65792248646547
6536,Shag,6957975,6957975,0,1989_boxofficemojo_rankings.csv,1989,1.0,0.0
6537,The Salesman,6953604,2402067,4551537,2016_boxofficemojo_rankings.csv,2016,0.3454420182685123,0.6545579817314877
6538,Santa vs. the Snowman 3D 2003 Re-release,6952764,3045032,3907732,2003_boxofficemojo_rankings.csv,2003,0.4379599250024882,0.5620400749975117
6539,La Cage aux Folles II,6950125,6950125,0,1981_boxofficemojo_rankings.csv,1981,1.0,0.0
6540,Suburban Commando,6948859,6948859,0,1991_boxofficemojo_rankings.csv,1991,1.0,0.0
6541,Red Sonja,6948633,6948633,0,1985_boxofficemojo_rankings.csv,1985,1.0,0.0
6542,Blue City,6947787,6947787,0,1986_boxofficemojo_rankings.csv,1986,1.0,0.0
6543,What We Do in the Shadows,6946808,3469224,3477584,2014_boxofficemojo_rankings.csv,2014,0.49939828479497345,0.5006017152050265
6544,Almost an Angel,6939946,6939946,0,1990_boxofficemojo_rankings.csv,1990,1.0,0.0
6545,Father and Sons,6935839,634968,6300871,2003_boxofficemojo_rankings.csv,2003,0.09154883785508862,0.9084511621449114
6546,The Wedding Banquet,6933459,6933459,0,1993_boxofficemojo_rankings.csv,1993,1.0,0.0
6547,Igby Goes Down,6919198,4777465,2141733,2002_boxofficemojo_rankings.csv,2002,0.6904651377226089,0.30953486227739113
6548,The Spectacular Now,6918591,6854611,63980,2013_boxofficemojo_rankings.csv,2013,0.9907524523418135,0.009247547658186472
6549,Hasee Toh Phasee,6914987,646035,6268952,2014_boxofficemojo_rankings.csv,2014,0.09342533832673872,0.9065746616732613
6550,Don 2,6913518,3680306,3233212,2011_boxofficemojo_rankings.csv,2011,0.5323347679141068,0.46766523208589317
6551,A Cry in the Dark,6908797,6908797,0,1988_boxofficemojo_rankings.csv,1988,1.0,0.0
6552,Painted Fire,6906235,64029,6842206,2002_boxofficemojo_rankings.csv,2002,0.00927118755733044,0.9907288124426695
6553,The Amateur,6892098,6892098,0,1982_boxofficemojo_rankings.csv,1982,1.0,0.0
6554,Centurion,6890432,123570,6766862,2010_boxofficemojo_rankings.csv,2010,0.01793356352693126,0.9820664364730688
6555,Barbara,6889185,1013902,5875283,2012_boxofficemojo_rankings.csv,2012,0.147172996515553,0.852827003484447
6556,Veer-Zaara,6887221,2938532,3948689,2004_boxofficemojo_rankings.csv,2004,0.4266643977302311,0.5733356022697689
6557,Death Wish 4: The Crackdown,6880310,6880310,0,1987_boxofficemojo_rankings.csv,1987,1.0,0.0
6558,Woman Thou Art Loosed,6879730,6879730,0,2004_boxofficemojo_rankings.csv,2004,1.0,0.0
6559,The Awakening,6879667,209696,6669971,2011_boxofficemojo_rankings.csv,2011,0.03048054506126532,0.9695194549387347
6560,Talvar,6879098,342370,6536728,2015_boxofficemojo_rankings.csv,2015,0.049769606422237336,0.9502303935777626
6561,A Good Woman,6878433,238609,6639824,2005_boxofficemojo_rankings.csv,2005,0.034689441621369284,0.9653105583786307
6562,Ladrón que roba a ladrón,6875089,4011254,2863835,2007_boxofficemojo_rankings.csv,2007,0.5834475742786748,0.4165524257213252
6563,Last Orders,6873892,2329631,4544261,2002_boxofficemojo_rankings.csv,2002,0.33891003815596754,0.6610899618440325
6564,The Unknown Woman,6868786,152114,6716672,2006_boxofficemojo_rankings.csv,2006,0.02214568920912662,0.9778543107908734
6565,Never Talk to Strangers,6858261,6858261,0,1995_boxofficemojo_rankings.csv,1995,1.0,0.0
6566,Romantic Comedy,6857733,6857733,0,1983_boxofficemojo_rankings.csv,1983,1.0,0.0
6567,Bee Season,6856989,1180560,5676429,2005_boxofficemojo_rankings.csv,2005,0.17216886303886444,0.8278311369611355
6568,Private Fears In Public Places (Coeurs),6855294,134636,6720658,2006_boxofficemojo_rankings.csv,2006,0.019639712024021143,0.9803602879759789
6569,200 Cigarettes,6852450,6852450,0,1999_boxofficemojo_rankings.csv,1999,1.0,0.0
6570,Dog Days,6842356,6809080,33276,2018_boxofficemojo_rankings.csv,2018,0.995136762834322,0.004863237165678021
6571,Exit to Eden,6841570,6841570,0,1994_boxofficemojo_rankings.csv,1994,1.0,0.0
6572,The Pope of Greenwich Village,6836201,6836201,0,1984_boxofficemojo_rankings.csv,1984,1.0,0.0
6573,Commitment,6834802,76543,6758259,2013_boxofficemojo_rankings.csv,2013,0.011199007666937535,0.9888009923330625
6574,Panther,6834525,6834525,0,1995_boxofficemojo_rankings.csv,1995,1.0,0.0
6575,Mixed Nuts,6821850,6821850,0,1994_boxofficemojo_rankings.csv,1994,1.0,0.0
6576,Flawless,6819587,1200234,5619353,2007_boxofficemojo_rankings.csv,2007,0.17599804797563254,0.8240019520243674
6577,Collide,6817535,2280004,4537531,2016_boxofficemojo_rankings.csv,2016,0.3344323131454404,0.6655676868545596
6578,Race 3,6817391,1690861,5126530,2018_boxofficemojo_rankings.csv,2018,0.2480217138785204,0.7519782861214797
6579,North Face,6815056,711421,6103635,2008_boxofficemojo_rankings.csv,2008,0.1043896044287824,0.8956103955712176
6580,Bran Nue Dae,6812530,113568,6698962,2010_boxofficemojo_rankings.csv,2010,0.016670458698897474,0.9833295413011025
6581,The Aristocrats,6809089,6377461,431628,2005_boxofficemojo_rankings.csv,2005,0.9366100222805136,0.06338997771948642
6582,The Big Bounce,6808550,6489476,319074,2004_boxofficemojo_rankings.csv,2004,0.9531362771808976,0.04686372281910245
6583,The Chipmunk Adventure,6804312,6804312,0,1987_boxofficemojo_rankings.csv,1987,1.0,0.0
6584,The Names of Love,6803887,514237,6289650,2010_boxofficemojo_rankings.csv,2010,0.07557988543901449,0.9244201145609855
6585,Trick or Treat,6797218,6797218,0,1986_boxofficemojo_rankings.csv,1986,1.0,0.0
6586,Baahubali: The Beginning,6787855,6738000,49855,2015_boxofficemojo_rankings.csv,2015,0.9926552644392079,0.007344735560792032
6587,China: The Panda Adventure,6784985,3921642,2863343,2001_boxofficemojo_rankings.csv,2001,0.5779883080065763,0.4220116919934237
6588,Fanny and Alexander,6783304,6783304,0,1983_boxofficemojo_rankings.csv,1983,1.0,0.0
6589,The Road Home,6780490,1280490,5500000,2001_boxofficemojo_rankings.csv,2001,0.1888491834660917,0.8111508165339083
6590,A Little Bit of Heaven,6778388,15375,6763013,2011_boxofficemojo_rankings.csv,2011,0.002268238407125706,0.9977317615928742
6591,Aaja Nachle,6773493,484108,6289385,2007_boxofficemojo_rankings.csv,2007,0.07147095302231803,0.928529046977682
6592,Runaway,6770587,6770587,0,1984_boxofficemojo_rankings.csv,1984,1.0,0.0
6593,Caught Up,6754958,6754958,0,1998_boxofficemojo_rankings.csv,1998,1.0,0.0
6594,Gone with the Wind 1998 Re-release,6750112,6750112,0,1998_boxofficemojo_rankings.csv,1998,1.0,0.0
6595,The Sun Is also a Star,6750029,4950029,1800000,2019_boxofficemojo_rankings.csv,2019,0.7333344790074235,0.26666552099257645
6596,The Piano Teacher,6749315,1012069,5737246,2001_boxofficemojo_rankings.csv,2001,0.14995136543486265,0.8500486345651374
6597,Séraphin: un homme et son péché,6749187,6749187,0,2002_boxofficemojo_rankings.csv,2002,1.0,0.0
6598,A Letter to Momo,6748888,71712,6677176,2012_boxofficemojo_rankings.csv,2012,0.010625750494007309,0.9893742495059927
6599,Smoke Signals,6745362,6745362,0,1998_boxofficemojo_rankings.csv,1998,1.0,0.0
6600,R-Point,6744984,0,6744984,2004_boxofficemojo_rankings.csv,2004,0.0,1.0
6601,The Mambo Kings,6742168,6742168,0,1992_boxofficemojo_rankings.csv,1992,1.0,0.0
6602,Midnight Special,6740647,3712282,3028365,2016_boxofficemojo_rankings.csv,2016,0.5507308126356416,0.44926918736435834
6603,Fortress,6739141,6739141,0,1993_boxofficemojo_rankings.csv,1993,1.0,0.0
6604,Wild Card,6738764,0,6738764,2015_boxofficemojo_rankings.csv,2015,0.0,1.0
6605,9½ Weeks,6735922,6735922,0,1986_boxofficemojo_rankings.csv,1986,1.0,0.0
6606,Kenny,6732051,69220,6662831,2006_boxofficemojo_rankings.csv,2006,0.01028215621064071,0.9897178437893593
6607,Churchill,6724365,1281258,5443107,2017_boxofficemojo_rankings.csv,2017,0.19053962716182124,0.8094603728381787
6608,Cesar Chavez 2014 Re-release,6719925,5571497,1148428,2014_boxofficemojo_rankings.csv,2014,0.8291010688363337,0.17089893116366625
6609,The Door in the Floor,6715067,3854624,2860443,2004_boxofficemojo_rankings.csv,2004,0.5740261415113207,0.42597385848867925
6610,Pati Patni Aur Woh,6712525,874044,5838481,2019_boxofficemojo_rankings.csv,2019,0.13021091169120413,0.8697890883087959
6611,What Just Happened,6710888,1090947,5619941,2008_boxofficemojo_rankings.csv,2008,0.16256373225123114,0.8374362677487689
6612,Jab Tak Hai Jaan,6703114,3047539,3655575,2012_boxofficemojo_rankings.csv,2012,0.45464525890504026,0.5453547410949597
6613,Bleed for This,6698679,5083906,1614773,2016_boxofficemojo_rankings.csv,2016,0.7589415763914049,0.24105842360859506
6614,Delta Force 2: The Colombian Connection,6698361,6698361,0,1990_boxofficemojo_rankings.csv,1990,1.0,0.0
6615,Innocence,6682271,294039,6388232,2014_boxofficemojo_rankings.csv,2014,0.04400285471810407,0.9559971452818959
6616,U Turn,6682098,6682098,0,1997_boxofficemojo_rankings.csv,1997,1.0,0.0
6617,Fragile,6680926,0,6680926,2005_boxofficemojo_rankings.csv,2005,0.0,1.0
6618,Fahrenheit 11/9,6674168,6352306,321862,2018_boxofficemojo_rankings.csv,2018,0.9517749628118441,0.048225037188155885
6619,Hairspray,6671108,6671108,0,1988_boxofficemojo_rankings.csv,1988,1.0,0.0
6620,Nightmares,6670680,6670680,0,1983_boxofficemojo_rankings.csv,1983,1.0,0.0
6621,Six Weeks,6668025,6668025,0,1982_boxofficemojo_rankings.csv,1982,1.0,0.0
6622,The Golden Seal,6666725,6666725,0,1983_boxofficemojo_rankings.csv,1983,1.0,0.0
6623,Forced Vengeance,6660333,6660333,0,1982_boxofficemojo_rankings.csv,1982,1.0,0.0
6624,Where the Buffalo Roam,6659377,6659377,0,1980_boxofficemojo_rankings.csv,1980,1.0,0.0
6625,Son of Saul,6659121,1777043,4882078,2015_boxofficemojo_rankings.csv,2015,0.2668584937861919,0.7331415062138081
6626,Swing Shift,6650206,6650206,0,1984_boxofficemojo_rankings.csv,1984,1.0,0.0
6627,Fresh Horses,6640346,6640346,0,1988_boxofficemojo_rankings.csv,1988,1.0,0.0
6628,Black Moon Rising,6637565,6637565,0,1986_boxofficemojo_rankings.csv,1986,1.0,0.0
6629,The Conquest,6637166,74474,6562692,2011_boxofficemojo_rankings.csv,2011,0.011220752953896287,0.9887792470461038
6630,Spider-Man/Men in Black II,6632970,6632970,0,2002_boxofficemojo_rankings.csv,2002,1.0,0.0
6631,Southside with You,6628603,6304223,324380,2016_boxofficemojo_rankings.csv,2016,0.9510635951496869,0.04893640485031311
6632,The Gong Show Movie,6621520,6621520,0,1980_boxofficemojo_rankings.csv,1980,1.0,0.0
6633,Duets,6620242,4739023,1881219,2000_boxofficemojo_rankings.csv,2000,0.7158383334023137,0.2841616665976863
6634,Pieta,6616296,22080,6594216,2012_boxofficemojo_rankings.csv,2012,0.003337214659078131,0.9966627853409219
6635,The Hunted,6609661,6609661,0,1995_boxofficemojo_rankings.csv,1995,1.0,0.0
6636,Best of the Best II,6608687,6608687,0,1993_boxofficemojo_rankings.csv,1993,1.0,0.0
6637,Against the Ropes,6596511,5884190,712321,2004_boxofficemojo_rankings.csv,2004,0.892015491219525,0.10798450878047501
6638,The Red Turtle,6591789,921974,5669815,2016_boxofficemojo_rankings.csv,2016,0.13986703761300612,0.8601329623869939
6639,Mambo Italiano 2003 Re-release,6590962,3205730,3385232,2003_boxofficemojo_rankings.csv,2003,0.48638271621047124,0.5136172837895288
6640,I Capture the Castle,6586341,1179035,5407306,2003_boxofficemojo_rankings.csv,2003,0.1790121404281983,0.8209878595718016
6641,Ned Kelly,6585516,86959,6498557,2003_boxofficemojo_rankings.csv,2003,0.013204584120667233,0.9867954158793327
6642,Once Upon a Forest,6582052,6582052,0,1993_boxofficemojo_rankings.csv,1993,1.0,0.0
6643,Soorma,6579645,390077,6189568,2018_boxofficemojo_rankings.csv,2018,0.05928541737434163,0.9407145826256583
6644,Nowhere Boy,6577779,1457248,5120531,2009_boxofficemojo_rankings.csv,2009,0.22154103991636082,0.7784589600836391
6645,The Raid 2,6566916,2627209,3939707,2014_boxofficemojo_rankings.csv,2014,0.4000673984561398,0.5999326015438602
6646,Grandma's Boy,6566277,6090172,476105,2006_boxofficemojo_rankings.csv,2006,0.9274923978991444,0.07250760210085563
6647,Here Come the Littles,6565359,6565359,0,1985_boxofficemojo_rankings.csv,1985,1.0,0.0
6648,The Road to Wellville,6562513,6562513,0,1994_boxofficemojo_rankings.csv,1994,1.0,0.0
6649,A Melody to Remember,6559996,44263,6515733,2016_boxofficemojo_rankings.csv,2016,0.006747412650861372,0.9932525873491387
6650,Lost & Found,6552255,6552255,0,1999_boxofficemojo_rankings.csv,1999,1.0,0.0
6651,The Razor's Edge,6551987,6551987,0,1984_boxofficemojo_rankings.csv,1984,1.0,0.0
6652,From the Land of the Moon,6547983,47748,6500235,2016_boxofficemojo_rankings.csv,2016,0.007292016488130773,0.9927079835118692
6653,Ae Fond Kiss,6547641,30148,6517493,2004_boxofficemojo_rankings.csv,2004,0.004604406380862971,0.995395593619137
6654,Bon voyage,6536601,148727,6387874,2003_boxofficemojo_rankings.csv,2003,0.022752956773711596,0.9772470432262884
6655,Chhapaak,6532100,604334,5927766,2020_boxofficemojo_rankings.csv,2020,0.09251756709174691,0.907482432908253
6656,Under the Sand,6531687,1452698,5078989,2001_boxofficemojo_rankings.csv,2001,0.22240777918476498,0.777592220815235
6657,Warriors of Virtue,6524620,6524620,0,1997_boxofficemojo_rankings.csv,1997,1.0,0.0
6658,Midnight Eagle,6522186,7116,6515070,2007_boxofficemojo_rankings.csv,2007,0.0010910452415800469,0.9989089547584199
6659,Blue Collar,6521083,6521083,0,1978_boxofficemojo_rankings.csv,1978,1.0,0.0
6660,The Measure of a Man,6518931,112391,6406540,2015_boxofficemojo_rankings.csv,2015,0.017240710171652376,0.9827592898283476
6661,National Theatre Live: Fleabag,6508794,326283,6182511,2019_boxofficemojo_rankings.csv,2019,0.05012956317253242,0.9498704368274675
6662,The Lobster,6504366,376871,6127495,2015_boxofficemojo_rankings.csv,2015,0.057941235164195866,0.9420587648358041
6663,Wadjda,6499169,1347747,5151422,2012_boxofficemojo_rankings.csv,2012,0.20737220404639423,0.7926277959536058
6664,Switchback,6492660,6492660,0,1997_boxofficemojo_rankings.csv,1997,1.0,0.0
6665,Teacher's Pet,6491969,6491969,0,2004_boxofficemojo_rankings.csv,2004,1.0,0.0
6666,It's Kind of a Funny Story,6491240,6363628,127612,2010_boxofficemojo_rankings.csv,2010,0.9803408901843099,0.01965910981569007
6667,Flashback,6488114,6488114,0,1990_boxofficemojo_rankings.csv,1990,1.0,0.0
6668,The Osterman Weekend,6486797,6486797,0,1983_boxofficemojo_rankings.csv,1983,1.0,0.0
6669,The Real McCoy,6484246,6484246,0,1993_boxofficemojo_rankings.csv,1993,1.0,0.0
6670,Everybody Loves Somebody,6481798,1915789,4566009,2017_boxofficemojo_rankings.csv,2017,0.2955644406073747,0.7044355593926254
6671,Irreversible,6479328,792200,5687128,2002_boxofficemojo_rankings.csv,2002,0.12226576583250609,0.877734234167494
6672,Star 80,6472990,6472990,0,1983_boxofficemojo_rankings.csv,1983,1.0,0.0
6673,Mighty Aphrodite,6468498,6468498,0,1995_boxofficemojo_rankings.csv,1995,1.0,0.0
6674,...All the Marbles,6468195,6468195,0,1981_boxofficemojo_rankings.csv,1981,1.0,0.0
6675,Gloria,6461559,2107925,4353634,2013_boxofficemojo_rankings.csv,2013,0.32622545116433976,0.6737745488356602
6676,The Devil's Backbone,6459020,755249,5703771,2001_boxofficemojo_rankings.csv,2001,0.11692934841508464,0.8830706515849154
6677,The Last Unicorn,6455330,6455330,0,1982_boxofficemojo_rankings.csv,1982,1.0,0.0
6678,Gods and Monsters,6451628,6451628,0,1998_boxofficemojo_rankings.csv,1998,1.0,0.0
6679,Feel the Noise,6451106,5898393,552713,2007_boxofficemojo_rankings.csv,2007,0.9143227533387298,0.08567724666127018
6680,Lassie,6442854,652163,5790691,2005_boxofficemojo_rankings.csv,2005,0.10122268795785222,0.8987773120421478
6681,The September Issue,6442300,3820067,2622233,2009_boxofficemojo_rankings.csv,2009,0.5929663319000978,0.4070336680999022
6682,Hot to Trot,6436211,6436211,0,1988_boxofficemojo_rankings.csv,1988,1.0,0.0
6683,Waiting for 'Superman',6433688,6417135,16553,2010_boxofficemojo_rankings.csv,2010,0.9974271366594091,0.002572863340590964
6684,Run the Race,6424420,6424420,0,2019_boxofficemojo_rankings.csv,2019,1.0,0.0
6685,Mac and Me,6424112,6424112,0,1988_boxofficemojo_rankings.csv,1988,1.0,0.0
6686,Same Kind of Different as Me,6423605,6423605,0,2017_boxofficemojo_rankings.csv,2017,1.0,0.0
6687,The Temp,6419876,6419876,0,1993_boxofficemojo_rankings.csv,1993,1.0,0.0
6688,The Straight Story,6416325,6203044,213281,1999_boxofficemojo_rankings.csv,1999,0.9667596326557648,0.03324036734423521
6689,Eye See You,6416302,79161,6337141,2002_boxofficemojo_rankings.csv,2002,0.01233748037420932,0.9876625196257907
6690,Post Grad,6414729,6380019,34710,2009_boxofficemojo_rankings.csv,2009,0.9945890153738373,0.005410984626162695
6691,Slackers,6413915,5285941,1127974,2002_boxofficemojo_rankings.csv,2002,0.8241364283748693,0.17586357162513067
6692,Defenseless,6413375,6413375,0,1991_boxofficemojo_rankings.csv,1991,1.0,0.0
6693,Gotti,6412349,4343227,2069122,2018_boxofficemojo_rankings.csv,2018,0.6773223041977284,0.3226776958022715
6694,The Secret Life of Words,6410058,20678,6389380,2005_boxofficemojo_rankings.csv,2005,0.003225867847061602,0.9967741321529384
6695,Just Between Friends,6408791,6408791,0,1986_boxofficemojo_rankings.csv,1986,1.0,0.0
6696,Six Degrees of Separation,6405918,6405918,0,1993_boxofficemojo_rankings.csv,1993,1.0,0.0
6697,The Mustang,6405816,5043620,1362196,2019_boxofficemojo_rankings.csv,2019,0.7873501205779249,0.2126498794220752
6698,The Company,6401690,2283914,4117776,2003_boxofficemojo_rankings.csv,2003,0.3567673536206845,0.6432326463793154
6699,My Own Private Idaho,6401336,6401336,0,1991_boxofficemojo_rankings.csv,1991,1.0,0.0
6700,Eyewitness,6400000,6400000,0,1981_boxofficemojo_rankings.csv,1981,1.0,0.0
6701,A Journey Through Time with Antony,6389648,127381,6262267,2015_boxofficemojo_rankings.csv,2015,0.01993552696486567,0.9800644730351343
6702,Article 99,6375979,6375979,0,1992_boxofficemojo_rankings.csv,1992,1.0,0.0
6703,"Farewell, My Queen",6366835,1597998,4768837,2012_boxofficemojo_rankings.csv,2012,0.25098781419653565,0.7490121858034644
6704,The Chorus 2005 Re-release,6353810,1548036,4805774,2005_boxofficemojo_rankings.csv,2005,0.2436390134423283,0.7563609865576717
6705,The Sting II,6347072,6347072,0,1983_boxofficemojo_rankings.csv,1983,1.0,0.0
6706,Greenberg,6344112,4234170,2109942,2010_boxofficemojo_rankings.csv,2010,0.6674172839319357,0.3325827160680644
6707,Motel Hell,6342668,6342668,0,1980_boxofficemojo_rankings.csv,1980,1.0,0.0
6708,Hector and the Search for Happiness,6337728,1124445,5213283,2014_boxofficemojo_rankings.csv,2014,0.17742083598412553,0.8225791640158745
6709,The Unholy,6337299,6337299,0,1988_boxofficemojo_rankings.csv,1988,1.0,0.0
6710,Hampstead,6335171,144396,6190775,2017_boxofficemojo_rankings.csv,2017,0.02279275492326884,0.9772072450767312
6711,Amityville 3-D,6333135,6333135,0,1983_boxofficemojo_rankings.csv,1983,1.0,0.0
6712,Closed Circuit,6331939,5750401,581538,2013_boxofficemojo_rankings.csv,2013,0.9081579907829181,0.09184200921708184
6713,Affliction,6330054,6330054,0,1998_boxofficemojo_rankings.csv,1998,1.0,0.0
6714,The Soldier,6328816,6328816,0,1982_boxofficemojo_rankings.csv,1982,1.0,0.0
6715,Girls Just Want to Have Fun,6326051,6326051,0,1985_boxofficemojo_rankings.csv,1985,1.0,0.0
6716,Little Miss Marker,6321392,6321392,0,1980_boxofficemojo_rankings.csv,1980,1.0,0.0
6717,Goodbye Bafana,6317170,0,6317170,2007_boxofficemojo_rankings.csv,2007,0.0,1.0
6718,Life in a Metro,6316418,150212,6166206,2007_boxofficemojo_rankings.csv,2007,0.02378120004090926,0.9762187999590908
6719,Sheng zhe wei wang,6313827,163406,6150421,2015_boxofficemojo_rankings.csv,2015,0.02588065843425865,0.9741193415657413
6720,Lowriders,6312033,6303560,8473,2017_boxofficemojo_rankings.csv,2017,0.9986576432664405,0.0013423567335595363
6721,Blood and Chocolate,6311117,3526847,2784270,2007_boxofficemojo_rankings.csv,2007,0.5588308694007733,0.44116913059922674
6722,Absolutely Anything,6303792,20169,6283623,2015_boxofficemojo_rankings.csv,2015,0.003199502775472287,0.9968004972245277
6723,A Late Quartet,6303709,1562548,4741161,2012_boxofficemojo_rankings.csv,2012,0.24787755906879586,0.7521224409312042
6724,My Boyfriend's Meds,6292780,2971116,3321664,2020_boxofficemojo_rankings.csv,2020,0.47214680951820975,0.5278531904817902
6725,High Tension,6291958,3681066,2610892,2003_boxofficemojo_rankings.csv,2003,0.5850430025120956,0.4149569974879044
6726,The Gods Must Be Crazy II,6291444,6291444,0,1990_boxofficemojo_rankings.csv,1990,1.0,0.0
6727,I Am Crazy About Love,6290342,1232228,5058114,2003_boxofficemojo_rankings.csv,2003,0.19589205165633283,0.8041079483436672
6728,Deuces Wild,6282446,6080065,202381,2002_boxofficemojo_rankings.csv,2002,0.9677862730535208,0.03221372694647913
6729,Max Steel,6272403,3818664,2453739,2016_boxofficemojo_rankings.csv,2016,0.6088039942586597,0.3911960057413403
6730,Rambling Rose,6266621,6266621,0,1991_boxofficemojo_rankings.csv,1991,1.0,0.0
6731,College,6265483,4694636,1570847,2008_boxofficemojo_rankings.csv,2008,0.749285569843538,0.250714430156462
6732,The House of the Spirits,6265311,6265311,0,1994_boxofficemojo_rankings.csv,1994,1.0,0.0
6733,A Night in the Life of Jimmy Reardon,6264058,6264058,0,1988_boxofficemojo_rankings.csv,1988,1.0,0.0
6734,Music Box,6263883,6263883,0,1989_boxofficemojo_rankings.csv,1989,1.0,0.0
6735,Dick,6262878,6262878,0,1999_boxofficemojo_rankings.csv,1999,1.0,0.0
6736,The Adventures of Buckaroo Banzai Across the 8th Dimension,6254148,6254148,0,1984_boxofficemojo_rankings.csv,1984,1.0,0.0
6737,Firstborn,6250994,6250994,0,1984_boxofficemojo_rankings.csv,1984,1.0,0.0
6738,Widows' Peak,6243722,6243722,0,1994_boxofficemojo_rankings.csv,1994,1.0,0.0
6739,Norman,6217567,3814868,2402699,2017_boxofficemojo_rankings.csv,2017,0.6135628293189281,0.38643717068107186
6740,Unbroken: Path to Redemption,6216897,6216897,0,2018_boxofficemojo_rankings.csv,2018,1.0,0.0
6741,Oh Heavenly Dog,6216067,6216067,0,1980_boxofficemojo_rankings.csv,1980,1.0,0.0
6742,Topsy-Turvy,6208548,6208548,0,1999_boxofficemojo_rankings.csv,1999,1.0,0.0
6743,Attack the Block,6206022,1024175,5181847,2011_boxofficemojo_rankings.csv,2011,0.16502922484000218,0.8349707751599978
6744,Happily Ever After,6204504,252379,5952125,2005_boxofficemojo_rankings.csv,2005,0.04067674063873599,0.9593232593612641
6745,Great Expectations,6202879,258656,5944223,2012_boxofficemojo_rankings.csv,2012,0.041699346384154845,0.9583006536158452
6746,Night and the City,6202756,6202756,0,1992_boxofficemojo_rankings.csv,1992,1.0,0.0
6747,The Snitch Cartel,6197324,0,6197324,2012_boxofficemojo_rankings.csv,2012,0.0,1.0
6748,Braddock: Missing in Action III,6193901,6193901,0,1988_boxofficemojo_rankings.csv,1988,1.0,0.0
6749,Copying Beethoven,6191746,384029,5807717,2006_boxofficemojo_rankings.csv,2006,0.0620227315526186,0.9379772684473814
6750,Yeh Jawaani Hai Deewani,6189998,3827466,2362532,2013_boxofficemojo_rankings.csv,2013,0.6183307329016907,0.38166926709830923
6751,Immortal Hero,6180032,43007,6137025,2019_boxofficemojo_rankings.csv,2019,0.006959025454884376,0.9930409745451156
6752,Flash Point,6177725,5151,6172574,2007_boxofficemojo_rankings.csv,2007,0.0008338020873379764,0.999166197912662
6753,Americathon,6171763,6171763,0,1979_boxofficemojo_rankings.csv,1979,1.0,0.0
6754,The Autopsy of Jane Doe,6170043,10474,6159569,2016_boxofficemojo_rankings.csv,2016,0.0016975570510610704,0.9983024429489389
6755,Tiger & Bunny: The Rising,6168617,34471,6134146,2014_boxofficemojo_rankings.csv,2014,0.005588124534235146,0.9944118754657648
6756,Mystery Date,6166819,6166819,0,1991_boxofficemojo_rankings.csv,1991,1.0,0.0
6757,Darker Than Night,6160114,870063,5290051,2014_boxofficemojo_rankings.csv,2014,0.14124137962381866,0.8587586203761813
6758,The Secret of Roan Inish,6159269,6159269,0,1995_boxofficemojo_rankings.csv,1995,1.0,0.0
6759,UHF,6157157,6157157,0,1989_boxofficemojo_rankings.csv,1989,1.0,0.0
6760,The Patriarch,6156936,2156047,4000889,2016_boxofficemojo_rankings.csv,2016,0.3501818112125902,0.6498181887874098
6761,Barton Fink,6153939,6153939,0,1991_boxofficemojo_rankings.csv,1991,1.0,0.0
6762,Chained Heat,6149983,6149983,0,1983_boxofficemojo_rankings.csv,1983,1.0,0.0
6763,Four Lions,6148687,304616,5844071,2010_boxofficemojo_rankings.csv,2010,0.0495416338480069,0.9504583661519931
6764,Plenty,6148000,6148000,0,1985_boxofficemojo_rankings.csv,1985,1.0,0.0
6765,Ploey,6146292,77815,6068477,2018_boxofficemojo_rankings.csv,2018,0.012660478870837898,0.9873395211291621
6766,Almost Heroes,6136856,6136856,0,1998_boxofficemojo_rankings.csv,1998,1.0,0.0
6767,Folks!,6132924,6132924,0,1992_boxofficemojo_rankings.csv,1992,1.0,0.0
6768,Battle for Terra,6129640,1647083,4482557,2009_boxofficemojo_rankings.csv,2009,0.268707950222199,0.7312920497778009
6769,Mobile Suit Gundam Narrative,6126259,259224,5867035,2018_boxofficemojo_rankings.csv,2018,0.04231358811307194,0.957686411886928
6770,The Border,6118683,6118683,0,1982_boxofficemojo_rankings.csv,1982,1.0,0.0
6771,Kull the Conqueror,6112613,6112613,0,1997_boxofficemojo_rankings.csv,1997,1.0,0.0
6772,Short Cuts,6110979,6110979,0,1993_boxofficemojo_rankings.csv,1993,1.0,0.0
6773,Evil Under the Sun,6110000,6110000,0,1982_boxofficemojo_rankings.csv,1982,1.0,0.0
6774,Warriors of Heaven and Earth,6106178,82936,6023242,2003_boxofficemojo_rankings.csv,2003,0.013582309588747659,0.9864176904112524
6775,The Duelist,6101904,13450,6088454,2016_boxofficemojo_rankings.csv,2016,0.0022042300239400684,0.9977957699760599
6776,Rustlers' Rhapsody,6090497,6090497,0,1985_boxofficemojo_rankings.csv,1985,1.0,0.0
6777,One Two Three,6090432,274589,5815843,2008_boxofficemojo_rankings.csv,2008,0.04508530757752488,0.9549146924224752
6778,The Trip to Italy,6089109,2880537,3208572,2014_boxofficemojo_rankings.csv,2014,0.4730637930771152,0.5269362069228848
6779,Van Wilder 2: The Rise of Taj,6086508,4300645,1785863,2006_boxofficemojo_rankings.csv,2006,0.706586601052689,0.293413398947311
6780,Vitus,6079556,187480,5892076,2006_boxofficemojo_rankings.csv,2006,0.030837778285124767,0.9691622217148752
6781,Assassination,6075793,6075793,0,1987_boxofficemojo_rankings.csv,1987,1.0,0.0
6782,Rosenstrasse,6075609,734519,5341090,2003_boxofficemojo_rankings.csv,2003,0.12089635787951462,0.8791036421204854
6783,Heaven Help Us,6070794,6070794,0,1985_boxofficemojo_rankings.csv,1985,1.0,0.0
6784,Men Don't Leave,6070725,6070725,0,1990_boxofficemojo_rankings.csv,1990,1.0,0.0
6785,Partners,6062898,6062898,0,1982_boxofficemojo_rankings.csv,1982,1.0,0.0
6786,Shirley Valentine,6056912,6056912,0,1989_boxofficemojo_rankings.csv,1989,1.0,0.0
6787,Megiddo,6047691,6047691,0,2001_boxofficemojo_rankings.csv,2001,1.0,0.0
6788,Meet the Mormons,6047363,6047363,0,2014_boxofficemojo_rankings.csv,2014,1.0,0.0
6789,Racing with the Moon,6045647,6045647,0,1984_boxofficemojo_rankings.csv,1984,1.0,0.0
6790,Jindabyne,6044112,400438,5643674,2006_boxofficemojo_rankings.csv,2006,0.06625257771530375,0.9337474222846962
6791,She's Funny That Way,6034851,111996,5922855,2015_boxofficemojo_rankings.csv,2015,0.01855820466818485,0.9814417953318152
6792,Foolish,6033999,6033999,0,1999_boxofficemojo_rankings.csv,1999,1.0,0.0
6793,East/West,6031521,2321029,3710492,2000_boxofficemojo_rankings.csv,2000,0.384816533010496,0.615183466989504
6794,A Fine Mess,6029824,6029824,0,1986_boxofficemojo_rankings.csv,1986,1.0,0.0
6795,Gold Diggers: The Secret of Bear Mountain,6029091,6029091,0,1995_boxofficemojo_rankings.csv,1995,1.0,0.0
6796,Trapped in Paradise,6017509,6017509,0,1994_boxofficemojo_rankings.csv,1994,1.0,0.0
6797,The Walking Dead,6014341,6014341,0,1995_boxofficemojo_rankings.csv,1995,1.0,0.0
6798,Running,6012556,6012556,0,1979_boxofficemojo_rankings.csv,1979,1.0,0.0
6799,The Cemetery Club,6011745,6011745,0,1993_boxofficemojo_rankings.csv,1993,1.0,0.0
6800,Matru's Bijlee's Mandola,6009116,0,6009116,2013_boxofficemojo_rankings.csv,2013,0.0,1.0
6801,The Illusionist,6007194,2231474,3775720,2010_boxofficemojo_rankings.csv,2010,0.3714669444669175,0.6285330555330825
6802,Russian Ark,6001714,2326979,3674735,2002_boxofficemojo_rankings.csv,2002,0.38771907491759855,0.6122809250824015
6803,Beyond the Limit,5997566,5997566,0,1983_boxofficemojo_rankings.csv,1983,1.0,0.0
6804,Blue Exorcist: The Movie,5994921,21796,5973125,2012_boxofficemojo_rankings.csv,2012,0.0036357443242371335,0.9963642556757629
6805,The Broken Circle Breakdown,5990754,175058,5815696,2012_boxofficemojo_rankings.csv,2012,0.029221363454416588,0.9707786365455834
6806,The Rhythm Section,5989583,5437971,551612,2020_boxofficemojo_rankings.csv,2020,0.9079047740051353,0.09209522599486475
6807,"Cyrano, My Love",5985822,351019,5634803,2019_boxofficemojo_rankings.csv,2019,0.058641737091413675,0.9413582629085864
6808,Light It Up,5985690,5985690,0,1999_boxofficemojo_rankings.csv,1999,1.0,0.0
6809,Farewell My Concubine,5985074,5216888,768186,1993_boxofficemojo_rankings.csv,1993,0.8716497072550815,0.12835029274491844
6810,The Butterfly,5983780,189144,5794636,2002_boxofficemojo_rankings.csv,2002,0.03160945088221826,0.9683905491177818
6811,Still of the Night,5979947,5979947,0,1982_boxofficemojo_rankings.csv,1982,1.0,0.0
6812,The Hunger,5979292,5979292,0,1983_boxofficemojo_rankings.csv,1983,1.0,0.0
6813,1969,5979011,5979011,0,1988_boxofficemojo_rankings.csv,1988,1.0,0.0
6814,Les Boys II,5974732,5974732,0,1998_boxofficemojo_rankings.csv,1998,1.0,0.0
6815,Central Station,5969553,5969553,0,1998_boxofficemojo_rankings.csv,1998,1.0,0.0
6816,Learning to Drive,5967516,3447633,2519883,2015_boxofficemojo_rankings.csv,2015,0.5777333483479559,0.4222666516520442
6817,Harsh Times,5967038,3337931,2629107,2006_boxofficemojo_rankings.csv,2006,0.5593949627939356,0.44060503720606436
6818,My Little Pony: The Movie,5958456,5958456,0,1986_boxofficemojo_rankings.csv,1986,1.0,0.0
6819,The Immigrant,5952884,2025328,3927556,2013_boxofficemojo_rankings.csv,2013,0.340226350790642,0.659773649209358
6820,Malamaal Weekly,5946304,204612,5741692,2006_boxofficemojo_rankings.csv,2006,0.034409946077428935,0.965590053922571
6821,Chalte Chalte,5945422,836225,5109197,2003_boxofficemojo_rankings.csv,2003,0.14065023475204955,0.8593497652479505
6822,All Saints,5942565,5802208,140357,2017_boxofficemojo_rankings.csv,2017,0.9763810745023404,0.02361892549765968
6823,Last Dance,5939449,5939449,0,1996_boxofficemojo_rankings.csv,1996,1.0,0.0
6824,Inventing the Abbotts,5936344,5936344,0,1997_boxofficemojo_rankings.csv,1997,1.0,0.0
6825,Immediate Family,5932613,5932613,0,1989_boxofficemojo_rankings.csv,1989,1.0,0.0
6826,Transsiberian,5926410,2206405,3720005,2008_boxofficemojo_rankings.csv,2008,0.3723004314585052,0.6276995685414948
6827,For Your Consideration,5925637,5549923,375714,2006_boxofficemojo_rankings.csv,2006,0.9365951711183118,0.06340482888168816
6828,Coco Chanel & Igor Stravinsky,5925295,1621226,4304069,2009_boxofficemojo_rankings.csv,2009,0.27361101852312836,0.7263889814768716
6829,Don't Tell,5923415,29015,5894400,2005_boxofficemojo_rankings.csv,2005,0.004898356775610016,0.99510164322439
6830,Evil Dead II,5923044,5923044,0,1987_boxofficemojo_rankings.csv,1987,1.0,0.0
6831,Never Die Alone,5923000,5645298,277702,2004_boxofficemojo_rankings.csv,2004,0.9531146378524397,0.04688536214756036
6832,The Good German,5914908,1308696,4606212,2006_boxofficemojo_rankings.csv,2006,0.22125382169934005,0.77874617830066
6833,Gang Related,5906773,5906773,0,1997_boxofficemojo_rankings.csv,1997,1.0,0.0
6834,Callas Forever,5906353,446955,5459398,2002_boxofficemojo_rankings.csv,2002,0.07567360095138236,0.9243263990486177
6835,Highlander,5900000,5900000,0,1986_boxofficemojo_rankings.csv,1986,1.0,0.0
6836,Cry Freedom,5899797,5899797,0,1987_boxofficemojo_rankings.csv,1987,1.0,0.0
6837,Local Hero,5895761,5895761,0,1983_boxofficemojo_rankings.csv,1983,1.0,0.0
6838,Ed Wood,5887457,5887457,0,1994_boxofficemojo_rankings.csv,1994,1.0,0.0
6839,Death of a Nation,5885881,5885881,0,2018_boxofficemojo_rankings.csv,2018,1.0,0.0
6840,Maggie's Plan,5883891,3351735,2532156,2016_boxofficemojo_rankings.csv,2016,0.5696460046591618,0.43035399534083824
6841,Blue Story,5881391,0,5881391,2019_boxofficemojo_rankings.csv,2019,0.0,1.0
6842,The Opposite of Sex,5881367,5881367,0,1998_boxofficemojo_rankings.csv,1998,1.0,0.0
6843,Underclassman,5879555,5655459,224096,2005_boxofficemojo_rankings.csv,2005,0.9618855508622677,0.03811444913773236
6844,Palmetto,5878911,5878911,0,1998_boxofficemojo_rankings.csv,1998,1.0,0.0
6845,Testament of Youth,5874883,1822250,4052633,2015_boxofficemojo_rankings.csv,2015,0.31017638989576474,0.6898236101042353
6846,Blood: The Last Vampire,5874530,257412,5617118,2009_boxofficemojo_rankings.csv,2009,0.043818313975756355,0.9561816860242437
6847,My Life as a Zucchini,5872598,309766,5562832,2016_boxofficemojo_rankings.csv,2016,0.05274769361022157,0.9472523063897784
6848,Heaven & Earth,5864949,5864949,0,1993_boxofficemojo_rankings.csv,1993,1.0,0.0
6849,Lakshya,5859242,753600,5105642,2004_boxofficemojo_rankings.csv,2004,0.12861731944166158,0.8713826805583385
6850,The Rescue,5855392,5855392,0,1988_boxofficemojo_rankings.csv,1988,1.0,0.0
6851,Tracks,5853509,510007,5343502,2014_boxofficemojo_rankings.csv,2014,0.08712842160147016,0.9128715783985298
6852,The Transformers: The Movie,5849647,5849647,0,1986_boxofficemojo_rankings.csv,1986,1.0,0.0
6853,The Hitcher,5844868,5844868,0,1986_boxofficemojo_rankings.csv,1986,1.0,0.0
6854,The Last Seduction,5842603,5842603,0,1994_boxofficemojo_rankings.csv,1994,1.0,0.0
6855,20 Feet from Stardom,5839368,4946445,892923,2013_boxofficemojo_rankings.csv,2013,0.847085677765128,0.152914322234872
6856,Crossroads,5839031,5839031,0,1986_boxofficemojo_rankings.csv,1986,1.0,0.0
6857,The Hero: Love Story of a Spy,5835846,285394,5550452,2003_boxofficemojo_rankings.csv,2003,0.04890362082892523,0.9510963791710748
6858,Night of the Living Dead,5835247,5835247,0,1990_boxofficemojo_rankings.csv,1990,1.0,0.0
6859,The Tie That Binds,5830454,5772529,57925,1995_boxofficemojo_rankings.csv,1995,0.9900650961314504,0.009934903868549515
6860,The Last American Virgin,5829781,5829781,0,1982_boxofficemojo_rankings.csv,1982,1.0,0.0
6861,Young Goethe in Love,5826565,162138,5664427,2010_boxofficemojo_rankings.csv,2010,0.027827373418128864,0.9721726265818711
6862,Cyrano de Bergerac,5820020,5820020,0,1990_boxofficemojo_rankings.csv,1990,1.0,0.0
6863,Stanley & Iris,5820015,5820015,0,1990_boxofficemojo_rankings.csv,1990,1.0,0.0
6864,Puella Magi Madoka Magica the Movie Part 1: Beginnings,5816330,180440,5635890,2012_boxofficemojo_rankings.csv,2012,0.031022999038912855,0.9689770009610872
6865,The Perfect Holiday,5812781,5812781,0,2007_boxofficemojo_rankings.csv,2007,1.0,0.0
6866,Spider,5808941,1642483,4166458,2002_boxofficemojo_rankings.csv,2002,0.2827508490790318,0.7172491509209682
6867,Carriers,5805279,104352,5700927,2009_boxofficemojo_rankings.csv,2009,0.017975363457983673,0.9820246365420163
6868,Phillauri,5805030,467596,5337434,2017_boxofficemojo_rankings.csv,2017,0.08055014358237597,0.919449856417624
6869,Porky's 1983 Re-release,5797190,5797190,0,1983_boxofficemojo_rankings.csv,1983,1.0,0.0
6870,Mona Lisa,5794184,5794184,0,1986_boxofficemojo_rankings.csv,1986,1.0,0.0
6871,Strange Gardens,5793539,78668,5714871,2003_boxofficemojo_rankings.csv,2003,0.013578574339449515,0.9864214256605505
6872,Phoenix,5793245,3184472,2608773,2014_boxofficemojo_rankings.csv,2014,0.5496870924671752,0.4503129075328249
6873,The Wizard of Oz 2013 3D/IMAX Release,5787802,5633202,154600,2013_boxofficemojo_rankings.csv,2013,0.9732886508557135,0.026711349144286554
6874,Passengers,5787152,292437,5494715,2008_boxofficemojo_rankings.csv,2008,0.05053210974932056,0.9494678902506795
6875,Pretty Baby,5786368,5786368,0,1978_boxofficemojo_rankings.csv,1978,1.0,0.0
6876,Dylan Dog: Dead of Night,5782515,1186538,4595977,2011_boxofficemojo_rankings.csv,2011,0.20519410671654115,0.7948058932834589
6877,Bordello of Blood,5781045,5781045,0,1996_boxofficemojo_rankings.csv,1996,1.0,0.0
6878,Sheena,5778353,5778353,0,1984_boxofficemojo_rankings.csv,1984,1.0,0.0
6879,Millennium,5777099,5777099,0,1989_boxofficemojo_rankings.csv,1989,1.0,0.0
6880,The Skeleton Twins,5776640,5284309,492331,2014_boxofficemojo_rankings.csv,2014,0.9147720820407711,0.08522791795922889
6881,Kolya,5770254,5770254,0,1997_boxofficemojo_rankings.csv,1997,1.0,0.0
6882,Leatherface: Texas Chainsaw Massacre III,5765562,5765562,0,1990_boxofficemojo_rankings.csv,1990,1.0,0.0
6883,Untold Scandal,5762801,63332,5699469,2004_boxofficemojo_rankings.csv,2004,0.010989794719616381,0.9890102052803836
6884,The Good Thief,5756945,3517797,2239148,2003_boxofficemojo_rankings.csv,2003,0.6110527371722329,0.38894726282776715
6885,Furie,5756185,594788,5161397,2019_boxofficemojo_rankings.csv,2019,0.10333024390286275,0.8966697560971373
6886,Get on the Bus,5754249,5754249,0,1996_boxofficemojo_rankings.csv,1996,1.0,0.0
6887,Thorns,5753991,1041228,4712763,2002_boxofficemojo_rankings.csv,2002,0.18095753017340485,0.8190424698265951
6888,The Golden Bowl,5753678,3050532,2703146,2001_boxofficemojo_rankings.csv,2001,0.5301881683333687,0.4698118316666313
6889,Airheads,5751882,5751882,0,1994_boxofficemojo_rankings.csv,1994,1.0,0.0
6890,Nicotina,5751007,1117864,4633143,2003_boxofficemojo_rankings.csv,2003,0.19437708909065837,0.8056229109093416
6891,Beyond Rangoon,5750110,5750110,0,1995_boxofficemojo_rankings.csv,1995,1.0,0.0
6892,The Disappointments Room,5745040,2423468,3321572,2016_boxofficemojo_rankings.csv,2016,0.42183657555038784,0.5781634244496122
6893,Feast of Love,5741608,3511074,2230534,2007_boxofficemojo_rankings.csv,2007,0.6115140566893456,0.38848594331065445
6894,Under the Skin,5735963,2614251,3121712,2014_boxofficemojo_rankings.csv,2014,0.4557649691952336,0.5442350308047663
6895,Gallipoli,5732587,5732587,0,1981_boxofficemojo_rankings.csv,1981,1.0,0.0
6896,Gymkata,5730596,5730596,0,1985_boxofficemojo_rankings.csv,1985,1.0,0.0
6897,Hardware,5728953,5728953,0,1990_boxofficemojo_rankings.csv,1990,1.0,0.0
6898,The Devil's Double,5728213,1361512,4366701,2011_boxofficemojo_rankings.csv,2011,0.2376852955712366,0.7623147044287634
6899,One Eight Seven,5727130,5727130,0,1997_boxofficemojo_rankings.csv,1997,1.0,0.0
6900,Kingsglaive: Final Fantasy XV,5725482,269980,5455502,2016_boxofficemojo_rankings.csv,2016,0.04715410859731984,0.9528458914026802
6901,The Lonely Guy,5718573,5718573,0,1984_boxofficemojo_rankings.csv,1984,1.0,0.0
6902,Like for Likes,5715555,50839,5664716,2016_boxofficemojo_rankings.csv,2016,0.008894849231614427,0.9911051507683856
6903,Wisdom,5715174,5715174,0,1987_boxofficemojo_rankings.csv,1987,1.0,0.0
6904,Who's Your Caddy?,5713425,5713425,0,2007_boxofficemojo_rankings.csv,2007,1.0,0.0
6905,Surrender,5711976,5711976,0,1987_boxofficemojo_rankings.csv,1987,1.0,0.0
6906,Screamers,5711695,5711695,0,1996_boxofficemojo_rankings.csv,1996,1.0,0.0
6907,Catch a Fire,5710236,4299773,1410463,2006_boxofficemojo_rankings.csv,2006,0.7529939217923742,0.24700607820762574
6908,Saaho,5708522,2872057,2836465,2019_boxofficemojo_rankings.csv,2019,0.5031174444103045,0.4968825555896956
6909,My Best Friend's Wedding,5707770,78578,5629192,2016_boxofficemojo_rankings.csv,2016,0.013766847648030668,0.9862331523519693
6910,Vincere,5701481,619162,5082319,2009_boxofficemojo_rankings.csv,2009,0.10859669619174386,0.8914033038082562
6911,Bill & Ted Face the Music,5698881,3353535,2345346,2020_boxofficemojo_rankings.csv,2020,0.5884549966914557,0.41154500330854427
6912,Under Fire,5696391,5696391,0,1983_boxofficemojo_rankings.csv,1983,1.0,0.0
6913,The Viral Factor,5687319,220496,5466823,2012_boxofficemojo_rankings.csv,2012,0.03876976128822737,0.9612302387117726
6914,Kundun,5684789,5684789,0,1997_boxofficemojo_rankings.csv,1997,1.0,0.0
6915,Cold Comfort Farm,5682429,5682429,0,1996_boxofficemojo_rankings.csv,1996,1.0,0.0
6916,Eight Men Out,5680515,5680515,0,1988_boxofficemojo_rankings.csv,1988,1.0,0.0
6917,Hear No Evil,5679569,5679569,0,1993_boxofficemojo_rankings.csv,1993,1.0,0.0
6918,Smokey and the Bandit Part 3,5678950,5678950,0,1983_boxofficemojo_rankings.csv,1983,1.0,0.0
6919,Megaforce,5675599,5675599,0,1982_boxofficemojo_rankings.csv,1982,1.0,0.0
6920,Down in the Delta,5672903,5672903,0,1998_boxofficemojo_rankings.csv,1998,1.0,0.0
6921,Personal Best,5672311,5672311,0,1982_boxofficemojo_rankings.csv,1982,1.0,0.0
6922,My Bloody Valentine,5672031,5672031,0,1981_boxofficemojo_rankings.csv,1981,1.0,0.0
6923,Wish I Was Here,5670776,3591299,2079477,2014_boxofficemojo_rankings.csv,2014,0.6332993932400081,0.36670060675999194
6924,Nadine,5669831,5669831,0,1987_boxofficemojo_rankings.csv,1987,1.0,0.0
6925,Mission Mangal,5667057,3659413,2007644,2019_boxofficemojo_rankings.csv,2019,0.6457342850089561,0.35426571499104387
6926,Anomalisa,5659286,3759286,1900000,2015_boxofficemojo_rankings.csv,2015,0.6642686020816053,0.3357313979183946
6927,The Pallbearer,5656388,5656388,0,1996_boxofficemojo_rankings.csv,1996,1.0,0.0
6928,Incident in a Ghostland,5643957,0,5643957,2018_boxofficemojo_rankings.csv,2018,0.0,1.0
6929,The Burning Plain,5642478,200730,5441748,2008_boxofficemojo_rankings.csv,2008,0.035574795329286174,0.9644252046707138
6930,Things to Come,5638693,388140,5250553,2016_boxofficemojo_rankings.csv,2016,0.0688351006164017,0.9311648993835983
6931,Pagalpanti,5633633,423340,5210293,2019_boxofficemojo_rankings.csv,2019,0.07514511506163074,0.9248548849383692
6932,Wazir,5633588,1124045,4509543,2016_boxofficemojo_rankings.csv,2016,0.19952559541095302,0.800474404589047
6933,Swing Kids,5632086,5632086,0,1993_boxofficemojo_rankings.csv,1993,1.0,0.0
6934,Phantoms,5624282,5624282,0,1998_boxofficemojo_rankings.csv,1998,1.0,0.0
6935,Dalida,5623134,3465,5619669,2017_boxofficemojo_rankings.csv,2017,0.0006162044155447833,0.9993837955844552
6936,Avenging Angel,5622787,5622787,0,1985_boxofficemojo_rankings.csv,1985,1.0,0.0
6937,Mother and Child,5621971,1110509,4511462,2010_boxofficemojo_rankings.csv,2010,0.19753019003477607,0.802469809965224
6938,Batman: Mask of the Phantasm,5617391,5617391,0,1993_boxofficemojo_rankings.csv,1993,1.0,0.0
6939,Solitary Man,5615390,4360548,1254842,2010_boxofficemojo_rankings.csv,2010,0.7765352005826843,0.22346479941731562
6940,Cuba,5610280,5610280,0,1979_boxofficemojo_rankings.csv,1979,1.0,0.0
6941,El Angel,5604680,109608,5495072,2018_boxofficemojo_rankings.csv,2018,0.01955651348515883,0.9804434865148411
6942,Indochine,5603158,5603158,0,1992_boxofficemojo_rankings.csv,1992,1.0,0.0
6943,The Party,5597950,749827,4848123,2017_boxofficemojo_rankings.csv,2017,0.13394671263587563,0.8660532873641243
6944,Elvira: Mistress of the Dark,5596267,5596267,0,1988_boxofficemojo_rankings.csv,1988,1.0,0.0
6945,Islands in the Stream,5596173,5596173,0,1977_boxofficemojo_rankings.csv,1977,1.0,0.0
6946,A Fish Tale,5595327,563911,5031416,2001_boxofficemojo_rankings.csv,2001,0.10078249224754872,0.8992175077524512
6947,Paradise,5588800,5588800,0,1982_boxofficemojo_rankings.csv,1982,1.0,0.0
6948,Fathers & Daughters,5587709,0,5587709,2015_boxofficemojo_rankings.csv,2015,0.0,1.0
6949,The French Minister,5586646,12027,5574619,2013_boxofficemojo_rankings.csv,2013,0.0021528122598066892,0.9978471877401933
6950,Loose Cannons,5585154,5585154,0,1990_boxofficemojo_rankings.csv,1990,1.0,0.0
6951,Destroyer,5580940,1533324,4047616,2018_boxofficemojo_rankings.csv,2018,0.2747429644468495,0.7252570355531506
6952,Pawn Sacrifice,5578519,2436633,3141886,2014_boxofficemojo_rankings.csv,2014,0.4367885096384901,0.56321149036151
6953,Europa Europa,5575738,5575738,0,1991_boxofficemojo_rankings.csv,1991,1.0,0.0
6954,Gridlock'd,5571205,5571205,0,1997_boxofficemojo_rankings.csv,1997,1.0,0.0
6955,Knock Knock,5567103,36336,5530767,2015_boxofficemojo_rankings.csv,2015,0.00652691354911163,0.9934730864508884
6956,A Night in Heaven,5563663,5563663,0,1983_boxofficemojo_rankings.csv,1983,1.0,0.0
6957,Dheepan,5562575,261819,5300756,2014_boxofficemojo_rankings.csv,2014,0.047067949645622754,0.9529320503543772
6958,The Star Chamber,5555305,5555305,0,1983_boxofficemojo_rankings.csv,1983,1.0,0.0
6959,Escobar: Paradise Lost,5552496,195792,5356704,2014_boxofficemojo_rankings.csv,2014,0.03526197947733776,0.9647380205226622
6960,Dream a Little Dream,5552441,5552441,0,1989_boxofficemojo_rankings.csv,1989,1.0,0.0
6961,The Contract,5549200,0,5549200,2007_boxofficemojo_rankings.csv,2007,0.0,1.0
6962,Delirious,5546827,5546827,0,1991_boxofficemojo_rankings.csv,1991,1.0,0.0
6963,Ek Tha Tiger,5543117,2347774,3195343,2012_boxofficemojo_rankings.csv,2012,0.42354761770318033,0.5764523822968196
6964,Last Cab to Darwin,5543036,34193,5508843,2015_boxofficemojo_rankings.csv,2015,0.006168641156218361,0.9938313588437816
6965,Black & White,5541431,5277299,264132,2000_boxofficemojo_rankings.csv,2000,0.9523350556922932,0.0476649443077068
6966,Before Sunrise,5535405,5535405,0,1995_boxofficemojo_rankings.csv,1995,1.0,0.0
6967,The Brothers Bloom,5530764,3531756,1999008,2009_boxofficemojo_rankings.csv,2009,0.6385656665155122,0.36143433348448784
6968,Shortbus,5526675,1985292,3541383,2006_boxofficemojo_rankings.csv,2006,0.3592199649879901,0.64078003501201
6969,Aqua Teen Hunger Force Colon Movie Film for Theaters,5520368,5520368,0,2007_boxofficemojo_rankings.csv,2007,1.0,0.0
6970,Wind,5519569,5519569,0,1992_boxofficemojo_rankings.csv,1992,1.0,0.0
6971,The Grey Fox,5516140,5516140,0,1983_boxofficemojo_rankings.csv,1983,1.0,0.0
6972,Severance,5515163,137221,5377942,2006_boxofficemojo_rankings.csv,2006,0.024880678957267446,0.9751193210427326
6973,Mademoiselle Chambon,5511371,531685,4979686,2009_boxofficemojo_rankings.csv,2009,0.09647055151975797,0.9035294484802421
6974,Heartbreak Hotel,5509417,5509417,0,1988_boxofficemojo_rankings.csv,1988,1.0,0.0
6975,The Child,5507396,651941,4855455,2005_boxofficemojo_rankings.csv,2005,0.11837554444968185,0.8816244555503182
6976,On My Way,5505705,317324,5188381,2013_boxofficemojo_rankings.csv,2013,0.057635489006403355,0.9423645109935966
6977,Going Ape!,5504218,5504218,0,1981_boxofficemojo_rankings.csv,1981,1.0,0.0
6978,Slums of Beverly Hills,5502773,5502773,0,1998_boxofficemojo_rankings.csv,1998,1.0,0.0
6979,Warriors of the Dawn,5497176,84532,5412644,2017_boxofficemojo_rankings.csv,2017,0.015377350115768533,0.9846226498842314
6980,Tale of Tales,5497104,118925,5378179,2015_boxofficemojo_rankings.csv,2015,0.021634118619549492,0.9783658813804506
6981,Three of Hearts,5495507,5495507,0,1993_boxofficemojo_rankings.csv,1993,1.0,0.0
6982,A Wizard's Tale,5487261,2150,5485111,2018_boxofficemojo_rankings.csv,2018,0.0003918166094158816,0.9996081833905841
6983,Ride,5485295,5485295,0,1998_boxofficemojo_rankings.csv,1998,1.0,0.0
6984,People I Know,5484302,126793,5357509,2002_boxofficemojo_rankings.csv,2002,0.023119259296807505,0.9768807407031925
6985,The Dogs of War,5484132,5484132,0,1981_boxofficemojo_rankings.csv,1981,1.0,0.0
6986,Made,5480653,5313300,167353,2001_boxofficemojo_rankings.csv,2001,0.9694647699827009,0.030535230017299034
6987,The Legend of Drona,5476404,475104,5001300,2008_boxofficemojo_rankings.csv,2008,0.08675473905869618,0.9132452609413039
6988,Of Mice and Men,5471088,5471088,0,1992_boxofficemojo_rankings.csv,1992,1.0,0.0
6989,Chalet Girl,5468650,1710,5466940,2011_boxofficemojo_rankings.csv,2011,0.00031269143207190075,0.9996873085679281
6990,Livin' Large!,5467959,5467959,0,1991_boxofficemojo_rankings.csv,1991,1.0,0.0
6991,Man of Tai Chi,5464885,100144,5364741,2013_boxofficemojo_rankings.csv,2013,0.018324996774863513,0.9816750032251365
6992,Shinjuku Incident,5461200,0,5461200,2009_boxofficemojo_rankings.csv,2009,0.0,1.0
6993,Frozen River,5457664,2511476,2946188,2008_boxofficemojo_rankings.csv,2008,0.46017416975467895,0.539825830245321
6994,Thank You,5452347,463540,4988807,2011_boxofficemojo_rankings.csv,2011,0.08501659927367058,0.9149834007263294
6995,Eve of Destruction,5451119,5451119,0,1991_boxofficemojo_rankings.csv,1991,1.0,0.0
6996,Troll,5450815,5450815,0,1986_boxofficemojo_rankings.csv,1986,1.0,0.0
6997,OK Jaanu,5445281,355922,5089359,2017_boxofficemojo_rankings.csv,2017,0.0653633852871872,0.9346366147128128
6998,Gray Lady Down,5438927,5438927,0,1978_boxofficemojo_rankings.csv,1978,1.0,0.0
6999,Hara-Kiri: Death of a Samurai,5435358,75688,5359670,2011_boxofficemojo_rankings.csv,2011,0.013925117719936755,0.9860748822800632
7000,An Inconvenient Sequel: Truth to Power,5433926,3496795,1937131,2017_boxofficemojo_rankings.csv,2017,0.6435117077413274,0.3564882922586726
7001,Split Second,5430822,5430822,0,1992_boxofficemojo_rankings.csv,1992,1.0,0.0
7002,Devdas,5427830,2745382,2682448,2002_boxofficemojo_rankings.csv,2002,0.5057973444267783,0.49420265557322174
7003,Belle Epoque,5418216,5418216,0,1994_boxofficemojo_rankings.csv,1994,1.0,0.0
7004,The Salt of the Earth,5412189,1343349,4068840,2014_boxofficemojo_rankings.csv,2014,0.24820807255622448,0.7517919274437755
7005,The Student and Mister Henri,5411932,761,5411171,2015_boxofficemojo_rankings.csv,2015,0.00014061521837303203,0.999859384781627
7006,Meatballs Part II,5410972,5410972,0,1984_boxofficemojo_rankings.csv,1984,1.0,0.0
7007,Virgin Territory,5410749,0,5410749,2008_boxofficemojo_rankings.csv,2008,0.0,1.0
7008,The Sicilian,5406879,5406879,0,1987_boxofficemojo_rankings.csv,1987,1.0,0.0
7009,Dangerous Ground,5406742,5303931,102811,1997_boxofficemojo_rankings.csv,1997,0.9809846669214104,0.019015333078589658
7010,Dolls,5405725,4067,5401658,2002_boxofficemojo_rankings.csv,2002,0.000752350517275666,0.9992476494827244
7011,Lady Macbeth,5401447,1129408,4272039,2017_boxofficemojo_rankings.csv,2017,0.2090936002889596,0.7909063997110404
7012,Read My Lips,5393526,1471911,3921615,2001_boxofficemojo_rankings.csv,2001,0.2729032918354338,0.7270967081645662
7013,Exit Through the Gift Shop,5386242,3291250,2094992,2010_boxofficemojo_rankings.csv,2010,0.6110475541202939,0.3889524458797061
7014,Truth,5383097,2541854,2841243,2015_boxofficemojo_rankings.csv,2015,0.4721917513282781,0.5278082486717218
7015,After the Storm,5382886,272132,5110754,2016_boxofficemojo_rankings.csv,2016,0.05055503683340126,0.9494449631665988
7016,Madame,5381950,90979,5290971,2017_boxofficemojo_rankings.csv,2017,0.016904467711517202,0.9830955322884828
7017,Won't Back Down,5378228,5310554,67674,2012_boxofficemojo_rankings.csv,2012,0.9874170451680367,0.012582954831963242
7018,The Lookout,5371181,4600585,770596,2007_boxofficemojo_rankings.csv,2007,0.8565313661930216,0.14346863380697839
7019,Second Sight,5368865,5368865,0,1989_boxofficemojo_rankings.csv,1989,1.0,0.0
7020,Diary of the Dead,5364858,958961,4405897,2008_boxofficemojo_rankings.csv,2008,0.1787486267110891,0.821251373288911
7021,Equilibrium,5359645,1203794,4155851,2002_boxofficemojo_rankings.csv,2002,0.22460330861465638,0.7753966913853436
7022,Creator,5349607,5349607,0,1985_boxofficemojo_rankings.csv,1985,1.0,0.0
7023,Intruders,5348049,69136,5278913,2011_boxofficemojo_rankings.csv,2011,0.01292733106970411,0.9870726689302959
7024,The Real Cancun,5345083,3825421,1519662,2003_boxofficemojo_rankings.csv,2003,0.7156897282979516,0.2843102717020484
7025,Monkey Shines,5344577,5344577,0,1988_boxofficemojo_rankings.csv,1988,1.0,0.0
7026,Vertigo 1983 Re-release,5343461,5343461,0,1983_boxofficemojo_rankings.csv,1983,1.0,0.0
7027,Much Ado About Nothing,5341221,4328849,1012372,2013_boxofficemojo_rankings.csv,2013,0.8104605669752291,0.18953943302477091
7028,Trollhunter,5341098,253444,5087654,2010_boxofficemojo_rankings.csv,2010,0.04745166630531775,0.9525483336946823
7029,Sky on fire,5335450,78366,5257084,2016_boxofficemojo_rankings.csv,2016,0.014687795781049395,0.9853122042189506
7030,He Loves Me... He Loves Me Not,5324097,1011102,4312995,2002_boxofficemojo_rankings.csv,2002,0.18991051440272408,0.8100894855972759
7031,Charlotte Gray,5323109,741394,4581715,2001_boxofficemojo_rankings.csv,2001,0.139278380360049,0.860721619639951
7032,Once Upon a Time in America,5321508,5321508,0,1984_boxofficemojo_rankings.csv,1984,1.0,0.0
7033,Orlando,5319445,5319445,0,1993_boxofficemojo_rankings.csv,1993,1.0,0.0
7034,Divine Madness,5318098,5318098,0,1980_boxofficemojo_rankings.csv,1980,1.0,0.0
7035,The Dresser,5310748,5310748,0,1983_boxofficemojo_rankings.csv,1983,1.0,0.0
7036,Force,5310437,0,5310437,2011_boxofficemojo_rankings.csv,2011,0.0,1.0
7037,Cannery Row,5301539,5301539,0,1982_boxofficemojo_rankings.csv,1982,1.0,0.0
7038,Hero and the Terror,5301200,5301200,0,1988_boxofficemojo_rankings.csv,1988,1.0,0.0
7039,Metalstorm: The Destruction of Jared-Syn,5301085,5301085,0,1983_boxofficemojo_rankings.csv,1983,1.0,0.0
7040,The Meddler 2016 Re-release,5294643,4267218,1027425,2016_boxofficemojo_rankings.csv,2016,0.80595008955278,0.19404991044721995
7041,Don't Let Go,5288011,5215062,72949,2019_boxofficemojo_rankings.csv,2019,0.9862048320247443,0.013795167975255724
7042,Whisper,5285197,0,5285197,2007_boxofficemojo_rankings.csv,2007,0.0,1.0
7043,The In Crowd,5280035,5280035,0,2000_boxofficemojo_rankings.csv,2000,1.0,0.0
7044,Talaash,5277766,2871956,2405810,2012_boxofficemojo_rankings.csv,2012,0.5441612985494241,0.45583870145057587
7045,Mustang,5274664,845464,4429200,2015_boxofficemojo_rankings.csv,2015,0.16028774534264173,0.8397122546573582
7046,Glitter,5271666,4274407,997259,2001_boxofficemojo_rankings.csv,2001,0.8108265963738978,0.18917340362610227
7047,Love Letters,5269990,5269990,0,1984_boxofficemojo_rankings.csv,1984,1.0,0.0
7048,Screen Two: Persuasion,5269757,5269757,0,1995_boxofficemojo_rankings.csv,1995,1.0,0.0
7049,Gardens of Stone,5262047,5262047,0,1987_boxofficemojo_rankings.csv,1987,1.0,0.0
7050,True Story,5261595,4719695,541900,2015_boxofficemojo_rankings.csv,2015,0.8970084166493241,0.10299158335067599
7051,The War with Grandpa,5259376,3608000,1651376,2020_boxofficemojo_rankings.csv,2020,0.686012941459215,0.31398705854078507
7052,Man on Wire,5258569,2962242,2296327,2008_boxofficemojo_rankings.csv,2008,0.5633171305729753,0.4366828694270247
7053,Les Misérables: The Staged Concert,5257431,459478,4797953,2019_boxofficemojo_rankings.csv,2019,0.08739591637056197,0.912604083629438
7054,Charlie Bartlett,5254986,3951699,1303287,2008_boxofficemojo_rankings.csv,2008,0.7519903954073331,0.24800960459266685
7055,Nathalie...,5254422,31008,5223414,2004_boxofficemojo_rankings.csv,2004,0.0059013151208639125,0.9940986848791361
7056,The Truth,5252668,9619,5243049,2019_boxofficemojo_rankings.csv,2019,0.0018312598473766094,0.9981687401526234
7057,The Biggest Little Farm,5248412,4366949,881463,2019_boxofficemojo_rankings.csv,2019,0.8320514852873593,0.1679485147126407
7058,Siegfried & Roy: The Magic Box,5231283,5231283,0,1999_boxofficemojo_rankings.csv,1999,1.0,0.0
7059,Venom,5229643,5229643,0,1982_boxofficemojo_rankings.csv,1982,1.0,0.0
7060,Hollywood Shuffle,5228617,5228617,0,1987_boxofficemojo_rankings.csv,1987,1.0,0.0
7061,The Dancer Upstairs,5227348,2377348,2850000,2002_boxofficemojo_rankings.csv,2002,0.4547904597130323,0.5452095402869677
7062,Tucker and Dale vs Evil,5224938,223838,5001100,2010_boxofficemojo_rankings.csv,2010,0.042840316956871065,0.9571596830431289
7063,Miami Rhapsody,5221281,5221281,0,1995_boxofficemojo_rankings.csv,1995,1.0,0.0
7064,Kill the Messenger,5218973,2450846,2768127,2014_boxofficemojo_rankings.csv,2014,0.4696031192343781,0.5303968807656219
7065,The New Girlfriend,5215796,146754,5069042,2014_boxofficemojo_rankings.csv,2014,0.028136453189503578,0.9718635468104965
7066,In God We Trust (or Gimme That Prime Time Religion),5215015,5215015,0,1980_boxofficemojo_rankings.csv,1980,1.0,0.0
7067,Mountains May Depart,5210160,82913,5127247,2015_boxofficemojo_rankings.csv,2015,0.015913714741965696,0.9840862852580343
7068,Inchon,5200986,5200986,0,1982_boxofficemojo_rankings.csv,1982,1.0,0.0
7069,Jane Eyre,5200601,5200601,0,1996_boxofficemojo_rankings.csv,1996,1.0,0.0
7070,Clara's Heart,5194491,5194491,0,1988_boxofficemojo_rankings.csv,1988,1.0,0.0
7071,Zindagi Na Milegi Dobara,5192743,3108485,2084258,2011_boxofficemojo_rankings.csv,2011,0.5986209985743566,0.4013790014256434
7072,Atanarjuat: The Fast Runner,5188289,3789952,1398337,2002_boxofficemojo_rankings.csv,2002,0.7304820529465494,0.26951794705345056
7073,Oldboy,5186767,2193658,2993109,2013_boxofficemojo_rankings.csv,2013,0.422933592351459,0.577066407648541
7074,52 Pick-Up,5186646,5186646,0,1986_boxofficemojo_rankings.csv,1986,1.0,0.0
7075,The Ex,5178640,3093394,2085246,2007_boxofficemojo_rankings.csv,2007,0.5973371387082322,0.4026628612917677
7076,Intermission,5175215,896993,4278222,2003_boxofficemojo_rankings.csv,2003,0.17332477974345029,0.8266752202565497
7077,My Wife Is an Actress,5169438,1121233,4048205,2001_boxofficemojo_rankings.csv,2001,0.2168964982266931,0.7831035017733069
7078,Prince,5167952,570090,4597862,2008_boxofficemojo_rankings.csv,2008,0.11031255708257352,0.8896874429174265
7079,Student Bodies,5165432,5165432,0,1981_boxofficemojo_rankings.csv,1981,1.0,0.0
7080,The House of Mirth,5164404,3043284,2121120,2000_boxofficemojo_rankings.csv,2000,0.5892807766394729,0.4107192233605272
7081,MI-5,5161464,0,5161464,2015_boxofficemojo_rankings.csv,2015,0.0,1.0
7082,October Baby 2012 Re-release,5157886,5157886,0,2012_boxofficemojo_rankings.csv,2012,1.0,0.0
7083,Jack the Bear,5145823,5145823,0,1993_boxofficemojo_rankings.csv,1993,1.0,0.0
7084,The Hotel New Hampshire,5142858,5142858,0,1984_boxofficemojo_rankings.csv,1984,1.0,0.0
7085,Grind,5141166,5123696,17470,2003_boxofficemojo_rankings.csv,2003,0.9966019381595537,0.003398061840446311
7086,Rabbit Hole,5140925,2229058,2911867,2010_boxofficemojo_rankings.csv,2010,0.43359084211498905,0.566409157885011
7087,The Legend of Chupacabras,5138140,0,5138140,2016_boxofficemojo_rankings.csv,2016,0.0,1.0
7088,Butch and Sundance: The Early Days,5136913,5136913,0,1979_boxofficemojo_rankings.csv,1979,1.0,0.0
7089,The Object of Beauty,5136759,5136759,0,1991_boxofficemojo_rankings.csv,1991,1.0,0.0
7090,Heidi's Song,5124391,5124391,0,1982_boxofficemojo_rankings.csv,1982,1.0,0.0
7091,Lorna's Silence,5123676,338795,4784881,2008_boxofficemojo_rankings.csv,2008,0.0661234238855072,0.9338765761144928
7092,King David,5111099,5111099,0,1985_boxofficemojo_rankings.csv,1985,1.0,0.0
7093,Solo,5107669,5107669,0,1996_boxofficemojo_rankings.csv,1996,1.0,0.0
7094,Never Look Away,5105444,1304042,3801402,2018_boxofficemojo_rankings.csv,2018,0.25542185948959584,0.7445781405104042
7095,In the Fade,5104991,321011,4783980,2017_boxofficemojo_rankings.csv,2017,0.06288179548210761,0.9371182045178924
7096,"Good Day, Ramon",5104868,154356,4950512,2014_boxofficemojo_rankings.csv,2014,0.030237020820126984,0.969762979179873
7097,Action Point,5103663,5059608,44055,2018_boxofficemojo_rankings.csv,2018,0.9913679645384109,0.008632035461589058
7098,Sin Nombre,5102705,2536665,2566040,2009_boxofficemojo_rankings.csv,2009,0.49712162470689564,0.5028783752931043
7099,Out of Bounds,5099316,5099316,0,1986_boxofficemojo_rankings.csv,1986,1.0,0.0
7100,The Grocer's Son,5095496,264889,4830607,2007_boxofficemojo_rankings.csv,2007,0.05198492943572127,0.9480150705642787
7101,Top Dog,5093707,5093707,0,1995_boxofficemojo_rankings.csv,1995,1.0,0.0
7102,Serena,5092129,176391,4915738,2014_boxofficemojo_rankings.csv,2014,0.03463993154925965,0.9653600684507403
7103,Vigilante,5091888,5091888,0,1983_boxofficemojo_rankings.csv,1983,1.0,0.0
7104,Kabul Express,5091289,302458,4788831,2006_boxofficemojo_rankings.csv,2006,0.05940695961278175,0.9405930403872182
7105,Dark Places,5090852,208588,4882264,2014_boxofficemojo_rankings.csv,2014,0.04097310234121911,0.9590268976587809
7106,Locke,5090608,1375769,3714839,2014_boxofficemojo_rankings.csv,2014,0.2702563230168184,0.7297436769831815
7107,Ghost in the Machine,5086909,5086909,0,1993_boxofficemojo_rankings.csv,1993,1.0,0.0
7108,The Liberator,5082098,113067,4969031,2014_boxofficemojo_rankings.csv,2014,0.02224809517644091,0.9777519048235591
7109,The Sense of an Ending,5081495,1274420,3807075,2017_boxofficemojo_rankings.csv,2017,0.2507962715696857,0.7492037284303144
7110,Miller's Crossing,5080409,5080409,0,1990_boxofficemojo_rankings.csv,1990,1.0,0.0
7111,Dogman,5080147,148225,4931922,2018_boxofficemojo_rankings.csv,2018,0.029177305302385936,0.9708226946976141
7112,Anthropoid,5079219,2964845,2114374,2016_boxofficemojo_rankings.csv,2016,0.583720646815977,0.416279353184023
7113,L'auberge espagnole 2003 Re-release,5079086,2830361,2248725,2003_boxofficemojo_rankings.csv,2003,0.5572579397159253,0.44274206028407476
7114,Konosuba!: God's Blessing on This Wonderful World! - Legend of Crimson,5078942,1134786,3944156,2019_boxofficemojo_rankings.csv,2019,0.22342960403958148,0.7765703959604185
7115,Celebrity,5078660,5078660,0,1998_boxofficemojo_rankings.csv,1998,1.0,0.0
7116,Doctor Who: The Day of the Doctor,5074950,0,5074950,2013_boxofficemojo_rankings.csv,2013,0.0,1.0
7117,Stand Up Guys,5072654,3310031,1762623,2013_boxofficemojo_rankings.csv,2013,0.652524497038434,0.3474755029615661
7118,Mr. X,5061387,44995,5016392,2015_boxofficemojo_rankings.csv,2015,0.008889855685803121,0.9911101443141969
7119,Monsters,5060438,237301,4823137,2010_boxofficemojo_rankings.csv,2010,0.04689337168047509,0.9531066283195249
7120,The Proposition,5048693,1903434,3145259,2005_boxofficemojo_rankings.csv,2005,0.37701519977546666,0.6229848002245334
7121,Vision,5043878,435274,4608604,2009_boxofficemojo_rankings.csv,2009,0.08629748776635755,0.9137025122336424
7122,Table 19,5042014,3614896,1427118,2017_boxofficemojo_rankings.csv,2017,0.7169547724381566,0.28304522756184336
7123,The Fog of War: Eleven Lessons from the Life of Robert S. McNamara,5038841,4198566,840275,2003_boxofficemojo_rankings.csv,2003,0.8332404217557172,0.16675957824428275
7124,Kedi,5037923,2835047,2202876,2017_boxofficemojo_rankings.csv,2017,0.562741232845361,0.4372587671546389
7125,The Real Exorcist,5035830,0,5035830,2020_boxofficemojo_rankings.csv,2020,0.0,1.0
7126,Breathe,5026154,490131,4536023,2017_boxofficemojo_rankings.csv,2017,0.09751611271759679,0.9024838872824033
7127,American Dreamer,5021751,5021751,0,1984_boxofficemojo_rankings.csv,1984,1.0,0.0
7128,La Femme Nikita,5017971,5017971,0,1991_boxofficemojo_rankings.csv,1991,1.0,0.0
7129,Oranges and Sunshine,5017653,143480,4874173,2011_boxofficemojo_rankings.csv,2011,0.028595042343502033,0.9714049576564979
7130,The Lover,5013090,4899194,113896,1992_boxofficemojo_rankings.csv,1992,0.9772802802263674,0.02271971977363263
7131,Double Lover,5012423,167581,4844842,2017_boxofficemojo_rankings.csv,2017,0.03343313204013309,0.9665668679598669
7132,Worlds Apart,5011560,60298,4951262,2015_boxofficemojo_rankings.csv,2015,0.012031782518816496,0.9879682174811835
7133,Brass Target,5011158,5011158,0,1978_boxofficemojo_rankings.csv,1978,1.0,0.0
7134,Heaven's Prisoners,5009305,5009305,0,1996_boxofficemojo_rankings.csv,1996,1.0,0.0
7135,Bubble Boy,5007898,5007898,0,2001_boxofficemojo_rankings.csv,2001,1.0,0.0
7136,Blindspotting,5006989,4333394,673595,2018_boxofficemojo_rankings.csv,2018,0.8654690473655924,0.13453095263440762
7137,Tempest,5005245,5005245,0,1982_boxofficemojo_rankings.csv,1982,1.0,0.0
7138,Day of the Dead,5000000,5000000,0,1985_boxofficemojo_rankings.csv,1985,1.0,0.0
7139,The Watcher in the Woods,5000000,5000000,0,1981_boxofficemojo_rankings.csv,1981,1.0,0.0
7140,Alien 2003 Director's Cut,4999112,1986910,3012202,2003_boxofficemojo_rankings.csv,2003,0.39745258757955415,0.6025474124204458
7141,No Small Affair,4994094,4994094,0,1984_boxofficemojo_rankings.csv,1984,1.0,0.0
7142,Hands of Stone,4978353,4712792,265561,2016_boxofficemojo_rankings.csv,2016,0.9466568561932028,0.053343143806797146
7143,Let It Ride,4973285,4973285,0,1989_boxofficemojo_rankings.csv,1989,1.0,0.0
7144,Summer Lovers,4968000,4968000,0,1982_boxofficemojo_rankings.csv,1982,1.0,0.0
7145,Take This Waltz,4965950,1239692,3726258,2012_boxofficemojo_rankings.csv,2012,0.24963843776115346,0.7503615622388465
7146,The Handmaid's Tale,4960385,4960385,0,1990_boxofficemojo_rankings.csv,1990,1.0,0.0
7147,The Professor and the Madman,4957273,0,4957273,2019_boxofficemojo_rankings.csv,2019,0.0,1.0
7148,Jakob the Liar,4956401,4956401,0,1999_boxofficemojo_rankings.csv,1999,1.0,0.0
7149,Shrooms,4954621,2863,4951758,2007_boxofficemojo_rankings.csv,2007,0.0005778444002074024,0.9994221555997926
7150,Stop Making Sense,4949438,4949438,0,1984_boxofficemojo_rankings.csv,1984,1.0,0.0
7151,Black Sheep,4947717,84283,4863434,2007_boxofficemojo_rankings.csv,2007,0.01703472530866256,0.9829652746913374
7152,Innocent Blood,4943279,4943279,0,1992_boxofficemojo_rankings.csv,1992,1.0,0.0
7153,Vamp,4941117,4941117,0,1986_boxofficemojo_rankings.csv,1986,1.0,0.0
7154,Jean de Florette,4940939,4940939,0,1987_boxofficemojo_rankings.csv,1987,1.0,0.0
7155,Girl 6,4939939,4939939,0,1996_boxofficemojo_rankings.csv,1996,1.0,0.0
7156,Swiss Army Man,4935501,4210454,725047,2016_boxofficemojo_rankings.csv,2016,0.8530955621323955,0.14690443786760451
7157,Nymphomaniac: Vol. II,4934725,327167,4607558,2014_boxofficemojo_rankings.csv,2014,0.06629893256463126,0.9337010674353687
7158,Sgt. Stubby: An American Hero,4932694,4015935,916759,2018_boxofficemojo_rankings.csv,2018,0.8141463873493876,0.18585361265061243
7159,The Anniversary Party,4931888,4047329,884559,2001_boxofficemojo_rankings.csv,2001,0.8206449538189026,0.17935504618109738
7160,From Justin to Kelly,4928883,4928883,0,2003_boxofficemojo_rankings.csv,2003,1.0,0.0
7161,Hamlet 2,4925288,4886216,39072,2008_boxofficemojo_rankings.csv,2008,0.9920670628803838,0.007932937119616153
7162,Desierto,4924990,2002036,2922954,2016_boxofficemojo_rankings.csv,2016,0.4065055969656791,0.5934944030343209
7163,Surf Ninjas,4916135,4916135,0,1993_boxofficemojo_rankings.csv,1993,1.0,0.0
7164,[REC] 4: Apocalypse,4915757,837,4914920,2014_boxofficemojo_rankings.csv,2014,0.00017026879074779326,0.9998297312092522
7165,Gremlins 1985 Re-release,4914643,4914643,0,1985_boxofficemojo_rankings.csv,1985,1.0,0.0
7166,Hilary and Jackie,4912892,4912892,0,1998_boxofficemojo_rankings.csv,1998,1.0,0.0
7167,The Playboys,4906900,4906900,0,1992_boxofficemojo_rankings.csv,1992,1.0,0.0
7168,Confetti,4903131,228498,4674633,2006_boxofficemojo_rankings.csv,2006,0.046602466872698284,0.9533975331273017
7169,Players,4896094,4896094,0,1979_boxofficemojo_rankings.csv,1979,1.0,0.0
7170,Rainbow Brite and the Star Stealer,4889971,4889971,0,1985_boxofficemojo_rankings.csv,1985,1.0,0.0
7171,Sleuth,4889751,342895,4546856,2007_boxofficemojo_rankings.csv,2007,0.07012524768643638,0.9298747523135636
7172,Panga,4886124,582720,4303404,2020_boxofficemojo_rankings.csv,2020,0.11926017432222351,0.8807398256777765
7173,Invaders from Mars,4884663,4884663,0,1986_boxofficemojo_rankings.csv,1986,1.0,0.0
7174,He Knows You're Alone,4875436,4875436,0,1980_boxofficemojo_rankings.csv,1980,1.0,0.0
7175,Samson,4873825,4719928,153897,2018_boxofficemojo_rankings.csv,2018,0.9684237739352561,0.03157622606474381
7176,The Long Walk Home,4873620,4873620,0,1990_boxofficemojo_rankings.csv,1990,1.0,0.0
7177,The Young Karl Marx,4870373,125659,4744714,2017_boxofficemojo_rankings.csv,2017,0.02580069329392225,0.9741993067060778
7178,Torch Song Trilogy,4868450,4865997,2453,1988_boxofficemojo_rankings.csv,1988,0.9994961435364439,0.0005038564635561626
7179,Band of the Hand,4865912,4865912,0,1986_boxofficemojo_rankings.csv,1986,1.0,0.0
7180,Harry & Son,4864980,4864980,0,1984_boxofficemojo_rankings.csv,1984,1.0,0.0
7181,Cloud 9,4864463,91675,4772788,2008_boxofficemojo_rankings.csv,2008,0.018845862328483124,0.9811541376715168
7182,No Man's Land,4858869,1012153,3846716,2001_boxofficemojo_rankings.csv,2001,0.20831041133234915,0.7916895886676508
7183,Little Buddha,4858139,4858139,0,1994_boxofficemojo_rankings.csv,1994,1.0,0.0
7184,Into Great Silence,4857107,790452,4066655,2005_boxofficemojo_rankings.csv,2005,0.16274131906091424,0.8372586809390857
7185,Silmido,4855181,298347,4556834,2004_boxofficemojo_rankings.csv,2004,0.06144920240872585,0.9385507975912741
7186,Enron: The Smartest Guys in the Room,4854164,4071700,782464,2005_boxofficemojo_rankings.csv,2005,0.8388056110176747,0.16119438898232527
7187,Back To The Future Day,4850000,1650000,3200000,2015_boxofficemojo_rankings.csv,2015,0.3402061855670103,0.6597938144329897
7188,American Anthem,4845724,4845724,0,1986_boxofficemojo_rankings.csv,1986,1.0,0.0
7189,Water,4842898,2250329,2592569,2005_boxofficemojo_rankings.csv,2005,0.46466578482553217,0.5353342151744679
7190,Off Beat,4842778,4842778,0,1986_boxofficemojo_rankings.csv,1986,1.0,0.0
7191,90 Minutes in Heaven,4842699,4842699,0,2015_boxofficemojo_rankings.csv,2015,1.0,0.0
7192,Roman de gare,4841132,1852764,2988368,2007_boxofficemojo_rankings.csv,2007,0.3827129687849867,0.6172870312150134
7193,RamLeela,4840059,2738863,2101196,2013_boxofficemojo_rankings.csv,2013,0.565873887074517,0.4341261129254829
7194,Diggstown,4836637,4836637,0,1992_boxofficemojo_rankings.csv,1992,1.0,0.0
7195,Antebellum,4831009,0,4831009,2020_boxofficemojo_rankings.csv,2020,0.0,1.0
7196,Wild Grass,4826090,403952,4422138,2009_boxofficemojo_rankings.csv,2009,0.08370171298090172,0.9162982870190983
7197,Jimmy's Hall,4825184,560592,4264592,2014_boxofficemojo_rankings.csv,2014,0.11618043995835185,0.8838195600416482
7198,Predestination,4824499,68372,4756127,2014_boxofficemojo_rankings.csv,2014,0.014171834215324742,0.9858281657846752
7199,Capital,4822849,101700,4721149,2012_boxofficemojo_rankings.csv,2012,0.021087120911311964,0.9789128790886881
7200,Angus,4821759,4821759,0,1995_boxofficemojo_rankings.csv,1995,1.0,0.0
7201,Passion Fish,4814619,4814619,0,1992_boxofficemojo_rankings.csv,1992,1.0,0.0
7202,Mazinger Z: INFINITY,4812371,220682,4591689,2017_boxofficemojo_rankings.csv,2017,0.04585722921196225,0.9541427707880378
7203,Wolves,4811282,4811282,0,1999_boxofficemojo_rankings.csv,1999,1.0,0.0
7204,Trash,4809022,17484,4791538,2014_boxofficemojo_rankings.csv,2014,0.00363566646191263,0.9963643335380874
7205,God You Are Great,4807638,163756,4643882,2008_boxofficemojo_rankings.csv,2008,0.03406163276020366,0.9659383672397963
7206,Robot & Frank,4806423,3325038,1481385,2012_boxofficemojo_rankings.csv,2012,0.6917905477732609,0.3082094522267391
7207,Flash of Genius,4802953,4442377,360576,2008_boxofficemojo_rankings.csv,2008,0.9249261860359658,0.07507381396403422
7208,See You in the Morning,4795009,4795009,0,1989_boxofficemojo_rankings.csv,1989,1.0,0.0
7209,Burke and Hare,4791599,4833,4786766,2010_boxofficemojo_rankings.csv,2010,0.0010086403307121485,0.9989913596692879
7210,Into the West,4790801,4790801,0,1993_boxofficemojo_rankings.csv,1993,1.0,0.0
7211,Eddie and the Cruisers,4786789,4786789,0,1983_boxofficemojo_rankings.csv,1983,1.0,0.0
7212,Ultimate X: The Movie,4786084,4197492,588592,2002_boxofficemojo_rankings.csv,2002,0.8770201275197008,0.12297987248029914
7213,My Chauffeur,4781448,4781448,0,1986_boxofficemojo_rankings.csv,1986,1.0,0.0
7214,A Royal Night Out,4779170,228136,4551034,2015_boxofficemojo_rankings.csv,2015,0.04773548545040247,0.9522645145495975
7215,Martha Marcy May Marlene,4778439,2990625,1787814,2011_boxofficemojo_rankings.csv,2011,0.6258581515846493,0.3741418484153507
7216,Talk to Me,4778376,4533261,245115,2007_boxofficemojo_rankings.csv,2007,0.948703283291227,0.051296716708773026
7217,Gladiator 20th Anniversary,4777216,0,4777216,2020_boxofficemojo_rankings.csv,2020,0.0,1.0
7218,Mansfield Park,4775847,4775847,0,1999_boxofficemojo_rankings.csv,1999,1.0,0.0
7219,Whipped,4775009,4159986,615023,2000_boxofficemojo_rankings.csv,2000,0.8711996144928732,0.1288003855071268
7220,Men & Chicken,4765472,30207,4735265,2015_boxofficemojo_rankings.csv,2015,0.00633872153692226,0.9936612784630777
7221,The Good Mother,4764606,4764606,0,1988_boxofficemojo_rankings.csv,1988,1.0,0.0
7222,Stealing Beauty,4762310,4722310,40000,1996_boxofficemojo_rankings.csv,1996,0.9916007147791723,0.008399285220827708
7223,A Walk on the Moon,4750660,4750660,0,1999_boxofficemojo_rankings.csv,1999,1.0,0.0
7224,Violets Are Blue...,4743287,4743287,0,1986_boxofficemojo_rankings.csv,1986,1.0,0.0
7225,"Grandview, U.S.A.",4743119,4743119,0,1984_boxofficemojo_rankings.csv,1984,1.0,0.0
7226,Hamlet,4739189,4708156,31033,1996_boxofficemojo_rankings.csv,1996,0.9934518332145015,0.006548166785498532
7227,Slack Bay,4734494,112621,4621873,2016_boxofficemojo_rankings.csv,2016,0.023787336091248612,0.9762126639087514
7228,The Magdalene Sisters 2003 Re-release,4734466,4583889,150577,2003_boxofficemojo_rankings.csv,2003,0.9681955684125728,0.03180443158742718
7229,The Double,4729855,137921,4591934,2011_boxofficemojo_rankings.csv,2011,0.02915966768537302,0.970840332314627
7230,Drugstore Cowboy,4729352,4729352,0,1989_boxofficemojo_rankings.csv,1989,1.0,0.0
7231,Clouds of Sils Maria,4728401,1851517,2876884,2014_boxofficemojo_rankings.csv,2014,0.3915735996164454,0.6084264003835546
7232,The Other Side of Heaven,4720371,4720371,0,2001_boxofficemojo_rankings.csv,2001,1.0,0.0
7233,Sweet Bean,4720010,124800,4595210,2015_boxofficemojo_rankings.csv,2015,0.026440621947834857,0.9735593780521652
7234,A Housekeeper,4719781,467288,4252493,2002_boxofficemojo_rankings.csv,2002,0.09900628863923983,0.9009937113607601
7235,Your Friends and Neighbors,4714658,4714658,0,1998_boxofficemojo_rankings.csv,1998,1.0,0.0
7236,King Kong Lives,4711220,4711220,0,1986_boxofficemojo_rankings.csv,1986,1.0,0.0
7237,Girl in Progress,4709246,2609412,2099834,2012_boxofficemojo_rankings.csv,2012,0.5541039903203188,0.4458960096796812
7238,Held Up,4705631,4705631,0,2000_boxofficemojo_rankings.csv,2000,1.0,0.0
7239,"Jeff, Who Lives at Home",4704757,4269426,435331,2012_boxofficemojo_rankings.csv,2012,0.9074700351155225,0.09252996488447757
7240,The Great Santini,4702575,4702575,0,1979_boxofficemojo_rankings.csv,1979,1.0,0.0
7241,Unlocked,4699125,0,4699125,2017_boxofficemojo_rankings.csv,2017,0.0,1.0
7242,Menteur,4697364,4697364,0,2019_boxofficemojo_rankings.csv,2019,1.0,0.0
7243,True Identity,4693236,4693236,0,1991_boxofficemojo_rankings.csv,1991,1.0,0.0
7244,Kickin' It Old Skool,4692108,4502604,189504,2007_boxofficemojo_rankings.csv,2007,0.9596121828397812,0.04038781716021882
7245,Hannah and Her Sisters 1987 Re-release,4691838,4691838,0,1987_boxofficemojo_rankings.csv,1987,1.0,0.0
7246,Jay and Silent Bob Reboot,4691248,4589490,101758,2019_boxofficemojo_rankings.csv,2019,0.9783089702356388,0.02169102976436121
7247,Senior Trip,4686937,4686937,0,1995_boxofficemojo_rankings.csv,1995,1.0,0.0
7248,Keith Lemon: The Film,4682943,0,4682943,2012_boxofficemojo_rankings.csv,2012,0.0,1.0
7249,The Runaways,4681651,3573673,1107978,2010_boxofficemojo_rankings.csv,2010,0.7633360538835552,0.2366639461164448
7250,Avenging Force,4679650,4679650,0,1986_boxofficemojo_rankings.csv,1986,1.0,0.0
7251,The Woodsman,4678405,1576231,3102174,2004_boxofficemojo_rankings.csv,2004,0.33691632084011536,0.6630836791598846
7252,Lovely & Amazing,4677852,4222923,454929,2002_boxofficemojo_rankings.csv,2002,0.9027483126871051,0.0972516873128949
7253,Warriors of the Rainbow: Seediq Bale I,4670432,136166,4534266,2011_boxofficemojo_rankings.csv,2011,0.029154904728299225,0.9708450952717008
7254,Where to Invade Next,4664756,3827261,837495,2016_boxofficemojo_rankings.csv,2016,0.8204632782507809,0.17953672174921903
7255,Don't Come Knocking,4663501,440793,4222708,2005_boxofficemojo_rankings.csv,2005,0.09451976101216661,0.9054802389878334
7256,A Simple Life,4663094,191826,4471268,2012_boxofficemojo_rankings.csv,2012,0.041137064790029966,0.95886293520997
7257,"No Retreat, No Surrender",4662137,4662137,0,1986_boxofficemojo_rankings.csv,1986,1.0,0.0
7258,Half Nelson,4660481,2697938,1962543,2006_boxofficemojo_rankings.csv,2006,0.5788968992685519,0.42110310073144813
7259,C.H.U.D.,4654423,4654423,0,1984_boxofficemojo_rankings.csv,1984,1.0,0.0
7260,The Hitman,4654288,4654288,0,1991_boxofficemojo_rankings.csv,1991,1.0,0.0
7261,Radio Flyer,4651977,4651977,0,1992_boxofficemojo_rankings.csv,1992,1.0,0.0
7262,Tubelight,4650456,930058,3720398,2017_boxofficemojo_rankings.csv,2017,0.19999286091514468,0.8000071390848553
7263,The SpongeBob Movie: Sponge on the Run,4649790,4649790,0,2020_boxofficemojo_rankings.csv,2020,1.0,0.0
7264,Blood and Bones,4649617,0,4649617,2004_boxofficemojo_rankings.csv,2004,0.0,1.0
7265,Rize,4646889,3336391,1310498,2005_boxofficemojo_rankings.csv,2005,0.717983795179958,0.28201620482004197
7266,Gemma Bovery,4644525,191533,4452992,2014_boxofficemojo_rankings.csv,2014,0.04123844741927323,0.9587615525807268
7267,Everybody Wants Some!!,4644472,3400278,1244194,2016_boxofficemojo_rankings.csv,2016,0.7321129290907556,0.26788707090924435
7268,Blade Runner The Final Cut,4642280,3740330,901950,1992_boxofficemojo_rankings.csv,1992,0.805709694374316,0.19429030562568392
7269,Fire with Fire,4636169,4636169,0,1986_boxofficemojo_rankings.csv,1986,1.0,0.0
7270,Housefull 4,4634173,2109160,2525013,2019_boxofficemojo_rankings.csv,2019,0.4551319081096023,0.5448680918903978
7271,Dear White People,4633961,4404154,229807,2014_boxofficemojo_rankings.csv,2014,0.9504080850054629,0.04959191499453707
7272,Killer Joe,4633668,1987762,2645906,2012_boxofficemojo_rankings.csv,2012,0.428982395803929,0.5710176041960711
7273,Rogue,4631926,10452,4621474,2007_boxofficemojo_rankings.csv,2007,0.0022565127335799407,0.99774348726642
7274,Hamlet 2018 Re-release,4630718,235229,4395489,2018_boxofficemojo_rankings.csv,2018,0.050797522112121705,0.9492024778878783
7275,Black Beauty,4630377,4630377,0,1994_boxofficemojo_rankings.csv,1994,1.0,0.0
7276,Let's Go to Prison,4630045,4630045,0,2006_boxofficemojo_rankings.csv,2006,1.0,0.0
7277,Bottle Shock,4628553,4078607,549946,2008_boxofficemojo_rankings.csv,2008,0.8811840331092676,0.11881596689073237
7278,Atlas Shrugged: Part I,4627375,4627375,0,2011_boxofficemojo_rankings.csv,2011,1.0,0.0
7279,Heneral Luna,4625639,206040,4419599,2015_boxofficemojo_rankings.csv,2015,0.044543035027160574,0.9554569649728394
7280,Bad Samaritan,4623836,3435047,1188789,2018_boxofficemojo_rankings.csv,2018,0.742899834682718,0.257100165317282
7281,Joe's Apartment,4619014,4619014,0,1996_boxofficemojo_rankings.csv,1996,1.0,0.0
7282,Leonard Part 6,4615255,4615255,0,1987_boxofficemojo_rankings.csv,1987,1.0,0.0
7283,Little Voice,4611784,4611784,0,1998_boxofficemojo_rankings.csv,1998,1.0,0.0
7284,The January Man,4611062,4611062,0,1989_boxofficemojo_rankings.csv,1989,1.0,0.0
7285,Longtime Companion,4609953,4609953,0,1990_boxofficemojo_rankings.csv,1990,1.0,0.0
7286,The Last Black Man in San Francisco,4607017,4515719,91298,2019_boxofficemojo_rankings.csv,2019,0.9801828384831226,0.019817161516877405
7287,"Food, Inc.",4606199,4417674,188525,2009_boxofficemojo_rankings.csv,2009,0.9590714600042247,0.04092853999577526
7288,Whitney,4605123,3026351,1578772,2018_boxofficemojo_rankings.csv,2018,0.6571705033720054,0.3428294966279945
7289,A Hidden Life,4604834,1730597,2874237,2019_boxofficemojo_rankings.csv,2019,0.37582179943945865,0.6241782005605414
7290,Dutch,4603929,4603929,0,1991_boxofficemojo_rankings.csv,1991,1.0,0.0
7291,Les Boys,4602341,4602341,0,1997_boxofficemojo_rankings.csv,1997,1.0,0.0
7292,Eliminators,4601256,4601256,0,1986_boxofficemojo_rankings.csv,1986,1.0,0.0
7293,River's Edge,4600000,4600000,0,1987_boxofficemojo_rankings.csv,1987,1.0,0.0
7294,The Guilty,4598051,207140,4390911,2018_boxofficemojo_rankings.csv,2018,0.04504952206924195,0.954950477930758
7295,The Book of Henry,4596705,4504974,91731,2017_boxofficemojo_rankings.csv,2017,0.9800441838229775,0.019955816177022453
7296,Sunset,4594452,4594452,0,1988_boxofficemojo_rankings.csv,1988,1.0,0.0
7297,Miss March,4591629,4543320,48309,2009_boxofficemojo_rankings.csv,2009,0.9894788973586498,0.010521102641350161
7298,Tortilla Soup,4574762,4467615,107147,2001_boxofficemojo_rankings.csv,2001,0.9765786722894,0.023421327710600025
7299,Labyrinth of Lies,4574756,794452,3780304,2014_boxofficemojo_rankings.csv,2014,0.17365997224770022,0.8263400277522998
7300,The Broken Hearts Gallery,4573894,3947336,626558,2020_boxofficemojo_rankings.csv,2020,0.8630143155919223,0.13698568440807768
7301,Made in Heaven,4572845,4572845,0,1987_boxofficemojo_rankings.csv,1987,1.0,0.0
7302,Find a Boyfriend for My Wife... PLEASE!,4570757,1741889,2828868,2016_boxofficemojo_rankings.csv,2016,0.38109420387038734,0.6189057961296127
7303,Welcome to the Dollhouse,4569019,4569019,0,1996_boxofficemojo_rankings.csv,1996,1.0,0.0
7304,Graffiti Bridge,4562778,4562778,0,1990_boxofficemojo_rankings.csv,1990,1.0,0.0
7305,Making the Grade,4561346,4561346,0,1984_boxofficemojo_rankings.csv,1984,1.0,0.0
7306,The Mighty Quinn,4557214,4557214,0,1989_boxofficemojo_rankings.csv,1989,1.0,0.0
7307,Mumford,4555459,4555459,0,1999_boxofficemojo_rankings.csv,1999,1.0,0.0
7308,Swingers,4555020,4555020,0,1996_boxofficemojo_rankings.csv,1996,1.0,0.0
7309,The Beach Bum,4554416,3502600,1051816,2019_boxofficemojo_rankings.csv,2019,0.7690557911266779,0.23094420887332207
7310,Dangerous Beauty,4553271,4553271,0,1998_boxofficemojo_rankings.csv,1998,1.0,0.0
7311,The Iceman,4552970,1969193,2583777,2013_boxofficemojo_rankings.csv,2013,0.432507352343635,0.567492647656365
7312,Death Before Dishonor,4546244,4546244,0,1987_boxofficemojo_rankings.csv,1987,1.0,0.0
7313,Paranoid Park,4545747,486767,4058980,2007_boxofficemojo_rankings.csv,2007,0.10708185035374825,0.8929181496462517
7314,Au Revoir les Enfants,4542825,4542825,0,1988_boxofficemojo_rankings.csv,1988,1.0,0.0
7315,The Keys to the House,4537451,0,4537451,2004_boxofficemojo_rankings.csv,2004,0.0,1.0
7316,Mediterraneo,4532791,4532791,0,1992_boxofficemojo_rankings.csv,1992,1.0,0.0
7317,Colossal,4531320,3029287,1502033,2017_boxofficemojo_rankings.csv,2017,0.6685219759363717,0.33147802406362825
7318,McHale's Navy,4529843,4529843,0,1997_boxofficemojo_rankings.csv,1997,1.0,0.0
7319,Cezanne et Moi,4529583,257597,4271986,2016_boxofficemojo_rankings.csv,2016,0.05686991495685144,0.9431300850431485
7320,Sweet and Lowdown,4525794,4197015,328779,1999_boxofficemojo_rankings.csv,1999,0.9273544045531016,0.07264559544689837
7321,"Juliet, Naked",4511157,3444895,1066262,2018_boxofficemojo_rankings.csv,2018,0.7636389068258985,0.23636109317410145
7322,Maps to the Stars,4510934,350741,4160193,2014_boxofficemojo_rankings.csv,2014,0.07775352066778188,0.9222464793322181
7323,Beyond a Reasonable Doubt,4508114,32917,4475197,2009_boxofficemojo_rankings.csv,2009,0.007301723070889512,0.9926982769291105
7324,Day Watch 2007 Re-release,4506717,450897,4055820,2007_boxofficemojo_rankings.csv,2007,0.10004999204520719,0.8999500079547929
7325,Simon and the Oaks,4505573,150664,4354909,2011_boxofficemojo_rankings.csv,2011,0.03343947595566646,0.9665605240443336
7326,Luck by Chance,4504365,356019,4148346,2009_boxofficemojo_rankings.csv,2009,0.07903866582748068,0.9209613341725194
7327,"Blood In, Blood Out",4496583,4496583,0,1993_boxofficemojo_rankings.csv,1993,1.0,0.0
7328,Coast to Coast,4495445,4495445,0,1980_boxofficemojo_rankings.csv,1980,1.0,0.0
7329,Curse of the Pink Panther,4491986,4491986,0,1983_boxofficemojo_rankings.csv,1983,1.0,0.0
7330,This Is Spinal Tap,4491645,4491645,0,1984_boxofficemojo_rankings.csv,1984,1.0,0.0
7331,Barfi!,4490134,2804874,1685260,2012_boxofficemojo_rankings.csv,2012,0.6246748983437911,0.3753251016562089
7332,Flawless,4488529,4488529,0,1999_boxofficemojo_rankings.csv,1999,1.0,0.0
7333,Honkytonk Man,4484991,4484991,0,1982_boxofficemojo_rankings.csv,1982,1.0,0.0
7334,Rundskop,4483147,151840,4331307,2011_boxofficemojo_rankings.csv,2011,0.03386906563625953,0.9661309343637404
7335,Woman at War,4481653,847495,3634158,2018_boxofficemojo_rankings.csv,2018,0.189103217049602,0.810896782950398
7336,Bob Roberts,4479470,4479470,0,1992_boxofficemojo_rankings.csv,1992,1.0,0.0
7337,The Wall,4476705,1803064,2673641,2017_boxofficemojo_rankings.csv,2017,0.4027658735610231,0.5972341264389769
7338,"Synecdoche, New York",4471324,3083538,1387786,2008_boxofficemojo_rankings.csv,2008,0.6896252653576435,0.3103747346423565
7339,Joy of Sex,4463841,4463841,0,1984_boxofficemojo_rankings.csv,1984,1.0,0.0
7340,Batman: The Killing Joke,4462034,3775000,687034,2016_boxofficemojo_rankings.csv,2016,0.8460267223423219,0.1539732776576781
7341,All Night Long,4454295,4454295,0,1981_boxofficemojo_rankings.csv,1981,1.0,0.0
7342,Flypaper,4453634,5043,4448591,2011_boxofficemojo_rankings.csv,2011,0.0011323337301628288,0.9988676662698371
7343,Buck,4448728,4038912,409816,2011_boxofficemojo_rankings.csv,2011,0.9078801850776221,0.09211981492237781
7344,In Harm's Way,4447734,0,4447734,2017_boxofficemojo_rankings.csv,2017,0.0,1.0
7345,Mental,4446852,17669,4429183,2012_boxofficemojo_rankings.csv,2012,0.003973372624049553,0.9960266273759505
7346,Walk on Water,4444265,2713932,1730333,2004_boxofficemojo_rankings.csv,2004,0.6106593553714731,0.38934064462852686
7347,Leviathan,4439481,1092800,3346681,2014_boxofficemojo_rankings.csv,2014,0.24615489963804327,0.7538451003619567
7348,The Return,4429093,504256,3924837,2003_boxofficemojo_rankings.csv,2003,0.11385084937254648,0.8861491506274535
7349,Swift,4428275,0,4428275,2019_boxofficemojo_rankings.csv,2019,0.0,1.0
7350,Samsara,4426444,2672413,1754031,2012_boxofficemojo_rankings.csv,2012,0.6037381247791681,0.3962618752208319
7351,The Assassination of Richard Nixon,4426087,708776,3717311,2004_boxofficemojo_rankings.csv,2004,0.1601360298611392,0.8398639701388608
7352,Safety Not Guaranteed,4424699,4010957,413742,2012_boxofficemojo_rankings.csv,2012,0.906492622436012,0.09350737756398797
7353,I'm Screwed by Getting Married,4423137,223137,4200000,2006_boxofficemojo_rankings.csv,2006,0.050447680006294175,0.9495523199937058
7354,Ed,4422380,4422380,0,1996_boxofficemojo_rankings.csv,1996,1.0,0.0
7355,Don't Think Twice,4417667,4417667,0,2016_boxofficemojo_rankings.csv,2016,1.0,0.0
7356,Wagons East,4412297,4412297,0,1994_boxofficemojo_rankings.csv,1994,1.0,0.0
7357,Laurel Canyon,4412203,3663356,748847,2003_boxofficemojo_rankings.csv,2003,0.8302782079609664,0.16972179203903356
7358,The Commune,4410339,38737,4371602,2016_boxofficemojo_rankings.csv,2016,0.008783225053675013,0.991216774946325
7359,Keeping Up with the Steins,4409374,4339241,70133,2006_boxofficemojo_rankings.csv,2006,0.9840945676188956,0.015905432381104437
7360,Run,4409328,4409328,0,1991_boxofficemojo_rankings.csv,1991,1.0,0.0
7361,Thérèse,4408087,101944,4306143,2012_boxofficemojo_rankings.csv,2012,0.02312658529652432,0.9768734147034757
7362,The Tao of Steve,4406030,4342203,63827,2000_boxofficemojo_rankings.csv,2000,0.9855137164295296,0.014486283570470469
7363,On the Line,4403019,4365455,37564,2001_boxofficemojo_rankings.csv,2001,0.9914685809895437,0.008531419010456235
7364,The Eagle Huntress,4400140,3169351,1230789,2016_boxofficemojo_rankings.csv,2016,0.7202841273232216,0.27971587267677844
7365,Simply Irresistible,4398989,4398989,0,1999_boxofficemojo_rankings.csv,1999,1.0,0.0
7366,Babette's Feast,4398938,4398938,0,1988_boxofficemojo_rankings.csv,1988,1.0,0.0
7367,360,4396975,100343,4296632,2012_boxofficemojo_rankings.csv,2012,0.02282091665292616,0.9771790833470738
7368,The Company of Wolves,4389334,4389334,0,1985_boxofficemojo_rankings.csv,1985,1.0,0.0
7369,Kabali,4388789,3903095,485694,2016_boxofficemojo_rankings.csv,2016,0.8893330255794936,0.11066697442050644
7370,White Elephant,4387907,8884,4379023,2012_boxofficemojo_rankings.csv,2012,0.0020246554906473632,0.9979753445093527
7371,The Lost City,4386236,2484186,1902050,2006_boxofficemojo_rankings.csv,2006,0.5663594024580528,0.4336405975419471
7372,Mrs. Soffel,4385312,4385312,0,1984_boxofficemojo_rankings.csv,1984,1.0,0.0
7373,Clown,4381603,55007,4326596,2014_boxofficemojo_rankings.csv,2014,0.012554081234653163,0.9874459187653468
7374,Brian Banks,4376819,4376819,0,2019_boxofficemojo_rankings.csv,2019,1.0,0.0
7375,Seven Days in Utopia,4373074,4373074,0,2011_boxofficemojo_rankings.csv,2011,1.0,0.0
7376,There Be Dragons,4372642,1069334,3303308,2011_boxofficemojo_rankings.csv,2011,0.24455100600506513,0.7554489939949349
7377,Mark Felt: The Man Who Brought Down the White House,4372130,768946,3603184,2017_boxofficemojo_rankings.csv,2017,0.17587445935962562,0.8241255406403744
7378,The Dead,4370078,4370078,0,1987_boxofficemojo_rankings.csv,1987,1.0,0.0
7379,A Life Less Ordinary,4366722,4366722,0,1997_boxofficemojo_rankings.csv,1997,1.0,0.0
7380,Demolition,4366460,1978592,2387868,2016_boxofficemojo_rankings.csv,2016,0.4531341177979416,0.5468658822020585
7381,King of Devil's Island,4360391,7615,4352776,2010_boxofficemojo_rankings.csv,2010,0.0017464030175275566,0.9982535969824724
7382,Bogus,4357406,4357406,0,1996_boxofficemojo_rankings.csv,1996,1.0,0.0
7383,Meet the Deedles,4356216,4356216,0,1998_boxofficemojo_rankings.csv,1998,1.0,0.0
7384,Brainscan,4352094,4352094,0,1994_boxofficemojo_rankings.csv,1994,1.0,0.0
7385,The Mean Season,4349446,4349446,0,1985_boxofficemojo_rankings.csv,1985,1.0,0.0
7386,Mr. Nanny,4348572,4348572,0,1993_boxofficemojo_rankings.csv,1993,1.0,0.0
7387,Dark Angel,4348368,4348368,0,1990_boxofficemojo_rankings.csv,1990,1.0,0.0
7388,Staying Together,4348025,4348025,0,1989_boxofficemojo_rankings.csv,1989,1.0,0.0
7389,Lisa,4347648,4347648,0,1990_boxofficemojo_rankings.csv,1990,1.0,0.0
7390,Blinky Bill the Movie,4344536,0,4344536,2015_boxofficemojo_rankings.csv,2015,0.0,1.0
7391,PCU,4330020,4330020,0,1994_boxofficemojo_rankings.csv,1994,1.0,0.0
7392,Standing Tall,4323120,26144,4296976,2015_boxofficemojo_rankings.csv,2015,0.006047484224356484,0.9939525157756435
7393,Storm Boy,4322950,71760,4251190,2018_boxofficemojo_rankings.csv,2018,0.01659977561618802,0.983400224383812
7394,Mortuary,4319001,4319001,0,1983_boxofficemojo_rankings.csv,1983,1.0,0.0
7395,Please Give,4313829,4033574,280255,2010_boxofficemojo_rankings.csv,2010,0.9350333543587379,0.06496664564126209
7396,Hear My Song,4313473,4313473,0,1991_boxofficemojo_rankings.csv,1991,1.0,0.0
7397,Melvin and Howard,4309490,4309490,0,1980_boxofficemojo_rankings.csv,1980,1.0,0.0
7398,Trenchcoat,4304286,4304286,0,1983_boxofficemojo_rankings.csv,1983,1.0,0.0
7399,Yellowbeard,4300000,4300000,0,1983_boxofficemojo_rankings.csv,1983,1.0,0.0
7400,Soul Survivors,4299141,3111545,1187596,2001_boxofficemojo_rankings.csv,2001,0.7237596999028411,0.27624030009715894
7401,Listen to Me,4299023,4299023,0,1989_boxofficemojo_rankings.csv,1989,1.0,0.0
7402,The Grand Seduction,4292517,3430018,862499,2014_boxofficemojo_rankings.csv,2014,0.7990691708384614,0.20093082916153857
7403,The Color Purple 1987 Re-release,4292009,4292009,0,1987_boxofficemojo_rankings.csv,1987,1.0,0.0
7404,High-Rise,4286576,346472,3940104,2016_boxofficemojo_rankings.csv,2016,0.08082721500796906,0.9191727849920309
7405,Caterina in the Big City,4285937,296464,3989473,2003_boxofficemojo_rankings.csv,2003,0.0691713387294307,0.9308286612705693
7406,The Other Side of Hope,4282973,183943,4099030,2017_boxofficemojo_rankings.csv,2017,0.042947503988467826,0.9570524960115322
7407,Mohabbatein,4279351,1070000,3209351,2000_boxofficemojo_rankings.csv,2000,0.25003791462770875,0.7499620853722913
7408,Best Seller,4278150,4278150,0,1987_boxofficemojo_rankings.csv,1987,1.0,0.0
7409,Wake Up Sid,4278081,718766,3559315,2009_boxofficemojo_rankings.csv,2009,0.16801131161378197,0.831988688386218
7410,Clueless 25th Anniversary,4263607,0,4263607,2020_boxofficemojo_rankings.csv,2020,0.0,1.0
7411,Lambada,4263112,4263112,0,1990_boxofficemojo_rankings.csv,1990,1.0,0.0
7412,Four Rooms,4257354,4257354,0,1995_boxofficemojo_rankings.csv,1995,1.0,0.0
7413,Linda Ronstadt: The Sound of My Voice,4252657,4252657,0,2019_boxofficemojo_rankings.csv,2019,1.0,0.0
7414,Antonia's Line,4249321,4228275,21046,1996_boxofficemojo_rankings.csv,1996,0.9950472087187576,0.004952791281242344
7415,Men with Brooms,4245870,4245870,0,2002_boxofficemojo_rankings.csv,2002,1.0,0.0
7416,I Hate Valentine's Day,4243957,11004,4232953,2009_boxofficemojo_rankings.csv,2009,0.002592863217040135,0.9974071367829599
7417,Santa vs. the Snowman 3D 2004 Re-release,4243755,1926034,2317721,2004_boxofficemojo_rankings.csv,2004,0.4538513651235757,0.5461486348764243
7418,Heaven,4243537,784399,3459138,2002_boxofficemojo_rankings.csv,2002,0.18484556632827756,0.8151544336717225
7419,"Don't Worry, He Won't Get Far on Foot",4241656,1441705,2799951,2018_boxofficemojo_rankings.csv,2018,0.3398920138738266,0.6601079861261734
7420,Until September,4239154,4239154,0,1984_boxofficemojo_rankings.csv,1984,1.0,0.0
7421,"Good Morning, Night",4234655,10093,4224562,2003_boxofficemojo_rankings.csv,2003,0.002383429110517858,0.9976165708894822
7422,Heroes,4229775,655538,3574237,2008_boxofficemojo_rankings.csv,2008,0.1549817661695953,0.8450182338304046
7423,Branded,4227984,353513,3874471,2012_boxofficemojo_rankings.csv,2012,0.08361266267800446,0.9163873373219955
7424,Roadie,4226370,4226370,0,1980_boxofficemojo_rankings.csv,1980,1.0,0.0
7425,Left Behind: The Movie,4224065,4224065,0,2001_boxofficemojo_rankings.csv,2001,1.0,0.0
7426,Exotica,4221036,4221036,0,1995_boxofficemojo_rankings.csv,1995,1.0,0.0
7427,The Keep,4218594,4218594,0,1983_boxofficemojo_rankings.csv,1983,1.0,0.0
7428,Detroit Rock City,4217115,4217115,0,1999_boxofficemojo_rankings.csv,1999,1.0,0.0
7429,Dabangg 2,4216988,2519190,1697798,2012_boxofficemojo_rankings.csv,2012,0.5973908391487004,0.40260916085129955
7430,Hot Pursuit,4215849,4215849,0,1987_boxofficemojo_rankings.csv,1987,1.0,0.0
7431,China Cry: A True Story,4212828,4212828,0,1990_boxofficemojo_rankings.csv,1990,1.0,0.0
7432,That's Dancing!,4210938,4210938,0,1985_boxofficemojo_rankings.csv,1985,1.0,0.0
7433,The Rabbi's Cat,4208573,23392,4185181,2011_boxofficemojo_rankings.csv,2011,0.005558178508487319,0.9944418214915127
7434,Diplomacy,4207242,230880,3976362,2014_boxofficemojo_rankings.csv,2014,0.05487680528003856,0.9451231947199614
7435,Popcorn,4205000,4205000,0,1991_boxofficemojo_rankings.csv,1991,1.0,0.0
7436,Gloria,4197729,4197729,0,1999_boxofficemojo_rankings.csv,1999,1.0,0.0
7437,Let the Sunshine In,4192590,892421,3300169,2017_boxofficemojo_rankings.csv,2017,0.2128567305651161,0.7871432694348839
7438,Red Scorpion,4192440,4192440,0,1989_boxofficemojo_rankings.csv,1989,1.0,0.0
7439,Sheep & Wolves,4190750,0,4190750,2016_boxofficemojo_rankings.csv,2016,0.0,1.0
7440,Song of the Sea,4190670,857522,3333148,2014_boxofficemojo_rankings.csv,2014,0.20462646784404404,0.795373532155956
7441,To Gillian on Her 37th Birthday,4189233,4189233,0,1996_boxofficemojo_rankings.csv,1996,1.0,0.0
7442,Evelyn,4186916,1487645,2699271,2002_boxofficemojo_rankings.csv,2002,0.3553080596792484,0.6446919403207516
7443,Tanu Weds Manu Returns,4180081,3043479,1136602,2015_boxofficemojo_rankings.csv,2015,0.7280909149846618,0.2719090850153382
7444,Changing Times,4178714,545255,3633459,2004_boxofficemojo_rankings.csv,2004,0.13048392400149902,0.869516075998501
7445,East Is East,4177818,4177818,0,2000_boxofficemojo_rankings.csv,2000,1.0,0.0
7446,Nitro Circus: The Movie,4174269,3377618,796651,2012_boxofficemojo_rankings.csv,2012,0.8091519736749117,0.1908480263250883
7447,Welcome to Collinwood,4172703,336620,3836083,2002_boxofficemojo_rankings.csv,2002,0.08067192896307261,0.9193280710369274
7448,Krrish 3,4170204,2191534,1978670,2013_boxofficemojo_rankings.csv,2013,0.5255220128319862,0.47447798716801387
7449,The Guardians,4167608,177331,3990277,2017_boxofficemojo_rankings.csv,2017,0.04254982714305184,0.9574501728569481
7450,Playing God,4166918,4166918,0,1997_boxofficemojo_rankings.csv,1997,1.0,0.0
7451,Priest,4165845,4165845,0,1995_boxofficemojo_rankings.csv,1995,1.0,0.0
7452,It's a Wonderful Life 2007 Re-release,4163338,0,4163338,2007_boxofficemojo_rankings.csv,2007,0.0,1.0
7453,Good Hair,4163135,4157223,5912,2009_boxofficemojo_rankings.csv,2009,0.9985799163370873,0.0014200836629126848
7454,Witless Protection,4161625,4161625,0,2008_boxofficemojo_rankings.csv,2008,1.0,0.0
7455,Twin Peaks: Fire Walk with Me,4160851,4160851,0,1992_boxofficemojo_rankings.csv,1992,1.0,0.0
7456,A Quiet Passion,4159246,1865396,2293850,2016_boxofficemojo_rankings.csv,2016,0.44849378949934676,0.5515062105006533
7457,The Abandoned,4153578,1331137,2822441,2007_boxofficemojo_rankings.csv,2007,0.3204795961457808,0.6795204038542192
7458,Idle Hands,4152230,4152230,0,1999_boxofficemojo_rankings.csv,1999,1.0,0.0
7459,King's Ransom,4143652,4008527,135125,2005_boxofficemojo_rankings.csv,2005,0.9673898773352588,0.03261012266474115
7460,Edison,4143414,0,4143414,2005_boxofficemojo_rankings.csv,2005,0.0,1.0
7461,Savage,4140502,74491,4066011,2019_boxofficemojo_rankings.csv,2019,0.01799081367428394,0.9820091863257161
7462,The Last Princess,4135255,29259,4105996,2016_boxofficemojo_rankings.csv,2016,0.007075500785320373,0.9929244992146796
7463,Heart Condition,4134992,4134992,0,1990_boxofficemojo_rankings.csv,1990,1.0,0.0
7464,Ghost Stories,4131358,148747,3982611,2018_boxofficemojo_rankings.csv,2018,0.03600438403062625,0.9639956159693738
7465,Military Wives,4127775,0,4127775,2020_boxofficemojo_rankings.csv,2020,0.0,1.0
7466,Apartment 143,4126744,383,4126361,2012_boxofficemojo_rankings.csv,2012,9.280924622414184e-05,0.9999071907537759
7467,Arctic 2019 Re-release,4124015,2410795,1713220,2019_boxofficemojo_rankings.csv,2019,0.5845747408775186,0.41542525912248135
7468,My Science Project,4122748,4122748,0,1985_boxofficemojo_rankings.csv,1985,1.0,0.0
7469,Carancho,4120012,85526,4034486,2010_boxofficemojo_rankings.csv,2010,0.02075867740191048,0.9792413225980895
7470,Godzilla 1985,4116395,4116395,0,1985_boxofficemojo_rankings.csv,1985,1.0,0.0
7471,The Fall of the American Empire,4110928,2178460,1932468,2018_boxofficemojo_rankings.csv,2018,0.5299192785667859,0.4700807214332141
7472,Kama Sutra: A Tale of Love,4109095,4109095,0,1997_boxofficemojo_rankings.csv,1997,1.0,0.0
7473,Naam Hai Akira,4108063,219401,3888662,2016_boxofficemojo_rankings.csv,2016,0.05340740879582421,0.9465925912041758
7474,Kissing a Fool,4106588,4106588,0,1998_boxofficemojo_rankings.csv,1998,1.0,0.0
7475,This Boy's Life,4104962,4104962,0,1993_boxofficemojo_rankings.csv,1993,1.0,0.0
7476,Life Stinks,4102526,4102526,0,1991_boxofficemojo_rankings.csv,1991,1.0,0.0
7477,The Hero,4101699,4077333,24366,2017_boxofficemojo_rankings.csv,2017,0.9940595348415376,0.005940465158462384
7478,Pete's Dragon 1984 Re-release,4100000,4100000,0,1984_boxofficemojo_rankings.csv,1984,1.0,0.0
7479,Man Trouble,4096030,4096030,0,1992_boxofficemojo_rankings.csv,1992,1.0,0.0
7480,Japanese Story,4095954,647054,3448900,2003_boxofficemojo_rankings.csv,2003,0.15797394209016996,0.8420260579098301
7481,Force Majeure,4094339,1359497,2734842,2014_boxofficemojo_rankings.csv,2014,0.3320430965779824,0.6679569034220175
7482,The White Countess,4092682,1669971,2422711,2005_boxofficemojo_rankings.csv,2005,0.4080382986022369,0.5919617013977632
7483,The Damned United,4091378,449865,3641513,2009_boxofficemojo_rankings.csv,2009,0.10995439678269767,0.8900456032173023
7484,Tie Me Up! Tie Me Down!,4087361,4087361,0,1990_boxofficemojo_rankings.csv,1990,1.0,0.0
7485,2001: A Space Odyssey 2018 Re-release,4084582,3236321,848261,2018_boxofficemojo_rankings.csv,2018,0.7923261180703436,0.20767388192965644
7486,Tere Naal Love Ho Gaya,4083976,177743,3906233,2012_boxofficemojo_rankings.csv,2012,0.043522048121732354,0.9564779518782677
7487,American Animals,4080073,2856954,1223119,2018_boxofficemojo_rankings.csv,2018,0.700221295060162,0.2997787049398381
7488,That's Life!,4079895,4079895,0,1986_boxofficemojo_rankings.csv,1986,1.0,0.0
7489,Katti Batti,4079135,364932,3714203,2015_boxofficemojo_rankings.csv,2015,0.08946308469810389,0.9105369153018961
7490,Capturing the Friedmans,4076990,3119113,957877,2003_boxofficemojo_rankings.csv,2003,0.7650528944147521,0.23494710558524795
7491,Impromptu,4076211,4076211,0,1991_boxofficemojo_rankings.csv,1991,1.0,0.0
7492,Meet Wally Sparks,4073582,4073582,0,1997_boxofficemojo_rankings.csv,1997,1.0,0.0
7493,Le Dîner de Cons,4071548,4071548,0,1999_boxofficemojo_rankings.csv,1999,1.0,0.0
7494,Bossa Nova,4069261,1823297,2245964,2000_boxofficemojo_rankings.csv,2000,0.4480658773177734,0.5519341226822265
7495,The Visual Bible: The Gospel of John,4069090,4069090,0,2003_boxofficemojo_rankings.csv,2003,1.0,0.0
7496,Tank Girl,4064495,4064495,0,1995_boxofficemojo_rankings.csv,1995,1.0,0.0
7497,Grizzly Man,4061305,3178403,882902,2005_boxofficemojo_rankings.csv,2005,0.7826063297388401,0.2173936702611599
7498,Gloria,4059673,4059673,0,1980_boxofficemojo_rankings.csv,1980,1.0,0.0
7499,From Prada to Nada,4058694,3033623,1025071,2011_boxofficemojo_rankings.csv,2011,0.7474382153471043,0.25256178465289575
7500,Peter's Friends,4058564,4058564,0,1992_boxofficemojo_rankings.csv,1992,1.0,0.0
7501,2 Days in New York,4058113,633210,3424903,2012_boxofficemojo_rankings.csv,2012,0.15603557614093053,0.8439644238590694
7502,The Killer Inside Me,4050140,217277,3832863,2010_boxofficemojo_rankings.csv,2010,0.053646787518456154,0.9463532124815438
7503,Dev.D,4047969,18613,4029356,2009_boxofficemojo_rankings.csv,2009,0.004598108335315809,0.9954018916646842
7504,Film Stars Don't Die in Liverpool,4047917,1026124,3021793,2017_boxofficemojo_rankings.csv,2017,0.2534943280704619,0.7465056719295381
7505,Love in the Buff,4045381,256451,3788930,2012_boxofficemojo_rankings.csv,2012,0.06339353450268342,0.9366064654973165
7506,Step Into Liquid,4041588,3681803,359785,2003_boxofficemojo_rankings.csv,2003,0.9109792982362378,0.08902070176376216
7507,Inland Empire,4037577,861355,3176222,2006_boxofficemojo_rankings.csv,2006,0.21333463114139992,0.7866653688586001
7508,Belle de Jour,4037017,4037017,0,1995_boxofficemojo_rankings.csv,1995,1.0,0.0
7509,Metropolis,4035192,722932,3312260,2002_boxofficemojo_rankings.csv,2002,0.17915677866133756,0.8208432213386625
7510,Schultze Gets the Blues,4034232,595071,3439161,2004_boxofficemojo_rankings.csv,2004,0.14750539879709446,0.8524946012029055
7511,Junglee,4033587,295784,3737803,2019_boxofficemojo_rankings.csv,2019,0.07333026410487738,0.9266697358951226
7512,Passed Away,4030793,4030793,0,1992_boxofficemojo_rankings.csv,1992,1.0,0.0
7513,Rare Exports,4028971,236347,3792624,2010_boxofficemojo_rankings.csv,2010,0.05866187669258478,0.9413381233074152
7514,Jaws 2 1980 Re-release,4028735,4028735,0,1980_boxofficemojo_rankings.csv,1980,1.0,0.0
7515,Vulgaria,4028543,59059,3969484,2012_boxofficemojo_rankings.csv,2012,0.014660138913746235,0.9853398610862537
7516,Jeepers Creepers III,4017852,2335162,1682690,2017_boxofficemojo_rankings.csv,2017,0.5811966194872284,0.4188033805127715
7517,Mountains of the Moon,4011793,4011793,0,1990_boxofficemojo_rankings.csv,1990,1.0,0.0
7518,Short Time,4010647,4010647,0,1990_boxofficemojo_rankings.csv,1990,1.0,0.0
7519,A Perfect Day,4009440,14044,3995396,2015_boxofficemojo_rankings.csv,2015,0.0035027335488247734,0.9964972664511752
7520,Tai-Pan,4007250,4007250,0,1986_boxofficemojo_rankings.csv,1986,1.0,0.0
7521,Penguin Highway,4006647,104567,3902080,2018_boxofficemojo_rankings.csv,2018,0.026098381015347744,0.9739016189846522
7522,Restoration,4005941,4005941,0,1995_boxofficemojo_rankings.csv,1995,1.0,0.0
7523,Kagemusha,4000000,4000000,0,1980_boxofficemojo_rankings.csv,1980,1.0,0.0
7524,American Ninja 2: The Confrontation,4000000,4000000,0,1987_boxofficemojo_rankings.csv,1987,1.0,0.0
7525,Faces Places,3998450,953717,3044733,2017_boxofficemojo_rankings.csv,2017,0.23852167714989558,0.7614783228501044
7526,Ride Your Wave,3995885,332432,3663453,2019_boxofficemojo_rankings.csv,2019,0.08319358540098126,0.9168064145990188
7527,Digimon Adventure: Last Evolution Kizuna,3989892,0,3989892,2020_boxofficemojo_rankings.csv,2020,0.0,1.0
7528,Sleight,3989705,3986245,3460,2017_boxofficemojo_rankings.csv,2017,0.999132767961541,0.0008672320384589838
7529,"Welcome Home, Roxy Carmichael",3989297,3989297,0,1990_boxofficemojo_rankings.csv,1990,1.0,0.0
7530,Fluke,3987768,3987768,0,1995_boxofficemojo_rankings.csv,1995,1.0,0.0
7531,The Invisible Woman,3986888,1234254,2752634,2013_boxofficemojo_rankings.csv,2013,0.3095782976597286,0.6904217023402714
7532,Le petit lieutenant,3984265,216724,3767541,2005_boxofficemojo_rankings.csv,2005,0.054394976237775346,0.9456050237622247
7533,Eden Lake,3983997,7321,3976676,2008_boxofficemojo_rankings.csv,2008,0.0018376017853427098,0.9981623982146572
7534,The Pebble and the Penguin,3983912,3983912,0,1995_boxofficemojo_rankings.csv,1995,1.0,0.0
7535,Choke,3982459,2926565,1055894,2008_boxofficemojo_rankings.csv,2008,0.7348638115295097,0.2651361884704902
7536,The Nile Hilton Incident,3979536,81089,3898447,2017_boxofficemojo_rankings.csv,2017,0.02037649615432553,0.9796235038456744
7537,Entre Nous,3974975,3974975,0,1984_boxofficemojo_rankings.csv,1984,1.0,0.0
7538,Playing by Heart,3970078,3970078,0,1999_boxofficemojo_rankings.csv,1999,1.0,0.0
7539,Ip Man: The Final Fight,3967001,37884,3929117,2013_boxofficemojo_rankings.csv,2013,0.009549783324985298,0.9904502166750146
7540,Bat*21,3966256,3966256,0,1988_boxofficemojo_rankings.csv,1988,1.0,0.0
7541,Memories of Me,3965604,3965604,0,1988_boxofficemojo_rankings.csv,1988,1.0,0.0
7542,Loverboy,3960327,3960327,0,1989_boxofficemojo_rankings.csv,1989,1.0,0.0
7543,The Winslow Boy,3957934,3957934,0,1999_boxofficemojo_rankings.csv,1999,1.0,0.0
7544,Lucifer,3956978,0,3956978,2019_boxofficemojo_rankings.csv,2019,0.0,1.0
7545,Break Ke Baad,3954699,427628,3527071,2010_boxofficemojo_rankings.csv,2010,0.10813161760224987,0.8918683823977501
7546,The Phantom of the Opera,3953745,3953745,0,1989_boxofficemojo_rankings.csv,1989,1.0,0.0
7547,Joysticks,3952448,3952448,0,1983_boxofficemojo_rankings.csv,1983,1.0,0.0
7548,The Devil's Violinist,3952097,11294,3940803,2013_boxofficemojo_rankings.csv,2013,0.002857723380777344,0.9971422766192226
7549,Bully 2012 Re-release,3950244,3863446,86798,2012_boxofficemojo_rankings.csv,2012,0.978027180093179,0.021972819906820946
7550,2:22,3945729,422,3945307,2017_boxofficemojo_rankings.csv,2017,0.00010695108559153454,0.9998930489144084
7551,Breakfast on Pluto,3942254,828699,3113555,2005_boxofficemojo_rankings.csv,2005,0.2102094385597681,0.7897905614402319
7552,Gordy,3941146,3941146,0,1995_boxofficemojo_rankings.csv,1995,1.0,0.0
7553,Manon of the Spring,3940542,3940542,0,1987_boxofficemojo_rankings.csv,1987,1.0,0.0
7554,The Wretched,3935238,1814193,2121045,2020_boxofficemojo_rankings.csv,2020,0.46101226914356896,0.538987730856431
7555,Tristram Shandy: A Cock and Bull Story,3931982,1253413,2678569,2006_boxofficemojo_rankings.csv,2006,0.31877383975816775,0.6812261602418322
7556,Terminator 2: Judgment Day 2017 Re-release,3931111,1037809,2893302,2017_boxofficemojo_rankings.csv,2017,0.2639989051441183,0.7360010948558817
7557,Yanks,3931010,3931010,0,1979_boxofficemojo_rankings.csv,1979,1.0,0.0
7558,Caravans,3930501,3930501,0,1978_boxofficemojo_rankings.csv,1978,1.0,0.0
7559,Welcome to the Punch,3926386,9747,3916639,2013_boxofficemojo_rankings.csv,2013,0.002482435501756577,0.9975175644982435
7560,Loveless,3925992,566356,3359636,2017_boxofficemojo_rankings.csv,2017,0.1442580626756244,0.8557419373243756
7561,Seven Sins Forgiven,3924850,270207,3654643,2011_boxofficemojo_rankings.csv,2011,0.06884517879664191,0.9311548212033581
7562,Indignation,3924527,3401155,523372,2016_boxofficemojo_rankings.csv,2016,0.86664074422217,0.13335925577783003
7563,My Demon Lover,3922273,3922273,0,1987_boxofficemojo_rankings.csv,1987,1.0,0.0
7564,Mrs. Palfrey at the Claremont,3919275,1720953,2198322,2005_boxofficemojo_rankings.csv,2005,0.43909983351512716,0.5609001664848728
7565,Brick,3919254,2075743,1843511,2006_boxofficemojo_rankings.csv,2006,0.5296270667836277,0.4703729332163723
7566,Earth Girls Are Easy,3916303,3916303,0,1989_boxofficemojo_rankings.csv,1989,1.0,0.0
7567,A Private War,3915207,1633208,2281999,2018_boxofficemojo_rankings.csv,2018,0.4171447384518877,0.5828552615481123
7568,Chup Chup Ke,3912699,334618,3578081,2006_boxofficemojo_rankings.csv,2006,0.08552101758913731,0.9144789824108627
7569,Resurrection,3910019,3910019,0,1980_boxofficemojo_rankings.csv,1980,1.0,0.0
7570,The To Do List,3909596,3491669,417927,2013_boxofficemojo_rankings.csv,2013,0.8931022540436403,0.10689774595635969
7571,The Starving Games,3906308,0,3906308,2013_boxofficemojo_rankings.csv,2013,0.0,1.0
7572,Taxi,3906227,321642,3584585,2015_boxofficemojo_rankings.csv,2015,0.08234083682284721,0.9176591631771528
7573,Warlock: The Armageddon,3902679,3902679,0,1993_boxofficemojo_rankings.csv,1993,1.0,0.0
7574,Camping sauvage,3900099,3894585,5514,2004_boxofficemojo_rankings.csv,2004,0.9985861897351836,0.0014138102648163548
7575,The Manhattan Project,3900000,3900000,0,1986_boxofficemojo_rankings.csv,1986,1.0,0.0
7576,The Wall,3889260,38674,3850586,2012_boxofficemojo_rankings.csv,2012,0.009943793935093051,0.990056206064907
7577,Osama,3888902,1270904,2617998,2003_boxofficemojo_rankings.csv,2003,0.32680278392204276,0.6731972160779572
7578,Rules Don't Apply,3885342,3652206,233136,2016_boxofficemojo_rankings.csv,2016,0.9399960157947486,0.06000398420525143
7579,Neruda,3884746,939101,2945645,2016_boxofficemojo_rankings.csv,2016,0.2417406440472556,0.7582593559527444
7580,The Perfect Game,3878993,1037071,2841922,2010_boxofficemojo_rankings.csv,2010,0.26735572866463025,0.7326442713353698
7581,"The Night Is Short, Walk on Girl",3878208,406490,3471718,2017_boxofficemojo_rankings.csv,2017,0.10481387279898345,0.8951861272010165
7582,Django,3876874,56556,3820318,2017_boxofficemojo_rankings.csv,2017,0.014588041808941946,0.9854119581910581
7583,Horns,3875442,173948,3701494,2014_boxofficemojo_rankings.csv,2014,0.044884686701542685,0.9551153132984573
7584,Submarine,3875173,467602,3407571,2011_boxofficemojo_rankings.csv,2011,0.1206660967136177,0.8793339032863823
7585,Trailer Park Boys: The Movie,3868567,3860678,7889,2006_boxofficemojo_rankings.csv,2006,0.9979607436035101,0.0020392563964899664
7586,First Reformed,3862498,3448256,414242,2018_boxofficemojo_rankings.csv,2018,0.8927528247263817,0.10724717527361827
7587,Flashpoint,3854833,3854833,0,1984_boxofficemojo_rankings.csv,1984,1.0,0.0
7588,The Heavenly Kid,3852271,3852271,0,1985_boxofficemojo_rankings.csv,1985,1.0,0.0
7589,Lan Yu,3847964,116325,3731639,2001_boxofficemojo_rankings.csv,2001,0.030230272424586094,0.9697697275754139
7590,Frozen,3843774,246176,3597598,2010_boxofficemojo_rankings.csv,2010,0.06404538872472731,0.9359546112752727
7591,Marley,3842919,1413480,2429439,2012_boxofficemojo_rankings.csv,2012,0.36781415377217164,0.6321858462278284
7592,Feds,3838793,3838793,0,1988_boxofficemojo_rankings.csv,1988,1.0,0.0
7593,North Shore,3832228,3832228,0,1987_boxofficemojo_rankings.csv,1987,1.0,0.0
7594,Gracie,3826568,2956339,870229,2007_boxofficemojo_rankings.csv,2007,0.7725823766884582,0.22741762331154183
7595,To Save a Life,3824868,3777210,47658,2010_boxofficemojo_rankings.csv,2010,0.9875399621634001,0.012460037836599852
7596,Elles,3822241,157508,3664733,2012_boxofficemojo_rankings.csv,2012,0.04120828592440927,0.9587917140755907
7597,Let's Spend the Night Together,3821199,3821199,0,1983_boxofficemojo_rankings.csv,1983,1.0,0.0
7598,The Other Son,3820405,1285918,2534487,2012_boxofficemojo_rankings.csv,2012,0.3365920628833854,0.6634079371166146
7599,The Homesman,3819421,2429989,1389432,2014_boxofficemojo_rankings.csv,2014,0.6362192070473509,0.3637807929526491
7600,Infidel,3819389,3819389,0,2020_boxofficemojo_rankings.csv,2020,1.0,0.0
7601,Benji: Off the Leash!,3817362,3817362,0,2004_boxofficemojo_rankings.csv,2004,1.0,0.0
7602,The Lord of the Rings: The Two Towers 2003 Re-release,3816801,1996877,1819924,2003_boxofficemojo_rankings.csv,2003,0.5231807998373507,0.4768192001626493
7603,Brad's Status,3816527,2133158,1683369,2017_boxofficemojo_rankings.csv,2017,0.558926479493005,0.441073520506995
7604,Green Street Hooligans,3814717,346830,3467887,2005_boxofficemojo_rankings.csv,2005,0.09091893317381079,0.9090810668261892
7605,Critters 2,3813293,3813293,0,1988_boxofficemojo_rankings.csv,1988,1.0,0.0
7606,Sweet 20,3810429,71775,3738654,2015_boxofficemojo_rankings.csv,2015,0.01883646172123926,0.9811635382787607
7607,Better Luck Tomorrow,3809226,3802390,6836,2003_boxofficemojo_rankings.csv,2003,0.998205409707904,0.0017945902920960845
7608,Hide in Plain Sight,3806930,3806930,0,1980_boxofficemojo_rankings.csv,1980,1.0,0.0
7609,Breaking the Waves,3803298,3803298,0,1996_boxofficemojo_rankings.csv,1996,1.0,0.0
7610,Bound,3802260,3802260,0,1996_boxofficemojo_rankings.csv,1996,1.0,0.0
7611,Power,3800000,3800000,0,1986_boxofficemojo_rankings.csv,1986,1.0,0.0
7612,Guyana: Cult of the Damned,3798102,3798102,0,1980_boxofficemojo_rankings.csv,1980,1.0,0.0
7613,Brick Lane,3794592,1095398,2699194,2007_boxofficemojo_rankings.csv,2007,0.28867345949182416,0.7113265405081759
7614,Barb Wire,3793614,3793614,0,1996_boxofficemojo_rankings.csv,1996,1.0,0.0
7615,Jekyll and Hyde... Together Again,3792188,3792188,0,1982_boxofficemojo_rankings.csv,1982,1.0,0.0
7616,Sweet Hearts Dance,3790493,3790493,0,1988_boxofficemojo_rankings.csv,1988,1.0,0.0
7617,Custody,3790303,83882,3706421,2018_boxofficemojo_rankings.csv,2018,0.022130684538940553,0.9778693154610595
7618,The Paperboy,3783865,693286,3090579,2012_boxofficemojo_rankings.csv,2012,0.18322165299237683,0.8167783470076232
7619,La traviata,3783329,3783329,0,1983_boxofficemojo_rankings.csv,1983,1.0,0.0
7620,Jimmy Hollywood,3783003,3783003,0,1994_boxofficemojo_rankings.csv,1994,1.0,0.0
7621,Donnie Darko 2004 Director's Cut,3782231,753147,3029084,2004_boxofficemojo_rankings.csv,2004,0.19912771060255177,0.8008722893974483
7622,Nitro,3780889,3768878,12011,2007_boxofficemojo_rankings.csv,2007,0.9968232339008101,0.0031767660991898995
7623,Citizenfour,3780692,2800870,979822,2014_boxofficemojo_rankings.csv,2014,0.7408352756585302,0.25916472434146975
7624,Paris Is Burning,3779620,3779620,0,1991_boxofficemojo_rankings.csv,1991,1.0,0.0
7625,Cheech & Chong's the Corsican Brothers,3772785,3772785,0,1984_boxofficemojo_rankings.csv,1984,1.0,0.0
7626,The Monster Squad,3769990,3769990,0,1987_boxofficemojo_rankings.csv,1987,1.0,0.0
7627,Green Room,3769214,3220371,548843,2016_boxofficemojo_rankings.csv,2016,0.8543879440116693,0.1456120559883307
7628,A Dry White Season,3766879,3766879,0,1989_boxofficemojo_rankings.csv,1989,1.0,0.0
7629,The Polar Express 2006 IMAX Release,3765011,2940722,824289,2006_boxofficemojo_rankings.csv,2006,0.7810659782932905,0.21893402170670948
7630,The Secret Lives of Dentists,3764286,3707346,56940,2003_boxofficemojo_rankings.csv,2003,0.984873625436537,0.015126374563463031
7631,Before the Fall,3764219,144254,3619965,2005_boxofficemojo_rankings.csv,2005,0.038322424917360015,0.96167757508264
7632,When Time Ran Out...,3763988,3763988,0,1980_boxofficemojo_rankings.csv,1980,1.0,0.0
7633,Kings & Queen,3761583,290973,3470610,2004_boxofficemojo_rankings.csv,2004,0.0773538693682952,0.9226461306317048
7634,Black Sea,3758103,1171559,2586544,2014_boxofficemojo_rankings.csv,2014,0.3117421209583665,0.6882578790416335
7635,Imagine: John Lennon,3754125,3753977,148,1988_boxofficemojo_rankings.csv,1988,0.9999605766989644,3.9423301035527586e-05
7636,"Lock, Stock and Two Smoking Barrels",3753929,3753929,0,1999_boxofficemojo_rankings.csv,1999,1.0,0.0
7637,Mannequin: On the Move,3752428,3752428,0,1991_boxofficemojo_rankings.csv,1991,1.0,0.0
7638,Riding Alone for Thousands of Miles,3752325,252325,3500000,2006_boxofficemojo_rankings.csv,2006,0.06724497478230164,0.9327550252176984
7639,Allan Quatermain and the Lost City of Gold,3751699,3751699,0,1987_boxofficemojo_rankings.csv,1987,1.0,0.0
7640,You Kill Me,3748295,2429367,1318928,2007_boxofficemojo_rankings.csv,2007,0.6481258812340011,0.35187411876599894
7641,The Trip,3741198,2030962,1710236,2011_boxofficemojo_rankings.csv,2011,0.542864077228738,0.457135922771262
7642,Take Shelter,3741098,1730296,2010802,2011_boxofficemojo_rankings.csv,2011,0.46251020422346595,0.5374897957765341
7643,Up at the Villa,3740113,2933161,806952,2000_boxofficemojo_rankings.csv,2000,0.7842439519875469,0.2157560480124531
7644,Exterminator 2,3739406,3739406,0,1984_boxofficemojo_rankings.csv,1984,1.0,0.0
7645,Liberty Heights,3736868,3736868,0,1999_boxofficemojo_rankings.csv,1999,1.0,0.0
7646,White Man's Burden,3734870,3734870,0,1995_boxofficemojo_rankings.csv,1995,1.0,0.0
7647,Like Crazy,3731489,3395391,336098,2011_boxofficemojo_rankings.csv,2011,0.9099292534427945,0.09007074655720544
7648,Born to Be Wild,3730409,3730409,0,1995_boxofficemojo_rankings.csv,1995,1.0,0.0
7649,The Big Kahuna,3728888,3165544,563344,2000_boxofficemojo_rankings.csv,2000,0.8489243978365668,0.1510756021634332
7650,The Gun in Betty Lou's Handbag,3721911,3721911,0,1992_boxofficemojo_rankings.csv,1992,1.0,0.0
7651,Ragnarok,3721345,1369,3719976,2013_boxofficemojo_rankings.csv,2013,0.00036787774312782074,0.9996321222568721
7652,The Governess,3719509,3719509,0,1998_boxofficemojo_rankings.csv,1998,1.0,0.0
7653,Free Fire,3719383,1799312,1920071,2017_boxofficemojo_rankings.csv,2017,0.4837662590811433,0.5162337409188567
7654,Summertime,3719031,35322,3683709,2015_boxofficemojo_rankings.csv,2015,0.009497635271123043,0.990502364728877
7655,Original Gangstas,3718087,3718087,0,1996_boxofficemojo_rankings.csv,1996,1.0,0.0
7656,Night of 7 Years,3716820,24281,3692539,2018_boxofficemojo_rankings.csv,2018,0.006532734972368853,0.9934672650276312
7657,Thirteen Conversations About One Thing,3706652,3288164,418488,2002_boxofficemojo_rankings.csv,2002,0.8870981144169995,0.1129018855830005
7658,The Last King,3705618,8905,3696713,2016_boxofficemojo_rankings.csv,2016,0.0024031079296354886,0.9975968920703645
7659,The Return of Martin Guerre,3704433,3704433,0,1983_boxofficemojo_rankings.csv,1983,1.0,0.0
7660,A Fantastic Woman,3702353,2020988,1681365,2017_boxofficemojo_rankings.csv,2017,0.5458658318102029,0.4541341681897971
7661,The Pursuit of D.B. Cooper,3702028,3702028,0,1981_boxofficemojo_rankings.csv,1981,1.0,0.0
7662,Spare Parts,3701281,3618912,82369,2015_boxofficemojo_rankings.csv,2015,0.9777458128685718,0.02225418713142828
7663,Crush,3695710,1084935,2610775,2002_boxofficemojo_rankings.csv,2002,0.29356605361351407,0.7064339463864859
7664,The Portrait of a Lady,3692836,3692836,0,1996_boxofficemojo_rankings.csv,1996,1.0,0.0
7665,Worth Winning,3690328,3690328,0,1989_boxofficemojo_rankings.csv,1989,1.0,0.0
7666,Three O'Clock High,3685862,3685862,0,1987_boxofficemojo_rankings.csv,1987,1.0,0.0
7667,Western Stars,3681681,1581681,2100000,2019_boxofficemojo_rankings.csv,2019,0.4296083772602787,0.5703916227397213
7668,Inspector Bellamy,3681654,107612,3574042,2009_boxofficemojo_rankings.csv,2009,0.029229254025500494,0.9707707459744995
7669,1911,3680151,135739,3544412,2011_boxofficemojo_rankings.csv,2011,0.03688408437588566,0.9631159156241144
7670,Gosnell: The Trial of America's Biggest Serial Killer,3679893,3679893,0,2018_boxofficemojo_rankings.csv,2018,1.0,0.0
7671,5 Flights Up,3679847,1020921,2658926,2015_boxofficemojo_rankings.csv,2015,0.2774357194742064,0.7225642805257936
7672,The Brother from Another Planet,3677209,3677209,0,1984_boxofficemojo_rankings.csv,1984,1.0,0.0
7673,Crossing Over,3676533,455654,3220879,2009_boxofficemojo_rankings.csv,2009,0.12393578406612969,0.8760642159338703
7674,Lost Highway,3675201,3675201,0,1997_boxofficemojo_rankings.csv,1997,1.0,0.0
7675,Bad Company,3674841,3674841,0,1995_boxofficemojo_rankings.csv,1995,1.0,0.0
7676,The Fall,3669465,2266905,1402560,2008_boxofficemojo_rankings.csv,2008,0.6177753432721119,0.38222465672788813
7677,Love Crime,3663918,539792,3124126,2010_boxofficemojo_rankings.csv,2010,0.1473264412576919,0.8526735587423081
7678,Cabin Boy,3662459,3662459,0,1994_boxofficemojo_rankings.csv,1994,1.0,0.0
7679,Ju-on: The Grudge,3657876,325680,3332196,2003_boxofficemojo_rankings.csv,2003,0.08903527620947238,0.9109647237905276
7680,"Lucía, Lucía",3653588,269586,3384002,2003_boxofficemojo_rankings.csv,2003,0.07378664479957783,0.9262133552004221
7681,Nicholas Nickleby,3651462,1587173,2064289,2002_boxofficemojo_rankings.csv,2002,0.4346678125090717,0.5653321874909283
7682,Number One Fan,3650598,15549,3635049,2014_boxofficemojo_rankings.csv,2014,0.004259302174602627,0.9957406978253974
7683,BloodRayne,3650275,2405420,1244855,2006_boxofficemojo_rankings.csv,2006,0.6589695296929683,0.34103047030703165
7684,Non-Fiction,3649042,704919,2944123,2018_boxofficemojo_rankings.csv,2018,0.19317919607392844,0.8068208039260716
7685,The Cat's Meow,3646994,3209481,437513,2002_boxofficemojo_rankings.csv,2002,0.8800346257767356,0.11996537422326442
7686,A la mala,3646627,3629842,16785,2015_boxofficemojo_rankings.csv,2015,0.9953971162940438,0.0046028837059562165
7687,Hedwig and the Angry Inch,3644200,3067312,576888,2001_boxofficemojo_rankings.csv,2001,0.8416969430876461,0.15830305691235388
7688,Celeste & Jesse Forever,3640975,3094813,546162,2012_boxofficemojo_rankings.csv,2012,0.84999567423561,0.15000432576439005
7689,Bhoot,3640472,106774,3533698,2003_boxofficemojo_rankings.csv,2003,0.029329713289925043,0.9706702867100749
7690,The German Doctor,3635718,418392,3217326,2013_boxofficemojo_rankings.csv,2013,0.11507823214011648,0.8849217678598835
7691,Sweet Sixteen,3633509,316319,3317190,2002_boxofficemojo_rankings.csv,2002,0.08705606618835952,0.9129439338116405
7692,Karthik Calling Karthik,3627172,286409,3340763,2010_boxofficemojo_rankings.csv,2010,0.078962067417812,0.921037932582188
7693,Crooked House,3625952,0,3625952,2017_boxofficemojo_rankings.csv,2017,0.0,1.0
7694,The Trigger Effect,3622979,3622979,0,1996_boxofficemojo_rankings.csv,1996,1.0,0.0
7695,Colonia,3621046,15709,3605337,2016_boxofficemojo_rankings.csv,2016,0.004338249224119219,0.9956617507758808
7696,Ran,3607393,3607393,0,1985_boxofficemojo_rankings.csv,1985,1.0,0.0
7697,The Last Circus,3604598,40548,3564050,2010_boxofficemojo_rankings.csv,2010,0.011248965904103592,0.9887510340958964
7698,My Heroes Have Always Been Cowboys,3603615,3603615,0,1991_boxofficemojo_rankings.csv,1991,1.0,0.0
7699,8 Heads in a Duffel Bag,3602884,3602884,0,1997_boxofficemojo_rankings.csv,1997,1.0,0.0
7700,Everything Is Illuminated,3601974,1712337,1889637,2005_boxofficemojo_rankings.csv,2005,0.4753884953084059,0.5246115046915941
7701,The Insult,3601603,1001305,2600298,2017_boxofficemojo_rankings.csv,2017,0.2780164832159458,0.7219835167840543
7702,The Pest,3600616,3600616,0,1997_boxofficemojo_rankings.csv,1997,1.0,0.0
7703,Phoenix Forgotten,3600146,3600146,0,2017_boxofficemojo_rankings.csv,2017,1.0,0.0
7704,Turk 182,3594997,3594997,0,1985_boxofficemojo_rankings.csv,1985,1.0,0.0
7705,Heart Blackened,3593480,37047,3556433,2017_boxofficemojo_rankings.csv,2017,0.010309504992375079,0.989690495007625
7706,Badla,3590894,1861000,1729894,2019_boxofficemojo_rankings.csv,2019,0.5182553425414396,0.48174465745856043
7707,Indivisible,3589633,3511417,78216,2018_boxofficemojo_rankings.csv,2018,0.9782105858732634,0.02178941412673663
7708,Dead Heat,3588626,3588626,0,1988_boxofficemojo_rankings.csv,1988,1.0,0.0
7709,Bagdad Cafe,3587303,3587303,0,1988_boxofficemojo_rankings.csv,1988,1.0,0.0
7710,Wrong Is Right,3583513,3583513,0,1982_boxofficemojo_rankings.csv,1982,1.0,0.0
7711,Tougher Than Leather,3582760,3582760,0,1988_boxofficemojo_rankings.csv,1988,1.0,0.0
7712,Three Colors: Red,3581969,3581969,0,1994_boxofficemojo_rankings.csv,1994,1.0,0.0
7713,Ghostbusters 30th Anniversary Release,3580343,3580343,0,2014_boxofficemojo_rankings.csv,2014,1.0,0.0
7714,Lemming,3580017,81698,3498319,2005_boxofficemojo_rankings.csv,2005,0.022820562025264127,0.9771794379747358
7715,Paradise Now,3579902,1457843,2122059,2005_boxofficemojo_rankings.csv,2005,0.40722986271691236,0.5927701372830876
7716,Old Gringo,3574256,3574256,0,1989_boxofficemojo_rankings.csv,1989,1.0,0.0
7717,Factory Girl,3572632,1675241,1897391,2006_boxofficemojo_rankings.csv,2006,0.46890947626287843,0.5310905237371215
7718,Major League: Back to the Minors,3572443,3572443,0,1998_boxofficemojo_rankings.csv,1998,1.0,0.0
7719,The New Adventures of Pippi Longstocking,3569939,3569939,0,1988_boxofficemojo_rankings.csv,1988,1.0,0.0
7720,Cats Don't Dance,3566637,3566637,0,1997_boxofficemojo_rankings.csv,1997,1.0,0.0
7721,New Jersey Drive,3565508,3565508,0,1995_boxofficemojo_rankings.csv,1995,1.0,0.0
7722,Fat Man and Little Boy,3563162,3563162,0,1989_boxofficemojo_rankings.csv,1989,1.0,0.0
7723,The Apparition,3562793,28293,3534500,2018_boxofficemojo_rankings.csv,2018,0.007941241604550137,0.9920587583954499
7724,Physical Evidence,3560932,3560932,0,1989_boxofficemojo_rankings.csv,1989,1.0,0.0
7725,Tom and Jerry: The Movie,3560469,3560469,0,1993_boxofficemojo_rankings.csv,1993,1.0,0.0
7726,The Bride,3558669,3558669,0,1985_boxofficemojo_rankings.csv,1985,1.0,0.0
7727,Les Boys III,3557100,3557100,0,2001_boxofficemojo_rankings.csv,2001,1.0,0.0
7728,Price of Glory,3548556,3440228,108328,2000_boxofficemojo_rankings.csv,2000,0.9694726531017124,0.030527346898287643
7729,Madame Sousatzka,3548238,3548238,0,1988_boxofficemojo_rankings.csv,1988,1.0,0.0
7730,Shout,3547684,3547684,0,1991_boxofficemojo_rankings.csv,1991,1.0,0.0
7731,Bacurau,3541476,58115,3483361,2019_boxofficemojo_rankings.csv,2019,0.016409824604204575,0.9835901753957954
7732,The Oscar Nominated Short Films 2019: Documentary,3538550,3531094,7456,2019_boxofficemojo_rankings.csv,2019,0.9978929222421613,0.0021070777578386627
7733,The Midnight Meat Train,3534313,83361,3450952,2008_boxofficemojo_rankings.csv,2008,0.023586196242381476,0.9764138037576185
7734,Catfish,3533711,3237343,296368,2010_boxofficemojo_rankings.csv,2010,0.9161312286149037,0.0838687713850963
7735,In Country,3531971,3531971,0,1989_boxofficemojo_rankings.csv,1989,1.0,0.0
7736,Ek Ladki Ko Dekha Toh Aisa Laga,3531837,1182636,2349201,2019_boxofficemojo_rankings.csv,2019,0.33485010774846063,0.6651498922515393
7737,Born Into Brothels: Calcutta's Red Light Kids,3529201,3515061,14140,2004_boxofficemojo_rankings.csv,2004,0.9959934274075067,0.004006572592493315
7738,Things Change,3527886,3527886,0,1988_boxofficemojo_rankings.csv,1988,1.0,0.0
7739,Ten Stories,3526678,219071,3307607,2007_boxofficemojo_rankings.csv,2007,0.06211823137808442,0.9378817686219156
7740,'Til There Was You,3525125,3525125,0,1997_boxofficemojo_rankings.csv,1997,1.0,0.0
7741,Sidewalks of New York,3520373,2402652,1117721,2001_boxofficemojo_rankings.csv,2001,0.6824992692535706,0.3175007307464294
7742,The Riot Club,3517925,7734,3510191,2014_boxofficemojo_rankings.csv,2014,0.0021984550551816767,0.9978015449448183
7743,The Oscar Nominated Short Films 2018: Live Action,3511123,3508777,2346,2018_boxofficemojo_rankings.csv,2018,0.9993318377054863,0.0006681622945137496
7744,Still Walking,3511120,167047,3344073,2008_boxofficemojo_rankings.csv,2008,0.047576556768210716,0.9524234432317893
7745,Head in the Clouds,3510605,398278,3112327,2004_boxofficemojo_rankings.csv,2004,0.11344996090417464,0.8865500390958254
7746,Lovewrecked,3505963,0,3505963,2006_boxofficemojo_rankings.csv,2006,0.0,1.0
7747,Ladrones,3504414,3063505,440909,2015_boxofficemojo_rankings.csv,2015,0.8741846711033571,0.12581532889664293
7748,The Big Blue,3500000,3500000,0,1988_boxofficemojo_rankings.csv,1988,1.0,0.0
7749,The Wraith,3500000,3500000,0,1986_boxofficemojo_rankings.csv,1986,1.0,0.0
7750,Thanks for Sharing,3499442,1065881,2433561,2013_boxofficemojo_rankings.csv,2013,0.3045859882804173,0.6954140117195827
7751,Faustina: Love and Mercy,3498887,2243180,1255707,2019_boxofficemojo_rankings.csv,2019,0.6411124451861406,0.35888755481385937
7752,Maiden,3495241,3168978,326263,2019_boxofficemojo_rankings.csv,2019,0.9066550775754805,0.09334492242451951
7753,Wild Target,3494154,108589,3385565,2010_boxofficemojo_rankings.csv,2010,0.031077336602794266,0.9689226633972058
7754,Racetime,3493043,1875283,1617760,2018_boxofficemojo_rankings.csv,2018,0.5368622716639904,0.4631377283360096
7755,Jeffrey,3487767,3487767,0,1995_boxofficemojo_rankings.csv,1995,1.0,0.0
7756,Where the Truth Lies,3487678,872142,2615536,2005_boxofficemojo_rankings.csv,2005,0.2500637960270415,0.7499362039729585
7757,Moll Flanders,3486957,3486957,0,1996_boxofficemojo_rankings.csv,1996,1.0,0.0
7758,Veronica Mars: The Movie,3485383,3322127,163256,2014_boxofficemojo_rankings.csv,2014,0.9531598105574051,0.04684018944259497
7759,The Aeronauts,3485251,0,3485251,2019_boxofficemojo_rankings.csv,2019,0.0,1.0
7760,3,3484446,59954,3424492,2010_boxofficemojo_rankings.csv,2010,0.01720617854316009,0.9827938214568399
7761,Jack and the Cuckoo-Clock Heart,3484370,0,3484370,2014_boxofficemojo_rankings.csv,2014,0.0,1.0
7762,Heaven's Gate,3484331,3484331,0,1980_boxofficemojo_rankings.csv,1980,1.0,0.0
7763,Miles Ahead,3473958,2610896,863062,2016_boxofficemojo_rankings.csv,2016,0.7515623389804943,0.2484376610195057
7764,The Lemon Sisters,3473905,3473905,0,1990_boxofficemojo_rankings.csv,1990,1.0,0.0
7765,Great Performances at the Met: Puccini: Tosca,3473616,2023749,1449867,2018_boxofficemojo_rankings.csv,2018,0.5826058493512236,0.4173941506487764
7766,The Method,3470651,7017,3463634,2005_boxofficemojo_rankings.csv,2005,0.002021810893691126,0.9979781891063089
7767,Hors la loi,3470487,96933,3373554,2010_boxofficemojo_rankings.csv,2010,0.027930662180840903,0.972069337819159
7768,Talk Radio,3468572,3468572,0,1988_boxofficemojo_rankings.csv,1988,1.0,0.0
7769,Enemy,3468224,1008726,2459498,2014_boxofficemojo_rankings.csv,2014,0.2908479959771918,0.7091520040228082
7770,The Long Weekend,3467374,1286,3466088,2005_boxofficemojo_rankings.csv,2005,0.00037088586348054753,0.9996291141365194
7771,Til Death Do Us Part,3455267,3455267,0,2017_boxofficemojo_rankings.csv,2017,1.0,0.0
7772,Obsession,3454709,528799,2925910,2016_boxofficemojo_rankings.csv,2016,0.1530661482631388,0.8469338517368612
7773,Separate Lies,3452023,924260,2527763,2005_boxofficemojo_rankings.csv,2005,0.2677444501383681,0.7322555498616319
7774,Days of Heaven,3446749,3446749,0,1978_boxofficemojo_rankings.csv,1978,1.0,0.0
7775,Free Willy 3: The Rescue,3446539,3446539,0,1997_boxofficemojo_rankings.csv,1997,1.0,0.0
7776,Words and Pictures,3438874,2171257,1267617,2014_boxofficemojo_rankings.csv,2014,0.63138602926423,0.3686139707357699
7777,Full Frontal,3438804,2512846,925958,2002_boxofficemojo_rankings.csv,2002,0.7307325453849652,0.26926745461503476
7778,A Gentleman,3438746,410055,3028691,2017_boxofficemojo_rankings.csv,2017,0.11924550402966663,0.8807544959703334
7779,The Ultimate Gift,3438735,3438735,0,2007_boxofficemojo_rankings.csv,2007,1.0,0.0
7780,The Rider,3434963,2419031,1015932,2018_boxofficemojo_rankings.csv,2018,0.7042378622418931,0.29576213775810684
7781,He Named Me Malala,3433606,2668936,764670,2015_boxofficemojo_rankings.csv,2015,0.7772982689335934,0.22270173106640656
7782,A Simple Twist of Fate,3430583,3430583,0,1994_boxofficemojo_rankings.csv,1994,1.0,0.0
7783,Borg vs. McEnroe,3430165,231346,3198819,2017_boxofficemojo_rankings.csv,2017,0.06744456899303677,0.9325554310069633
7784,Disconnect,3428048,1436900,1991148,2013_boxofficemojo_rankings.csv,2013,0.41915982506662686,0.5808401749333731
7785,Special Forces,3424648,10759,3413889,2011_boxofficemojo_rankings.csv,2011,0.0031416367463167017,0.9968583632536833
7786,Next Time I'll Aim for the Heart,3418213,815,3417398,2014_boxofficemojo_rankings.csv,2014,0.00023842867603627977,0.9997615713239637
7787,Father Hood,3418141,3418141,0,1993_boxofficemojo_rankings.csv,1993,1.0,0.0
7788,The Cave of the Yellow Dog,3417511,141803,3275708,2005_boxofficemojo_rankings.csv,2005,0.04149306322642414,0.9585069367735759
7789,A Shock to the System,3417056,3417056,0,1990_boxofficemojo_rankings.csv,1990,1.0,0.0
7790,Kinjite: Forbidden Subjects,3416846,3416846,0,1989_boxofficemojo_rankings.csv,1989,1.0,0.0
7791,Days of Darkness,3414681,1491525,1923156,2007_boxofficemojo_rankings.csv,2007,0.4367977565107839,0.5632022434892161
7792,Angels and Insects,3414301,3414301,0,1996_boxofficemojo_rankings.csv,1996,1.0,0.0
7793,Midnight Diner,3412771,18555,3394216,2019_boxofficemojo_rankings.csv,2019,0.005436930869372718,0.9945630691306273
7794,Gunmen,3411885,3411885,0,1994_boxofficemojo_rankings.csv,1994,1.0,0.0
7795,3-Iron,3403957,241914,3162043,2004_boxofficemojo_rankings.csv,2004,0.07106846531845144,0.9289315346815485
7796,Friends 25th: The One With The Anniversary,3403406,2884827,518579,2019_boxofficemojo_rankings.csv,2019,0.8476294041909781,0.1523705958090219
7797,Honey Boy,3400977,3012615,388362,2019_boxofficemojo_rankings.csv,2019,0.8858086955601288,0.11419130443987124
7798,The Protector 2,3399790,2463,3397327,2013_boxofficemojo_rankings.csv,2013,0.000724456510549181,0.9992755434894508
7799,Junebug,3399228,2678691,720537,2005_boxofficemojo_rankings.csv,2005,0.7880292231059522,0.2119707768940477
7800,The Good Lie,3396345,2722209,674136,2014_boxofficemojo_rankings.csv,2014,0.8015113305627078,0.19848866943729215
7801,Next Stop Wonderland,3395581,3395581,0,1998_boxofficemojo_rankings.csv,1998,1.0,0.0
7802,Rock the Kasbah,3394174,3020664,373510,2015_boxofficemojo_rankings.csv,2015,0.889955553250953,0.11004444674904704
7803,Head Office,3393807,3393807,0,1986_boxofficemojo_rankings.csv,1986,1.0,0.0
7804,The MatchMaker,3392080,3392080,0,1997_boxofficemojo_rankings.csv,1997,1.0,0.0
7805,"All's Well, Ends Well 2012",3390232,47919,3342313,2012_boxofficemojo_rankings.csv,2012,0.014134430918002072,0.985865569081998
7806,Big Shots,3390043,3390043,0,1987_boxofficemojo_rankings.csv,1987,1.0,0.0
7807,Gauguin: Voyage to Tahiti,3389322,200140,3189182,2017_boxofficemojo_rankings.csv,2017,0.059050158114218716,0.9409498418857812
7808,Born American,3388020,3388020,0,1986_boxofficemojo_rankings.csv,1986,1.0,0.0
7809,Anything for Alice,3387582,1092,3386490,2014_boxofficemojo_rankings.csv,2014,0.00032235382051268427,0.9996776461794873
7810,Pumpkinhead,3385516,3385516,0,1988_boxofficemojo_rankings.csv,1988,1.0,0.0
7811,Apartment 1303 3D,3377891,0,3377891,2012_boxofficemojo_rankings.csv,2012,0.0,1.0
7812,The Neon Demon,3377430,1333124,2044306,2016_boxofficemojo_rankings.csv,2016,0.39471550853755666,0.6052844914624433
7813,Red Satin,3375341,231879,3143462,2002_boxofficemojo_rankings.csv,2002,0.06869794785178741,0.9313020521482126
7814,The King's Speech PG-13 Version,3375215,3344306,30909,2011_boxofficemojo_rankings.csv,2011,0.9908423611532895,0.009157638846710506
7815,The Hole in the Ground,3373474,21072,3352402,2019_boxofficemojo_rankings.csv,2019,0.006246379844634937,0.9937536201553651
7816,Bunty Aur Babli,3370142,942756,2427386,2005_boxofficemojo_rankings.csv,2005,0.2797377677261077,0.7202622322738923
7817,Sunshine State,3369654,3065921,303733,2002_boxofficemojo_rankings.csv,2002,0.9098622588550634,0.09013774114493654
7818,Patrick the Pug,3369468,6290,3363178,2018_boxofficemojo_rankings.csv,2018,0.0018667635365582935,0.9981332364634417
7819,Near Dark,3369307,3369307,0,1987_boxofficemojo_rankings.csv,1987,1.0,0.0
7820,Is Anybody There?,3368300,2026756,1341544,2009_boxofficemojo_rankings.csv,2009,0.6017148116260428,0.3982851883739572
7821,The Last Full Measure,3364426,2949212,415214,2020_boxofficemojo_rankings.csv,2020,0.8765869720421849,0.12341302795781509
7822,We Don't Live Here Anymore,3361213,2041014,1320199,2004_boxofficemojo_rankings.csv,2004,0.6072254272490318,0.39277457275096817
7823,Starchaser: The Legend of Orin,3360800,3360800,0,1985_boxofficemojo_rankings.csv,1985,1.0,0.0
7824,Ten Canoes,3360030,283654,3076376,2006_boxofficemojo_rankings.csv,2006,0.08442007958262278,0.9155799204173772
7825,Blue Sky,3359465,3359465,0,1994_boxofficemojo_rankings.csv,1994,1.0,0.0
7826,Fighting Back,3355948,3355948,0,1982_boxofficemojo_rankings.csv,1982,1.0,0.0
7827,Echo in the Canyon,3355324,3355324,0,2019_boxofficemojo_rankings.csv,2019,1.0,0.0
7828,Reality,3350996,72577,3278419,2012_boxofficemojo_rankings.csv,2012,0.021658336804937995,0.978341663195062
7829,Boynton Beach Club,3350115,3127472,222643,2006_boxofficemojo_rankings.csv,2006,0.9335416843899389,0.06645831561006114
7830,Panipat,3349899,461863,2888036,2019_boxofficemojo_rankings.csv,2019,0.13787370902824234,0.8621262909717576
7831,The Work and the Glory,3347647,3347647,0,2004_boxofficemojo_rankings.csv,2004,1.0,0.0
7832,Supercross,3344431,3102550,241881,2005_boxofficemojo_rankings.csv,2005,0.9276764866729198,0.07232351332708015
7833,Squanto: A Warrior's Tale,3342223,3342223,0,1994_boxofficemojo_rankings.csv,1994,1.0,0.0
7834,Mistress America,3340737,2500431,840306,2015_boxofficemojo_rankings.csv,2015,0.7484668802123603,0.25153311978763965
7835,No News from God,3340382,77858,3262524,2002_boxofficemojo_rankings.csv,2002,0.023308112664958677,0.9766918873350413
7836,Machine Gun Preacher,3338690,538690,2800000,2011_boxofficemojo_rankings.csv,2011,0.16134771422324326,0.8386522857767568
7837,Unknown,3338228,26403,3311825,2006_boxofficemojo_rankings.csv,2006,0.007909286004431094,0.9920907139955689
7838,Atlas Shrugged II: The Strike,3336053,3336053,0,2012_boxofficemojo_rankings.csv,2012,1.0,0.0
7839,My Boyfriend's Back,3335984,3335984,0,1993_boxofficemojo_rankings.csv,1993,1.0,0.0
7840,On Chesil Beach,3335913,745971,2589942,2018_boxofficemojo_rankings.csv,2018,0.22361824184263798,0.776381758157362
7841,The Program,3335613,13074,3322539,2015_boxofficemojo_rankings.csv,2015,0.003919519440654536,0.9960804805593455
7842,By the Sea,3334927,538460,2796467,2015_boxofficemojo_rankings.csv,2015,0.16146080558884798,0.838539194411152
7843,Everlasting Moments,3334754,610825,2723929,2008_boxofficemojo_rankings.csv,2008,0.18316943318757545,0.8168305668124245
7844,Fraternity Vacation,3333306,3333306,0,1985_boxofficemojo_rankings.csv,1985,1.0,0.0
7845,Raiders of the Lost Ark 2012 IMAX Release,3332854,3125613,207241,2012_boxofficemojo_rankings.csv,2012,0.9378187583374489,0.062181241662551075
7846,Camille Claudel,3331297,3331297,0,1989_boxofficemojo_rankings.csv,1989,1.0,0.0
7847,A Smile Like Yours,3330352,3330352,0,1997_boxofficemojo_rankings.csv,1997,1.0,0.0
7848,Last Ounce of Courage,3329674,3329674,0,2012_boxofficemojo_rankings.csv,2012,1.0,0.0
7849,Vanishing Time: A Boy Who Returned,3328517,57759,3270758,2016_boxofficemojo_rankings.csv,2016,0.017352773021739112,0.9826472269782609
7850,Fifty,3328240,3328240,0,1999_boxofficemojo_rankings.csv,1999,1.0,0.0
7851,The Death & Life of John F. Donovan,3326364,152713,3173651,2019_boxofficemojo_rankings.csv,2019,0.04590988839465555,0.9540901116053444
7852,Carpool,3325651,3325651,0,1996_boxofficemojo_rankings.csv,1996,1.0,0.0
7853,Obvious Child,3325417,3123963,201454,2014_boxofficemojo_rankings.csv,2014,0.9394199283879285,0.06058007161207151
7854,Screen Two: The Snapper,3323524,3323524,0,1993_boxofficemojo_rankings.csv,1993,1.0,0.0
7855,Flying Swords of Dragon Gate,3323381,170276,3153105,2011_boxofficemojo_rankings.csv,2011,0.051235774652379606,0.9487642253476204
7856,Breath,3322479,37108,3285371,2018_boxofficemojo_rankings.csv,2018,0.01116876886204548,0.9888312311379546
7857,Wildlife,3321367,1050616,2270751,2018_boxofficemojo_rankings.csv,2018,0.31632035845481693,0.683679641545183
7858,Elvis Gratton II: Miracle à Memphis,3316272,3316272,0,1999_boxofficemojo_rankings.csv,1999,1.0,0.0
7859,Pootie Tang,3313583,3313583,0,2001_boxofficemojo_rankings.csv,2001,1.0,0.0
7860,Chhichhore,3311391,2004400,1306991,2019_boxofficemojo_rankings.csv,2019,0.6053045381835005,0.39469546181649945
7861,Train of Life,3311162,98687,3212475,1999_boxofficemojo_rankings.csv,1999,0.029804340591007023,0.970195659408993
7862,Samsam,3311093,53273,3257820,2020_boxofficemojo_rankings.csv,2020,0.01608924907877852,0.9839107509212215
7863,Mrs Dalloway,3309421,3309421,0,1998_boxofficemojo_rankings.csv,1998,1.0,0.0
7864,Art School Confidential,3306629,3297137,9492,2006_boxofficemojo_rankings.csv,2006,0.9971294027845277,0.0028705972154723135
7865,2020 Oscar Nominated Short Films,3306611,3306611,0,2020_boxofficemojo_rankings.csv,2020,1.0,0.0
7866,Happily Ever After,3299382,3299382,0,1993_boxofficemojo_rankings.csv,1993,1.0,0.0
7867,Heist,3294317,50136,3244181,2015_boxofficemojo_rankings.csv,2015,0.015218936125454836,0.9847810638745451
7868,Heading South,3294052,898468,2395584,2006_boxofficemojo_rankings.csv,2006,0.2727546498962372,0.7272453501037628
7869,The Glass Shield,3291163,3291163,0,1995_boxofficemojo_rankings.csv,1995,1.0,0.0
7870,Bluff Master,3289047,722847,2566200,2005_boxofficemojo_rankings.csv,2005,0.21977399532448152,0.7802260046755185
7871,Wonderstruck,3285916,1060377,2225539,2017_boxofficemojo_rankings.csv,2017,0.32270362358623894,0.6772963764137611
7872,Wish You Were Here,3283832,3283832,0,1987_boxofficemojo_rankings.csv,1987,1.0,0.0
7873,Only the Strong,3283371,3283371,0,1993_boxofficemojo_rankings.csv,1993,1.0,0.0
7874,Good Time,3283369,2026499,1256870,2017_boxofficemojo_rankings.csv,2017,0.6172011126376596,0.3827988873623403
7875,Bharath Ane Nenu,3276257,2663090,613167,2018_boxofficemojo_rankings.csv,2018,0.8128452682436085,0.18715473175639152
7876,Romeo Is Bleeding,3275585,3275585,0,1994_boxofficemojo_rankings.csv,1994,1.0,0.0
7877,Marianne & Leonard: Words of Love,3273573,1012034,2261539,2019_boxofficemojo_rankings.csv,2019,0.30915272089548634,0.6908472791045136
7878,'Round Midnight,3272593,3272593,0,1986_boxofficemojo_rankings.csv,1986,1.0,0.0
7879,Pieces of April,3272028,2528664,743364,2003_boxofficemojo_rankings.csv,2003,0.7728124575951062,0.22718754240489383
7880,Skinwalkers,3269736,1018965,2250771,2007_boxofficemojo_rankings.csv,2007,0.3116352512863424,0.6883647487136576
7881,Mi vida loca,3267313,3267313,0,1994_boxofficemojo_rankings.csv,1994,1.0,0.0
7882,Chicken with Plums,3265941,253874,3012067,2011_boxofficemojo_rankings.csv,2011,0.077733798620367,0.922266201379633
7883,The Sweet Hereafter,3263585,3263585,0,1997_boxofficemojo_rankings.csv,1997,1.0,0.0
7884,Pinocchio and the Emperor of the Night,3261638,3261638,0,1987_boxofficemojo_rankings.csv,1987,1.0,0.0
7885,Peaceful Warrior 2007 Re-release,3260179,2893666,366513,2007_boxofficemojo_rankings.csv,2007,0.8875788722030293,0.11242112779697065
7886,"Patrik, Age 1.5",3259068,57468,3201600,2008_boxofficemojo_rankings.csv,2008,0.017633262024603354,0.9823667379753966
7887,No Escape,3258462,149458,3109004,2020_boxofficemojo_rankings.csv,2020,0.04586765167124858,0.9541323483287514
7888,Zoot Suit,3256082,3256082,0,1981_boxofficemojo_rankings.csv,1981,1.0,0.0
7889,Clifford's Really Big Movie,3255426,2922354,333072,2004_boxofficemojo_rankings.csv,2004,0.8976871229756106,0.10231287702438943
7890,Bilal: A New Breed of Hero,3254027,0,3254027,2016_boxofficemojo_rankings.csv,2016,0.0,1.0
7891,The Boys Are Back,3252136,809752,2442384,2009_boxofficemojo_rankings.csv,2009,0.2489908171121995,0.7510091828878005
7892,Little Fish,3248506,8148,3240358,2005_boxofficemojo_rankings.csv,2005,0.0025082299370849247,0.9974917700629151
7893,Splitting Heirs,3246063,3246063,0,1993_boxofficemojo_rankings.csv,1993,1.0,0.0
7894,Queens,3245067,140417,3104650,2005_boxofficemojo_rankings.csv,2005,0.04327090935256499,0.956729090647435
7895,Resurrecting the Champ,3243064,3172573,70491,2007_boxofficemojo_rankings.csv,2007,0.978264073727808,0.021735926272191976
7896,Your Sister's Sister,3242802,1636190,1606612,2012_boxofficemojo_rankings.csv,2012,0.5045605621311446,0.4954394378688554
7897,In Harmony,3242445,3144,3239301,2015_boxofficemojo_rankings.csv,2015,0.0009696386523133006,0.9990303613476867
7898,Carrington,3242342,3242342,0,1995_boxofficemojo_rankings.csv,1995,1.0,0.0
7899,The Front Runner,3242235,2000105,1242130,2018_boxofficemojo_rankings.csv,2018,0.616890817599588,0.3831091824004121
7900,Pathology,3234706,109846,3124860,2008_boxofficemojo_rankings.csv,2008,0.033958573051152095,0.9660414269488479
7901,Sleeping with Other People,3224947,819431,2405516,2015_boxofficemojo_rankings.csv,2015,0.25409130754706977,0.7459086924529302
7902,"Race for Your Life, Charlie Brown",3223888,3223888,0,1977_boxofficemojo_rankings.csv,1977,1.0,0.0
7903,Lost and Found,3223197,3223197,0,1979_boxofficemojo_rankings.csv,1979,1.0,0.0
7904,The Final Cut,3222439,551281,2671158,2004_boxofficemojo_rankings.csv,2004,0.1710756976315145,0.8289243023684855
7905,Barfly,3221568,3221568,0,1987_boxofficemojo_rankings.csv,1987,1.0,0.0
7906,Love is in the Air 2013 Re-release,3221554,8425,3213129,2013_boxofficemojo_rankings.csv,2013,0.0026151975102698885,0.9973848024897302
7907,Gun Shy,3221280,1638202,1583078,2000_boxofficemojo_rankings.csv,2000,0.5085562260964586,0.49144377390354144
7908,Pi,3221152,3221152,0,1998_boxofficemojo_rankings.csv,1998,1.0,0.0
7909,The Wild Parrots of Telegraph Hill,3218709,3058527,160182,2005_boxofficemojo_rankings.csv,2005,0.950234084535135,0.04976591546486495
7910,The Year My Parents Went on Vacation,3218370,807117,2411253,2006_boxofficemojo_rankings.csv,2006,0.25078440328489265,0.7492155967151073
7911,Embrace of the Serpent,3217176,1329249,1887927,2015_boxofficemojo_rankings.csv,2015,0.41317260852374876,0.5868273914762512
7912,The Mystery of Happiness,3216374,8528,3207846,2014_boxofficemojo_rankings.csv,2014,0.0026514329490289375,0.9973485670509711
7913,Riding Giants,3216111,2276368,939743,2004_boxofficemojo_rankings.csv,2004,0.7078014409328534,0.29219855906714665
7914,Wings of Desire,3212686,3210139,2547,1988_boxofficemojo_rankings.csv,1988,0.9992072054349538,0.000792794565046195
7915,Traces of Red,3206714,3206714,0,1992_boxofficemojo_rankings.csv,1992,1.0,0.0
7916,6 Souls,3205167,0,3205167,2010_boxofficemojo_rankings.csv,2010,0.0,1.0
7917,The Limey,3204663,3204663,0,1999_boxofficemojo_rankings.csv,1999,1.0,0.0
7918,Saint Laurent,3202241,429477,2772764,2014_boxofficemojo_rankings.csv,2014,0.13411763824146902,0.865882361758531
7919,Lady Chatterley,3200383,687414,2512969,2006_boxofficemojo_rankings.csv,2006,0.2147911671821779,0.7852088328178222
7920,Tadpole,3200241,2891288,308953,2002_boxofficemojo_rankings.csv,2002,0.9034594582095536,0.09654054179044641
7921,I,3200113,1449232,1750881,2015_boxofficemojo_rankings.csv,2015,0.4528690080631528,0.5471309919368472
7922,Dear Zindagi,3199581,2376479,823102,2016_boxofficemojo_rankings.csv,2016,0.7427469409275778,0.2572530590724223
7923,Fill the Void,3197615,1775316,1422299,2012_boxofficemojo_rankings.csv,2012,0.5552000475354287,0.44479995246457127
7924,Victoria,3191971,0,3191971,2015_boxofficemojo_rankings.csv,2015,0.0,1.0
7925,Empire of Lust,3191168,10654,3180514,2015_boxofficemojo_rankings.csv,2015,0.003338589507039429,0.9966614104929605
7926,Machuca,3187700,26676,3161024,2004_boxofficemojo_rankings.csv,2004,0.008368416099382,0.991631583900618
7927,Thoroughbreds,3187255,3072605,114650,2018_boxofficemojo_rankings.csv,2018,0.9640286076890616,0.03597139231093841
7928,Showtime Championship Boxing: Floyd Mayweather vs. Conor McGregor,3184384,2620183,564201,2017_boxofficemojo_rankings.csv,2017,0.822822561600611,0.17717743839938901
7929,Strayed,3184020,482757,2701263,2003_boxofficemojo_rankings.csv,2003,0.15161870842519834,0.8483812915748017
7930,Tea With the Dames,3181152,889343,2291809,2018_boxofficemojo_rankings.csv,2018,0.2795663332025631,0.7204336667974369
7931,Silent Fall,3180674,3180674,0,1994_boxofficemojo_rankings.csv,1994,1.0,0.0
7932,Pastorela,3179022,161194,3017828,2011_boxofficemojo_rankings.csv,2011,0.05070553144960935,0.9492944685503907
7933,Chocolate,3179014,14845,3164169,2008_boxofficemojo_rankings.csv,2008,0.004669686890337696,0.9953303131096624
7934,Penitentiary II,3178542,3178542,0,1982_boxofficemojo_rankings.csv,1982,1.0,0.0
7935,Wordplay,3177636,3121270,56366,2006_boxofficemojo_rankings.csv,2006,0.9822616561494142,0.017738343850585783
7936,Waking Life,3176880,2901447,275433,2001_boxofficemojo_rankings.csv,2001,0.9133007856765128,0.08669921432348719
7937,The Wackness,3175469,2077116,1098353,2008_boxofficemojo_rankings.csv,2008,0.6541131404526387,0.34588685954736137
7938,Pilgrim's Progress,3173282,1294596,1878686,2019_boxofficemojo_rankings.csv,2019,0.4079675238443983,0.5920324761556017
7939,Rosewater,3171593,3128941,42652,2014_boxofficemojo_rankings.csv,2014,0.9865518684143899,0.013448131585610134
7940,Songcatcher,3171273,3059834,111439,2001_boxofficemojo_rankings.csv,2001,0.9648598528098968,0.03514014719010315
7941,Beautiful,3169930,3157348,12582,2000_boxofficemojo_rankings.csv,2000,0.996030827179149,0.003969172820850933
7942,Rude Awakening,3169719,3169719,0,1989_boxofficemojo_rankings.csv,1989,1.0,0.0
7943,Land of Mine,3169553,435266,2734287,2015_boxofficemojo_rankings.csv,2015,0.1373272508773319,0.8626727491226681
7944,My One and Only,3167681,2479538,688143,2009_boxofficemojo_rankings.csv,2009,0.7827612692060848,0.21723873079391517
7945,The Bridesmaid,3162662,111728,3050934,2004_boxofficemojo_rankings.csv,2004,0.03532720221130174,0.9646727977886983
7946,The Lodge,3155858,2138907,1016951,2020_boxofficemojo_rankings.csv,2020,0.6777576811123948,0.3222423188876052
7947,Clerks,3151130,3151130,0,1994_boxofficemojo_rankings.csv,1994,1.0,0.0
7948,Steal Big Steal Little,3150170,3150170,0,1995_boxofficemojo_rankings.csv,1995,1.0,0.0
7949,Ingrid Goes West,3146831,3024308,122523,2017_boxofficemojo_rankings.csv,2017,0.9610646393149171,0.03893536068508287
7950,Them,3144202,50057,3094145,2006_boxofficemojo_rankings.csv,2006,0.015920414782510793,0.9840795852174892
7951,Genesis,3139313,16413,3122900,2004_boxofficemojo_rankings.csv,2004,0.005228213943623971,0.9947717860563761
7952,Munna Bhai M.B.B.S.,3137716,48772,3088944,2003_boxofficemojo_rankings.csv,2003,0.015543790451398407,0.9844562095486016
7953,The Naked Cage,3136701,3136701,0,1986_boxofficemojo_rankings.csv,1986,1.0,0.0
7954,The Favor,3134381,3134381,0,1994_boxofficemojo_rankings.csv,1994,1.0,0.0
7955,Mr. Wonderful,3125424,3125424,0,1993_boxofficemojo_rankings.csv,1993,1.0,0.0
7956,Feeling Minnesota,3124440,3124440,0,1996_boxofficemojo_rankings.csv,1996,1.0,0.0
7957,Mother of Tears,3119957,58669,3061288,2007_boxofficemojo_rankings.csv,2007,0.01880442583022779,0.9811955741697722
7958,Jawbreaker,3117085,3117085,0,1999_boxofficemojo_rankings.csv,1999,1.0,0.0
7959,The Deep Blue Sea,3115609,1126525,1989084,2011_boxofficemojo_rankings.csv,2011,0.3615745749867843,0.6384254250132158
7960,In a World...,3114953,2963902,151051,2013_boxofficemojo_rankings.csv,2013,0.9515077755587323,0.048492224441267655
7961,The Boss of It All,3111395,51548,3059847,2006_boxofficemojo_rankings.csv,2006,0.016567488216700225,0.9834325117832998
7962,Night of the Demons,3109904,3109904,0,1988_boxofficemojo_rankings.csv,1988,1.0,0.0
7963,White Mischief,3107551,3107551,0,1988_boxofficemojo_rankings.csv,1988,1.0,0.0
7964,Illegal Tender,3106835,3106835,0,2007_boxofficemojo_rankings.csv,2007,1.0,0.0
7965,K2,3106559,3106559,0,1992_boxofficemojo_rankings.csv,1992,1.0,0.0
7966,Blame It on the Bellboy,3104545,3104545,0,1992_boxofficemojo_rankings.csv,1992,1.0,0.0
7967,Death and the Maiden,3103716,3103716,0,1994_boxofficemojo_rankings.csv,1994,1.0,0.0
7968,Close Encounters of the Third Kind 2017 Re-release,3101507,3100479,1028,2017_boxofficemojo_rankings.csv,2017,0.9996685482251048,0.00033145177489523643
7969,Come Undone,3101465,10035,3091430,2010_boxofficemojo_rankings.csv,2010,0.003235567707518866,0.9967644322924811
7970,The Legend of Billie Jean,3099497,3099497,0,1985_boxofficemojo_rankings.csv,1985,1.0,0.0
7971,Raw,3096815,514870,2581945,2017_boxofficemojo_rankings.csv,2017,0.16625791337228735,0.8337420866277127
7972,Paid in Full,3090862,3090862,0,2002_boxofficemojo_rankings.csv,2002,1.0,0.0
7973,Tous les matins du monde,3089497,3089497,0,1992_boxofficemojo_rankings.csv,1992,1.0,0.0
7974,Nomad: The Warrior,3088685,79123,3009562,2006_boxofficemojo_rankings.csv,2006,0.02561705062186659,0.9743829493781334
7975,Hocus Pocus 2020 Re-release,3086000,3086000,0,2020_boxofficemojo_rankings.csv,2020,1.0,0.0
7976,Aquarius,3085977,285930,2800047,2016_boxofficemojo_rankings.csv,2016,0.09265461148932737,0.9073453885106726
7977,The People Vs. Fritz Bauer,3083973,288483,2795490,2015_boxofficemojo_rankings.csv,2015,0.09354264774691608,0.9064573522530839
7978,Mumbai Diaries,3082958,576639,2506319,2011_boxofficemojo_rankings.csv,2011,0.1870408224828233,0.8129591775171767
7979,Incantato,3082196,108954,2973242,2003_boxofficemojo_rankings.csv,2003,0.03534947161050109,0.9646505283894989
7980,The Fan,3082096,3082096,0,1981_boxofficemojo_rankings.csv,1981,1.0,0.0
7981,Provoked: A True Story,3078709,761740,2316969,2007_boxofficemojo_rankings.csv,2007,0.24742189014941002,0.7525781098505899
7982,3 Hearts,3077754,161129,2916625,2014_boxofficemojo_rankings.csv,2014,0.052352787129835585,0.9476472128701644
7983,Speed Zone,3077361,3077361,0,1989_boxofficemojo_rankings.csv,1989,1.0,0.0
7984,Dominick and Eugene,3076031,3076031,0,1988_boxofficemojo_rankings.csv,1988,1.0,0.0
7985,Ismael's Ghosts,3075562,102510,2973052,2017_boxofficemojo_rankings.csv,2017,0.03333049374390762,0.9666695062560924
7986,Living Is Easy with Eyes Closed,3075169,11600,3063569,2013_boxofficemojo_rankings.csv,2013,0.003772150408644208,0.9962278495913558
7987,Messenger of Death,3074681,3074681,0,1988_boxofficemojo_rankings.csv,1988,1.0,0.0
7988,The End of the Tour,3072991,3002884,70107,2015_boxofficemojo_rankings.csv,2015,0.9771860705091554,0.022813929490844587
7989,The Public Eye,3067917,3067917,0,1992_boxofficemojo_rankings.csv,1992,1.0,0.0
7990,Jane Got a Gun,3067531,1513793,1553738,2015_boxofficemojo_rankings.csv,2015,0.49348906335420895,0.506510936645791
7991,Princess Caraboo,3062530,3062530,0,1994_boxofficemojo_rankings.csv,1994,1.0,0.0
7992,'71,3062178,1270847,1791331,2014_boxofficemojo_rankings.csv,2014,0.4150140847462166,0.5849859152537834
7993,Malone,3060858,3060858,0,1987_boxofficemojo_rankings.csv,1987,1.0,0.0
7994,Remember,3054936,547009,2507927,2015_boxofficemojo_rankings.csv,2015,0.1790574336090838,0.8209425663909162
7995,CrissCross,3052738,3052738,0,1992_boxofficemojo_rankings.csv,1992,1.0,0.0
7996,Heavenly Creatures,3049135,3049135,0,1994_boxofficemojo_rankings.csv,1994,1.0,0.0
7997,Mambo Italiano,3047296,3047296,0,2003_boxofficemojo_rankings.csv,2003,1.0,0.0
7998,La moustache,3044771,244771,2800000,2005_boxofficemojo_rankings.csv,2005,0.08039061065676203,0.919609389343238
7999,The Witnesses,3041093,78440,2962653,2007_boxofficemojo_rankings.csv,2007,0.02579335784864192,0.9742066421513581
8000,Crumb,3041083,3041083,0,1995_boxofficemojo_rankings.csv,1995,1.0,0.0
8001,The Mother,3039587,1063163,1976424,2003_boxofficemojo_rankings.csv,2003,0.349772189445474,0.6502278105545259
8002,China Moon,3038499,3038499,0,1994_boxofficemojo_rankings.csv,1994,1.0,0.0
8003,Adam,3035915,2277396,758519,2009_boxofficemojo_rankings.csv,2009,0.7501514370461624,0.24984856295383764
8004,Harrison's Flowers,3033646,1871025,1162621,2002_boxofficemojo_rankings.csv,2002,0.6167578550694445,0.38324214493055553
8005,Innocence,3026796,2202382,824414,2001_boxofficemojo_rankings.csv,2001,0.7276281586205348,0.2723718413794653
8006,Starred Up,3025189,54915,2970274,2014_boxofficemojo_rankings.csv,2014,0.018152584846764946,0.981847415153235
8007,G,3020784,3020784,0,2005_boxofficemojo_rankings.csv,2005,1.0,0.0
8008,The Last Days of Disco,3020601,3020601,0,1998_boxofficemojo_rankings.csv,1998,1.0,0.0
8009,The Greatest Miracle,3019382,555166,2464216,2011_boxofficemojo_rankings.csv,2011,0.18386742717549484,0.8161325728245051
8010,All Is True,3019143,1200481,1818662,2019_boxofficemojo_rankings.csv,2019,0.3976231003301268,0.6023768996698732
8011,Top Gun 2013 3D Release,3018873,3018873,0,2013_boxofficemojo_rankings.csv,2013,1.0,0.0
8012,Rigor Mortis,3016904,7865,3009039,2013_boxofficemojo_rankings.csv,2013,0.0026069772190298397,0.9973930227809702
8013,Star Wars: Episode V - The Empire Strikes Back 2020 Re-release,3016382,2403000,613382,2020_boxofficemojo_rankings.csv,2020,0.7966497612039855,0.20335023879601458
8014,Basquiat,3011195,3011195,0,1996_boxofficemojo_rankings.csv,1996,1.0,0.0
8015,Cowboy Bebop: The Movie,3007903,1000045,2007858,2003_boxofficemojo_rankings.csv,2003,0.3324724899705875,0.6675275100294125
8016,The Last Metro,3007436,3007436,0,1981_boxofficemojo_rankings.csv,1981,1.0,0.0
8017,The Second Mother,3003560,376986,2626574,2015_boxofficemojo_rankings.csv,2015,0.1255130578380322,0.8744869421619678
8018,Isn't She Great,3003296,2962465,40831,2000_boxofficemojo_rankings.csv,2000,0.9864046034756481,0.013595396524351912
8019,The Imposter,3001877,898317,2103560,2012_boxofficemojo_rankings.csv,2012,0.2992517681437314,0.7007482318562686
8020,Sign 'o' the Times,3000073,3000073,0,1987_boxofficemojo_rankings.csv,1987,1.0,0.0
8021,Hanover Street,3000000,3000000,0,1979_boxofficemojo_rankings.csv,1979,1.0,0.0
8022,Running Brave,3000000,3000000,0,1983_boxofficemojo_rankings.csv,1983,1.0,0.0
8023,Made for More,2999134,2999134,0,2018_boxofficemojo_rankings.csv,2018,1.0,0.0
8024,Incredible Love,2998940,1445739,1553201,2009_boxofficemojo_rankings.csv,2009,0.4820833361120929,0.517916663887907
8025,Pinocchio Italian Version,2995810,8586,2987224,2003_boxofficemojo_rankings.csv,2003,0.002866002850648072,0.9971339971493519
8026,Bullies,2995527,2995527,0,1986_boxofficemojo_rankings.csv,1986,1.0,0.0
8027,ffolkes,2993772,2993772,0,1980_boxofficemojo_rankings.csv,1980,1.0,0.0
8028,Samoan Wedding,2993332,72244,2921088,2006_boxofficemojo_rankings.csv,2006,0.024134977342974318,0.9758650226570257
8029,The Corporation 2004 Re-release,2992149,1879983,1112166,2004_boxofficemojo_rankings.csv,2004,0.6283052749044249,0.3716947250955751
8030,Elsa & Fred,2985837,189024,2796813,2005_boxofficemojo_rankings.csv,2005,0.06330687174149158,0.9366931282585084
8031,Fright Night Part 2,2983784,2983784,0,1989_boxofficemojo_rankings.csv,1989,1.0,0.0
8032,Happiness,2982011,2982011,0,1998_boxofficemojo_rankings.csv,1998,1.0,0.0
8033,The Last Word,2982004,1783421,1198583,2017_boxofficemojo_rankings.csv,2017,0.5980612366717147,0.40193876332828526
8034,Darwin's Nightmare,2981713,203746,2777967,2005_boxofficemojo_rankings.csv,2005,0.06833186158426381,0.9316681384157361
8035,Memoir of War,2980982,103636,2877346,2018_boxofficemojo_rankings.csv,2018,0.034765724851743486,0.9652342751482565
8036,Love Is Strange 2014 Re-release,2979739,2262223,717516,2014_boxofficemojo_rankings.csv,2014,0.759201728742014,0.24079827125798603
8037,Love! Valour! Compassion!,2977807,2977807,0,1997_boxofficemojo_rankings.csv,1997,1.0,0.0
8038,The Challenge,2977706,2977706,0,1982_boxofficemojo_rankings.csv,1982,1.0,0.0
8039,Homicide,2971661,2971661,0,1991_boxofficemojo_rankings.csv,1991,1.0,0.0
8040,Clean,2971219,138711,2832508,2004_boxofficemojo_rankings.csv,2004,0.046684879169122166,0.9533151208308779
8041,Love Songs,2966934,104567,2862367,2007_boxofficemojo_rankings.csv,2007,0.035244127439302664,0.9647558725606974
8042,Romeo and Juliet,2966268,1162635,1803633,2013_boxofficemojo_rankings.csv,2013,0.39195210951943654,0.6080478904805634
8043,Donnie Darko,2962988,517375,2445613,2001_boxofficemojo_rankings.csv,2001,0.17461258702363966,0.8253874129763603
8044,Killshot,2961647,18643,2943004,2008_boxofficemojo_rankings.csv,2008,0.006294808260403755,0.9937051917395963
8045,976-EVIL,2955917,2955917,0,1989_boxofficemojo_rankings.csv,1989,1.0,0.0
8046,The Last: Naruto the Movie,2949185,524451,2424734,2015_boxofficemojo_rankings.csv,2015,0.17782912906447035,0.8221708709355297
8047,The Adventures of Milo and Otis,2948215,2948215,0,1989_boxofficemojo_rankings.csv,1989,1.0,0.0
8048,Turtle: The Incredible Journey,2945067,386073,2558994,2009_boxofficemojo_rankings.csv,2009,0.13109141489820095,0.868908585101799
8049,Shattered Glass,2944752,2220008,724744,2003_boxofficemojo_rankings.csv,2003,0.7538862355811288,0.24611376441887126
8050,Sibyl,2943278,0,2943278,2019_boxofficemojo_rankings.csv,2019,0.0,1.0
8051,Fearless,2942554,1288549,1654005,2010_boxofficemojo_rankings.csv,2010,0.4379015644232867,0.5620984355767132
8052,Filly Brown,2940411,2850357,90054,2013_boxofficemojo_rankings.csv,2013,0.9693736691911436,0.030626330808856312
8053,Metropolitan,2938208,2938208,0,1990_boxofficemojo_rankings.csv,1990,1.0,0.0
8054,"Careful, He Might Hear You",2938179,2938179,0,1984_boxofficemojo_rankings.csv,1984,1.0,0.0
8055,Shall We Kiss?,2936437,535499,2400938,2007_boxofficemojo_rankings.csv,2007,0.18236352423021504,0.8176364757697849
8056,Romance & Cigarettes,2935242,557471,2377771,2006_boxofficemojo_rankings.csv,2006,0.1899233521460922,0.8100766478539078
8057,Joan Rivers: A Piece of Work,2930687,2930687,0,2010_boxofficemojo_rankings.csv,2010,1.0,0.0
8058,The Lord of the Rings: The Fellowship of the Ring 2003 Extended Edition,2928554,1412056,1516498,2003_boxofficemojo_rankings.csv,2003,0.48216833290422506,0.5178316670957749
8059,Love Stinks,2924635,2924635,0,1999_boxofficemojo_rankings.csv,1999,1.0,0.0
8060,Waiting for Guffman,2923982,2923982,0,1997_boxofficemojo_rankings.csv,1997,1.0,0.0
8061,This Is My Life,2922094,2922094,0,1992_boxofficemojo_rankings.csv,1992,1.0,0.0
8062,My Architect,2920081,2750707,169374,2003_boxofficemojo_rankings.csv,2003,0.9419968144719273,0.05800318552807268
8063,Sylvia,2917393,1315498,1601895,2003_boxofficemojo_rankings.csv,2003,0.45091559484786586,0.5490844051521341
8064,Homework,2914328,2914328,0,1982_boxofficemojo_rankings.csv,1982,1.0,0.0
8065,Brighton Rock,2913599,229653,2683946,2011_boxofficemojo_rankings.csv,2011,0.07882107318131287,0.9211789268186872
8066,Crimes of Passion,2912945,2912945,0,1984_boxofficemojo_rankings.csv,1984,1.0,0.0
8067,The House That Jack Built,2911800,87993,2823807,2018_boxofficemojo_rankings.csv,2018,0.03021945188543169,0.9697805481145683
8068,Letters to God,2908893,2848578,60315,2010_boxofficemojo_rankings.csv,2010,0.9792653081429946,0.020734691857005397
8069,Bright Young Things,2905499,933637,1971862,2003_boxofficemojo_rankings.csv,2003,0.3213344764530981,0.6786655235469019
8070,Cradle Will Rock,2903404,2903404,0,1999_boxofficemojo_rankings.csv,1999,1.0,0.0
8071,Margot at the Wedding,2900156,1959420,940736,2007_boxofficemojo_rankings.csv,2007,0.6756257249610021,0.3243742750389979
8072,Midnight Madness,2900000,2900000,0,1980_boxofficemojo_rankings.csv,1980,1.0,0.0
8073,The Rental,2894793,1635345,1259448,2020_boxofficemojo_rankings.csv,2020,0.5649264040641248,0.4350735959358752
8074,Time to Leave,2893462,117686,2775776,2005_boxofficemojo_rankings.csv,2005,0.040673076059060044,0.95932692394094
8075,The East,2891812,2301839,589973,2013_boxofficemojo_rankings.csv,2013,0.7959850087073433,0.20401499129265666
8076,Married Life,2888315,1507990,1380325,2008_boxofficemojo_rankings.csv,2008,0.5221002556854083,0.4778997443145917
8077,The Warrior and the Sorceress,2886225,2886225,0,1984_boxofficemojo_rankings.csv,1984,1.0,0.0
8078,Phar Lap,2878404,2878404,0,1984_boxofficemojo_rankings.csv,1984,1.0,0.0
8079,The Oscar Nominated Short Films 2017: Live Action,2877797,2835355,42442,2017_boxofficemojo_rankings.csv,2017,0.9852519131822015,0.014748086817798475
8080,No Man's Land,2877571,2877571,0,1987_boxofficemojo_rankings.csv,1987,1.0,0.0
8081,Unzipped,2875086,2875086,0,1995_boxofficemojo_rankings.csv,1995,1.0,0.0
8082,Tetro,2874474,518522,2355952,2009_boxofficemojo_rankings.csv,2009,0.18038848151000844,0.8196115184899916
8083,Jinxed!,2869638,2869638,0,1982_boxofficemojo_rankings.csv,1982,1.0,0.0
8084,Gas,2869425,2869425,0,1981_boxofficemojo_rankings.csv,1981,1.0,0.0
8085,Maria By Callas,2869237,1267301,1601936,2017_boxofficemojo_rankings.csv,2017,0.4416857164465675,0.5583142835534325
8086,Another You,2865916,2865916,0,1991_boxofficemojo_rankings.csv,1991,1.0,0.0
8087,Starbuck,2865068,340058,2525010,2011_boxofficemojo_rankings.csv,2011,0.11869107469700545,0.8813089253029945
8088,Rappin',2864844,2864844,0,1985_boxofficemojo_rankings.csv,1985,1.0,0.0
8089,Modern Romance,2863642,2863642,0,1981_boxofficemojo_rankings.csv,1981,1.0,0.0
8090,Home Run,2861020,2861020,0,2013_boxofficemojo_rankings.csv,2013,1.0,0.0
8091,The Private Lives of Pippa Lee,2860973,337356,2523617,2009_boxofficemojo_rankings.csv,2009,0.11791652699973051,0.8820834730002695
8092,And Now Ladies & Gentlemen,2860785,736872,2123913,2002_boxofficemojo_rankings.csv,2002,0.25757685390548396,0.742423146094516
8093,eXistenZ,2856712,2856712,0,1999_boxofficemojo_rankings.csv,1999,1.0,0.0
8094,The Flowers of War,2855644,311434,2544210,2012_boxofficemojo_rankings.csv,2012,0.10905911241037047,0.8909408875896295
8095,The Man in the Moon,2853801,2853801,0,1991_boxofficemojo_rankings.csv,1991,1.0,0.0
8096,Inhumans,2852282,1521787,1330495,2017_boxofficemojo_rankings.csv,2017,0.5335331499480065,0.46646685005199345
8097,Rise: Blood Hunter,2850927,114306,2736621,2007_boxofficemojo_rankings.csv,2007,0.04009432721356948,0.9599056727864305
8098,The Salt of Life,2850852,317405,2533447,2011_boxofficemojo_rankings.csv,2011,0.1113368915678541,0.8886631084321459
8099,The Oscar Nominated Short Films 2016: Live Action,2850840,2816816,34024,2016_boxofficemojo_rankings.csv,2016,0.9880652719900099,0.011934728009990039
8100,Airborne,2850263,2850263,0,1993_boxofficemojo_rankings.csv,1993,1.0,0.0
8101,The Judas Project,2850135,2850135,0,1993_boxofficemojo_rankings.csv,1993,1.0,0.0
8102,God Bless the Broken Road,2848233,2846257,1976,2018_boxofficemojo_rankings.csv,2018,0.9993062365333173,0.0006937634666826766
8103,The Double Hour,2848165,1514942,1333223,2009_boxofficemojo_rankings.csv,2009,0.5319010661250314,0.4680989338749686
8104,Wah-Wah,2846148,234750,2611398,2006_boxofficemojo_rankings.csv,2006,0.08247989914790095,0.917520100852099
8105,All or Nothing,2845696,201546,2644150,2002_boxofficemojo_rankings.csv,2002,0.07082485268981648,0.9291751473101835
8106,Remember You,2845124,14814,2830310,2016_boxofficemojo_rankings.csv,2016,0.005206802937235776,0.9947931970627643
8107,Othello,2844379,2844379,0,1995_boxofficemojo_rankings.csv,1995,1.0,0.0
8108,"Moscow, Belgium",2842635,0,2842635,2008_boxofficemojo_rankings.csv,2008,0.0,1.0
8109,A Breath Away,2842040,77987,2764053,2018_boxofficemojo_rankings.csv,2018,0.027440500485566705,0.9725594995144333
8110,The Identical,2840991,2827666,13325,2014_boxofficemojo_rankings.csv,2014,0.9953097352297139,0.0046902647702861434
8111,Personal Shopper,2840408,1305195,1535213,2016_boxofficemojo_rankings.csv,2016,0.4595096901571887,0.5404903098428113
8112,Running on Empty,2835116,2835116,0,1988_boxofficemojo_rankings.csv,1988,1.0,0.0
8113,The Perez Family,2832826,2832826,0,1995_boxofficemojo_rankings.csv,1995,1.0,0.0
8114,Reservoir Dogs,2832029,2832029,0,1992_boxofficemojo_rankings.csv,1992,1.0,0.0
8115,Terribly Happy,2828984,170943,2658041,2008_boxofficemojo_rankings.csv,2008,0.06042558034969445,0.9395744196503055
8116,The Fluffy Movie: Unity Through Laughter,2827393,2827393,0,2014_boxofficemojo_rankings.csv,2014,1.0,0.0
8117,The Power of One,2827107,2827107,0,1992_boxofficemojo_rankings.csv,1992,1.0,0.0
8118,Sid and Nancy,2826523,2826523,0,1986_boxofficemojo_rankings.csv,1986,1.0,0.0
8119,A Coffee in Berlin,2826333,150275,2676058,2012_boxofficemojo_rankings.csv,2012,0.05316960174190373,0.9468303982580962
8120,Unforgettable,2821671,2821671,0,1996_boxofficemojo_rankings.csv,1996,1.0,0.0
8121,Everything Must Go,2820490,2711643,108847,2011_boxofficemojo_rankings.csv,2011,0.9614084786686001,0.03859152133139986
8122,Newsies,2819485,2819485,0,1992_boxofficemojo_rankings.csv,1992,1.0,0.0
8123,The Hudsucker Proxy,2816518,2816518,0,1994_boxofficemojo_rankings.csv,1994,1.0,0.0
8124,Raising Victor Vargas,2816116,2078661,737455,2003_boxofficemojo_rankings.csv,2003,0.7381304605350064,0.26186953946499364
8125,"Yor, the Hunter from the Future",2810199,2810199,0,1983_boxofficemojo_rankings.csv,1983,1.0,0.0
8126,Return to the Blue Lagoon,2807854,2807854,0,1991_boxofficemojo_rankings.csv,1991,1.0,0.0
8127,Map of the Human Heart,2806881,2806881,0,1993_boxofficemojo_rankings.csv,1993,1.0,0.0
8128,Loving Couples,2806659,2806659,0,1980_boxofficemojo_rankings.csv,1980,1.0,0.0
8129,In the Company of Men,2804473,2804473,0,1997_boxofficemojo_rankings.csv,1997,1.0,0.0
8130,Captive,2801508,2583301,218207,2015_boxofficemojo_rankings.csv,2015,0.9221108774274427,0.07788912257255735
8131,To the Wonder,2801166,587615,2213551,2013_boxofficemojo_rankings.csv,2013,0.20977514363661418,0.7902248563633858
8132,"Cinco de Mayo, La Batalla",2794852,173472,2621380,2013_boxofficemojo_rankings.csv,2013,0.06206840290648664,0.9379315970935134
8133,Heat,2793214,2793214,0,1987_boxofficemojo_rankings.csv,1987,1.0,0.0
8134,Year of the Comet,2791515,2791515,0,1992_boxofficemojo_rankings.csv,1992,1.0,0.0
8135,Fast Forward,2791350,2791350,0,1985_boxofficemojo_rankings.csv,1985,1.0,0.0
8136,After the Wedding,2790019,1574258,1215761,2019_boxofficemojo_rankings.csv,2019,0.564246336673693,0.4357536633263071
8137,When We Were Kings,2789985,2789985,0,1996_boxofficemojo_rankings.csv,1996,1.0,0.0
8138,Children of the Sea,2789668,0,2789668,2019_boxofficemojo_rankings.csv,2019,0.0,1.0
8139,Bon voyage 2004 Re-release,2788330,2354559,433771,2004_boxofficemojo_rankings.csv,2004,0.8444334063758594,0.1555665936241406
8140,Hexed,2786807,2786807,0,1993_boxofficemojo_rankings.csv,1993,1.0,0.0
8141,Kirk Cameron's Saving Christmas,2783970,2783970,0,2014_boxofficemojo_rankings.csv,2014,1.0,0.0
8142,24 Hour Party People,2781211,1184096,1597115,2002_boxofficemojo_rankings.csv,2002,0.4257483520667795,0.5742516479332205
8143,"My Daughter, My Angel",2780005,2779545,460,2007_boxofficemojo_rankings.csv,2007,0.9998345326717039,0.00016546732829617213
8144,Gleaming the Cube,2777280,2777280,0,1989_boxofficemojo_rankings.csv,1989,1.0,0.0
8145,Gabrielle,2775311,332829,2442482,2005_boxofficemojo_rankings.csv,2005,0.11992493814206769,0.8800750618579323
8146,Impulse,2773433,2773433,0,1984_boxofficemojo_rankings.csv,1984,1.0,0.0
8147,The Wonders,2772358,73378,2698980,2014_boxofficemojo_rankings.csv,2014,0.026467721701165577,0.9735322782988344
8148,Every Little Step,2769763,1725141,1044622,2008_boxofficemojo_rankings.csv,2008,0.6228478754319413,0.3771521245680587
8149,My Summer of Love,2766976,1000915,1766061,2004_boxofficemojo_rankings.csv,2004,0.3617360613174816,0.6382639386825184
8150,Dr. Jekyll and Ms. Hyde,2763020,2763020,0,1995_boxofficemojo_rankings.csv,1995,1.0,0.0
8151,Kinky Boots the Musical,2761654,900451,1861203,2019_boxofficemojo_rankings.csv,2019,0.3260549656111881,0.6739450343888119
8152,The Manchurian Candidate 1988 Re-release,2757256,2757256,0,1988_boxofficemojo_rankings.csv,1988,1.0,0.0
8153,When Did You Last See Your Father?,2752471,1077273,1675198,2007_boxofficemojo_rankings.csv,2007,0.3913839600853197,0.6086160399146803
8154,Comedian,2751988,2751988,0,2002_boxofficemojo_rankings.csv,2002,1.0,0.0
8155,Deadtime Stories,2750741,2750741,0,1986_boxofficemojo_rankings.csv,1986,1.0,0.0
8156,Ma vie en cinémascope,2750263,2750263,0,2004_boxofficemojo_rankings.csv,2004,1.0,0.0
8157,Freeriders,2750064,2750064,0,1998_boxofficemojo_rankings.csv,1998,1.0,0.0
8158,Battle for Incheon: Operation Chromite,2749918,1023348,1726570,2016_boxofficemojo_rankings.csv,2016,0.37213764192241366,0.6278623580775863
8159,Ben X,2744414,1601,2742813,2007_boxofficemojo_rankings.csv,2007,0.0005833667952429918,0.999416633204757
8160,Ararat,2743336,1555959,1187377,2002_boxofficemojo_rankings.csv,2002,0.5671776989767203,0.4328223010232797
8161,Desperate Hours,2742912,2742912,0,1990_boxofficemojo_rankings.csv,1990,1.0,0.0
8162,McQueen,2739246,1257275,1481971,2018_boxofficemojo_rankings.csv,2018,0.4589857939009494,0.5410142060990506
8163,Shadows and Fog,2735731,2735731,0,1992_boxofficemojo_rankings.csv,1992,1.0,0.0
8164,Hot Moves,2732684,2732684,0,1985_boxofficemojo_rankings.csv,1985,1.0,0.0
8165,Edie,2731170,71790,2659380,2018_boxofficemojo_rankings.csv,2018,0.02628543810894232,0.9737145618910577
8166,XXY,2728869,48334,2680535,2007_boxofficemojo_rankings.csv,2007,0.017712099774668554,0.9822879002253314
8167,Lucky,2728446,955925,1772521,2017_boxofficemojo_rankings.csv,2017,0.35035511056476837,0.6496448894352316
8168,Sukiyaki Western Django,2725258,50659,2674599,2007_boxofficemojo_rankings.csv,2007,0.01858869875806254,0.9814113012419374
8169,Control Room,2724826,2589616,135210,2004_boxofficemojo_rankings.csv,2004,0.9503784828829437,0.049621517117056285
8170,Cocktail,2724695,1227789,1496906,2012_boxofficemojo_rankings.csv,2012,0.4506152064726511,0.5493847935273489
8171,The Color of Paradise,2724595,1817216,907379,2000_boxofficemojo_rankings.csv,2000,0.6669673841433313,0.3330326158566686
8172,Hunger,2724474,154084,2570390,2008_boxofficemojo_rankings.csv,2008,0.05655550392479429,0.9434444960752058
8173,O Jerusalem,2724303,234480,2489823,2006_boxofficemojo_rankings.csv,2006,0.08606972131954485,0.9139302786804552
8174,Chi-Raq,2719699,2653032,66667,2015_boxofficemojo_rankings.csv,2015,0.9754873609175133,0.0245126390824867
8175,Billionaire Boys Club,2713955,1349,2712606,2018_boxofficemojo_rankings.csv,2018,0.0004970605629054277,0.9995029394370946
8176,Straight Out of Brooklyn,2712293,2712293,0,1991_boxofficemojo_rankings.csv,1991,1.0,0.0
8177,What Maisie Knew,2711379,1066471,1644908,2013_boxofficemojo_rankings.csv,2013,0.3933315851454186,0.6066684148545813
8178,Factotum,2708087,808221,1899866,2005_boxofficemojo_rankings.csv,2005,0.2984472064597629,0.701552793540237
8179,Bobby Jones: Stroke of Genius,2707913,2694071,13842,2004_boxofficemojo_rankings.csv,2004,0.9948883143586962,0.005111685641303838
8180,Up and Down,2705163,245127,2460036,2004_boxofficemojo_rankings.csv,2004,0.09061450271203621,0.9093854972879638
8181,Auto Focus,2704951,2063196,641755,2002_boxofficemojo_rankings.csv,2002,0.7627480128105832,0.23725198718941673
8182,The Show,2702578,2702578,0,1995_boxofficemojo_rankings.csv,1995,1.0,0.0
8183,The Guest,2700051,332890,2367161,2014_boxofficemojo_rankings.csv,2014,0.12329026377649904,0.876709736223501
8184,The Allnighter,2700000,2700000,0,1987_boxofficemojo_rankings.csv,1987,1.0,0.0
8185,Gangsterdam,2697522,954,2696568,2017_boxofficemojo_rankings.csv,2017,0.0003536579127065507,0.9996463420872934
8186,The Scout,2694234,2694234,0,1994_boxofficemojo_rankings.csv,1994,1.0,0.0
8187,The Best of Youth,2693053,274024,2419029,2003_boxofficemojo_rankings.csv,2003,0.10175217494791228,0.8982478250520878
8188,Jiro Dreams of Sushi,2692864,2552478,140386,2012_boxofficemojo_rankings.csv,2012,0.9478674006559559,0.05213259934404411
8189,Blind Fury,2692037,2692037,0,1990_boxofficemojo_rankings.csv,1990,1.0,0.0
8190,Thérèse: The Story of Saint Thérèse of Lisieux,2689828,2627016,62812,2004_boxofficemojo_rankings.csv,2004,0.976648321007886,0.023351678992113992
8191,Infamous,2689799,1151330,1538469,2006_boxofficemojo_rankings.csv,2006,0.4280357008088708,0.5719642991911291
8192,A Hijacking,2688444,414437,2274007,2012_boxofficemojo_rankings.csv,2012,0.15415496845015184,0.8458450315498481
8193,The Bear,2687148,2687148,0,1984_boxofficemojo_rankings.csv,1984,1.0,0.0
8194,Bad Medicine,2685453,2685453,0,1985_boxofficemojo_rankings.csv,1985,1.0,0.0
8195,Richard III,2684904,2684904,0,1995_boxofficemojo_rankings.csv,1995,1.0,0.0
8196,Prom Night II,2683519,2683519,0,1987_boxofficemojo_rankings.csv,1987,1.0,0.0
8197,Magic in the Water,2680717,2680717,0,1995_boxofficemojo_rankings.csv,1995,1.0,0.0
8198,"After Dark, My Sweet",2678414,2678414,0,1990_boxofficemojo_rankings.csv,1990,1.0,0.0
8199,Redbelt,2674090,2345941,328149,2008_boxofficemojo_rankings.csv,2008,0.8772857308467553,0.12271426915324465
8200,Intimacy,2672527,405094,2267433,2001_boxofficemojo_rankings.csv,2001,0.1515771402870766,0.8484228597129234
8201,Playing for Keeps,2669366,2669366,0,1986_boxofficemojo_rankings.csv,1986,1.0,0.0
8202,The Final Option,2666873,2666873,0,1983_boxofficemojo_rankings.csv,1983,1.0,0.0
8203,Crash,2664812,2664812,0,1996_boxofficemojo_rankings.csv,1996,1.0,0.0
8204,In Your Name,2663172,0,2663172,2003_boxofficemojo_rankings.csv,2003,0.0,1.0
8205,The Evil Dead,2661944,2400000,261944,1983_boxofficemojo_rankings.csv,1983,0.9015967278049426,0.09840327219505744
8206,The Cup,2660645,0,2660645,2011_boxofficemojo_rankings.csv,2011,0.0,1.0
8207,Ava,2657900,377037,2280863,2020_boxofficemojo_rankings.csv,2020,0.14185522404906128,0.8581447759509387
8208,Diego Maradona,2656890,0,2656890,2019_boxofficemojo_rankings.csv,2019,0.0,1.0
8209,Speechless,2655669,73819,2581850,2007_boxofficemojo_rankings.csv,2007,0.027796762322412922,0.9722032376775871
8210,Kids in the Hall: Brain Candy,2654308,2654308,0,1996_boxofficemojo_rankings.csv,1996,1.0,0.0
8211,The Mighty,2652246,2652246,0,1998_boxofficemojo_rankings.csv,1998,1.0,0.0
8212,Camp,2650356,1629862,1020494,2003_boxofficemojo_rankings.csv,2003,0.6149596507035281,0.38504034929647185
8213,Hillsong: Let Hope Rise,2649761,2394386,255375,2016_boxofficemojo_rankings.csv,2016,0.9036233833919362,0.0963766166080639
8214,Twelve,2648195,183920,2464275,2010_boxofficemojo_rankings.csv,2010,0.06945107894244948,0.9305489210575505
8215,Pioneer,2647820,6871,2640949,2013_boxofficemojo_rankings.csv,2013,0.0025949649145334654,0.9974050350854665
8216,One Night Stand,2642983,2642983,0,1997_boxofficemojo_rankings.csv,1997,1.0,0.0
8217,Naked Lunch,2641357,2641357,0,1991_boxofficemojo_rankings.csv,1991,1.0,0.0
8218,Stories We Tell,2641053,1600145,1040908,2013_boxofficemojo_rankings.csv,2013,0.6058738692483642,0.39412613075163583
8219,God's Army,2637726,2637726,0,2000_boxofficemojo_rankings.csv,2000,1.0,0.0
8220,Find Me Guilty,2636637,1173643,1462994,2006_boxofficemojo_rankings.csv,2006,0.44512877578521426,0.5548712242147857
8221,Imagine Me & You,2635305,672243,1963062,2006_boxofficemojo_rankings.csv,2006,0.2550911564316085,0.7449088435683915
8222,Everyone Else,2634462,102042,2532420,2009_boxofficemojo_rankings.csv,2009,0.03873352509924227,0.9612664749007577
8223,Beautiful Accident,2632092,51766,2580326,2017_boxofficemojo_rankings.csv,2017,0.01966724567378344,0.9803327543262166
8224,Maniac,2631275,31081,2600194,2012_boxofficemojo_rankings.csv,2012,0.011812144302666958,0.988187855697333
8225,Voices,2631244,2631244,0,1979_boxofficemojo_rankings.csv,1979,1.0,0.0
8226,The Idolmaker,2625716,2625716,0,1980_boxofficemojo_rankings.csv,1980,1.0,0.0
8227,Third Person,2624761,1021398,1603363,2014_boxofficemojo_rankings.csv,2014,0.3891394302185989,0.610860569781401
8228,Youth Without Youth,2624759,244397,2380362,2007_boxofficemojo_rankings.csv,2007,0.09311216763139016,0.9068878323686098
8229,Below,2622015,605562,2016453,2002_boxofficemojo_rankings.csv,2002,0.23095291216869468,0.7690470878313053
8230,The Happy Prince,2621992,466440,2155552,2018_boxofficemojo_rankings.csv,2018,0.17789527961946489,0.8221047203805351
8231,The Informer,2620824,0,2620824,2019_boxofficemojo_rankings.csv,2019,0.0,1.0
8232,Happy End,2610794,301718,2309076,2017_boxofficemojo_rankings.csv,2017,0.11556560954253764,0.8844343904574624
8233,The Little Mermaid,2610742,147175,2463567,2018_boxofficemojo_rankings.csv,2018,0.05637286258082951,0.9436271374191705
8234,Russian Ark Canadian Release,2610711,684034,1926677,2003_boxofficemojo_rankings.csv,2003,0.2620106170311459,0.7379893829688541
8235,Heathcliff: The Movie,2610686,2610686,0,1986_boxofficemojo_rankings.csv,1986,1.0,0.0
8236,The Care Bears Adventure in Wonderland,2608000,2608000,0,1987_boxofficemojo_rankings.csv,1987,1.0,0.0
8237,Raise the Red Lantern,2603061,2603061,0,1992_boxofficemojo_rankings.csv,1992,1.0,0.0
8238,Poster Boys,2602256,97049,2505207,2017_boxofficemojo_rankings.csv,2017,0.03729417858965452,0.9627058214103454
8239,The Air I Breathe,2597648,25775,2571873,2007_boxofficemojo_rankings.csv,2007,0.009922437528102344,0.9900775624718977
8240,N-Secure,2595644,2595644,0,2010_boxofficemojo_rankings.csv,2010,1.0,0.0
8241,The Signal,2595622,600896,1994726,2014_boxofficemojo_rankings.csv,2014,0.23150366270589476,0.7684963372941053
8242,But I'm a Cheerleader,2595216,2205627,389589,2000_boxofficemojo_rankings.csv,2000,0.849881859544639,0.15011814045536095
8243,It's Easier for a Camel...,2590219,16150,2574069,2003_boxofficemojo_rankings.csv,2003,0.006234994029462373,0.9937650059705376
8244,City of Men,2589732,325131,2264601,2007_boxofficemojo_rankings.csv,2007,0.12554619551366705,0.8744538044863329
8245,Leo Da Vinci: Mission Mona Lisa,2588859,19978,2568881,2018_boxofficemojo_rankings.csv,2018,0.007716913126593608,0.9922830868734064
8246,A Question of Faith,2587072,2587072,0,2017_boxofficemojo_rankings.csv,2017,1.0,0.0
8247,House of Games,2585639,2585639,0,1987_boxofficemojo_rankings.csv,1987,1.0,0.0
8248,Blancanieves,2585522,279735,2305787,2012_boxofficemojo_rankings.csv,2012,0.10819285235244566,0.8918071476475543
8249,Assassination Nation,2584988,2005142,579846,2018_boxofficemojo_rankings.csv,2018,0.7756871598630245,0.2243128401369755
8250,Metallica & San Francisco Symphony - S&M2,2582847,1252385,1330462,2019_boxofficemojo_rankings.csv,2019,0.4848854771498273,0.5151145228501727
8251,Love and Death on Long Island,2581012,2581012,0,1998_boxofficemojo_rankings.csv,1998,1.0,0.0
8252,The Nightmare Before Christmas 2009 3D Release,2578558,1109188,1469370,2008_boxofficemojo_rankings.csv,2008,0.43015825123964635,0.5698417487603537
8253,Brassed Off,2576331,2576331,0,1997_boxofficemojo_rankings.csv,1997,1.0,0.0
8254,After Dark's Horror Fest: 8 Films to Die For,2575000,2575000,0,2006_boxofficemojo_rankings.csv,2006,1.0,0.0
8255,The Polar Express 2007 IMAX Release,2574903,2483757,91146,2007_boxofficemojo_rankings.csv,2007,0.9646021617124995,0.03539783828750054
8256,The Gatekeepers,2573616,2415727,157889,2013_boxofficemojo_rankings.csv,2013,0.9386509098482446,0.06134909015175535
8257,It Came from Hollywood,2573342,2573342,0,1982_boxofficemojo_rankings.csv,1982,1.0,0.0
8258,Calendar Girl,2570550,2570550,0,1993_boxofficemojo_rankings.csv,1993,1.0,0.0
8259,Is Genesis History?,2570392,2570392,0,2017_boxofficemojo_rankings.csv,2017,1.0,0.0
8260,Maquia: When the Promised Flower Blooms 2018 Re-release,2569927,18539,2551388,2018_boxofficemojo_rankings.csv,2018,0.007213823583315791,0.9927861764166842
8261,The Cure,2568425,2568425,0,1995_boxofficemojo_rankings.csv,1995,1.0,0.0
8262,18 Again!,2567099,2567099,0,1988_boxofficemojo_rankings.csv,1988,1.0,0.0
8263,Blood Ties,2566435,42472,2523963,2013_boxofficemojo_rankings.csv,2013,0.016549026178336874,0.9834509738216631
8264,Maxie,2564278,2564278,0,1985_boxofficemojo_rankings.csv,1985,1.0,0.0
8265,Waves,2563497,1658790,904707,2019_boxofficemojo_rankings.csv,2019,0.6470809211011365,0.35291907889886354
8266,Young Adam,2561820,767373,1794447,2003_boxofficemojo_rankings.csv,2003,0.2995421223973581,0.7004578776026419
8267,God's Own Country,2559939,335609,2224330,2017_boxofficemojo_rankings.csv,2017,0.1311003895014686,0.8688996104985314
8268,Lucky Break,2559317,54606,2504711,2001_boxofficemojo_rankings.csv,2001,0.021336161171124954,0.9786638388288751
8269,Under the Volcano,2556800,2556800,0,1984_boxofficemojo_rankings.csv,1984,1.0,0.0
8270,The Men's Club,2556361,2556361,0,1986_boxofficemojo_rankings.csv,1986,1.0,0.0
8271,Management,2555950,934658,1621292,2009_boxofficemojo_rankings.csv,2009,0.36567929732584753,0.6343207026741524
8272,King of New York,2554476,2554476,0,1990_boxofficemojo_rankings.csv,1990,1.0,0.0
8273,The Only Living Boy in New York,2550321,624332,1925989,2017_boxofficemojo_rankings.csv,2017,0.2448052617690087,0.7551947382309914
8274,"1,000 Times Good Night",2549568,53895,2495673,2013_boxofficemojo_rankings.csv,2013,0.021138875291814144,0.9788611247081859
8275,Streets of Gold,2546238,2546238,0,1986_boxofficemojo_rankings.csv,1986,1.0,0.0
8276,True Stories,2545142,2545142,0,1986_boxofficemojo_rankings.csv,1986,1.0,0.0
8277,Disney's Newsies: The Broadway Musical!,2545060,2545060,0,2017_boxofficemojo_rankings.csv,2017,1.0,0.0
8278,The Dinner,2544921,1323312,1221609,2017_boxofficemojo_rankings.csv,2017,0.5199815632783886,0.4800184367216114
8279,Impulse,2544504,2544504,0,1990_boxofficemojo_rankings.csv,1990,1.0,0.0
8280,The Man of My Life,2542577,7704,2534873,2006_boxofficemojo_rankings.csv,2006,0.003029996731662404,0.9969700032683376
8281,El Jeremías,2540144,650465,1889679,2016_boxofficemojo_rankings.csv,2016,0.25607406509237274,0.7439259349076273
8282,In the Name of My Daughter,2537899,277528,2260371,2014_boxofficemojo_rankings.csv,2014,0.10935344550748473,0.8906465544925153
8283,The King of Comedy,2536242,2536242,0,1983_boxofficemojo_rankings.csv,1983,1.0,0.0
8284,Novocaine,2534372,2036682,497690,2001_boxofficemojo_rankings.csv,2001,0.8036239352391835,0.19637606476081648
8285,IN OUR HANDS: Battle for Jerusalem,2534370,2534370,0,2017_boxofficemojo_rankings.csv,2017,1.0,0.0
8286,Shi,2533089,356149,2176940,2010_boxofficemojo_rankings.csv,2010,0.14059869195278965,0.8594013080472104
8287,Spirits in the Forest,2531785,704744,1827041,2019_boxofficemojo_rankings.csv,2019,0.2783585494028916,0.7216414505971084
8288,Bucky Larson: Born to Be a Star,2530394,2529395,999,2011_boxofficemojo_rankings.csv,2011,0.9996051998226363,0.00039480017736368326
8289,A Private Function,2527088,2527088,0,1985_boxofficemojo_rankings.csv,1985,1.0,0.0
8290,Quinceañera,2522787,1692693,830094,2006_boxofficemojo_rankings.csv,2006,0.6709615199380685,0.3290384800619315
8291,Lonely Hearts,2520835,188565,2332270,2006_boxofficemojo_rankings.csv,2006,0.0748025951718379,0.9251974048281622
8292,Ittefaq,2520487,298032,2222455,2017_boxofficemojo_rankings.csv,2017,0.11824381558008433,0.8817561844199157
8293,A Stranger Is Watching,2519559,2519559,0,1982_boxofficemojo_rankings.csv,1982,1.0,0.0
8294,Restless,2518012,163265,2354747,2011_boxofficemojo_rankings.csv,2011,0.06483884906029042,0.9351611509397095
8295,Aces: Iron Eagle III,2517600,2517600,0,1992_boxofficemojo_rankings.csv,1992,1.0,0.0
8296,Birds of Passage,2517405,507259,2010146,2018_boxofficemojo_rankings.csv,2018,0.2015007517662037,0.7984992482337963
8297,Fateless,2512009,196857,2315152,2005_boxofficemojo_rankings.csv,2005,0.07836635935619657,0.9216336406438034
8298,Reform School Girls,2510433,2510433,0,1986_boxofficemojo_rankings.csv,1986,1.0,0.0
8299,LBJ,2510151,2470979,39172,2017_boxofficemojo_rankings.csv,2017,0.9843945643110713,0.015605435688928674
8300,The Rover,2510007,1114423,1395584,2014_boxofficemojo_rankings.csv,2014,0.44399198886696334,0.5560080111330367
8301,Marie,2507995,2507995,0,1985_boxofficemojo_rankings.csv,1985,1.0,0.0
8302,Grace Unplugged,2507201,2507201,0,2013_boxofficemojo_rankings.csv,2013,1.0,0.0
8303,Words on Bathroom Walls,2505457,2505457,0,2020_boxofficemojo_rankings.csv,2020,1.0,0.0
8304,Still Life,2504465,76983,2427482,2006_boxofficemojo_rankings.csv,2006,0.030738301393710834,0.9692616986062892
8305,I'm in Love with a Church Girl,2503392,2387730,115662,2013_boxofficemojo_rankings.csv,2013,0.953797887026882,0.046202112973118076
8306,Red Rock West,2502551,2502551,0,1994_boxofficemojo_rankings.csv,1994,1.0,0.0
8307,The Black Marble,2500000,2500000,0,1980_boxofficemojo_rankings.csv,1980,1.0,0.0
8308,P.O.W. the Escape,2497233,2497233,0,1986_boxofficemojo_rankings.csv,1986,1.0,0.0
8309,The Queen of Versailles,2495706,2401999,93707,2012_boxofficemojo_rankings.csv,2012,0.9624527087725878,0.037547291227412204
8310,Still Life,2495025,9481,2485544,2013_boxofficemojo_rankings.csv,2013,0.0037999619242292163,0.9962000380757707
8311,Rumble Fish,2494480,2494480,0,1983_boxofficemojo_rankings.csv,1983,1.0,0.0
8312,Desert Hearts,2492088,2492088,0,1986_boxofficemojo_rankings.csv,1986,1.0,0.0
8313,The Stupids,2491989,2491989,0,1996_boxofficemojo_rankings.csv,1996,1.0,0.0
8314,"Silent Night, Deadly Night",2491460,2491460,0,1984_boxofficemojo_rankings.csv,1984,1.0,0.0
8315,Choose Me,2490233,2490233,0,1984_boxofficemojo_rankings.csv,1984,1.0,0.0
8316,Look Both Ways,2490011,105067,2384944,2005_boxofficemojo_rankings.csv,2005,0.04219539592395375,0.9578046040760463
8317,The Stepfather,2488740,2488740,0,1987_boxofficemojo_rankings.csv,1987,1.0,0.0
8318,Moonlight and Valentino,2484226,2484226,0,1995_boxofficemojo_rankings.csv,1995,1.0,0.0
8319,13B: Fear Has a New Address,2482072,36594,2445478,2009_boxofficemojo_rankings.csv,2009,0.014743327349085764,0.9852566726509142
8320,"One Nation, One King",2481681,6576,2475105,2018_boxofficemojo_rankings.csv,2018,0.0026498167975658434,0.9973501832024342
8321,Cairo Time,2477315,1603616,873699,2010_boxofficemojo_rankings.csv,2010,0.6473201833436604,0.35267981665633963
8322,The Christmas Candle,2476775,2258620,218155,2013_boxofficemojo_rankings.csv,2013,0.9119197343319437,0.08808026566805624
8323,Tuya's Marriage,2476766,88148,2388618,2007_boxofficemojo_rankings.csv,2007,0.035589958841489265,0.9644100411585107
8324,Jefferson in Paris,2473668,2473668,0,1995_boxofficemojo_rankings.csv,1995,1.0,0.0
8325,Wonderland,2466444,1060512,1405932,2003_boxofficemojo_rankings.csv,2003,0.42997611135707925,0.5700238886429208
8326,Afterglow,2465960,2465960,0,1997_boxofficemojo_rankings.csv,1997,1.0,0.0
8327,Bamboozled,2463650,2274979,188671,2000_boxofficemojo_rankings.csv,2000,0.9234180991618127,0.07658190083818724
8328,Just Another Love Story,2460360,45835,2414525,2007_boxofficemojo_rankings.csv,2007,0.018629387569298803,0.9813706124307012
8329,Ask the Dust,2460057,743847,1716210,2006_boxofficemojo_rankings.csv,2006,0.30236982313824434,0.6976301768617557
8330,Class of 1999,2459895,2459895,0,1990_boxofficemojo_rankings.csv,1990,1.0,0.0
8331,Queen to Play,2456722,478710,1978012,2009_boxofficemojo_rankings.csv,2009,0.1948572121713405,0.8051427878286594
8332,Last Days,2456454,463080,1993374,2005_boxofficemojo_rankings.csv,2005,0.1885156408383792,0.8114843591616208
8333,Painted Skin: The Resurrection,2455359,50425,2404934,2012_boxofficemojo_rankings.csv,2012,0.020536711739505303,0.9794632882604947
8334,The Endurance,2453083,2453083,0,2001_boxofficemojo_rankings.csv,2001,1.0,0.0
8335,Piku,2452343,1801807,650536,2015_boxofficemojo_rankings.csv,2015,0.7347287879387182,0.2652712120612818
8336,Crime Spree,2451607,0,2451607,2003_boxofficemojo_rankings.csv,2003,0.0,1.0
8337,My Beautiful Laundrette,2451545,2451545,0,1986_boxofficemojo_rankings.csv,1986,1.0,0.0
8338,Footnote,2451259,2007758,443501,2011_boxofficemojo_rankings.csv,2011,0.819072158429607,0.18092784157039302
8339,The Tree,2450045,71158,2378887,2010_boxofficemojo_rankings.csv,2010,0.029043548179727312,0.9709564518202727
8340,The Hand,2447576,2447576,0,1981_boxofficemojo_rankings.csv,1981,1.0,0.0
8341,Côte d'Azur,2447211,141039,2306172,2005_boxofficemojo_rankings.csv,2005,0.057632545783751384,0.9423674542162486
8342,Love at First Fight,2446362,25229,2421133,2014_boxofficemojo_rankings.csv,2014,0.010312864571964411,0.9896871354280355
8343,Lean on Pete,2443584,1163056,1280528,2018_boxofficemojo_rankings.csv,2018,0.47596317540137767,0.5240368245986223
8344,The Man Who Wasn't There,2443487,2443487,0,1983_boxofficemojo_rankings.csv,1983,1.0,0.0
8345,Highwaymen,2442378,371396,2070982,2004_boxofficemojo_rankings.csv,2004,0.15206327603671504,0.847936723963285
8346,Ricky,2440234,3457,2436777,2009_boxofficemojo_rankings.csv,2009,0.0014166674179607365,0.9985833325820392
8347,Table for Five,2439705,2439705,0,1983_boxofficemojo_rankings.csv,1983,1.0,0.0
8348,A Family Secret,2438422,2438422,0,2006_boxofficemojo_rankings.csv,2006,1.0,0.0
8349,Maurice,2438304,2438304,0,1987_boxofficemojo_rankings.csv,1987,1.0,0.0
8350,"Hey There, It's Yogi Bear",2438233,2438233,0,1986_boxofficemojo_rankings.csv,1986,1.0,0.0
8351,Son of the Pink Panther,2438031,2438031,0,1993_boxofficemojo_rankings.csv,1993,1.0,0.0
8352,Stranger Than Paradise,2436000,2436000,0,1984_boxofficemojo_rankings.csv,1984,1.0,0.0
8353,Coriolanus,2435325,757195,1678130,2012_boxofficemojo_rankings.csv,2012,0.31092154024616836,0.6890784597538316
8354,Tough Enough,2433722,2433722,0,1983_boxofficemojo_rankings.csv,1983,1.0,0.0
8355,The Unknown Girl,2432640,150549,2282091,2016_boxofficemojo_rankings.csv,2016,0.061887085635359114,0.9381129143646408
8356,Kansas,2432536,2432536,0,1988_boxofficemojo_rankings.csv,1988,1.0,0.0
8357,Joe,2431443,373375,2058068,2014_boxofficemojo_rankings.csv,2014,0.15356107463757118,0.8464389253624288
8358,The Grace Card,2430735,2430735,0,2011_boxofficemojo_rankings.csv,2011,1.0,0.0
8359,The Breadwinner 2018 Re-release,2426907,834,2426073,2018_boxofficemojo_rankings.csv,2018,0.0003436472843829615,0.999656352715617
8360,The Secret: Dare to Dream,2423478,0,2423478,2020_boxofficemojo_rankings.csv,2020,0.0,1.0
8361,Life of Riley,2423379,11616,2411763,2014_boxofficemojo_rankings.csv,2014,0.004793307196274293,0.9952066928037258
8362,The Matrix Reloaded 2003 IMAX Release,2423288,0,2423288,2003_boxofficemojo_rankings.csv,2003,0.0,1.0
8363,After.Life,2422634,108595,2314039,2010_boxofficemojo_rankings.csv,2010,0.044825177884897184,0.9551748221151029
8364,Adam's Apples,2421577,1305,2420272,2005_boxofficemojo_rankings.csv,2005,0.0005389050193324433,0.9994610949806676
8365,Farewell to the King,2420917,2420917,0,1989_boxofficemojo_rankings.csv,1989,1.0,0.0
8366,If Lucy Fell,2420162,2420162,0,1996_boxofficemojo_rankings.csv,1996,1.0,0.0
8367,Hearts Beat Loud,2417165,2386251,30914,2018_boxofficemojo_rankings.csv,2018,0.9872106372548005,0.012789362745199439
8368,Torremolinos 73,2416771,87385,2329386,2003_boxofficemojo_rankings.csv,2003,0.03615774932751179,0.9638422506724882
8369,Career Girls,2416734,2416734,0,1997_boxofficemojo_rankings.csv,1997,1.0,0.0
8370,Riddle,2415975,1409499,1006476,2005_boxofficemojo_rankings.csv,2005,0.5834079408934281,0.4165920591065719
8371,Flirting,2415396,2415396,0,1992_boxofficemojo_rankings.csv,1992,1.0,0.0
8372,Body Chemistry,2415312,2415312,0,1990_boxofficemojo_rankings.csv,1990,1.0,0.0
8373,The Art of Self-Defense,2414269,2410914,3355,2019_boxofficemojo_rankings.csv,2019,0.9986103454089001,0.0013896545910998318
8374,Dead of Winter,2413427,2413427,0,1987_boxofficemojo_rankings.csv,1987,1.0,0.0
8375,The Oscar Nominated Short Films 2015: Live Action,2412593,2412593,0,2015_boxofficemojo_rankings.csv,2015,1.0,0.0
8376,Wanda Nevada,2411145,2411145,0,1979_boxofficemojo_rankings.csv,1979,1.0,0.0
8377,A Sunday in the Country,2411143,2411143,0,1984_boxofficemojo_rankings.csv,1984,1.0,0.0
8378,Sunburn,2410776,2410776,0,1979_boxofficemojo_rankings.csv,1979,1.0,0.0
8379,Lawnmower Man 2: Beyond Cyberspace,2409225,2409225,0,1996_boxofficemojo_rankings.csv,1996,1.0,0.0
8380,The Marsh,2408452,336,2408116,2007_boxofficemojo_rankings.csv,2007,0.00013950869687251395,0.9998604913031275
8381,Beloved Sisters,2407680,54030,2353650,2014_boxofficemojo_rankings.csv,2014,0.022440689792663476,0.9775593102073366
8382,The Kindred,2407024,2407024,0,1987_boxofficemojo_rankings.csv,1987,1.0,0.0
8383,Horsemen,2405815,0,2405815,2009_boxofficemojo_rankings.csv,2009,0.0,1.0
8384,Fish Tank,2404300,374675,2029625,2009_boxofficemojo_rankings.csv,2009,0.15583537828058064,0.8441646217194194
8385,Gone with the Wind 1989 Re-release,2403316,2403316,0,1989_boxofficemojo_rankings.csv,1989,1.0,0.0
8386,Sound! Euphonium the Movie - Our Promise: A Brand New Day,2403030,90341,2312689,2019_boxofficemojo_rankings.csv,2019,0.037594620125424985,0.962405379874575
8387,The Stroller Strategy,2401291,3462,2397829,2013_boxofficemojo_rankings.csv,2013,0.0014417244723775669,0.9985582755276224
8388,The Race Against Time,2395616,815064,1580552,2005_boxofficemojo_rankings.csv,2005,0.3402314895208581,0.6597685104791419
8389,Kalifornia,2395231,2395231,0,1993_boxofficemojo_rankings.csv,1993,1.0,0.0
8390,Backbeat,2392589,2392589,0,1994_boxofficemojo_rankings.csv,1994,1.0,0.0
8391,Dangerously Close,2390525,2390525,0,1986_boxofficemojo_rankings.csv,1986,1.0,0.0
8392,The Man Who Killed Don Quixote,2390383,391963,1998420,2018_boxofficemojo_rankings.csv,2018,0.1639749780683681,0.8360250219316319
8393,Twilight/New Moon,2385237,2385237,0,2010_boxofficemojo_rankings.csv,2010,1.0,0.0
8394,Finding Vivian Maier,2384584,1514782,869802,2014_boxofficemojo_rankings.csv,2014,0.6352395218620942,0.3647604781379058
8395,Dark Blue World,2381183,258771,2122412,2001_boxofficemojo_rankings.csv,2001,0.10867329390475239,0.8913267060952477
8396,The Basketball Diaries,2381087,2381087,0,1995_boxofficemojo_rankings.csv,1995,1.0,0.0
8397,Laggies,2379154,1066981,1312173,2014_boxofficemojo_rankings.csv,2014,0.44847075893363775,0.5515292410663623
8398,Journey,2377609,2377609,0,2003_boxofficemojo_rankings.csv,2003,1.0,0.0
8399,Buffalo '66,2375097,2375097,0,1998_boxofficemojo_rankings.csv,1998,1.0,0.0
8400,Red Lights,2373828,673828,1700000,2004_boxofficemojo_rankings.csv,2004,0.2838571286546456,0.7161428713453544
8401,Smilla's Sense of Snow,2372903,2372903,0,1997_boxofficemojo_rankings.csv,1997,1.0,0.0
8402,The Pillow Book,2372744,2372744,0,1997_boxofficemojo_rankings.csv,1997,1.0,0.0
8403,I Wish,2371548,145808,2225740,2011_boxofficemojo_rankings.csv,2011,0.06148220487209198,0.938517795127908
8404,A Little Sex,2370376,2370376,0,1982_boxofficemojo_rankings.csv,1982,1.0,0.0
8405,Lore,2362019,970325,1391694,2012_boxofficemojo_rankings.csv,2012,0.4108032153848043,0.5891967846151958
8406,Cake,2360281,1951776,408505,2015_boxofficemojo_rankings.csv,2015,0.8269252686438606,0.17307473135613938
8407,Desi Boyz,2355293,1078826,1276467,2011_boxofficemojo_rankings.csv,2011,0.4580432243461854,0.5419567756538146
8408,Chico & Rita,2347919,350524,1997395,2010_boxofficemojo_rankings.csv,2010,0.14929135119226855,0.8507086488077314
8409,At Close Range,2347000,2347000,0,1986_boxofficemojo_rankings.csv,1986,1.0,0.0
8410,Downtown,2346150,2346150,0,1990_boxofficemojo_rankings.csv,1990,1.0,0.0
8411,Memories of the Sword,2345062,111071,2233991,2015_boxofficemojo_rankings.csv,2015,0.047363779720962604,0.9526362202790374
8412,Standing in the Shadows of Motown,2344256,1722119,622137,2002_boxofficemojo_rankings.csv,2002,0.7346121754620656,0.2653878245379344
8413,Terraferma,2343302,19996,2323306,2011_boxofficemojo_rankings.csv,2011,0.008533257770445295,0.9914667422295547
8414,1991,2342264,2342264,0,2018_boxofficemojo_rankings.csv,2018,1.0,0.0
8415,JCVD,2342211,470691,1871520,2008_boxofficemojo_rankings.csv,2008,0.20096011845218045,0.7990398815478196
8416,Double Dragon,2341309,2341309,0,1994_boxofficemojo_rankings.csv,1994,1.0,0.0
8417,Housefull,2340550,1183658,1156892,2010_boxofficemojo_rankings.csv,2010,0.5057178868214736,0.49428211317852644
8418,Ong-bak 3,2340516,14890,2325626,2010_boxofficemojo_rankings.csv,2010,0.00636184499486438,0.9936381550051356
8419,High Heels and Low Lifes,2340411,228194,2112217,2001_boxofficemojo_rankings.csv,2001,0.09750167812405598,0.902498321875944
8420,Teeth,2340110,347578,1992532,2008_boxofficemojo_rankings.csv,2008,0.14853062462875677,0.8514693753712432
8421,Me and Orson Welles,2336172,1190003,1146169,2009_boxofficemojo_rankings.csv,2009,0.5093815866297515,0.4906184133702484
8422,Gabriela,2335352,2335352,0,2001_boxofficemojo_rankings.csv,2001,1.0,0.0
8423,Meru,2334228,2334228,0,2015_boxofficemojo_rankings.csv,2015,1.0,0.0
8424,Jem and the Holograms,2333684,2184640,149044,2015_boxofficemojo_rankings.csv,2015,0.9361335982078122,0.0638664017921878
8425,To Live,2332728,2332728,0,1994_boxofficemojo_rankings.csv,1994,1.0,0.0
8426,The Experiment 2002 Re-release,2327755,144634,2183121,2002_boxofficemojo_rankings.csv,2002,0.06213454594663098,0.937865454053369
8427,A World Apart,2326860,2326860,0,1988_boxofficemojo_rankings.csv,1988,1.0,0.0
8428,Bhaag Milkha Bhaag,2325917,1636731,689186,2013_boxofficemojo_rankings.csv,2013,0.7036927800949045,0.2963072199050955
8429,Weeds,2325444,2325444,0,1987_boxofficemojo_rankings.csv,1987,1.0,0.0
8430,White Hunter Black Heart,2319124,2319124,0,1990_boxofficemojo_rankings.csv,1990,1.0,0.0
8431,Chocolat,2317091,2317091,0,1989_boxofficemojo_rankings.csv,1989,1.0,0.0
8432,The Oranges,2316971,366377,1950594,2012_boxofficemojo_rankings.csv,2012,0.158127572593701,0.841872427406299
8433,Shanghai Surprise,2315683,2315683,0,1986_boxofficemojo_rankings.csv,1986,1.0,0.0
8434,"Man, Woman and Child",2314561,2314561,0,1983_boxofficemojo_rankings.csv,1983,1.0,0.0
8435,Austenland,2313509,2159041,154468,2013_boxofficemojo_rankings.csv,2013,0.9332321594599373,0.06676784054006274
8436,A Aa,2313043,2313043,0,2016_boxofficemojo_rankings.csv,2016,1.0,0.0
8437,Fur: An Imaginary Portrait of Diane Arbus,2312717,223202,2089515,2006_boxofficemojo_rankings.csv,2006,0.09651072742579399,0.903489272574206
8438,Shadow Conspiracy,2312463,2312463,0,1997_boxofficemojo_rankings.csv,1997,1.0,0.0
8439,WARx2,2310625,2310625,0,2015_boxofficemojo_rankings.csv,2015,1.0,0.0
8440,A Good Man in Africa,2308390,2308390,0,1994_boxofficemojo_rankings.csv,1994,1.0,0.0
8441,The Resurrection of Gavin Stone,2308355,2303792,4563,2017_boxofficemojo_rankings.csv,2017,0.9980232676516394,0.001976732348360629
8442,Merry Christmas Mr. Lawrence,2306560,2306560,0,1983_boxofficemojo_rankings.csv,1983,1.0,0.0
8443,Blackfish,2303417,2073582,229835,2013_boxofficemojo_rankings.csv,2013,0.900219977537719,0.09978002246228104
8444,Burnt by the Sun,2302338,2302338,0,1995_boxofficemojo_rankings.csv,1995,1.0,0.0
8445,Lost Embrace,2298732,190860,2107872,2004_boxofficemojo_rankings.csv,2004,0.08302838260397472,0.9169716173960253
8446,Piranhas,2298525,23494,2275031,2019_boxofficemojo_rankings.csv,2019,0.010221337596937167,0.9897786624030628
8447,The Remaining,2297261,1169603,1127658,2014_boxofficemojo_rankings.csv,2014,0.509129350126085,0.49087064987391504
8448,Mark Twain's America in 3D,2297096,2297096,0,1998_boxofficemojo_rankings.csv,1998,1.0,0.0
8449,3 from Hell,2295825,2172949,122876,2019_boxofficemojo_rankings.csv,2019,0.9464784990145155,0.05352150098548452
8450,Sky Bandits,2295500,2295500,0,1986_boxofficemojo_rankings.csv,1986,1.0,0.0
8451,Buffalo Soldiers,2295274,354421,1940853,2002_boxofficemojo_rankings.csv,2002,0.15441337286964432,0.8455866271303557
8452,Cashback,2294291,25343,2268948,2007_boxofficemojo_rankings.csv,2007,0.011046114028255352,0.9889538859717446
8453,Ek Main Aur Ekk Tu,2293823,1155545,1138278,2012_boxofficemojo_rankings.csv,2012,0.5037638039203548,0.4962361960796452
8454,Disgrace,2291680,69705,2221975,2008_boxofficemojo_rankings.csv,2008,0.030416550303707324,0.9695834496962926
8455,Once Upon a Time... When We Were Colored,2291255,2291255,0,1996_boxofficemojo_rankings.csv,1996,1.0,0.0
8456,Going Away,2290889,19501,2271388,2014_boxofficemojo_rankings.csv,2014,0.008512415922377732,0.9914875840776223
8457,American Honey,2290649,663246,1627403,2016_boxofficemojo_rankings.csv,2016,0.28954501540829697,0.7104549845917031
8458,Love Crimes,2287928,2287928,0,1992_boxofficemojo_rankings.csv,1992,1.0,0.0
8459,Dancing at Lughnasa,2287818,2287818,0,1998_boxofficemojo_rankings.csv,1998,1.0,0.0
8460,Snowriders II,2287639,2287639,0,1997_boxofficemojo_rankings.csv,1997,1.0,0.0
8461,Hav Plenty,2284034,2284034,0,1998_boxofficemojo_rankings.csv,1998,1.0,0.0
8462,Pecker,2281761,2281761,0,1998_boxofficemojo_rankings.csv,1998,1.0,0.0
8463,The Nasty Girl,2281569,2281569,0,1990_boxofficemojo_rankings.csv,1990,1.0,0.0
8464,Noel,2280924,0,2280924,2004_boxofficemojo_rankings.csv,2004,0.0,1.0
8465,Noises Off...,2280148,2280148,0,1992_boxofficemojo_rankings.csv,1992,1.0,0.0
8466,A Brief History of Time,2279692,2279692,0,1992_boxofficemojo_rankings.csv,1992,1.0,0.0
8467,"Yes, Giorgio",2279543,2279543,0,1982_boxofficemojo_rankings.csv,1982,1.0,0.0
8468,Nomads,2278264,2278264,0,1986_boxofficemojo_rankings.csv,1986,1.0,0.0
8469,Escanaba in da Moonlight,2276602,2276602,0,2001_boxofficemojo_rankings.csv,2001,1.0,0.0
8470,Showdown in Little Tokyo,2275557,2275557,0,1991_boxofficemojo_rankings.csv,1991,1.0,0.0
8471,RV: Resurrected Victims,2269892,20374,2249518,2017_boxofficemojo_rankings.csv,2017,0.008975757436917704,0.9910242425630823
8472,Luce,2268204,2010613,257591,2019_boxofficemojo_rankings.csv,2019,0.8864339362773366,0.1135660637226634
8473,Texasville,2268181,2268181,0,1990_boxofficemojo_rankings.csv,1990,1.0,0.0
8474,Sleepwalk with Me,2266067,2266067,0,2012_boxofficemojo_rankings.csv,2012,1.0,0.0
8475,Nobody Knows,2265264,684118,1581146,2004_boxofficemojo_rankings.csv,2004,0.30200365167150495,0.697996348328495
8476,Gilda Live,2261507,2261507,0,1980_boxofficemojo_rankings.csv,1980,1.0,0.0
8477,Puzzle,2260946,2032018,228928,2018_boxofficemojo_rankings.csv,2018,0.8987468077521533,0.1012531922478467
8478,Bronson,2260712,104979,2155733,2009_boxofficemojo_rankings.csv,2009,0.046436255480574264,0.9535637445194257
8479,Leprechaun 2,2260622,2260622,0,1994_boxofficemojo_rankings.csv,1994,1.0,0.0
8480,Sing,2260616,2260616,0,1989_boxofficemojo_rankings.csv,1989,1.0,0.0
8481,Dans une galaxie près de chez vous - Le film,2259688,2259688,0,2004_boxofficemojo_rankings.csv,2004,1.0,0.0
8482,The Draughtsman's Contract,2256246,2256246,0,1983_boxofficemojo_rankings.csv,1983,1.0,0.0
8483,DysFunktional Family,2255000,2255000,0,2003_boxofficemojo_rankings.csv,2003,1.0,0.0
8484,Strangers with Candy,2254124,2072645,181479,2006_boxofficemojo_rankings.csv,2006,0.9194902321256506,0.08050976787434941
8485,Shadow Dancer,2253819,100616,2153203,2012_boxofficemojo_rankings.csv,2012,0.04464244910527421,0.9553575508947258
8486,An Interview with God,2251795,1201434,1050361,2018_boxofficemojo_rankings.csv,2018,0.5335450163092111,0.4664549836907889
8487,The Night of the Shooting Stars,2251121,2251121,0,1983_boxofficemojo_rankings.csv,1983,1.0,0.0
8488,Marius,2249781,9781,2240000,2013_boxofficemojo_rankings.csv,2013,0.0043475342711135,0.9956524657288865
8489,Touch of Evil 1998 Re-release,2247465,2247465,0,1998_boxofficemojo_rankings.csv,1998,1.0,0.0
8490,My All-American,2246000,2246000,0,2015_boxofficemojo_rankings.csv,2015,1.0,0.0
8491,No culpes al karma de lo que te pasa por gilipollas,2242471,5614,2236857,2016_boxofficemojo_rankings.csv,2016,0.0025034883394255713,0.9974965116605744
8492,At War,2235052,4605,2230447,2018_boxofficemojo_rankings.csv,2018,0.002060354747898483,0.9979396452521015
8493,"Romulus, My Father",2234889,4283,2230606,2007_boxofficemojo_rankings.csv,2007,0.0019164262744145236,0.9980835737255854
8494,Vincent & Theo,2231274,2231274,0,1990_boxofficemojo_rankings.csv,1990,1.0,0.0
8495,The Squeeze,2228951,2228951,0,1987_boxofficemojo_rankings.csv,1987,1.0,0.0
8496,Elena,2227905,233380,1994525,2011_boxofficemojo_rankings.csv,2011,0.10475312008366605,0.895246879916334
8497,Delhi Safari,2225597,0,2225597,2012_boxofficemojo_rankings.csv,2012,0.0,1.0
8498,The Beaches of Agnès,2225430,239711,1985719,2008_boxofficemojo_rankings.csv,2008,0.1077144641709692,0.8922855358290308
8499,Heal the Living,2223529,3176,2220353,2016_boxofficemojo_rankings.csv,2016,0.0014283600528709093,0.998571639947129
8500,Def by Temptation,2218579,2218579,0,1990_boxofficemojo_rankings.csv,1990,1.0,0.0
8501,Blade Runner The Final Cut (2007 re-release),2217175,1548502,668673,2007_boxofficemojo_rankings.csv,2007,0.6984121686380191,0.3015878313619809
8502,The Lovers,2216083,2194521,21562,2017_boxofficemojo_rankings.csv,2017,0.9902702200233475,0.0097297799766525
8503,Autumn Tale,2215467,2205339,10128,1999_boxofficemojo_rankings.csv,1999,0.9954285033358655,0.004571496664134469
8504,The Incredibly True Adventure of Two Girls in Love,2210408,2210408,0,1995_boxofficemojo_rankings.csv,1995,1.0,0.0
8505,Bill Cunningham: New York,2210382,1510026,700356,2011_boxofficemojo_rankings.csv,2011,0.6831516000401741,0.31684839995982594
8506,Fast Food Nation,2209322,1005539,1203783,2006_boxofficemojo_rankings.csv,2006,0.45513465216930804,0.544865347830692
8507,Valentino: The Last Emperor,2203403,1755134,448269,2009_boxofficemojo_rankings.csv,2009,0.7965560544303516,0.2034439455696484
8508,Neil Young: Heart of Gold,2201933,1904606,297327,2006_boxofficemojo_rankings.csv,2006,0.864970005899362,0.13502999410063793
8509,Dark Eyes,2201428,2201428,0,1987_boxofficemojo_rankings.csv,1987,1.0,0.0
8510,Rivers and Tides: Andy Goldsworthy Working with Time,2200276,2200276,0,2002_boxofficemojo_rankings.csv,2002,1.0,0.0
8511,The Impostors,2198044,2198044,0,1998_boxofficemojo_rankings.csv,1998,1.0,0.0
8512,Wild Bill,2193982,2193982,0,1995_boxofficemojo_rankings.csv,1995,1.0,0.0
8513,Electric Dreams,2193612,2193612,0,1984_boxofficemojo_rankings.csv,1984,1.0,0.0
8514,Goodnight Mommy,2193474,1178196,1015278,2015_boxofficemojo_rankings.csv,2015,0.5371369799687619,0.46286302003123814
8515,3 Faces,2191516,72324,2119192,2018_boxofficemojo_rankings.csv,2018,0.033001812443988546,0.9669981875560114
8516,What Will People Say,2191131,44156,2146975,2017_boxofficemojo_rankings.csv,2017,0.020152149734543486,0.9798478502654565
8517,Russkies,2189047,2189047,0,1987_boxofficemojo_rankings.csv,1987,1.0,0.0
8518,Echelon Conspiracy,2186782,666009,1520773,2009_boxofficemojo_rankings.csv,2009,0.3045612228379418,0.6954387771620583
8519,Home 2008 Re-release,2186716,15925,2170791,2008_boxofficemojo_rankings.csv,2008,0.007282610087455344,0.9927173899125447
8520,Kuch Naa Kaho,2185360,224831,1960529,2003_boxofficemojo_rankings.csv,2003,0.10288053226928287,0.8971194677307172
8521,Anchorman 2: The Legend Continues R-Rated Extended Cut,2185255,2184339,916,2014_boxofficemojo_rankings.csv,2014,0.9995808269515457,0.0004191730484542994
8522,"Paris, Texas",2181987,2181987,0,1984_boxofficemojo_rankings.csv,1984,1.0,0.0
8523,Bird,2181286,2181286,0,1988_boxofficemojo_rankings.csv,1988,1.0,0.0
8524,Chinese Box,2178160,2178160,0,1998_boxofficemojo_rankings.csv,1998,1.0,0.0
8525,Border,2177678,771930,1405748,2018_boxofficemojo_rankings.csv,2018,0.35447389375288724,0.6455261062471127
8526,Amreeka,2176304,627436,1548868,2009_boxofficemojo_rankings.csv,2009,0.28830347230901565,0.7116965276909843
8527,Gone with the Wind 2019 Re-release,2176120,2176120,0,2019_boxofficemojo_rankings.csv,2019,1.0,0.0
8528,Veere Di Wedding,2176099,0,2176099,2018_boxofficemojo_rankings.csv,2018,0.0,1.0
8529,Dance with a Stranger,2174622,2174622,0,1985_boxofficemojo_rankings.csv,1985,1.0,0.0
8530,Desire,2174005,301010,1872995,2003_boxofficemojo_rankings.csv,2003,0.13845874319516285,0.8615412568048372
8531,Tarzan and the Lost City,2172941,2172941,0,1998_boxofficemojo_rankings.csv,1998,1.0,0.0
8532,The Oscar Nominated Short Films 2014: Live Action,2171849,2171849,0,2014_boxofficemojo_rankings.csv,2014,1.0,0.0
8533,Dark Blue Almost Black,2171323,6646,2164677,2006_boxofficemojo_rankings.csv,2006,0.003060806706326051,0.996939193293674
8534,Henry's Crime,2169799,102541,2067258,2011_boxofficemojo_rankings.csv,2011,0.04725829443188056,0.9527417055681194
8535,The Reluctant Fundamentalist,2167020,552959,1614061,2013_boxofficemojo_rankings.csv,2013,0.25517023377726095,0.7448297662227391
8536,A Dog of Flanders,2165637,2165637,0,1999_boxofficemojo_rankings.csv,1999,1.0,0.0
8537,Ma vie en rose,2162043,2162043,0,1997_boxofficemojo_rankings.csv,1997,1.0,0.0
8538,In the Shadow of the Moon,2161369,1134358,1027011,2007_boxofficemojo_rankings.csv,2007,0.5248331034635918,0.4751668965364082
8539,Dhoondte Reh Jaoge,2161095,5127,2155968,2009_boxofficemojo_rankings.csv,2009,0.0023724084318366384,0.9976275915681634
8540,Mad Detective,2160790,4629,2156161,2007_boxofficemojo_rankings.csv,2007,0.002142272039393,0.997857727960607
8541,Limbo,2160710,2160710,0,1999_boxofficemojo_rankings.csv,1999,1.0,0.0
8542,The Benefactor,2159380,0,2159380,2015_boxofficemojo_rankings.csv,2015,0.0,1.0
8543,Wilde,2158775,2158775,0,1998_boxofficemojo_rankings.csv,1998,1.0,0.0
8544,Turtle Diary,2156772,2156772,0,1986_boxofficemojo_rankings.csv,1986,1.0,0.0
8545,Scenes from the Class Struggle in Beverly Hills,2156471,2156471,0,1989_boxofficemojo_rankings.csv,1989,1.0,0.0
8546,The Endless Summer 2,2155385,2155385,0,1994_boxofficemojo_rankings.csv,1994,1.0,0.0
8547,Heartbeeps,2154696,2154696,0,1981_boxofficemojo_rankings.csv,1981,1.0,0.0
8548,Stage Beauty,2153070,782383,1370687,2004_boxofficemojo_rankings.csv,2004,0.36338019664943544,0.6366198033505646
8549,Shower,2150929,1157764,993165,2000_boxofficemojo_rankings.csv,2000,0.5382623043345457,0.4617376956654543
8550,Blood Simple,2150000,2150000,0,1985_boxofficemojo_rankings.csv,1985,1.0,0.0
8551,Rich in Love,2149866,2149866,0,1993_boxofficemojo_rankings.csv,1993,1.0,0.0
8552,Hallam Foe,2149799,60641,2089158,2007_boxofficemojo_rankings.csv,2007,0.028207753376013292,0.9717922466239867
8553,Meatballs III: Summer Job,2147228,2147228,0,1987_boxofficemojo_rankings.csv,1987,1.0,0.0
8554,The Saratov Approach,2146999,2146999,0,2013_boxofficemojo_rankings.csv,2013,1.0,0.0
8555,Mrs. Parker and the Vicious Circle,2144667,2144667,0,1994_boxofficemojo_rankings.csv,1994,1.0,0.0
8556,The Oscar Nominated Short Films 2013: Live Action,2142342,2142342,0,2013_boxofficemojo_rankings.csv,2013,1.0,0.0
8557,Let Yourself Go,2140190,12189,2128001,2017_boxofficemojo_rankings.csv,2017,0.0056952887360468,0.9943047112639533
8558,The Attack,2139516,1720325,419191,2013_boxofficemojo_rankings.csv,2013,0.80407204246194,0.19592795753806
8559,Thumbsucker,2138742,1328679,810063,2005_boxofficemojo_rankings.csv,2005,0.6212432355094724,0.3787567644905276
8560,The Other Man,2138350,149528,1988822,2009_boxofficemojo_rankings.csv,2009,0.06992681272944093,0.9300731872705591
8561,The Black Balloon,2136663,0,2136663,2008_boxofficemojo_rankings.csv,2008,0.0,1.0
8562,Morgan Stewart's Coming Home,2136381,2136381,0,1987_boxofficemojo_rankings.csv,1987,1.0,0.0
8563,High Life,2133033,1225852,907181,2018_boxofficemojo_rankings.csv,2018,0.5746990318480774,0.42530096815192264
8564,Mutant Chronicles,2131057,6820,2124237,2008_boxofficemojo_rankings.csv,2008,0.003200289809235511,0.9967997101907645
8565,My Scientology Movie,2130866,22936,2107930,2016_boxofficemojo_rankings.csv,2016,0.010763698890498042,0.989236301109502
8566,Mountain,2129889,365412,1764477,2017_boxofficemojo_rankings.csv,2017,0.17156387022985706,0.8284361297701429
8567,Windows,2128395,2128395,0,1980_boxofficemojo_rankings.csv,1980,1.0,0.0
8568,Heleno,2126384,0,2126384,2012_boxofficemojo_rankings.csv,2012,0.0,1.0
8569,The Quiet Earth,2123135,2123135,0,1985_boxofficemojo_rankings.csv,1985,1.0,0.0
8570,Sightseers,2122909,61782,2061127,2012_boxofficemojo_rankings.csv,2012,0.029102519231865333,0.9708974807681346
8571,Jai Ho,2122804,1264515,858289,2014_boxofficemojo_rankings.csv,2014,0.595681466588531,0.404318533411469
8572,Mallrats,2122561,2122561,0,1995_boxofficemojo_rankings.csv,1995,1.0,0.0
8573,29th Street,2120564,2120564,0,1991_boxofficemojo_rankings.csv,1991,1.0,0.0
8574,Videodrome,2120439,2120439,0,1983_boxofficemojo_rankings.csv,1983,1.0,0.0
8575,The Nutcracker,2119994,2119994,0,1993_boxofficemojo_rankings.csv,1993,1.0,0.0
8576,Abracadabra,2114260,13975,2100285,2017_boxofficemojo_rankings.csv,2017,0.006609877687701608,0.9933901223122984
8577,Left Luggage,2111280,1069540,1041740,2000_boxofficemojo_rankings.csv,2000,0.5065836838316092,0.4934163161683907
8578,Friday the 13th Part III 1983 Re-release,2108548,2108548,0,1983_boxofficemojo_rankings.csv,1983,1.0,0.0
8579,Screen Two: The Clothes in the Wardrobe,2106846,2106846,0,1993_boxofficemojo_rankings.csv,1993,1.0,0.0
8580,State Property,2106838,2106838,0,2002_boxofficemojo_rankings.csv,2002,1.0,0.0
8581,"20,000 Days on Earth",2105558,279558,1826000,2014_boxofficemojo_rankings.csv,2014,0.13277145535767715,0.8672285446423228
8582,Candy,2105096,45128,2059968,2006_boxofficemojo_rankings.csv,2006,0.02143750213766973,0.9785624978623303
8583,The Princess and the Goblin,2105078,2105078,0,1994_boxofficemojo_rankings.csv,1994,1.0,0.0
8584,The Eye of the Storm,2104689,83566,2021123,2011_boxofficemojo_rankings.csv,2011,0.03970467845843258,0.9602953215415674
8585,Faithful,2104439,2104439,0,1996_boxofficemojo_rankings.csv,1996,1.0,0.0
8586,A Month by the Lake,2101087,2101087,0,1995_boxofficemojo_rankings.csv,1995,1.0,0.0
8587,Eating,2100538,2100538,0,1990_boxofficemojo_rankings.csv,1990,1.0,0.0
8588,The Daytrippers,2099677,2099677,0,1997_boxofficemojo_rankings.csv,1997,1.0,0.0
8589,Once Upon a Time in Anatolia,2099472,152408,1947064,2011_boxofficemojo_rankings.csv,2011,0.07259349017276724,0.9274065098272327
8590,The Wizard of Oz 2019 Re-release,2097514,2076020,21494,2019_boxofficemojo_rankings.csv,2019,0.9897526309717122,0.010247369028287772
8591,Indian Horse,2097362,2097362,0,2018_boxofficemojo_rankings.csv,2018,1.0,0.0
8592,Mary Shelley,2096600,108900,1987700,2018_boxofficemojo_rankings.csv,2018,0.051941238195173135,0.9480587618048268
8593,Bollywood/Hollywood,2092228,1454510,637718,2002_boxofficemojo_rankings.csv,2002,0.6951966994036979,0.3048033005963021
8594,Garam Masala,2091698,1007943,1083755,2005_boxofficemojo_rankings.csv,2005,0.4818778810325391,0.5181221189674609
8595,The Captive,2090612,1075178,1015434,2014_boxofficemojo_rankings.csv,2014,0.5142886389248699,0.48571136107513013
8596,"The Butcher, the Chef, and the Swordsman",2089266,47896,2041370,2011_boxofficemojo_rankings.csv,2011,0.022924797512619263,0.9770752024873808
8597,Apollo 13 The IMAX Experience,2089051,1766621,322430,2002_boxofficemojo_rankings.csv,2002,0.8456571907531218,0.15434280924687813
8598,Zero Effect,2087471,2087471,0,1998_boxofficemojo_rankings.csv,1998,1.0,0.0
8599,Trick,2087228,2087228,0,1999_boxofficemojo_rankings.csv,1999,1.0,0.0
8600,Lost in Paris,2087225,691597,1395628,2017_boxofficemojo_rankings.csv,2017,0.33134760267819713,0.6686523973218029
8601,Just Tell Me What You Want,2086905,2086905,0,1980_boxofficemojo_rankings.csv,1980,1.0,0.0
8602,Shanghai Triad,2086101,2086101,0,1995_boxofficemojo_rankings.csv,1995,1.0,0.0
8603,Girl Most Likely,2085617,1378591,707026,2013_boxofficemojo_rankings.csv,2013,0.6609991192054917,0.3390008807945083
8604,The Hard Word,2085562,426880,1658682,2002_boxofficemojo_rankings.csv,2002,0.20468343784553036,0.7953165621544697
8605,Summer Storm,2085166,95204,1989962,2004_boxofficemojo_rankings.csv,2004,0.045657755785390705,0.9543422442146093
8606,Equals,2084628,33258,2051370,2016_boxofficemojo_rankings.csv,2016,0.01595392559247981,0.9840460744075202
8607,High Strung,2084451,53447,2031004,2016_boxofficemojo_rankings.csv,2016,0.02564080422135133,0.9743591957786487
8608,Strawberry and Chocolate,2084187,2080805,3382,1995_boxofficemojo_rankings.csv,1995,0.9983773049155378,0.0016226950844621907
8609,I'm Not Ashamed,2082980,2082980,0,2016_boxofficemojo_rankings.csv,2016,1.0,0.0
8610,Screwballs,2082215,2082215,0,1983_boxofficemojo_rankings.csv,1983,1.0,0.0
8611,A Cat in Paris,2080634,309973,1770661,2010_boxofficemojo_rankings.csv,2010,0.1489800704977425,0.8510199295022575
8612,The King of Staten Island,2080275,0,2080275,2020_boxofficemojo_rankings.csv,2020,0.0,1.0
8613,Salaam Bombay!,2080046,2080046,0,1988_boxofficemojo_rankings.csv,1988,1.0,0.0
8614,Shallow Grave,2079569,2079569,0,1995_boxofficemojo_rankings.csv,1995,1.0,0.0
8615,Purple Hearts,2075282,2075282,0,1984_boxofficemojo_rankings.csv,1984,1.0,0.0
8616,The Sheltering Sky,2075084,2075084,0,1990_boxofficemojo_rankings.csv,1990,1.0,0.0
8617,Wi-heom-han gyan-gye,2074864,54000,2020864,2012_boxofficemojo_rankings.csv,2012,0.02602580217305809,0.973974197826942
8618,Black '47,2073063,57520,2015543,2018_boxofficemojo_rankings.csv,2018,0.027746383009102954,0.9722536169908971
8619,Cadence,2070871,2070871,0,1991_boxofficemojo_rankings.csv,1991,1.0,0.0
8620,Billy's Hollywood Screen Kiss,2070399,2070399,0,1998_boxofficemojo_rankings.csv,1998,1.0,0.0
8621,Blood Simple 2000 Re-release,2068701,1701855,366846,2000_boxofficemojo_rankings.csv,2000,0.82266842815854,0.17733157184145992
8622,Snowriders,2068490,2068490,0,1996_boxofficemojo_rankings.csv,1996,1.0,0.0
8623,A Fool,2067820,8212,2059608,2015_boxofficemojo_rankings.csv,2015,0.003971332127554622,0.9960286678724454
8624,Hotchpotch 3,2067671,1132192,935479,2010_boxofficemojo_rankings.csv,2010,0.5475687379665334,0.4524312620334666
8625,American Pastoral,2063436,544098,1519338,2016_boxofficemojo_rankings.csv,2016,0.263685425668642,0.7363145743313579
8626,Ravenous,2062405,2062405,0,1999_boxofficemojo_rankings.csv,1999,1.0,0.0
8627,The Krays,2060847,2060847,0,1990_boxofficemojo_rankings.csv,1990,1.0,0.0
8628,Married to It,2059832,2059832,0,1993_boxofficemojo_rankings.csv,1993,1.0,0.0
8629,Creation,2058675,341323,1717352,2009_boxofficemojo_rankings.csv,2009,0.16579741824231606,0.8342025817576839
8630,Hotchpotch Again,2057329,1013893,1043436,2017_boxofficemojo_rankings.csv,2017,0.4928200594071245,0.5071799405928755
8631,Battle of the Brave,2057293,1599716,457577,2004_boxofficemojo_rankings.csv,2004,0.7775829694652148,0.2224170305347853
8632,Two Girls and a Guy,2057193,2057193,0,1998_boxofficemojo_rankings.csv,1998,1.0,0.0
8633,Pelle the Conqueror,2053931,2053931,0,1988_boxofficemojo_rankings.csv,1988,1.0,0.0
8634,Beyond the Mat,2053648,2053648,0,1999_boxofficemojo_rankings.csv,1999,1.0,0.0
8635,Under the Silver Lake,2053469,46083,2007386,2018_boxofficemojo_rankings.csv,2018,0.022441536736127986,0.977558463263872
8636,Three Men and a Cradle,2052466,2052466,0,1986_boxofficemojo_rankings.csv,1986,1.0,0.0
8637,Jacknife,2049769,2049769,0,1989_boxofficemojo_rankings.csv,1989,1.0,0.0
8638,Besieged,2048740,2048740,0,1999_boxofficemojo_rankings.csv,1999,1.0,0.0
8639,Family Comes First,2048588,327615,1720973,2005_boxofficemojo_rankings.csv,2005,0.1599223465137939,0.8400776534862061
8640,Hamlet,2046433,1577287,469146,2000_boxofficemojo_rankings.csv,2000,0.7707493966330684,0.22925060336693162
8641,Being 17,2045219,52713,1992506,2016_boxofficemojo_rankings.csv,2016,0.025773767992571944,0.9742262320074281
8642,Testament,2044892,2044892,0,1983_boxofficemojo_rankings.csv,1983,1.0,0.0
8643,Rooftops,2043889,2043889,0,1989_boxofficemojo_rankings.csv,1989,1.0,0.0
8644,Right at Your Door,2043704,65018,1978686,2006_boxofficemojo_rankings.csv,2006,0.03181380473884672,0.9681861952611532
8645,Big Bully,2042530,2042530,0,1996_boxofficemojo_rankings.csv,1996,1.0,0.0
8646,W.E.,2042203,583455,1458748,2012_boxofficemojo_rankings.csv,2012,0.2856988262185493,0.7143011737814507
8647,El Mariachi,2040920,2040920,0,1993_boxofficemojo_rankings.csv,1993,1.0,0.0
8648,Wildfire: Feel the Heat,2040635,2040635,0,1999_boxofficemojo_rankings.csv,1999,1.0,0.0
8649,The Wedding Weekend,2037373,1232961,804412,2006_boxofficemojo_rankings.csv,2006,0.6051719542764138,0.3948280457235862
8650,The Dangerous Lives of Altar Boys,2036599,1815864,220735,2002_boxofficemojo_rankings.csv,2002,0.8916158752901283,0.1083841247098717
8651,A Guide to Recognizing Your Saints,2035468,517809,1517659,2006_boxofficemojo_rankings.csv,2006,0.25439309289067674,0.7456069071093233
8652,Mom and Dad Save the World,2034470,2034470,0,1992_boxofficemojo_rankings.csv,1992,1.0,0.0
8653,Mammoth,2033946,9580,2024366,2009_boxofficemojo_rankings.csv,2009,0.004710056215848405,0.9952899437841516
8654,Gate 2: The Trespassers,2032973,2032973,0,1992_boxofficemojo_rankings.csv,1992,1.0,0.0
8655,Pieces,2032311,2032311,0,1983_boxofficemojo_rankings.csv,1983,1.0,0.0
8656,Raid,2031135,1010385,1020750,2018_boxofficemojo_rankings.csv,2018,0.49744847092881567,0.5025515290711844
8657,The High Note,2029462,0,2029462,2020_boxofficemojo_rankings.csv,2020,0.0,1.0
8658,This Is Elvis,2028612,2028612,0,1981_boxofficemojo_rankings.csv,1981,1.0,0.0
8659,Climax,2027391,817339,1210052,2018_boxofficemojo_rankings.csv,2018,0.40314818404540614,0.5968518159545939
8660,The Work and the Glory II: American Zion,2025032,2025032,0,2005_boxofficemojo_rankings.csv,2005,1.0,0.0
8661,Re-Animator,2023414,2023414,0,1985_boxofficemojo_rankings.csv,1985,1.0,0.0
8662,Winter People,2023282,2023282,0,1989_boxofficemojo_rankings.csv,1989,1.0,0.0
8663,Sphinx,2022771,2022771,0,1981_boxofficemojo_rankings.csv,1981,1.0,0.0
8664,42nd Street - The Musical,2022093,187440,1834653,2019_boxofficemojo_rankings.csv,2019,0.09269603326849953,0.9073039667315005
8665,Ba mùa,2021698,2021698,0,1999_boxofficemojo_rankings.csv,1999,1.0,0.0
8666,Surviving Picasso,2021348,2021348,0,1996_boxofficemojo_rankings.csv,1996,1.0,0.0
8667,Taal,2020532,2020532,0,1999_boxofficemojo_rankings.csv,1999,1.0,0.0
8668,Kika,2019581,2019581,0,1994_boxofficemojo_rankings.csv,1994,1.0,0.0
8669,Bad Lieutenant,2019469,2000022,19447,1992_boxofficemojo_rankings.csv,1992,0.9903702408900558,0.009629759109944248
8670,The Broken Hearts Club: A Romantic Comedy,2019121,1746585,272536,2000_boxofficemojo_rankings.csv,2000,0.8650224528396268,0.13497754716037325
8671,Armadillo,2018685,14566,2004119,2010_boxofficemojo_rankings.csv,2010,0.007215588365693509,0.9927844116343065
8672,Rad,2015882,2015882,0,1986_boxofficemojo_rankings.csv,1986,1.0,0.0
8673,Night on Earth,2015810,2015810,0,1992_boxofficemojo_rankings.csv,1992,1.0,0.0
8674,Better Than Chocolate,2015406,2015406,0,1999_boxofficemojo_rankings.csv,1999,1.0,0.0
8675,Graduation,2015002,175975,1839027,2016_boxofficemojo_rankings.csv,2016,0.0873324195211717,0.9126675804788283
8676,What to Do in Case of Fire,2014162,33545,1980617,2002_boxofficemojo_rankings.csv,2002,0.01665456899693272,0.9833454310030673
8677,Sur le seuil,2014071,2014071,0,2003_boxofficemojo_rankings.csv,2003,1.0,0.0
8678,"Bon Voyage, Charlie Brown (and Don't Come Back!!)",2013193,2013193,0,1980_boxofficemojo_rankings.csv,1980,1.0,0.0
8679,The Moderns,2011497,2011497,0,1988_boxofficemojo_rankings.csv,1988,1.0,0.0
8680,Little Men,2008649,702537,1306112,2016_boxofficemojo_rankings.csv,2016,0.34975598026335114,0.6502440197366489
8681,The Italian,2007774,555436,1452338,2006_boxofficemojo_rankings.csv,2006,0.2766426898644967,0.7233573101355033
8682,Titus,2007290,2007290,0,1999_boxofficemojo_rankings.csv,1999,1.0,0.0
8683,Paradise Road,2007100,2007100,0,1997_boxofficemojo_rankings.csv,1997,1.0,0.0
8684,The Man from Elysian Fields,2006391,1435016,571375,2002_boxofficemojo_rankings.csv,2002,0.7152225064805414,0.2847774935194586
8685,Crazy in Alabama,2005840,2005840,0,1999_boxofficemojo_rankings.csv,1999,1.0,0.0
8686,We Stand United,2005094,2005094,0,1999_boxofficemojo_rankings.csv,1999,1.0,0.0
8687,Red Nose,2004814,2004814,0,2003_boxofficemojo_rankings.csv,2003,1.0,0.0
8688,Honky Tonk Freeway,2004742,2004742,0,1981_boxofficemojo_rankings.csv,1981,1.0,0.0
8689,Betty Blue,2003822,2003822,0,1986_boxofficemojo_rankings.csv,1986,1.0,0.0
8690,Introducing the Dwights,2003304,379408,1623896,2007_boxofficemojo_rankings.csv,2007,0.18939112586007914,0.8106088741399209
8691,The Double Life of Véronique,2002966,1999955,3011,1991_boxofficemojo_rankings.csv,1991,0.9984967293503734,0.0015032706496266037
8692,Nemesis,2001124,2001124,0,1993_boxofficemojo_rankings.csv,1993,1.0,0.0
8693,Greater,2000093,2000093,0,2016_boxofficemojo_rankings.csv,2016,1.0,0.0
8694,Peterloo,1998945,151971,1846974,2018_boxofficemojo_rankings.csv,2018,0.07602560350584933,0.9239743964941507
8695,Our Winning Season,1997705,1997705,0,1978_boxofficemojo_rankings.csv,1978,1.0,0.0
8696,The Butcher Boy,1995911,1995911,0,1998_boxofficemojo_rankings.csv,1998,1.0,0.0
8697,1898: Our Last Men in the Philippines,1995045,2848,1992197,2016_boxofficemojo_rankings.csv,2016,0.001427536722229323,0.9985724632777707
8698,Antboy,1994566,0,1994566,2013_boxofficemojo_rankings.csv,2013,0.0,1.0
8699,Va Savoir (Who Knows?),1989779,907323,1082456,2001_boxofficemojo_rankings.csv,2001,0.4559918463306729,0.5440081536693271
8700,Date with an Angel,1988962,1988962,0,1987_boxofficemojo_rankings.csv,1987,1.0,0.0
8701,The Trip to Spain,1988841,1157604,831237,2017_boxofficemojo_rankings.csv,2017,0.5820495454387756,0.41795045456122437
8702,Ju Dou,1986433,1986433,0,1991_boxofficemojo_rankings.csv,1991,1.0,0.0
8703,Dead Snow,1984662,46742,1937920,2009_boxofficemojo_rankings.csv,2009,0.023551617353483868,0.9764483826465161
8704,"Gandhi, My Father",1983906,242967,1740939,2007_boxofficemojo_rankings.csv,2007,0.12246900810824707,0.877530991891753
8705,Summer 1993,1983149,185903,1797246,2017_boxofficemojo_rankings.csv,2017,0.0937413174703464,0.9062586825296536
8706,Great Performances at the Met: Verdi: La Traviata,1982588,1882931,99657,2018_boxofficemojo_rankings.csv,2018,0.9497338831870262,0.05026611681297375
8707,The Limits of Control,1981134,426688,1554446,2009_boxofficemojo_rankings.csv,2009,0.2153756383969989,0.7846243616030011
8708,Metallica: Some Kind of Monster,1980444,1222708,757736,2004_boxofficemojo_rankings.csv,2004,0.6173908477088976,0.3826091522911024
8709,Ridicule,1979768,1979768,0,1996_boxofficemojo_rankings.csv,1996,1.0,0.0
8710,Roadside Romeo,1978021,55202,1922819,2008_boxofficemojo_rankings.csv,2008,0.027907691576580834,0.9720923084234192
8711,Three Monkeys,1977780,41343,1936437,2007_boxofficemojo_rankings.csv,2007,0.02090374055759488,0.9790962594424051
8712,Ashes of Time,1977198,174273,1802925,2008_boxofficemojo_rankings.csv,2008,0.08814140010256939,0.9118585998974306
8713,Oye Lucky! Lucky Oye!,1976868,80037,1896831,2008_boxofficemojo_rankings.csv,2008,0.04048676998160727,0.9595132300183927
8714,Raggedy Man,1976198,1976198,0,1981_boxofficemojo_rankings.csv,1981,1.0,0.0
8715,Singham Returns,1974745,1232018,742727,2014_boxofficemojo_rankings.csv,2014,0.6238871347946191,0.37611286520538095
8716,Beloved,1971858,137515,1834343,2011_boxofficemojo_rankings.csv,2011,0.06973879457851427,0.9302612054214857
8717,Diary of a Chambermaid,1971247,54235,1917012,2015_boxofficemojo_rankings.csv,2015,0.027513041237348743,0.9724869587626512
8718,Vertigo 1996 Restored 70mm,1967552,1967552,0,1996_boxofficemojo_rankings.csv,1996,1.0,0.0
8719,Endless Winter,1966454,1966454,0,1995_boxofficemojo_rankings.csv,1995,1.0,0.0
8720,Savage Islands,1963756,1963756,0,1983_boxofficemojo_rankings.csv,1983,1.0,0.0
8721,Maquia: When the Promised Flower Blooms,1963575,185699,1777876,2018_boxofficemojo_rankings.csv,2018,0.09457189055676508,0.9054281094432349
8722,Dreams,1963207,1963207,0,1990_boxofficemojo_rankings.csv,1990,1.0,0.0
8723,Menashe,1962265,1703036,259229,2017_boxofficemojo_rankings.csv,2017,0.8678929706232339,0.13210702937676613
8724,Cecil B. Demented,1961544,1284646,676898,2000_boxofficemojo_rankings.csv,2000,0.6549157194536549,0.3450842805463451
8725,Greenfingers,1961054,1443067,517987,2001_boxofficemojo_rankings.csv,2001,0.7358629594085629,0.26413704059143706
8726,High Art,1960216,1960216,0,1998_boxofficemojo_rankings.csv,1998,1.0,0.0
8727,"Happy, Texas",1955933,1955933,0,1999_boxofficemojo_rankings.csv,1999,1.0,0.0
8728,Holy Motors,1954125,641100,1313025,2012_boxofficemojo_rankings.csv,2012,0.3280752254845519,0.6719247745154481
8729,Swades,1953889,1223240,730649,2004_boxofficemojo_rankings.csv,2004,0.626053987713734,0.373946012286266
8730,The Clan of the Cave Bear,1953732,1953732,0,1986_boxofficemojo_rankings.csv,1986,1.0,0.0
8731,God Is Great and I'm Not,1952817,73181,1879636,2001_boxofficemojo_rankings.csv,2001,0.03747458159161867,0.9625254184083814
8732,A Ghost Story,1951683,1596371,355312,2017_boxofficemojo_rankings.csv,2017,0.8179458446889172,0.1820541553110828
8733,Vertical Reality,1951429,1951429,0,1994_boxofficemojo_rankings.csv,1994,1.0,0.0
8734,Deadfall,1946254,66351,1879903,2012_boxofficemojo_rankings.csv,2012,0.03409164476990156,0.9659083552300984
8735,Liam,1945689,1016021,929668,2001_boxofficemojo_rankings.csv,2001,0.5221908537284222,0.47780914627157783
8736,Race the Sun,1945552,1945552,0,1996_boxofficemojo_rankings.csv,1996,1.0,0.0
8737,I Wanna Hold Your Hand,1944682,1944682,0,1978_boxofficemojo_rankings.csv,1978,1.0,0.0
8738,Marie Curie: The Courage of Knowledge,1944392,127986,1816406,2017_boxofficemojo_rankings.csv,2017,0.06582314677287296,0.9341768532271271
8739,V/H/S,1944287,100345,1843942,2012_boxofficemojo_rankings.csv,2012,0.0516101789499184,0.9483898210500816
8740,Housefull 3,1944262,1326999,617263,2016_boxofficemojo_rankings.csv,2016,0.6825206685107255,0.3174793314892746
8741,Broken English,1944150,956919,987231,2007_boxofficemojo_rankings.csv,2007,0.4922043052233624,0.5077956947766376
8742,Jake Speed,1943751,1943751,0,1986_boxofficemojo_rankings.csv,1986,1.0,0.0
8743,Madame Bovary,1942423,1942423,0,1991_boxofficemojo_rankings.csv,1991,1.0,0.0
8744,Goodbye Lover,1940299,1940299,0,1999_boxofficemojo_rankings.csv,1999,1.0,0.0
8745,Another Earth,1938783,1321194,617589,2011_boxofficemojo_rankings.csv,2011,0.6814553253252169,0.3185446746747831
8746,New York,1935820,997437,938383,2009_boxofficemojo_rankings.csv,2009,0.5152529677346034,0.48474703226539656
8747,Masterminds,1935539,1935539,0,1997_boxofficemojo_rankings.csv,1997,1.0,0.0
8748,Monty Python and the Holy Grail 2001 Re-release,1935066,1827696,107370,2001_boxofficemojo_rankings.csv,2001,0.9445135204690692,0.05548647953093073
8749,Roger Dodger,1934497,1266828,667669,2002_boxofficemojo_rankings.csv,2002,0.6548617030680327,0.34513829693196735
8750,Erik the Viking,1932642,1932642,0,1989_boxofficemojo_rankings.csv,1989,1.0,0.0
8751,The Curse,1930001,1930001,0,1987_boxofficemojo_rankings.csv,1987,1.0,0.0
8752,Henry Poole Is Here,1923800,1836515,87285,2008_boxofficemojo_rankings.csv,2008,0.9546288595488096,0.04537114045119035
8753,Luka Chuppi,1923586,1042905,880681,2019_boxofficemojo_rankings.csv,2019,0.5421670775312359,0.45783292246876406
8754,Jane,1921221,1723379,197842,2017_boxofficemojo_rankings.csv,2017,0.8970227787433096,0.10297722125669041
8755,Communion,1919653,1919653,0,1989_boxofficemojo_rankings.csv,1989,1.0,0.0
8756,"Kiss Me, Guido",1918497,1918497,0,1997_boxofficemojo_rankings.csv,1997,1.0,0.0
8757,Warning Sign,1918117,1918117,0,1985_boxofficemojo_rankings.csv,1985,1.0,0.0
8758,The Keeper,1916514,0,1916514,2019_boxofficemojo_rankings.csv,2019,0.0,1.0
8759,A Dirty Shame,1914166,1339668,574498,2004_boxofficemojo_rankings.csv,2004,0.6998703351746922,0.30012966482530773
8760,Old Fashioned,1914090,1914090,0,2015_boxofficemojo_rankings.csv,2015,1.0,0.0
8761,State of Grace,1911542,1911542,0,1990_boxofficemojo_rankings.csv,1990,1.0,0.0
8762,Hattrick,1911270,24502,1886768,2007_boxofficemojo_rankings.csv,2007,0.012819748125591885,0.9871802518744082
8763,Am Limit,1909568,18254,1891314,2007_boxofficemojo_rankings.csv,2007,0.009559230150484299,0.9904407698495157
8764,The Decline of the American Empire,1902706,1902706,0,1986_boxofficemojo_rankings.csv,1986,1.0,0.0
8765,Quiet Cool,1900000,1900000,0,1986_boxofficemojo_rankings.csv,1986,1.0,0.0
8766,Professor Marston & the Wonder Women,1899615,1584759,314856,2017_boxofficemojo_rankings.csv,2017,0.8342527301584794,0.16574726984152052
8767,Secuestro express,1898606,307208,1591398,2005_boxofficemojo_rankings.csv,2005,0.16180713639375416,0.8381928636062459
8768,Tango,1897948,1897948,0,1999_boxofficemojo_rankings.csv,1999,1.0,0.0
8769,Oscar and Lucinda,1897404,1897404,0,1998_boxofficemojo_rankings.csv,1998,1.0,0.0
8770,Frank,1897363,645186,1252177,2014_boxofficemojo_rankings.csv,2014,0.3400435235640202,0.6599564764359799
8771,Jurassic Park 2020 Re-release,1896545,1386600,509945,2020_boxofficemojo_rankings.csv,2020,0.7311189557853887,0.2688810442146113
8772,It Might Get Loud,1896244,1610163,286081,2009_boxofficemojo_rankings.csv,2009,0.8491328120220816,0.15086718797791845
8773,Game of Thrones Season 4 Finale,1896092,1896092,0,2015_boxofficemojo_rankings.csv,2015,1.0,0.0
8774,The Art of Getting By,1892130,1430241,461889,2011_boxofficemojo_rankings.csv,2011,0.7558893944919218,0.2441106055080782
8775,The Mighty Macs,1891936,1891936,0,2011_boxofficemojo_rankings.csv,2011,1.0,0.0
8776,Awake: The Life of Yogananda,1891918,1539680,352238,2014_boxofficemojo_rankings.csv,2014,0.8138196264320123,0.1861803735679876
8777,Bring on the Night,1890571,1890571,0,1985_boxofficemojo_rankings.csv,1985,1.0,0.0
8778,The Story of Qiu Ju,1890247,1890247,0,1993_boxofficemojo_rankings.csv,1993,1.0,0.0
8779,Red Lips,1889869,136163,1753706,2011_boxofficemojo_rankings.csv,2011,0.07204890921010927,0.9279510907898907
8780,The Night We Never Met,1884814,1884814,0,1993_boxofficemojo_rankings.csv,1993,1.0,0.0
8781,Vibes,1883811,1883811,0,1988_boxofficemojo_rankings.csv,1988,1.0,0.0
8782,Tusk,1882074,1826705,55369,2014_boxofficemojo_rankings.csv,2014,0.9705808592010728,0.02941914079892714
8783,Me and You,1878702,796641,1082061,2004_boxofficemojo_rankings.csv,2004,0.42403797941344606,0.5759620205865539
8784,The Slugger's Wife,1878561,1878561,0,1985_boxofficemojo_rankings.csv,1985,1.0,0.0
8785,Kill Your Darlings,1877924,1030064,847860,2013_boxofficemojo_rankings.csv,2013,0.5485120803610796,0.45148791963892043
8786,Fantastic Fungi,1877675,1788322,89353,2019_boxofficemojo_rankings.csv,2019,0.9524129575139467,0.04758704248605323
8787,Breaking In,1877618,1877618,0,1989_boxofficemojo_rankings.csv,1989,1.0,0.0
8788,I Shot Andy Warhol,1875527,1875527,0,1996_boxofficemojo_rankings.csv,1996,1.0,0.0
8789,Red State,1874460,1104682,769778,2011_boxofficemojo_rankings.csv,2011,0.5893334613702079,0.410666538629792
8790,Wilbur Wants to Kill Himself,1873482,235294,1638188,2003_boxofficemojo_rankings.csv,2003,0.12559181246470477,0.8744081875352953
8791,Last Flag Flying,1872950,965481,907469,2017_boxofficemojo_rankings.csv,2017,0.5154867989001308,0.4845132010998692
8792,The Whistleblower,1870392,1124966,745426,2011_boxofficemojo_rankings.csv,2011,0.6014600147990368,0.39853998520096323
8793,Cookie,1869417,1869417,0,1989_boxofficemojo_rankings.csv,1989,1.0,0.0
8794,Undertaking Betty,1868949,0,1868949,2002_boxofficemojo_rankings.csv,2002,0.0,1.0
8795,Purple Rain 2016 Re-release,1868929,1868075,854,2016_boxofficemojo_rankings.csv,2016,0.9995430538024719,0.000456946197528103
8796,Late Marriage,1868298,1656445,211853,2001_boxofficemojo_rankings.csv,2001,0.8866064193185456,0.11339358068145446
8797,Baby It's You,1867792,1867792,0,1983_boxofficemojo_rankings.csv,1983,1.0,0.0
8798,The Luzhin Defence,1864747,1053070,811677,2001_boxofficemojo_rankings.csv,2001,0.5647254024272461,0.43527459757275383
8799,Arctic Tale,1864636,833532,1031104,2007_boxofficemojo_rankings.csv,2007,0.4470212953091113,0.5529787046908887
8800,Inseparables,1864605,6258,1858347,2016_boxofficemojo_rankings.csv,2016,0.003356206810557732,0.9966437931894423
8801,Matthias & Maxime,1863999,374739,1489260,2019_boxofficemojo_rankings.csv,2019,0.2010403439057639,0.7989596560942361
8802,A Better Life,1863506,1759252,104254,2011_boxofficemojo_rankings.csv,2011,0.9440549158414301,0.05594508415856992
8803,Girlhood,1862990,60765,1802225,2014_boxofficemojo_rankings.csv,2014,0.03261692225937874,0.9673830777406213
8804,Bitter Moon,1862805,1862805,0,1994_boxofficemojo_rankings.csv,1994,1.0,0.0
8805,The Hallow,1862407,13906,1848501,2015_boxofficemojo_rankings.csv,2015,0.007466681557790537,0.9925333184422095
8806,The Dark Horse,1862114,67533,1794581,2014_boxofficemojo_rankings.csv,2014,0.036266845101857355,0.9637331548981426
8807,Made in Italy,1858824,101339,1757485,2020_boxofficemojo_rankings.csv,2020,0.054517802653720845,0.9454821973462791
8808,Rich Kids,1856122,1856122,0,1979_boxofficemojo_rankings.csv,1979,1.0,0.0
8809,The Pact,1855647,2488,1853159,2018_boxofficemojo_rankings.csv,2018,0.0013407722481700453,0.9986592277518299
8810,Miss Firecracker,1852655,1852655,0,1989_boxofficemojo_rankings.csv,1989,1.0,0.0
8811,The Five of Us,1852272,1852272,0,2004_boxofficemojo_rankings.csv,2004,1.0,0.0
8812,Smother,1851790,0,1851790,2008_boxofficemojo_rankings.csv,2008,0.0,1.0
8813,Washington Square,1851761,1851761,0,1997_boxofficemojo_rankings.csv,1997,1.0,0.0
8814,Sweet Country,1847693,104297,1743396,2018_boxofficemojo_rankings.csv,2018,0.056447147875756415,0.9435528521242436
8815,A Woman in Berlin,1847322,294014,1553308,2008_boxofficemojo_rankings.csv,2008,0.15915687681952578,0.8408431231804743
8816,A Love Song for Bobby Long,1841260,164308,1676952,2004_boxofficemojo_rankings.csv,2004,0.0892367183341842,0.9107632816658158
8817,"You, the Living",1840899,21438,1819461,2007_boxofficemojo_rankings.csv,2007,0.01164539716736225,0.9883546028326378
8818,Heavenly Bodies,1839623,1839623,0,1985_boxofficemojo_rankings.csv,1985,1.0,0.0
8819,Elvis Gratton 3: Le retour d'Elvis Wong,1838920,1838920,0,2004_boxofficemojo_rankings.csv,2004,1.0,0.0
8820,Election 2,1833853,55758,1778095,2006_boxofficemojo_rankings.csv,2006,0.0304048361564422,0.9695951638435578
8821,Crooked Arrows,1832541,1832541,0,2012_boxofficemojo_rankings.csv,2012,1.0,0.0
8822,The Last Mistress,1831577,785671,1045906,2007_boxofficemojo_rankings.csv,2007,0.4289587606745444,0.5710412393254556
8823,Renaissance,1831348,70644,1760704,2006_boxofficemojo_rankings.csv,2006,0.03857486397997541,0.9614251360200246
8824,Spartacus 1991 Re-release,1830650,1830650,0,1991_boxofficemojo_rankings.csv,1991,1.0,0.0
8825,Startup.com,1830008,1283356,546652,2001_boxofficemojo_rankings.csv,2001,0.7012843659699848,0.29871563403001516
8826,Poison Ivy,1829804,1829804,0,1992_boxofficemojo_rankings.csv,1992,1.0,0.0
8827,Me and Mrs. Khanna,1828902,197183,1631719,2009_boxofficemojo_rankings.csv,2009,0.10781496220136454,0.8921850377986354
8828,99 Homes,1828232,1411927,416305,2015_boxofficemojo_rankings.csv,2015,0.7722909346297406,0.22770906537025937
8829,Enduring Love,1828184,358362,1469822,2004_boxofficemojo_rankings.csv,2004,0.19602075064654323,0.8039792493534568
8830,Grease 2018 Re-release,1827688,1213413,614275,2018_boxofficemojo_rankings.csv,2018,0.6639059839534975,0.33609401604650246
8831,Rams,1826583,149250,1677333,2015_boxofficemojo_rankings.csv,2015,0.08170994693370079,0.9182900530662992
8832,A Somewhat Gentle Man,1826459,37743,1788716,2010_boxofficemojo_rankings.csv,2010,0.02066457555302364,0.9793354244469764
8833,The Little Stranger,1824902,713143,1111759,2018_boxofficemojo_rankings.csv,2018,0.39078427225133183,0.6092157277486682
8834,Mozart's Sister,1824891,707885,1117006,2010_boxofficemojo_rankings.csv,2010,0.3879053598269705,0.6120946401730295
8835,Infinitely Polar Bear,1824678,1430655,394023,2015_boxofficemojo_rankings.csv,2015,0.7840588860061884,0.21594111399381152
8836,Human Flow,1824537,527845,1296692,2017_boxofficemojo_rankings.csv,2017,0.28930353289629096,0.710696467103709
8837,The Forbidden Dance,1823154,1823154,0,1990_boxofficemojo_rankings.csv,1990,1.0,0.0
8838,The Seagull,1820461,1252960,567501,2018_boxofficemojo_rankings.csv,2018,0.688265225127042,0.311734774872958
8839,The Buddy System,1820049,1820049,0,1984_boxofficemojo_rankings.csv,1984,1.0,0.0
8840,Carny,1817720,1817720,0,1980_boxofficemojo_rankings.csv,1980,1.0,0.0
8841,Brodeuses - A Common Thread,1812833,26042,1786791,2004_boxofficemojo_rankings.csv,2004,0.014365360736482622,0.9856346392635174
8842,Dans Paris,1810452,63667,1746785,2006_boxofficemojo_rankings.csv,2006,0.03516635624694828,0.9648336437530517
8843,The Monk,1809527,13472,1796055,2011_boxofficemojo_rankings.csv,2011,0.0074450395047987675,0.9925549604952012
8844,NSync: Bigger Than Live,1808679,1808679,0,2001_boxofficemojo_rankings.csv,2001,1.0,0.0
8845,The Navigators,1807686,3052,1804634,2002_boxofficemojo_rankings.csv,2002,0.0016883463167828925,0.9983116536832171
8846,The Other Side of Heaven 2: Fire of Faith,1807216,1807216,0,2019_boxofficemojo_rankings.csv,2019,1.0,0.0
8847,Moses,1807117,1807117,0,2018_boxofficemojo_rankings.csv,2018,1.0,0.0
8848,The Face of Love,1806548,350006,1456542,2013_boxofficemojo_rankings.csv,2013,0.19374298385650424,0.8062570161434958
8849,The Aura,1805261,58804,1746457,2005_boxofficemojo_rankings.csv,2005,0.032573683251341495,0.9674263167486585
8850,The Secret of Kells,1803412,676775,1126637,2009_boxofficemojo_rankings.csv,2009,0.3752747569606945,0.6247252430393055
8851,How I Killed My Father,1802142,145396,1656746,2001_boxofficemojo_rankings.csv,2001,0.0806795468947508,0.9193204531052492
8852,Oyster Farmer,1801199,15456,1785743,2005_boxofficemojo_rankings.csv,2005,0.008580950799994892,0.9914190492000051
8853,The Bridge of San Luis Rey,1800141,49981,1750160,2004_boxofficemojo_rankings.csv,2004,0.027765047293517562,0.9722349527064824
8854,Hurlyburly,1798862,1798862,0,1998_boxofficemojo_rankings.csv,1998,1.0,0.0
8855,Elvis & Nixon,1798432,1055287,743145,2016_boxofficemojo_rankings.csv,2016,0.5867817076208608,0.41321829237913915
8856,The Polar Express 2010 IMAX Release,1798274,672796,1125478,2010_boxofficemojo_rankings.csv,2010,0.3741343087872037,0.6258656912127962
8857,Slow Burn,1797256,1237615,559641,2007_boxofficemojo_rankings.csv,2007,0.6886136421300026,0.31138635786999735
8858,Boxing Helena,1796389,1796389,0,1993_boxofficemojo_rankings.csv,1993,1.0,0.0
8859,Delicatessen,1794187,1794187,0,1992_boxofficemojo_rankings.csv,1992,1.0,0.0
8860,Clay Pigeons,1794086,1794086,0,1998_boxofficemojo_rankings.csv,1998,1.0,0.0
8861,Tune in Tomorrow...,1794001,1794001,0,1990_boxofficemojo_rankings.csv,1990,1.0,0.0
8862,Stormy Monday,1791328,1791328,0,1988_boxofficemojo_rankings.csv,1988,1.0,0.0
8863,King of the Mountain,1791147,1791147,0,1981_boxofficemojo_rankings.csv,1981,1.0,0.0
8864,Mine,1788934,0,1788934,2016_boxofficemojo_rankings.csv,2016,0.0,1.0
8865,Mondovino,1788325,209618,1578707,2004_boxofficemojo_rankings.csv,2004,0.11721471209092307,0.882785287909077
8866,Harry Potter IMAX Marathon,1784557,1729226,55331,2016_boxofficemojo_rankings.csv,2016,0.9689945459853622,0.031005454014637807
8867,Soldiers of Fortune,1784286,38898,1745388,2012_boxofficemojo_rankings.csv,2012,0.021800316765361608,0.9781996832346384
8868,Reservation Road,1783226,121994,1661232,2007_boxofficemojo_rankings.csv,2007,0.06841196797265181,0.9315880320273482
8869,A Soldier's Daughter Never Cries,1782005,1782005,0,1998_boxofficemojo_rankings.csv,1998,1.0,0.0
8870,The Nutcracker Prince,1781694,1781694,0,1990_boxofficemojo_rankings.csv,1990,1.0,0.0
8871,The City of Lost Children,1781465,1738611,42854,1995_boxofficemojo_rankings.csv,1995,0.9759445175740191,0.024055482425980865
8872,The Mangler,1781383,1781383,0,1995_boxofficemojo_rankings.csv,1995,1.0,0.0
8873,O'Horten,1778791,302232,1476559,2007_boxofficemojo_rankings.csv,2007,0.16990866268156293,0.8300913373184371
8874,Che: Part One/Che: Part Two,1778287,1497109,281178,2008_boxofficemojo_rankings.csv,2008,0.8418826657339339,0.15811733426606617
8875,Song to Song,1778021,443684,1334337,2017_boxofficemojo_rankings.csv,2017,0.2495381100673164,0.7504618899326836
8876,The Notorious Bettie Page,1778006,1415082,362924,2006_boxofficemojo_rankings.csv,2006,0.7958814537183789,0.2041185462816211
8877,Working Girls,1777378,1777378,0,1987_boxofficemojo_rankings.csv,1987,1.0,0.0
8878,Ondine,1777019,550472,1226547,2010_boxofficemojo_rankings.csv,2010,0.30977271486686414,0.6902272851331359
8879,Tom of Finland,1776931,378296,1398635,2017_boxofficemojo_rankings.csv,2017,0.2128929035511227,0.7871070964488773
8880,Too Beautiful for You,1776440,1776440,0,1990_boxofficemojo_rankings.csv,1990,1.0,0.0
8881,The Diary of a Teenage Girl,1775133,1477002,298131,2015_boxofficemojo_rankings.csv,2015,0.832051457552758,0.16794854244724197
8882,Sweet Land,1774931,1706325,68606,2006_boxofficemojo_rankings.csv,2006,0.9613472298359768,0.03865277016402328
8883,Polaroid,1772204,0,1772204,2019_boxofficemojo_rankings.csv,2019,0.0,1.0
8884,Bloodfist,1770082,1770082,0,1989_boxofficemojo_rankings.csv,1989,1.0,0.0
8885,Dior and I,1769832,1028953,740879,2015_boxofficemojo_rankings.csv,2015,0.5813845607944709,0.4186154392055291
8886,Naked,1769305,1769305,0,1993_boxofficemojo_rankings.csv,1993,1.0,0.0
8887,I Saw the Light,1767963,1646788,121175,2016_boxofficemojo_rankings.csv,2016,0.9314606697085855,0.06853933029141447
8888,Invisible Life,1766249,146535,1619714,2019_boxofficemojo_rankings.csv,2019,0.08296395355354766,0.9170360464464523
8889,Carman: The Champion,1765751,1765751,0,2001_boxofficemojo_rankings.csv,2001,1.0,0.0
8890,Holy Smoke,1765545,1765545,0,1999_boxofficemojo_rankings.csv,1999,1.0,0.0
8891,Game,1764828,139528,1625300,2011_boxofficemojo_rankings.csv,2011,0.07906039568728511,0.9209396043127149
8892,Who Killed the Electric Car?,1764304,1678874,85430,2006_boxofficemojo_rankings.csv,2006,0.9515786395088375,0.048421360491162524
8893,Great Performances at the Met: Puccini: La Bohème,1764201,1764201,0,2018_boxofficemojo_rankings.csv,2018,1.0,0.0
8894,Tales of the Night,1762194,10975,1751219,2011_boxofficemojo_rankings.csv,2011,0.006228031646912883,0.9937719683530871
8895,I Like It Like That,1760527,1760527,0,1994_boxofficemojo_rankings.csv,1994,1.0,0.0
8896,Bloody Sunday,1758689,773228,985461,2002_boxofficemojo_rankings.csv,2002,0.43966158883122597,0.560338411168774
8897,The Blue Butterfly,1755355,1755355,0,2004_boxofficemojo_rankings.csv,2004,1.0,0.0
8898,Flipped,1755212,1755212,0,2010_boxofficemojo_rankings.csv,2010,1.0,0.0
8899,Carnosaur,1753979,1753979,0,1993_boxofficemojo_rankings.csv,1993,1.0,0.0
8900,Going the Distance,1752950,1230897,522053,2004_boxofficemojo_rankings.csv,2004,0.7021860292649533,0.2978139707350466
8901,Pledge This!,1751490,0,1751490,2007_boxofficemojo_rankings.csv,2007,0.0,1.0
8902,Prospero's Books,1750301,1750301,0,1991_boxofficemojo_rankings.csv,1991,1.0,0.0
8903,Murderball,1750211,1531154,219057,2005_boxofficemojo_rankings.csv,2005,0.8748396621893018,0.12516033781069824
8904,Hunk,1749956,1749956,0,1987_boxofficemojo_rankings.csv,1987,1.0,0.0
8905,Great Performances at the Met: Massenet: Cendrillon,1747259,1243306,503953,2018_boxofficemojo_rankings.csv,2018,0.7115751013444487,0.2884248986555514
8906,Vanya on 42nd Street,1746050,1746050,0,1994_boxofficemojo_rankings.csv,1994,1.0,0.0
8907,The Debut,1745778,1745778,0,2001_boxofficemojo_rankings.csv,2001,1.0,0.0
8908,Everybody's Fine,1745470,1745470,0,1991_boxofficemojo_rankings.csv,1991,1.0,0.0
8909,Personal Services,1744164,1744164,0,1987_boxofficemojo_rankings.csv,1987,1.0,0.0
8910,Beast,1744071,800365,943706,2018_boxofficemojo_rankings.csv,2018,0.45890620278646915,0.5410937972135309
8911,"Turn Me On, Dammit!",1743743,126085,1617658,2011_boxofficemojo_rankings.csv,2011,0.07230710030090444,0.9276928996990955
8912,Wuthering Heights,1742215,100915,1641300,2011_boxofficemojo_rankings.csv,2011,0.057923390626300426,0.9420766093736995
8913,Heat and Dust,1741435,1741435,0,1983_boxofficemojo_rankings.csv,1983,1.0,0.0
8914,Suicide Kings,1740156,1740156,0,1998_boxofficemojo_rankings.csv,1998,1.0,0.0
8915,The Horror Show,1738897,1738897,0,1989_boxofficemojo_rankings.csv,1989,1.0,0.0
8916,Starter for 10,1736394,216839,1519555,2006_boxofficemojo_rankings.csv,2006,0.1248789157299553,0.8751210842700446
8917,Barbarosa,1736123,1736123,0,1982_boxofficemojo_rankings.csv,1982,1.0,0.0
8918,L'odyssée d'Alice Tremblay,1734925,1734925,0,2002_boxofficemojo_rankings.csv,2002,1.0,0.0
8919,Little Nikita,1733070,1733070,0,1988_boxofficemojo_rankings.csv,1988,1.0,0.0
8920,The Big Town,1733017,1733017,0,1987_boxofficemojo_rankings.csv,1987,1.0,0.0
8921,National Theatre Live: King Lear,1731751,185305,1546446,2018_boxofficemojo_rankings.csv,2018,0.1070044134520494,0.8929955865479506
8922,My Father's Glory,1730856,1730856,0,1991_boxofficemojo_rankings.csv,1991,1.0,0.0
8923,First Position,1730824,1014071,716753,2012_boxofficemojo_rankings.csv,2012,0.5858891487522706,0.4141108512477294
8924,The Rosary Murders,1730337,1730337,0,1987_boxofficemojo_rankings.csv,1987,1.0,0.0
8925,Last Exit to Brooklyn,1730005,1730005,0,1990_boxofficemojo_rankings.csv,1990,1.0,0.0
8926,Cutter's Way,1729274,1729274,0,1981_boxofficemojo_rankings.csv,1981,1.0,0.0
8927,After Love,1728251,13693,1714558,2016_boxofficemojo_rankings.csv,2016,0.007923038956725614,0.9920769610432744
8928,Elling,1727470,314729,1412741,2001_boxofficemojo_rankings.csv,2001,0.18219071821797195,0.817809281782028
8929,Girl Rising,1727259,1727259,0,2013_boxofficemojo_rankings.csv,2013,1.0,0.0
8930,The Dreamlife of Angels,1726567,1726567,0,1999_boxofficemojo_rankings.csv,1999,1.0,0.0
8931,Koyaanisqatsi,1723872,1723872,0,1983_boxofficemojo_rankings.csv,1983,1.0,0.0
8932,Stryker,1723487,1723487,0,1983_boxofficemojo_rankings.csv,1983,1.0,0.0
8933,The Waterdance,1723319,1723319,0,1992_boxofficemojo_rankings.csv,1992,1.0,0.0
8934,Diana Vreeland: The Eye Has to Travel,1721472,1017579,703893,2012_boxofficemojo_rankings.csv,2012,0.5911098176444345,0.40889018235556546
8935,A Faithful Man,1720605,77491,1643114,2018_boxofficemojo_rankings.csv,2018,0.04503706545081527,0.9549629345491847
8936,Link,1720450,1720450,0,1986_boxofficemojo_rankings.csv,1986,1.0,0.0
8937,Casablanca 1992 Re-release,1719913,1719913,0,1992_boxofficemojo_rankings.csv,1992,1.0,0.0
8938,The Souvenir,1719157,1036737,682420,2019_boxofficemojo_rankings.csv,2019,0.6030496342102554,0.39695036578974463
8939,Weiner,1715955,1676108,39847,2016_boxofficemojo_rankings.csv,2016,0.9767785285744672,0.02322147142553272
8940,Live Flesh,1713459,1713459,0,1998_boxofficemojo_rankings.csv,1998,1.0,0.0
8941,Safe Conduct,1713421,25440,1687981,2002_boxofficemojo_rankings.csv,2002,0.014847489321071704,0.9851525106789283
8942,The Life and Times of Hank Greenberg,1712385,1712385,0,2000_boxofficemojo_rankings.csv,2000,1.0,0.0
8943,Steel,1710972,1710972,0,1997_boxofficemojo_rankings.csv,1997,1.0,0.0
8944,High Heels,1710057,1710057,0,1991_boxofficemojo_rankings.csv,1991,1.0,0.0
8945,"To Joey, with Love",1709073,1709073,0,2016_boxofficemojo_rankings.csv,2016,1.0,0.0
8946,Paradise: Love,1709036,24267,1684769,2012_boxofficemojo_rankings.csv,2012,0.01419923278386178,0.9858007672161382
8947,Even Cowgirls Get the Blues,1708873,1708873,0,1994_boxofficemojo_rankings.csv,1994,1.0,0.0
8948,The Girl on the Bridge,1708839,1708839,0,2000_boxofficemojo_rankings.csv,2000,1.0,0.0
8949,"Men, Women & Children",1705908,705908,1000000,2014_boxofficemojo_rankings.csv,2014,0.4138019166332534,0.5861980833667466
8950,The Polar Express 2008 IMAX Release,1705694,1705694,0,2008_boxofficemojo_rankings.csv,2008,1.0,0.0
8951,Lady in White,1705139,1705139,0,1988_boxofficemojo_rankings.csv,1988,1.0,0.0
8952,The Girl on the Train,1703963,208023,1495940,2009_boxofficemojo_rankings.csv,2009,0.12208187619097363,0.8779181238090263
8953,The Oscar Nominated Short Films 2012: Live Action,1702415,1702415,0,2012_boxofficemojo_rankings.csv,2012,1.0,0.0
8954,Death Wish V: The Face of Death,1702394,1702394,0,1994_boxofficemojo_rankings.csv,1994,1.0,0.0
8955,The Scent of Green Papaya,1700992,1700992,0,1994_boxofficemojo_rankings.csv,1994,1.0,0.0
8956,Meet the Patels,1700681,1700681,0,2015_boxofficemojo_rankings.csv,2015,1.0,0.0
8957,Best of the Best,1700000,1700000,0,1989_boxofficemojo_rankings.csv,1989,1.0,0.0
8958,Rear Window 2000 Re-release,1699210,1574607,124603,2000_boxofficemojo_rankings.csv,2000,0.9266700407836583,0.07332995921634171
8959,Tekken,1697207,0,1697207,2010_boxofficemojo_rankings.csv,2010,0.0,1.0
8960,The Wild Pear Tree,1696258,34014,1662244,2018_boxofficemojo_rankings.csv,2018,0.020052374108184015,0.9799476258918159
8961,The Rain Killer,1696066,1696066,0,1990_boxofficemojo_rankings.csv,1990,1.0,0.0
8962,Dunkirk 2017 Re-release,1695119,1695119,0,2017_boxofficemojo_rankings.csv,2017,1.0,0.0
8963,Open Hearts,1692272,136170,1556102,2002_boxofficemojo_rankings.csv,2002,0.08046578800571066,0.9195342119942893
8964,State Property: Blood on the Streets,1691706,1691706,0,2005_boxofficemojo_rankings.csv,2005,1.0,0.0
8965,El vacilón: The Movie,1690929,1291951,398978,2005_boxofficemojo_rankings.csv,2005,0.7640480469611675,0.2359519530388325
8966,The Legend of Johnny Lingo,1690767,1690767,0,2003_boxofficemojo_rankings.csv,2003,1.0,0.0
8967,The Breed,1689984,14500,1675484,2006_boxofficemojo_rankings.csv,2006,0.008579962887222601,0.9914200371127774
8968,All Good Things 2010 Re-release,1689646,582024,1107622,2010_boxofficemojo_rankings.csv,2010,0.34446505362661767,0.6555349463733824
8969,Body Rock,1689501,1689501,0,1984_boxofficemojo_rankings.csv,1984,1.0,0.0
8970,Slamma Jamma,1687000,1687000,0,2017_boxofficemojo_rankings.csv,2017,1.0,0.0
8971,Tim's Vermeer,1686917,1671377,15540,2014_boxofficemojo_rankings.csv,2014,0.9907879285110056,0.00921207148899442
8972,Janis: Little Girl Blue,1683166,410465,1272701,2015_boxofficemojo_rankings.csv,2015,0.2438648356727738,0.7561351643272262
8973,The Bride,1682689,0,1682689,2015_boxofficemojo_rankings.csv,2015,0.0,1.0
8974,Detachment,1681521,72689,1608832,2012_boxofficemojo_rankings.csv,2012,0.04322812501300906,0.9567718749869909
8975,The Hunter,1680778,176669,1504109,2011_boxofficemojo_rankings.csv,2011,0.10511144243915616,0.8948885575608438
8976,Matewan,1680358,1680358,0,1987_boxofficemojo_rankings.csv,1987,1.0,0.0
8977,"The Book of Mormon Movie, Volume 1: The Journey",1680020,1680020,0,2003_boxofficemojo_rankings.csv,2003,1.0,0.0
8978,In Between,1679952,107977,1571975,2016_boxofficemojo_rankings.csv,2016,0.06427386020552968,0.9357261397944703
8979,Final Portrait,1677835,461972,1215863,2017_boxofficemojo_rankings.csv,2017,0.275338158996564,0.724661841003436
8980,A Home of Our Own,1677807,1677807,0,1993_boxofficemojo_rankings.csv,1993,1.0,0.0
8981,The Gingerbread Man,1677131,1677131,0,1998_boxofficemojo_rankings.csv,1998,1.0,0.0
8982,Marci X,1675706,1648818,26888,2003_boxofficemojo_rankings.csv,2003,0.9839542258606223,0.01604577413937767
8983,Nothing Left to Fear,1675381,7886,1667495,2013_boxofficemojo_rankings.csv,2013,0.0047069890371205115,0.9952930109628795
8984,Walk Proud,1675040,1675040,0,1979_boxofficemojo_rankings.csv,1979,1.0,0.0
8985,Ginger & Rosa,1674776,1012973,661803,2012_boxofficemojo_rankings.csv,2012,0.6048408861841822,0.39515911381581775
8986,Happy Endings,1673288,1315701,357587,2005_boxofficemojo_rankings.csv,2005,0.7862968000726713,0.2137031999273287
8987,Equity,1672306,1605463,66843,2016_boxofficemojo_rankings.csv,2016,0.9600294443720229,0.039970555627977175
8988,Divine Intervention,1672044,421343,1250701,2002_boxofficemojo_rankings.csv,2002,0.25199277052517755,0.7480072294748225
8989,A Brother's Love,1671969,539524,1132445,2019_boxofficemojo_rankings.csv,2019,0.32268780102980377,0.6773121989701962
8990,Vanishing on 7th Street,1671196,22729,1648467,2011_boxofficemojo_rankings.csv,2011,0.013600439445762197,0.9863995605542378
8991,L.I.E.,1667192,1138836,528356,2001_boxofficemojo_rankings.csv,2001,0.6830862912010135,0.31691370879898656
8992,Girlfight,1666028,1565852,100176,2000_boxofficemojo_rankings.csv,2000,0.9398713587046557,0.06012864129534438
8993,A Thousand Years of Good Prayers,1665585,76806,1588779,2008_boxofficemojo_rankings.csv,2008,0.04611352767946397,0.953886472320536
8994,A Hard Day's Night,1664617,965351,699266,2000_boxofficemojo_rankings.csv,2000,0.579923790277283,0.420076209722717
8995,The Double,1662515,200406,1462109,2014_boxofficemojo_rankings.csv,2014,0.12054387479210714,0.8794561252078928
8996,Storm,1661518,16013,1645505,2009_boxofficemojo_rankings.csv,2009,0.009637572388622935,0.990362427611377
8997,Out on a Limb,1659542,1659542,0,1992_boxofficemojo_rankings.csv,1992,1.0,0.0
8998,The Comedian,1659002,1659002,0,2016_boxofficemojo_rankings.csv,2016,1.0,0.0
8999,Rustom,1658594,1087419,571175,2016_boxofficemojo_rankings.csv,2016,0.6556269949125585,0.3443730050874415
9000,Sharkwater,1658393,850920,807473,2007_boxofficemojo_rankings.csv,2007,0.5130991266846882,0.48690087331531184
9001,The Celebration,1657778,1656223,1555,1998_boxofficemojo_rankings.csv,1998,0.9990619974447724,0.0009380025552275395
9002,Dear Frankie,1656829,18025,1638804,2005_boxofficemojo_rankings.csv,2005,0.010879215658344947,0.9891207843416551
9003,Sweetheart,1656433,650000,1006433,2006_boxofficemojo_rankings.csv,2006,0.3924094726439282,0.6075905273560718
9004,Prick Up Your Ears,1654743,1654743,0,1987_boxofficemojo_rankings.csv,1987,1.0,0.0
9005,Rockstar,1651601,986697,664904,2011_boxofficemojo_rankings.csv,2011,0.5974185048325836,0.40258149516741637
9006,Talento de barrio,1650198,68542,1581656,2008_boxofficemojo_rankings.csv,2008,0.04153562178599174,0.9584643782140082
9007,Namaste England,1649863,104156,1545707,2018_boxofficemojo_rankings.csv,2018,0.06313009019536774,0.9368699098046323
9008,What's Cooking?,1649655,1045899,603756,2000_boxofficemojo_rankings.csv,2000,0.6340107477017922,0.36598925229820783
9009,Two Lives,1649260,22620,1626640,2012_boxofficemojo_rankings.csv,2012,0.013715241987315524,0.9862847580126844
9010,Appleseed,1647770,129135,1518635,2004_boxofficemojo_rankings.csv,2004,0.0783695540032893,0.9216304459967107
9011,The Maid,1647555,576608,1070947,2009_boxofficemojo_rankings.csv,2009,0.34997799769962157,0.6500220023003784
9012,Dough,1647429,1148304,499125,2016_boxofficemojo_rankings.csv,2016,0.6970279144048089,0.30297208559519107
9013,The Letters,1647416,1647416,0,2015_boxofficemojo_rankings.csv,2015,1.0,0.0
9014,The Little Hours,1647175,1647175,0,2017_boxofficemojo_rankings.csv,2017,1.0,0.0
9015,Get Crazy,1645711,1645711,0,1983_boxofficemojo_rankings.csv,1983,1.0,0.0
9016,Short Term 12,1645164,1013100,632064,2013_boxofficemojo_rankings.csv,2013,0.6158048680860996,0.38419513191390037
9017,Asylum,1644363,375403,1268960,2005_boxofficemojo_rankings.csv,2005,0.2282969149755863,0.7717030850244138
9018,Daughters of the Dust,1642436,1642436,0,1992_boxofficemojo_rankings.csv,1992,1.0,0.0
9019,How I Got Into College,1642239,1642239,0,1989_boxofficemojo_rankings.csv,1989,1.0,0.0
9020,Pirates,1641825,1641825,0,1986_boxofficemojo_rankings.csv,1986,1.0,0.0
9021,Deerskin,1641693,0,1641693,2019_boxofficemojo_rankings.csv,2019,0.0,1.0
9022,A Family Man,1641235,0,1641235,2017_boxofficemojo_rankings.csv,2017,0.0,1.0
9023,Josh and S.A.M.,1640220,1640220,0,1993_boxofficemojo_rankings.csv,1993,1.0,0.0
9024,Sorry Angel,1636273,30628,1605645,2018_boxofficemojo_rankings.csv,2018,0.018718147888524713,0.9812818521114753
9025,Student of the Year 2,1635907,778566,857341,2019_boxofficemojo_rankings.csv,2019,0.47592314233021804,0.524076857669782
9026,Black Diamond Rush,1634386,1634386,0,1993_boxofficemojo_rankings.csv,1993,1.0,0.0
9027,Since Otar Left,1634307,350391,1283916,2003_boxofficemojo_rankings.csv,2003,0.21439729500026616,0.7856027049997338
9028,Mohenjo Daro,1630231,1264339,365892,2016_boxofficemojo_rankings.csv,2016,0.7755581877660283,0.22444181223397175
9029,Brain Dead,1627955,1627955,0,1990_boxofficemojo_rankings.csv,1990,1.0,0.0
9030,Withnail & I,1627318,1544889,82429,2007_boxofficemojo_rankings.csv,2007,0.9493467164991722,0.05065328350082774
9031,Silence of the North,1622898,1622898,0,1981_boxofficemojo_rankings.csv,1981,1.0,0.0
9032,Iris,1620708,1310678,310030,2015_boxofficemojo_rankings.csv,2015,0.8087070588903121,0.19129294110968786
9033,All You Need Is Love,1620654,0,1620654,2014_boxofficemojo_rankings.csv,2014,0.0,1.0
9034,I Still See You,1620637,1359,1619278,2018_boxofficemojo_rankings.csv,2018,0.0008385591591454472,0.9991614408408546
9035,Son of Sardaar,1618361,771789,846572,2012_boxofficemojo_rankings.csv,2012,0.4768954516328557,0.5231045483671443
9036,Safe Passage,1618282,1618282,0,1994_boxofficemojo_rankings.csv,1994,1.0,0.0
9037,Grand Piano,1618085,22555,1595530,2013_boxofficemojo_rankings.csv,2013,0.013939317155773645,0.9860606828442263
9038,Lights in the Dusk,1615018,14056,1600962,2006_boxofficemojo_rankings.csv,2006,0.008703308569935444,0.9912966914300646
9039,Wide Sargasso Sea,1614784,1614784,0,1993_boxofficemojo_rankings.csv,1993,1.0,0.0
9040,In My Father's Den,1614675,0,1614675,2004_boxofficemojo_rankings.csv,2004,0.0,1.0
9041,The Corporation,1613533,1613533,0,2004_boxofficemojo_rankings.csv,2004,1.0,0.0
9042,Batman Begins 2012 Re-release,1612434,1508658,103776,2012_boxofficemojo_rankings.csv,2012,0.9356401564343099,0.06435984356569013
9043,Session 9,1612259,378176,1234083,2001_boxofficemojo_rankings.csv,2001,0.23456280907720162,0.7654371909227984
9044,Black Friday,1610897,35000,1575897,2007_boxofficemojo_rankings.csv,2007,0.021727025377786414,0.9782729746222136
9045,Singin' in the Rain 2012 Re-release,1609789,1608925,864,2012_boxofficemojo_rankings.csv,2012,0.9994632836974287,0.0005367163025713307
9046,Once Were Warriors,1608570,1608570,0,1995_boxofficemojo_rankings.csv,1995,1.0,0.0
9047,Rhyme & Reason,1608277,1608277,0,1997_boxofficemojo_rankings.csv,1997,1.0,0.0
9048,Walk With Me,1606705,726726,879979,2017_boxofficemojo_rankings.csv,2017,0.4523082955489651,0.5476917044510349
9049,Year of the Dog,1606237,1540141,66096,2007_boxofficemojo_rankings.csv,2007,0.9588504062600973,0.041149593739902644
9050,Un Coeur en Hiver,1605437,1605437,0,1993_boxofficemojo_rankings.csv,1993,1.0,0.0
9051,More Than Honey,1604609,79772,1524837,2012_boxofficemojo_rankings.csv,2012,0.049714291768275014,0.950285708231725
9052,We are the Best!,1604273,180590,1423683,2013_boxofficemojo_rankings.csv,2013,0.11256812275716166,0.8874318772428383
9053,Jesus of Montreal,1601612,1601612,0,1990_boxofficemojo_rankings.csv,1990,1.0,0.0
9054,Monos,1601199,406473,1194726,2019_boxofficemojo_rankings.csv,2019,0.25385539211553343,0.7461446078844666
9055,Northfork,1599804,1420578,179226,2003_boxofficemojo_rankings.csv,2003,0.8879700263282252,0.1120299736717748
9056,The Code,1598493,13152,1585341,2002_boxofficemojo_rankings.csv,2002,0.008227749511571212,0.9917722504884288
9057,Crazy Mad Lover,1597269,993031,604238,2011_boxofficemojo_rankings.csv,2011,0.6217055486583662,0.37829445134163375
9058,Chasers,1596687,1596687,0,1994_boxofficemojo_rankings.csv,1994,1.0,0.0
9059,The Hottie & the Nottie,1596232,27696,1568536,2008_boxofficemojo_rankings.csv,2008,0.017350861278310422,0.9826491387216896
9060,Great Performances at the Met: Verdi: Aida,1595902,1595902,0,2018_boxofficemojo_rankings.csv,2018,1.0,0.0
9061,The Messenger,1595417,1109660,485757,2009_boxofficemojo_rankings.csv,2009,0.6955297580507165,0.30447024194928346
9062,Queen of the Desert,1592853,0,1592853,2015_boxofficemojo_rankings.csv,2015,0.0,1.0
9063,It's All Gone Pete Tong,1591879,120620,1471259,2005_boxofficemojo_rankings.csv,2005,0.0757720907179503,0.9242279092820497
9064,Beanpole,1591621,196258,1395363,2019_boxofficemojo_rankings.csv,2019,0.12330699331059342,0.8766930066894066
9065,Nine Lives,1591523,478830,1112693,2005_boxofficemojo_rankings.csv,2005,0.30086275850239047,0.6991372414976095
9066,"Mèche Blanche, les aventures du petit castor",1591520,360886,1230634,2008_boxofficemojo_rankings.csv,2008,0.2267555544385242,0.7732444455614759
9067,I Am,1591034,1591034,0,2011_boxofficemojo_rankings.csv,2011,1.0,0.0
9068,The Crossing,1589212,90896,1498316,2019_boxofficemojo_rankings.csv,2019,0.05719564161357956,0.9428043583864204
9069,Dance Academy: The Movie,1586858,0,1586858,2017_boxofficemojo_rankings.csv,2017,0.0,1.0
9070,Romance,1585642,1585642,0,1999_boxofficemojo_rankings.csv,1999,1.0,0.0
9071,Citizen Kane 1991 Re-release,1585634,1585634,0,1991_boxofficemojo_rankings.csv,1991,1.0,0.0
9072,Lovelace,1585583,356582,1229001,2013_boxofficemojo_rankings.csv,2013,0.22489015081518912,0.7751098491848109
9073,Two 2004 Re-release,1585139,47806,1537333,2004_boxofficemojo_rankings.csv,2004,0.030158869348366295,0.9698411306516337
9074,Making Mr. Right,1584970,1584970,0,1987_boxofficemojo_rankings.csv,1987,1.0,0.0
9075,Make Your Move,1583687,125106,1458581,2012_boxofficemojo_rankings.csv,2012,0.07899667042793178,0.9210033295720682
9076,Bra Boys,1582036,155056,1426980,2007_boxofficemojo_rankings.csv,2007,0.09801041189960279,0.9019895881003972
9077,The Bay,1581252,30668,1550584,2012_boxofficemojo_rankings.csv,2012,0.019394758077776346,0.9806052419222236
9078,Lou!,1581125,287,1580838,2014_boxofficemojo_rankings.csv,2014,0.00018151632540121747,0.9998184836745988
9079,The Stray,1579440,1579440,0,2017_boxofficemojo_rankings.csv,2017,1.0,0.0
9080,Solarbabies,1579260,1579260,0,1986_boxofficemojo_rankings.csv,1986,1.0,0.0
9081,Vincent: The Life and Death of Vincent Van Gogh,1577480,1577480,0,1988_boxofficemojo_rankings.csv,1988,1.0,0.0
9082,May Fools,1576702,1576702,0,1990_boxofficemojo_rankings.csv,1990,1.0,0.0
9083,Lay the Favorite,1576687,20998,1555689,2012_boxofficemojo_rankings.csv,2012,0.013317798649953985,0.986682201350046
9084,The Garbage Pail Kids Movie,1576615,1576615,0,1987_boxofficemojo_rankings.csv,1987,1.0,0.0
9085,After Midnight,1576003,50469,1525534,2004_boxofficemojo_rankings.csv,2004,0.03202341619908084,0.9679765838009191
9086,Adore,1575749,318982,1256767,2013_boxofficemojo_rankings.csv,2013,0.2024319863125409,0.7975680136874591
9087,Genesis: Paradise Lost,1575000,1575000,0,2017_boxofficemojo_rankings.csv,2017,1.0,0.0
9088,Teri Meri Kahaani,1574703,781196,793507,2012_boxofficemojo_rankings.csv,2012,0.49609100890771146,0.5039089910922885
9089,Human Nature,1574660,705308,869352,2002_boxofficemojo_rankings.csv,2002,0.44791129513672795,0.5520887048632721
9090,9 Songs,1574623,66853,1507770,2004_boxofficemojo_rankings.csv,2004,0.04245651181266881,0.9575434881873311
9091,Teen Spirit,1573601,441366,1132235,2019_boxofficemojo_rankings.csv,2019,0.2804815197753433,0.7195184802246567
9092,Farinelli,1573411,1573411,0,1995_boxofficemojo_rankings.csv,1995,1.0,0.0
9093,City of Industry,1568258,1568258,0,1997_boxofficemojo_rankings.csv,1997,1.0,0.0
9094,Caesar Must Die,1567339,76908,1490431,2012_boxofficemojo_rankings.csv,2012,0.04906915479038038,0.9509308452096196
9095,Hope Springs,1567189,0,1567189,2003_boxofficemojo_rankings.csv,2003,0.0,1.0
9096,Nanking,1566248,161182,1405066,2007_boxofficemojo_rankings.csv,2007,0.10290962861564708,0.8970903713843529
9097,Ushpizin,1565016,1400666,164350,2005_boxofficemojo_rankings.csv,2005,0.894985099193874,0.10501490080612594
9098,Another Woman,1562749,1562749,0,1988_boxofficemojo_rankings.csv,1988,1.0,0.0
9099,"Bless Me, Ultima",1561962,1561962,0,2013_boxofficemojo_rankings.csv,2013,1.0,0.0
9100,A Handful of Dust,1560700,1560700,0,1988_boxofficemojo_rankings.csv,1988,1.0,0.0
9101,Persecuted,1558836,1558836,0,2014_boxofficemojo_rankings.csv,2014,1.0,0.0
9102,The Married Woman,1558018,802758,755260,2005_boxofficemojo_rankings.csv,2005,0.5152430844829777,0.48475691551702227
9103,Zebrahead,1557771,1557771,0,1992_boxofficemojo_rankings.csv,1992,1.0,0.0
9104,Truly Madly Deeply,1554742,1554742,0,1991_boxofficemojo_rankings.csv,1991,1.0,0.0
9105,The Milk of Sorrow,1553977,10462,1543515,2009_boxofficemojo_rankings.csv,2009,0.006732403375339532,0.9932675966246605
9106,Night of the Living Dead 3D,1553837,271000,1282837,2006_boxofficemojo_rankings.csv,2006,0.17440696804104935,0.8255930319589506
9107,The Kid,1553483,1508593,44890,2019_boxofficemojo_rankings.csv,2019,0.9711036425889437,0.028896357411056315
9108,Out of Control,1553195,36486,1516709,2003_boxofficemojo_rankings.csv,2003,0.023490933205424946,0.976509066794575
9109,Eros,1553020,188392,1364628,2004_boxofficemojo_rankings.csv,2004,0.12130687306023104,0.878693126939769
9110,Still Mine,1552730,1159336,393394,2013_boxofficemojo_rankings.csv,2013,0.7466436534362059,0.2533563465637941
9111,Good,1552024,27276,1524748,2008_boxofficemojo_rankings.csv,2008,0.0175744704978789,0.9824255295021211
9112,Yardie,1551163,36012,1515151,2018_boxofficemojo_rankings.csv,2018,0.0232161288014219,0.9767838711985781
9113,A Home at the End of the World,1548955,1029872,519083,2004_boxofficemojo_rankings.csv,2004,0.6648818074120939,0.33511819258790604
9114,Tel Aviv on Fire,1548893,506145,1042748,2019_boxofficemojo_rankings.csv,2019,0.3267785444184976,0.6732214555815024
9115,Beautiful Thing,1548120,1548120,0,1996_boxofficemojo_rankings.csv,1996,1.0,0.0
9116,The Haunting of Morella,1547867,1547867,0,1990_boxofficemojo_rankings.csv,1990,1.0,0.0
9117,Cold in July,1547630,427418,1120212,2014_boxofficemojo_rankings.csv,2014,0.276175830140279,0.723824169859721
9118,Two Moon Junction,1547397,1547397,0,1988_boxofficemojo_rankings.csv,1988,1.0,0.0
9119,Lagaan: Once Upon a Time in India,1546734,835767,710967,2001_boxofficemojo_rankings.csv,2001,0.5403430712714662,0.4596569287285338
9120,In God's Hands,1546414,1546414,0,1998_boxofficemojo_rankings.csv,1998,1.0,0.0
9121,Fed Up,1546229,1538899,7330,2014_boxofficemojo_rankings.csv,2014,0.9952594344046063,0.0047405655953936966
9122,"New York, New York",1545352,92377,1452975,2016_boxofficemojo_rankings.csv,2016,0.059777319342130465,0.9402226806578695
9123,The Lords of Salem,1544989,1165882,379107,2013_boxofficemojo_rankings.csv,2013,0.7546215539398662,0.24537844606013376
9124,Mystery Train,1544973,1541218,3755,2018_boxofficemojo_rankings.csv,2018,0.9975695368139119,0.0024304631860880416
9125,Divided We Fall 2001 Re-release,1544317,1332586,211731,2001_boxofficemojo_rankings.csv,2001,0.8628966721210736,0.1371033278789264
9126,Rampart,1543613,972512,571101,2012_boxofficemojo_rankings.csv,2012,0.6300231988199114,0.3699768011800885
9127,One False Move,1543112,1543112,0,1992_boxofficemojo_rankings.csv,1992,1.0,0.0
9128,The Wedding Plan,1542345,1412404,129941,2016_boxofficemojo_rankings.csv,2016,0.9157510154991263,0.08424898450087367
9129,Asterix and Obelix vs. Caesar,1541261,1541261,0,1999_boxofficemojo_rankings.csv,1999,1.0,0.0
9130,The Chaperone,1541223,600654,940569,2019_boxofficemojo_rankings.csv,2019,0.38972556210230447,0.6102744378976955
9131,Three for the Road,1539000,1539000,0,1987_boxofficemojo_rankings.csv,1987,1.0,0.0
9132,Last Embrace,1537125,1537125,0,1979_boxofficemojo_rankings.csv,1979,1.0,0.0
9133,Reaching for the Moon,1534391,45502,1488889,2013_boxofficemojo_rankings.csv,2013,0.029654762052175748,0.9703452379478242
9134,Love,1533874,309200,1224674,2012_boxofficemojo_rankings.csv,2012,0.2015810946661851,0.7984189053338149
9135,The Blind Swordsman: Zatoichi 2004 Re-release,1532969,862894,670075,2004_boxofficemojo_rankings.csv,2004,0.5628907042477702,0.43710929575222984
9136,The Last of the Finest,1531489,1531489,0,1990_boxofficemojo_rankings.csv,1990,1.0,0.0
9137,Lianna,1530839,1530839,0,1983_boxofficemojo_rankings.csv,1983,1.0,0.0
9138,Blonde Ambition,1530479,6422,1524057,2007_boxofficemojo_rankings.csv,2007,0.004196071948716709,0.9958039280512833
9139,The Bullet Vanishes,1528580,117629,1410951,2012_boxofficemojo_rankings.csv,2012,0.07695311988904735,0.9230468801109526
9140,Gold,1528185,5539,1522646,2017_boxofficemojo_rankings.csv,2017,0.0036245611624247066,0.9963754388375753
9141,Certain Women,1526698,1087585,439113,2016_boxofficemojo_rankings.csv,2016,0.7123773005532201,0.28762269944677993
9142,A Midnight Clear,1526697,1526697,0,1992_boxofficemojo_rankings.csv,1992,1.0,0.0
9143,Misunderstood,1525532,1525532,0,1984_boxofficemojo_rankings.csv,1984,1.0,0.0
9144,Mysterious Skin,1524966,713240,811726,2005_boxofficemojo_rankings.csv,2005,0.4677087882615088,0.5322912117384913
9145,The Sea Is Watching,1523691,30577,1493114,2002_boxofficemojo_rankings.csv,2002,0.02006771714212396,0.979932282857876
9146,Dogtown and Z-Boys,1523090,1300682,222408,2002_boxofficemojo_rankings.csv,2002,0.8539757991976836,0.14602420080231635
9147,Mandy,1523052,1214525,308527,2018_boxofficemojo_rankings.csv,2018,0.7974284528696328,0.20257154713036718
9148,The Syrian Bride,1522967,380505,1142462,2005_boxofficemojo_rankings.csv,2005,0.24984454686148813,0.7501554531385118
9149,She Hate Me,1522377,366037,1156340,2004_boxofficemojo_rankings.csv,2004,0.2404378153374624,0.7595621846625376
9150,Shaadi Ke Side Effects,1521778,921277,600501,2014_boxofficemojo_rankings.csv,2014,0.605395136478514,0.39460486352148605
9151,The Kid Stays in the Picture,1521593,1439232,82361,2002_boxofficemojo_rankings.csv,2002,0.9458718592948311,0.05412814070516886
9152,Stepfather II,1519796,1519796,0,1989_boxofficemojo_rankings.csv,1989,1.0,0.0
9153,Being Human,1519366,1519366,0,1994_boxofficemojo_rankings.csv,1994,1.0,0.0
9154,Princess Mononoke 2018 Re-release,1519321,1423877,95444,2018_boxofficemojo_rankings.csv,2018,0.9371798323066686,0.06282016769333143
9155,Life Is Sweet,1516414,1516414,0,1991_boxofficemojo_rankings.csv,1991,1.0,0.0
9156,"I, the Jury",1515578,1515578,0,1982_boxofficemojo_rankings.csv,1982,1.0,0.0
9157,Relic,1515433,1047083,468350,2020_boxofficemojo_rankings.csv,2020,0.6909464159748402,0.3090535840251598
9158,Leaving Normal,1514114,1514114,0,1992_boxofficemojo_rankings.csv,1992,1.0,0.0
9159,The Dark Knight 2012 Re-release,1513086,1513086,0,2012_boxofficemojo_rankings.csv,2012,1.0,0.0
9160,Streets,1510053,1510053,0,1990_boxofficemojo_rankings.csv,1990,1.0,0.0
9161,My Golden Days,1509773,269144,1240629,2015_boxofficemojo_rankings.csv,2015,0.17826785881056292,0.821732141189437
9162,The Road to Guantanamo,1508988,326876,1182112,2006_boxofficemojo_rankings.csv,2006,0.21661935018701275,0.7833806498129873
9163,Take a Shot,1508912,564489,944423,2011_boxofficemojo_rankings.csv,2011,0.3741033274306255,0.6258966725693745
9164,The Daughter,1505434,26376,1479058,2016_boxofficemojo_rankings.csv,2016,0.01752052896374069,0.9824794710362593
9165,Company Business,1501785,1501785,0,1991_boxofficemojo_rankings.csv,1991,1.0,0.0
9166,The Kings of Summer,1501595,1315590,186005,2013_boxofficemojo_rankings.csv,2013,0.8761283834855603,0.12387161651443965
9167,Salvador,1500000,1500000,0,1986_boxofficemojo_rankings.csv,1986,1.0,0.0
9168,The Whistle Blower,1500000,1500000,0,1987_boxofficemojo_rankings.csv,1987,1.0,0.0
9169,Priceless,1499605,1499605,0,2016_boxofficemojo_rankings.csv,2016,1.0,0.0
9170,Guadalupe,1498950,848139,650811,2006_boxofficemojo_rankings.csv,2006,0.5658220754528169,0.434177924547183
9171,M. Butterfly,1498795,1498795,0,1993_boxofficemojo_rankings.csv,1993,1.0,0.0
9172,A Dangerous Woman,1497222,1497222,0,1993_boxofficemojo_rankings.csv,1993,1.0,0.0
9173,The Blind Swordsman: Zatoichi Canadian Release,1496523,255269,1241254,2004_boxofficemojo_rankings.csv,2004,0.17057472554715164,0.8294252744528484
9174,A Cry in the Wild,1494969,1494969,0,1990_boxofficemojo_rankings.csv,1990,1.0,0.0
9175,The Field,1494399,1494399,0,1990_boxofficemojo_rankings.csv,1990,1.0,0.0
9176,Garbo Talks,1493782,1493782,0,1984_boxofficemojo_rankings.csv,1984,1.0,0.0
9177,Moka,1493067,129547,1363520,2016_boxofficemojo_rankings.csv,2016,0.0867656977215356,0.9132343022784644
9178,The Artist and the Model,1492780,127958,1364822,2012_boxofficemojo_rankings.csv,2012,0.08571792226583957,0.9142820777341605
9179,Gonzo,1491958,1252100,239858,2008_boxofficemojo_rankings.csv,2008,0.8392327397956243,0.16076726020437573
9180,In My Country,1491434,163893,1327541,2004_boxofficemojo_rankings.csv,2004,0.10988954254764206,0.890110457452358
9181,Mully,1489771,1489771,0,2017_boxofficemojo_rankings.csv,2017,1.0,0.0
9182,The Simpsons: Family Portrait/Beat Dedication/Propagandance/Scaredy Cat!/Rarg/Knick Knack/Pencil Dance/Quinoscopio 2/Umbabarauma/Goodnight Norma... Goodnight Milton.../Tin Toy/25 Ways to Quit Smoking,1487606,1487606,0,1989_boxofficemojo_rankings.csv,1989,1.0,0.0
9183,John Rabe,1484665,67519,1417146,2009_boxofficemojo_rankings.csv,2009,0.04547759932375317,0.9545224006762468
9184,Patti Cake$,1482356,800148,682208,2017_boxofficemojo_rankings.csv,2017,0.5397812671180202,0.4602187328819798
9185,Oasis: Supersonic,1478119,242867,1235252,2016_boxofficemojo_rankings.csv,2016,0.16430815110285438,0.8356918488971457
9186,My Mother's Castle,1477071,1477071,0,1991_boxofficemojo_rankings.csv,1991,1.0,0.0
9187,Clockwise,1476356,1476356,0,1986_boxofficemojo_rankings.csv,1986,1.0,0.0
9188,When the Cat's Away,1474628,1474628,0,1997_boxofficemojo_rankings.csv,1997,1.0,0.0
9189,The Miseducation of Cameron Post,1474577,904703,569874,2018_boxofficemojo_rankings.csv,2018,0.613533915149904,0.386466084850096
9190,Good Kill,1474471,316472,1157999,2015_boxofficemojo_rankings.csv,2015,0.21463426544163974,0.7853657345583602
9191,Freeheld,1474471,573335,901136,2015_boxofficemojo_rankings.csv,2015,0.3888411504871917,0.6111588495128083
9192,Endangered Species,1474249,1474249,0,1982_boxofficemojo_rankings.csv,1982,1.0,0.0
9193,Mausam,1473341,728316,745025,2011_boxofficemojo_rankings.csv,2011,0.4943295543937215,0.5056704456062785
9194,De De Pyaar De,1473116,425934,1047182,2019_boxofficemojo_rankings.csv,2019,0.28913812625753843,0.7108618737424616
9195,X Games 3D: The Movie,1472747,1391434,81313,2009_boxofficemojo_rankings.csv,2009,0.9447882087011551,0.055211791298844945
9196,A Pigeon Sat on a Branch Reflecting on Existence,1472431,222989,1249442,2014_boxofficemojo_rankings.csv,2014,0.15144275011868127,0.8485572498813188
9197,Jimmy P.,1470582,30283,1440299,2013_boxofficemojo_rankings.csv,2013,0.020592527312315805,0.9794074726876842
9198,Finders Keepers,1467396,1467396,0,1984_boxofficemojo_rankings.csv,1984,1.0,0.0
9199,Violeta Went to Heaven,1466032,21496,1444536,2011_boxofficemojo_rankings.csv,2011,0.014662708590262696,0.9853372914097374
9200,Modigliani,1466013,205165,1260848,2004_boxofficemojo_rankings.csv,2004,0.13994759937326612,0.8600524006267338
9201,Mister Johnson,1464242,1464242,0,1991_boxofficemojo_rankings.csv,1991,1.0,0.0
9202,Thelma,1463727,147391,1316336,2017_boxofficemojo_rankings.csv,2017,0.10069568983833733,0.8993043101616627
9203,Joshua,1461635,1461635,0,2002_boxofficemojo_rankings.csv,2002,1.0,0.0
9204,Kurbaan,1461611,754268,707343,2009_boxofficemojo_rankings.csv,2009,0.5160524927631224,0.4839475072368777
9205,The Center of the World,1460687,1101344,359343,2001_boxofficemojo_rankings.csv,2001,0.7539904168381043,0.24600958316189575
9206,Greed,1460431,355308,1105123,2020_boxofficemojo_rankings.csv,2020,0.24328982334666957,0.7567101766533304
9207,Ek Vivaah... Aisa Bhi,1456886,6437,1450449,2008_boxofficemojo_rankings.csv,2008,0.004418327858185198,0.9955816721418148
9208,Life of Crime,1456675,265452,1191223,2014_boxofficemojo_rankings.csv,2014,0.1822314517651501,0.8177685482348499
9209,Trade,1455890,214307,1241583,2007_boxofficemojo_rankings.csv,2007,0.14719999450507937,0.8528000054949206
9210,Interview,1455393,416951,1038442,2007_boxofficemojo_rankings.csv,2007,0.28648688017600743,0.7135131198239926
9211,Birdy,1455045,1455045,0,1984_boxofficemojo_rankings.csv,1984,1.0,0.0
9212,Pascali's Island,1451857,1451857,0,1988_boxofficemojo_rankings.csv,1988,1.0,0.0
9213,The Other Woman,1451343,25423,1425920,2010_boxofficemojo_rankings.csv,2010,0.017516879193960354,0.9824831208060396
9214,Ernest Rides Again,1450029,1450029,0,1993_boxofficemojo_rankings.csv,1993,1.0,0.0
9215,The Disappearance of Eleanor Rigby: Them,1448076,587774,860302,2014_boxofficemojo_rankings.csv,2014,0.4058999665763399,0.5941000334236601
9216,The City of Your Final Destination,1444401,493296,951105,2010_boxofficemojo_rankings.csv,2010,0.34152288734222697,0.658477112657773
9217,Shameless,1443479,679866,763613,2013_boxofficemojo_rankings.csv,2013,0.4709912648538704,0.5290087351461296
9218,The Dawn Wall 2018 Re-release,1442013,970032,471981,2018_boxofficemojo_rankings.csv,2018,0.6726929646265325,0.3273070353734675
9219,No Good Deed,1440653,181600,1259053,2002_boxofficemojo_rankings.csv,2002,0.12605394914667167,0.8739460508533283
9220,Why We Fight,1439972,1439972,0,2006_boxofficemojo_rankings.csv,2006,1.0,0.0
9221,Vox Lux,1439539,727119,712420,2018_boxofficemojo_rankings.csv,2018,0.5051054538987829,0.49489454610121714
9222,Tomboy,1437501,129834,1307667,2011_boxofficemojo_rankings.csv,2011,0.09031924151704938,0.9096807584829506
9223,My Friend Dahmer,1436751,1361611,75140,2017_boxofficemojo_rankings.csv,2017,0.947701445831602,0.052298554168398
9224,Restrepo,1436391,1330894,105497,2010_boxofficemojo_rankings.csv,2010,0.9265541207094725,0.07344587929052744
9225,Love at Large,1436308,1436308,0,1990_boxofficemojo_rankings.csv,1990,1.0,0.0
9226,Down by Law,1435668,1435668,0,1986_boxofficemojo_rankings.csv,1986,1.0,0.0
9227,Kai Po Che,1435272,1122527,312745,2013_boxofficemojo_rankings.csv,2013,0.7821005356475985,0.21789946435240148
9228,Monica la mitraille,1435015,1435015,0,2004_boxofficemojo_rankings.csv,2004,1.0,0.0
9229,Shadow of the Wolf,1434174,1434174,0,1993_boxofficemojo_rankings.csv,1993,1.0,0.0
9230,No End in Sight,1433319,1433319,0,2007_boxofficemojo_rankings.csv,2007,1.0,0.0
9231,Microcosmos,1433210,1433210,0,1996_boxofficemojo_rankings.csv,1996,1.0,0.0
9232,Savage Grace,1432799,435746,997053,2007_boxofficemojo_rankings.csv,2007,0.3041222111405717,0.6958777888594283
9233,A Prayer for the Dying,1432687,1432687,0,1987_boxofficemojo_rankings.csv,1987,1.0,0.0
9234,Timecode,1431406,1057750,373656,2000_boxofficemojo_rankings.csv,2000,0.7389587580323123,0.2610412419676877
9235,Food Beware: The French Organic Revolution,1429635,1181,1428454,2008_boxofficemojo_rankings.csv,2008,0.000826084979732589,0.9991739150202674
9236,I Hope They Serve Beer in Hell,1429299,1429299,0,2009_boxofficemojo_rankings.csv,2009,1.0,0.0
9237,The Devil's Hand,1428494,5746,1422748,2014_boxofficemojo_rankings.csv,2014,0.004022418015056416,0.9959775819849436
9238,The Zero Theorem,1428362,257706,1170656,2014_boxofficemojo_rankings.csv,2014,0.18042064966724122,0.8195793503327587
9239,Thr3e,1420418,1008849,411569,2007_boxofficemojo_rankings.csv,2007,0.7102479692597531,0.28975203074024686
9240,American Flyers,1420355,1420355,0,1985_boxofficemojo_rankings.csv,1985,1.0,0.0
9241,Fairy Tail: Dragon Cry,1420035,519461,900574,2017_boxofficemojo_rankings.csv,2017,0.3658085892249135,0.6341914107750866
9242,Monsieur Hire,1417030,1417030,0,1990_boxofficemojo_rankings.csv,1990,1.0,0.0
9243,Black Butterflies,1416573,0,1416573,2011_boxofficemojo_rankings.csv,2011,0.0,1.0
9244,It 2019 Re-release,1414696,1347126,67570,2019_boxofficemojo_rankings.csv,2019,0.9522370883921352,0.04776291160786487
9245,The Wolfpack,1414140,1301696,112444,2015_boxofficemojo_rankings.csv,2015,0.9204859490573777,0.07951405094262237
9246,Bombón: El Perro,1412753,19791,1392962,2005_boxofficemojo_rankings.csv,2005,0.01400881824352877,0.9859911817564713
9247,Parkland,1412181,653651,758530,2013_boxofficemojo_rankings.csv,2013,0.4628663039652849,0.5371336960347151
9248,Saint Ralph,1410952,489389,921563,2005_boxofficemojo_rankings.csv,2005,0.34685021177191006,0.65314978822809
9249,Looking for Richard,1408575,1408575,0,1996_boxofficemojo_rankings.csv,1996,1.0,0.0
9250,I've Heard the Mermaids Singing,1408491,1408491,0,1987_boxofficemojo_rankings.csv,1987,1.0,0.0
9251,The U.S. vs. John Lennon,1408065,1109146,298919,2006_boxofficemojo_rankings.csv,2006,0.7877093742121279,0.212290625787872
9252,Lost in La Mancha,1407019,732393,674626,2002_boxofficemojo_rankings.csv,2002,0.5205281520718625,0.4794718479281374
9253,Lazer Team,1406538,1186426,220112,2016_boxofficemojo_rankings.csv,2016,0.8435079606807637,0.1564920393192363
9254,Just a Sigh,1406331,75531,1330800,2013_boxofficemojo_rankings.csv,2013,0.053707839761763056,0.9462921602382369
9255,El Chicano,1404646,1400603,4043,2019_boxofficemojo_rankings.csv,2019,0.9971216947188117,0.002878305281188285
9256,Haider,1404307,1048143,356164,2014_boxofficemojo_rankings.csv,2014,0.7463773946864894,0.2536226053135105
9257,Where Angels Fear to Tread,1403033,1403033,0,1992_boxofficemojo_rankings.csv,1992,1.0,0.0
9258,Sahara,1402962,1402962,0,1984_boxofficemojo_rankings.csv,1984,1.0,0.0
9259,Universal Soldier: Day of Reckoning,1402307,5460,1396847,2012_boxofficemojo_rankings.csv,2012,0.0038935839299097845,0.9961064160700902
9260,Saheb Biwi Aur Gangster 3,1401894,0,1401894,2018_boxofficemojo_rankings.csv,2018,0.0,1.0
9261,Born to Be Blue 2016 Re-release,1401411,678203,723208,2016_boxofficemojo_rankings.csv,2016,0.4839429689077651,0.5160570310922349
9262,The Celluloid Closet,1400591,1400591,0,1996_boxofficemojo_rankings.csv,1996,1.0,0.0
9263,10 Items or Less,1399222,83291,1315931,2006_boxofficemojo_rankings.csv,2006,0.0595266512390457,0.9404733487609543
9264,Leonard Cohen: I'm Your Man,1398424,1044254,354170,2006_boxofficemojo_rankings.csv,2006,0.7467363260355944,0.25326367396440563
9265,Criminal,1398053,929233,468820,2004_boxofficemojo_rankings.csv,2004,0.664662212376784,0.335337787623216
9266,For Sama,1397546,43796,1353750,2019_boxofficemojo_rankings.csv,2019,0.03133778780805784,0.9686622121919422
9267,Maggie,1394052,187112,1206940,2015_boxofficemojo_rankings.csv,2015,0.1342216789617604,0.8657783210382396
9268,Courage Mountain,1393610,1393610,0,1990_boxofficemojo_rankings.csv,1990,1.0,0.0
9269,Light of My Life,1392898,20056,1372842,2019_boxofficemojo_rankings.csv,2019,0.014398757123637194,0.9856012428763629
9270,Penitentiary III,1392616,1392616,0,1987_boxofficemojo_rankings.csv,1987,1.0,0.0
9271,White Material,1392434,304020,1088414,2010_boxofficemojo_rankings.csv,2010,0.21833709892174422,0.7816629010782558
9272,Holiday: A Soldier is Never Off Duty,1390054,706893,683161,2014_boxofficemojo_rankings.csv,2014,0.5085363590191461,0.491463640980854
9273,Roméo et Juliette,1386582,1386582,0,2006_boxofficemojo_rankings.csv,2006,1.0,0.0
9274,"Oslo, August 31st",1386378,101475,1284903,2011_boxofficemojo_rankings.csv,2011,0.07319432362602407,0.9268056763739759
9275,"For a Good Time, Call...",1386088,1251749,134339,2012_boxofficemojo_rankings.csv,2012,0.9030804681953816,0.09691953180461847
9276,National Lampoon's Christmas Vacation 2019 Re-release,1385620,1385620,0,2019_boxofficemojo_rankings.csv,2019,1.0,0.0
9277,Climates,1385085,119958,1265127,2006_boxofficemojo_rankings.csv,2006,0.08660695913969178,0.9133930408603083
9278,House of Tolerance,1384443,19327,1365116,2011_boxofficemojo_rankings.csv,2011,0.013960126924691013,0.9860398730753089
9279,Silver City,1384395,1020656,363739,2004_boxofficemojo_rankings.csv,2004,0.7372577913095613,0.2627422086904388
9280,Phat Beach,1383553,1383553,0,1996_boxofficemojo_rankings.csv,1996,1.0,0.0
9281,Repossessed,1382462,1382462,0,1990_boxofficemojo_rankings.csv,1990,1.0,0.0
9282,Book of Love,1382259,1382259,0,1991_boxofficemojo_rankings.csv,1991,1.0,0.0
9283,Snow Cake,1381665,26651,1355014,2006_boxofficemojo_rankings.csv,2006,0.01928904618702797,0.980710953812972
9284,Certain Fury,1381091,1381091,0,1985_boxofficemojo_rankings.csv,1985,1.0,0.0
9285,Sometimes Always Never,1377856,0,1377856,2018_boxofficemojo_rankings.csv,2018,0.0,1.0
9286,Swimming with Men,1377748,24708,1353040,2018_boxofficemojo_rankings.csv,2018,0.0179336134039026,0.9820663865960974
9287,Ma ma,1375709,47258,1328451,2015_boxofficemojo_rankings.csv,2015,0.03435174153836313,0.9656482584616368
9288,Khoobsurat,1375623,710508,665115,2014_boxofficemojo_rankings.csv,2014,0.5164990698759762,0.4835009301240238
9289,Daddy's Dyin'... Who's Got the Will?,1373728,1373728,0,1990_boxofficemojo_rankings.csv,1990,1.0,0.0
9290,South Central,1373196,1373196,0,1992_boxofficemojo_rankings.csv,1992,1.0,0.0
9291,Everybody Wins,1372350,1372350,0,1990_boxofficemojo_rankings.csv,1990,1.0,0.0
9292,Umrao Jaan,1371723,485000,886723,2006_boxofficemojo_rankings.csv,2006,0.353569926289783,0.646430073710217
9293,A Good Old Fashioned Orgy,1369485,200227,1169258,2011_boxofficemojo_rankings.csv,2011,0.14620605556103206,0.8537939444389679
9294,The Outpost,1369175,0,1369175,2020_boxofficemojo_rankings.csv,2020,0.0,1.0
9295,Little Nemo: Adventures in Slumberland,1368000,1368000,0,1992_boxofficemojo_rankings.csv,1992,1.0,0.0
9296,Sarileru Neekevvaru,1366335,821000,545335,2020_boxofficemojo_rankings.csv,2020,0.600877530034728,0.39912246996527206
9297,The Salvation,1363964,44903,1319061,2014_boxofficemojo_rankings.csv,2014,0.03292095685809889,0.9670790431419011
9298,Little Italy,1362536,990230,372306,2018_boxofficemojo_rankings.csv,2018,0.726755109589765,0.27324489041023503
9299,Strange Invaders,1362303,1362303,0,1983_boxofficemojo_rankings.csv,1983,1.0,0.0
9300,Gimme Shelter,1362018,1359910,2108,2014_boxofficemojo_rankings.csv,2014,0.9984522965188419,0.0015477034811581052
9301,Blame it on Fidel,1360243,168065,1192178,2006_boxofficemojo_rankings.csv,2006,0.12355512948789298,0.8764448705121071
9302,The Bank,1360012,88414,1271598,2001_boxofficemojo_rankings.csv,2001,0.06500972050246616,0.9349902794975339
9303,Spanking the Monkey,1359736,1359736,0,1994_boxofficemojo_rankings.csv,1994,1.0,0.0
9304,Chasing Ice,1358668,1328467,30201,2012_boxofficemojo_rankings.csv,2012,0.9777716116078394,0.022228388392160556
9305,Raavan,1356461,708726,647735,2010_boxofficemojo_rankings.csv,2010,0.5224816636821847,0.47751833631781526
9306,Kansas City,1356329,1356329,0,1996_boxofficemojo_rankings.csv,1996,1.0,0.0
9307,Foxtrot,1356159,618883,737276,2018_boxofficemojo_rankings.csv,2018,0.45634988227781553,0.5436501177221845
9308,Papa,1356033,26677,1329356,2016_boxofficemojo_rankings.csv,2016,0.019672825071366258,0.9803271749286337
9309,Griffin & Phoenix,1355967,0,1355967,2007_boxofficemojo_rankings.csv,2007,0.0,1.0
9310,From a Whisper to a Scream,1355728,1355728,0,1987_boxofficemojo_rankings.csv,1987,1.0,0.0
9311,The Secrets of Jonathan Sperry,1355079,1355079,0,2009_boxofficemojo_rankings.csv,2009,1.0,0.0
9312,Nueba Yol 3: Bajo la nueva ley,1354652,1354652,0,1996_boxofficemojo_rankings.csv,1996,1.0,0.0
9313,National Theater Live: Cyrano de Bergerac 2020 Re-release,1354584,198352,1156232,2020_boxofficemojo_rankings.csv,2020,0.14643019554342884,0.8535698044565712
9314,True Love,1354268,1354268,0,1989_boxofficemojo_rankings.csv,1989,1.0,0.0
9315,Le dernier tunnel,1352489,1352489,0,2004_boxofficemojo_rankings.csv,2004,1.0,0.0
9316,The Oscar Nominated Short Films 2011: Live Action,1352152,1352152,0,2011_boxofficemojo_rankings.csv,2011,1.0,0.0
9317,Unforgivable,1351146,154189,1196957,2011_boxofficemojo_rankings.csv,2011,0.11411720124990193,0.885882798750098
9318,Lost in Beijing,1350967,11163,1339804,2007_boxofficemojo_rankings.csv,2007,0.008262970153971193,0.9917370298460289
9319,The Teacher,1350426,64437,1285989,2016_boxofficemojo_rankings.csv,2016,0.04771605404516797,0.952283945954832
9320,Tumbleweeds,1350248,1350248,0,1999_boxofficemojo_rankings.csv,1999,1.0,0.0
9321,The Snowtown Murders,1349387,8452,1340935,2011_boxofficemojo_rankings.csv,2011,0.006263584872241989,0.993736415127758
9322,The Cokeville Miracle,1348456,1348456,0,2015_boxofficemojo_rankings.csv,2015,1.0,0.0
9323,Bolshoi Ballet: The Nutcracker,1348248,252935,1095313,2019_boxofficemojo_rankings.csv,2019,0.18760272590799318,0.8123972740920068
9324,The Gathering,1346475,0,1346475,2003_boxofficemojo_rankings.csv,2003,0.0,1.0
9325,At Play in the Fields of the Lord,1345903,1345903,0,1991_boxofficemojo_rankings.csv,1991,1.0,0.0
9326,City of Hope,1345015,1345015,0,1991_boxofficemojo_rankings.csv,1991,1.0,0.0
9327,Gas Food Lodging,1342613,1342613,0,1992_boxofficemojo_rankings.csv,1992,1.0,0.0
9328,Ashoka the Great,1340718,731277,609441,2001_boxofficemojo_rankings.csv,2001,0.5454368480172564,0.45456315198274355
9329,Bonneville,1338570,488393,850177,2008_boxofficemojo_rankings.csv,2008,0.36486175545544874,0.6351382445445513
9330,Henry Fool,1338335,1338335,0,1998_boxofficemojo_rankings.csv,1998,1.0,0.0
9331,GoBots: Battle of the Rock Lords,1338264,1338264,0,1986_boxofficemojo_rankings.csv,1986,1.0,0.0
9332,The Assistant,1338220,1100313,237907,2020_boxofficemojo_rankings.csv,2020,0.8222213089028709,0.17777869109712902
9333,The Whales of August,1338198,1338198,0,1987_boxofficemojo_rankings.csv,1987,1.0,0.0
9334,The Rider Named Death,1338136,3375,1334761,2004_boxofficemojo_rankings.csv,2004,0.0025221651610897546,0.9974778348389103
9335,Student of the Year,1337281,670086,667195,2012_boxofficemojo_rankings.csv,2012,0.5010809246523356,0.4989190753476644
9336,Gwendoline,1337274,1337274,0,1985_boxofficemojo_rankings.csv,1985,1.0,0.0
9337,Barney Thomson,1336254,0,1336254,2015_boxofficemojo_rankings.csv,2015,0.0,1.0
9338,Flight of the Red Balloon,1335987,461674,874313,2007_boxofficemojo_rankings.csv,2007,0.3455677338177692,0.6544322661822308
9339,Godard Mon Amour,1335846,82264,1253582,2017_boxofficemojo_rankings.csv,2017,0.06158194881745351,0.9384180511825465
9340,Darna Mana Hai,1335493,132348,1203145,2003_boxofficemojo_rankings.csv,2003,0.09910048199428975,0.9008995180057102
9341,Sarah Silverman: Jesus Is Magic,1333799,1324339,9460,2005_boxofficemojo_rankings.csv,2005,0.9929074770636356,0.007092522936364475
9342,The Navigator: A Medieval Odyssey,1333379,1333379,0,1989_boxofficemojo_rankings.csv,1989,1.0,0.0
9343,Julia,1333241,65108,1268133,2008_boxofficemojo_rankings.csv,2008,0.04883438178093833,0.9511656182190616
9344,Great Performances at the Met: Rossini: Semiramide,1332900,1033651,299249,2018_boxofficemojo_rankings.csv,2018,0.7754902843424113,0.2245097156575887
9345,Ghost in the Shell: The New Movie,1332311,101203,1231108,2015_boxofficemojo_rankings.csv,2015,0.0759604927077837,0.9240395072922163
9346,Kapow,1331922,812737,519185,2016_boxofficemojo_rankings.csv,2016,0.6101986452660141,0.3898013547339859
9347,Ajami,1331651,622403,709248,2010_boxofficemojo_rankings.csv,2010,0.4673919818330779,0.5326080181669222
9348,Ballets Russes,1331363,815848,515515,2005_boxofficemojo_rankings.csv,2005,0.6127915527170276,0.38720844728297243
9349,Midnight Crossing,1328001,1328001,0,1988_boxofficemojo_rankings.csv,1988,1.0,0.0
9350,The Ultimate Life,1327841,1327841,0,2013_boxofficemojo_rankings.csv,2013,1.0,0.0
9351,Steele Justice,1327740,1327740,0,1987_boxofficemojo_rankings.csv,1987,1.0,0.0
9352,The Work and the Glory III: A House Divided,1325092,1325092,0,2006_boxofficemojo_rankings.csv,2006,1.0,0.0
9353,Three Colors: Blue,1324974,1324974,0,1993_boxofficemojo_rankings.csv,1993,1.0,0.0
9354,Spirited Away 2019 Re-release,1322927,1322927,0,2019_boxofficemojo_rankings.csv,2019,1.0,0.0
9355,It's a Wonderful Afterlife,1321438,0,1321438,2010_boxofficemojo_rankings.csv,2010,0.0,1.0
9356,The Horseman on the Roof,1320043,1320043,0,1995_boxofficemojo_rankings.csv,1995,1.0,0.0
9357,Catfish in Black Bean Sauce,1319592,1319592,0,2000_boxofficemojo_rankings.csv,2000,1.0,0.0
9358,Thirty Two Short Films About Glenn Gould,1319521,1319521,0,1993_boxofficemojo_rankings.csv,1993,1.0,0.0
9359,Off the Map,1319492,1317167,2325,2005_boxofficemojo_rankings.csv,2005,0.9982379582445365,0.0017620417554634663
9360,Storytelling,1318945,921445,397500,2001_boxofficemojo_rankings.csv,2001,0.6986227628900371,0.3013772371099629
9361,Gabriela,1318839,1318839,0,1984_boxofficemojo_rankings.csv,1984,1.0,0.0
9362,Skateboard,1318823,1318823,0,1978_boxofficemojo_rankings.csv,1978,1.0,0.0
9363,The Look of Love,1318468,21252,1297216,2013_boxofficemojo_rankings.csv,2013,0.016118707469578327,0.9838812925304217
9364,Hearts of Darkness: A Filmmaker's Apocalypse,1318449,1318449,0,1991_boxofficemojo_rankings.csv,1991,1.0,0.0
9365,Noi the Albino,1317132,60555,1256577,2003_boxofficemojo_rankings.csv,2003,0.04597489089931761,0.9540251091006824
9366,Radioland Murders,1316865,1316865,0,1994_boxofficemojo_rankings.csv,1994,1.0,0.0
9367,Before the Rains,1316722,1029655,287067,2008_boxofficemojo_rankings.csv,2008,0.7819835925882609,0.21801640741173917
9368,Romero,1316495,1316495,0,1989_boxofficemojo_rankings.csv,1989,1.0,0.0
9369,Erased,1314735,0,1314735,2012_boxofficemojo_rankings.csv,2012,0.0,1.0
9370,Damsels in Distress,1314358,1008455,305903,2012_boxofficemojo_rankings.csv,2012,0.7672605180628109,0.2327394819371891
9371,A Christmas Story 1984 Re-release,1311065,1311065,0,1984_boxofficemojo_rankings.csv,1984,1.0,0.0
9372,Saints and Soldiers,1310470,1310470,0,2004_boxofficemojo_rankings.csv,2004,1.0,0.0
9373,Anne Frank Remembered,1310200,1310200,0,1996_boxofficemojo_rankings.csv,1996,1.0,0.0
9374,Air Racers,1309987,1309987,0,2012_boxofficemojo_rankings.csv,2012,1.0,0.0
9375,Come What May,1309818,37766,1272052,2015_boxofficemojo_rankings.csv,2015,0.02883301344156211,0.9711669865584379
9376,Dom Hemingway,1307599,523511,784088,2013_boxofficemojo_rankings.csv,2013,0.40036050807625273,0.5996394919237472
9377,An American Crime,1306875,0,1306875,2007_boxofficemojo_rankings.csv,2007,0.0,1.0
9378,Heights,1306281,1160817,145464,2005_boxofficemojo_rankings.csv,2005,0.8886426427391962,0.11135735726080376
9379,Brother's Keeper,1305915,1305915,0,1992_boxofficemojo_rankings.csv,1992,1.0,0.0
9380,The Fourth War,1305887,1305887,0,1990_boxofficemojo_rankings.csv,1990,1.0,0.0
9381,Something in the Air,1305473,85154,1220319,2012_boxofficemojo_rankings.csv,2012,0.06522846508506878,0.9347715349149313
9382,Babar: The Movie,1305187,1305187,0,1989_boxofficemojo_rankings.csv,1989,1.0,0.0
9383,8 Million Ways to Die,1305114,1305114,0,1986_boxofficemojo_rankings.csv,1986,1.0,0.0
9384,The Aviator,1304192,1304192,0,1985_boxofficemojo_rankings.csv,1985,1.0,0.0
9385,Great Performances at the Met: Mozart: Così fan tutte,1302949,1302949,0,2018_boxofficemojo_rankings.csv,2018,1.0,0.0
9386,Les Cowboys,1302493,73725,1228768,2015_boxofficemojo_rankings.csv,2015,0.056602991340452505,0.9433970086595475
9387,Sunset Song,1302482,159714,1142768,2015_boxofficemojo_rankings.csv,2015,0.12262280783918703,0.877377192160813
9388,Jesus' Son,1302067,1302067,0,2000_boxofficemojo_rankings.csv,2000,1.0,0.0
9389,Native Son,1301121,1301121,0,1986_boxofficemojo_rankings.csv,1986,1.0,0.0
9390,Ponette,1300377,1300377,0,1997_boxofficemojo_rankings.csv,1997,1.0,0.0
9391,Wetherby,1299985,1299985,0,1985_boxofficemojo_rankings.csv,1985,1.0,0.0
9392,Hard to Be a God,1299035,28608,1270427,2014_boxofficemojo_rankings.csv,2014,0.022022501318286265,0.9779774986817137
9393,Eagle vs Shark,1298037,221846,1076191,2007_boxofficemojo_rankings.csv,2007,0.1709088415815574,0.8290911584184426
9394,Yamakasi,1297401,184441,1112960,2001_boxofficemojo_rankings.csv,2001,0.14216190676591123,0.8578380932340888
9395,Reprise,1297260,554826,742434,2006_boxofficemojo_rankings.csv,2006,0.4276906711067943,0.5723093288932056
9396,Paper Heart,1296971,1274062,22909,2009_boxofficemojo_rankings.csv,2009,0.9823365364375919,0.017663463562408104
9397,"War, Inc.",1296184,580862,715322,2008_boxofficemojo_rankings.csv,2008,0.4481323639236405,0.5518676360763596
9398,Slow West,1295574,229094,1066480,2015_boxofficemojo_rankings.csv,2015,0.17682818580798934,0.8231718141920107
9399,Cousin Bette,1295194,1295194,0,1998_boxofficemojo_rankings.csv,1998,1.0,0.0
9400,Roger Waters - Us + Them,1294480,611644,682836,2019_boxofficemojo_rankings.csv,2019,0.47250169952413323,0.5274983004758668
9401,In Search of a Midnight Kiss,1294176,172605,1121571,2008_boxofficemojo_rankings.csv,2008,0.1333705771085231,0.8666294228914769
9402,The Hot Spot,1293976,1293976,0,1990_boxofficemojo_rankings.csv,1990,1.0,0.0
9403,Bloodfist II,1292323,1292323,0,1990_boxofficemojo_rankings.csv,1990,1.0,0.0
9404,Queen Margot,1292232,1292232,0,1994_boxofficemojo_rankings.csv,1994,1.0,0.0
9405,No Safe Spaces,1291514,1291514,0,2019_boxofficemojo_rankings.csv,2019,1.0,0.0
9406,Under Suspicion,1291020,260562,1030458,2000_boxofficemojo_rankings.csv,2000,0.20182646279685829,0.7981735372031417
9407,This Is Not Frank's Planet/Snowie and the Seven Dorps/Poumse...,1289551,1289551,0,1990_boxofficemojo_rankings.csv,1990,1.0,0.0
9408,The Business of Strangers,1287598,1030920,256678,2001_boxofficemojo_rankings.csv,2001,0.8006536201516312,0.1993463798483688
9409,The Cakemaker,1287568,875751,411817,2018_boxofficemojo_rankings.csv,2018,0.6801590284940291,0.31984097150597096
9410,Walking and Talking,1287480,1287480,0,1996_boxofficemojo_rankings.csv,1996,1.0,0.0
9411,Time Changer,1285167,1285167,0,2002_boxofficemojo_rankings.csv,2002,1.0,0.0
9412,Buddha Mar Gaya,1284490,18528,1265962,2007_boxofficemojo_rankings.csv,2007,0.014424401902700683,0.9855755980972993
9413,Filmistaan,1282717,45406,1237311,2014_boxofficemojo_rankings.csv,2014,0.035398299079220125,0.9646017009207799
9414,Festival Express,1281754,1174079,107675,2004_boxofficemojo_rankings.csv,2004,0.9159940206935184,0.08400597930648158
9415,I Spit on Your Grave,1278650,93051,1185599,2010_boxofficemojo_rankings.csv,2010,0.07277284636139679,0.9272271536386032
9416,Howl,1278390,617334,661056,2010_boxofficemojo_rankings.csv,2010,0.4828995846337972,0.5171004153662028
9417,Black Souls,1278360,101088,1177272,2014_boxofficemojo_rankings.csv,2014,0.07907631653055477,0.9209236834694452
9418,The Villain,1278108,730530,547578,2014_boxofficemojo_rankings.csv,2014,0.5715714165000141,0.4284285834999859
9419,Shed Skin Papa,1278065,13331,1264734,2018_boxofficemojo_rankings.csv,2018,0.0104306119015856,0.9895693880984144
9420,Kontroll,1277800,237183,1040617,2003_boxofficemojo_rankings.csv,2003,0.18561825011738925,0.8143817498826107
9421,The Rapture,1277404,1277404,0,1991_boxofficemojo_rankings.csv,1991,1.0,0.0
9422,Driving Lessons,1277351,239962,1037389,2006_boxofficemojo_rankings.csv,2006,0.18785909276306983,0.8121409072369302
9423,City of Ghosts,1277187,357197,919990,2003_boxofficemojo_rankings.csv,2003,0.2796747852898597,0.7203252147101403
9424,The Believer,1274112,416925,857187,2001_boxofficemojo_rankings.csv,2001,0.3272279046112116,0.6727720953887885
9425,Yellow Submarine,1273261,992305,280956,2018_boxofficemojo_rankings.csv,2018,0.7793413919062941,0.22065860809370585
9426,Robot Jox,1272977,1272977,0,1990_boxofficemojo_rankings.csv,1990,1.0,0.0
9427,The Women's Balcony,1272517,1200885,71632,2017_boxofficemojo_rankings.csv,2017,0.94370841411156,0.05629158588844
9428,Beautifully Broken,1271572,1209645,61927,2018_boxofficemojo_rankings.csv,2018,0.9512988647123403,0.04870113528765969
9429,Tai ji 1: Cong ling kai shi,1271521,212094,1059427,2012_boxofficemojo_rankings.csv,2012,0.16680337957454106,0.833196620425459
9430,Texas Killing Fields,1271319,45469,1225850,2011_boxofficemojo_rankings.csv,2011,0.03576521706983062,0.9642347829301694
9431,Blue in the Face,1268636,1268636,0,1995_boxofficemojo_rankings.csv,1995,1.0,0.0
9432,Spike & Mike's Festival of Animation Volume 1,1268529,1268529,0,1992_boxofficemojo_rankings.csv,1992,1.0,0.0
9433,The Adventures of the American Rabbit,1268443,1268443,0,1986_boxofficemojo_rankings.csv,1986,1.0,0.0
9434,Apartment Zero,1267578,1267578,0,1989_boxofficemojo_rankings.csv,1989,1.0,0.0
9435,The Godfather 1997 Re-release,1267490,1267490,0,1997_boxofficemojo_rankings.csv,1997,1.0,0.0
9436,The Emperor and the Assassin,1267239,1267239,0,1999_boxofficemojo_rankings.csv,1999,1.0,0.0
9437,September 11,1266063,127035,1139028,2002_boxofficemojo_rankings.csv,2002,0.10033860874221899,0.899661391257781
9438,Fagara,1265949,43417,1222532,2019_boxofficemojo_rankings.csv,2019,0.03429601034480852,0.9657039896551914
9439,Why Don't You Play in Hell?,1265872,28534,1237338,2013_boxofficemojo_rankings.csv,2013,0.022540983606557378,0.9774590163934426
9440,Batla House,1264337,493180,771157,2019_boxofficemojo_rankings.csv,2019,0.39007005252555293,0.6099299474744471
9441,Valley of Love,1264277,28648,1235629,2015_boxofficemojo_rankings.csv,2015,0.02265959121300158,0.9773404087869985
9442,Hideous Kinky,1263279,1263279,0,1999_boxofficemojo_rankings.csv,1999,1.0,0.0
9443,Black 2005 Re-release,1263200,754819,508381,2005_boxofficemojo_rankings.csv,2005,0.5975451234958835,0.40245487650411654
9444,Little Vera,1262598,1262598,0,1989_boxofficemojo_rankings.csv,1989,1.0,0.0
9445,China Girl,1262091,1262091,0,1987_boxofficemojo_rankings.csv,1987,1.0,0.0
9446,When a Stranger Calls 1980 Re-release,1262052,1262052,0,1980_boxofficemojo_rankings.csv,1980,1.0,0.0
9447,The Holy Girl,1261792,304124,957668,2004_boxofficemojo_rankings.csv,2004,0.24102546219979204,0.758974537800208
9448,From Beyond,1261000,1261000,0,1986_boxofficemojo_rankings.csv,1986,1.0,0.0
9449,The Flying Scotsman,1260553,171817,1088736,2007_boxofficemojo_rankings.csv,2007,0.13630287659463744,0.8636971234053625
9450,Chonda Pierce: Enough,1260116,1260116,0,2017_boxofficemojo_rankings.csv,2017,1.0,0.0
9451,Meerkats,1259616,777595,482021,2012_boxofficemojo_rankings.csv,2012,0.6173270266493915,0.38267297335060846
9452,The Music of Strangers: Yo-Yo Ma and the Silk Road Ensemble,1259588,1176781,82807,2016_boxofficemojo_rankings.csv,2016,0.9342586623562625,0.06574133764373748
9453,Gett,1259160,988150,271010,2014_boxofficemojo_rankings.csv,2014,0.7847692112201785,0.21523078877982146
9454,Bewafaa,1258036,670076,587960,2005_boxofficemojo_rankings.csv,2005,0.5326365859164602,0.46736341408353976
9455,Guy,1257937,1319,1256618,2018_boxofficemojo_rankings.csv,2018,0.0010485421765954893,0.9989514578234046
9456,Anna,1257142,4288,1252854,2014_boxofficemojo_rankings.csv,2014,0.0034109114165305114,0.9965890885834695
9457,Water,1256862,1256862,0,1986_boxofficemojo_rankings.csv,1986,1.0,0.0
9458,Baraka,1254237,1254237,0,1993_boxofficemojo_rankings.csv,1993,1.0,0.0
9459,Touch and Go,1254040,1254040,0,1986_boxofficemojo_rankings.csv,1986,1.0,0.0
9460,The Best Intentions,1253106,1253106,0,1992_boxofficemojo_rankings.csv,1992,1.0,0.0
9461,For a Woman,1252416,32286,1220130,2013_boxofficemojo_rankings.csv,2013,0.025778974398283,0.974221025601717
9462,Demi-soeur,1251642,943,1250699,2013_boxofficemojo_rankings.csv,2013,0.0007534103202033809,0.9992465896797966
9463,The Singles Ward,1250798,1250798,0,2002_boxofficemojo_rankings.csv,2002,1.0,0.0
9464,Kickboxer 2: The Road Back,1250712,1250712,0,1991_boxofficemojo_rankings.csv,1991,1.0,0.0
9465,Home of the Brave: A Film by Laurie Anderson,1250000,1250000,0,1986_boxofficemojo_rankings.csv,1986,1.0,0.0
9466,MVP: Most Valuable Primate,1248746,1248746,0,2000_boxofficemojo_rankings.csv,2000,1.0,0.0
9467,Turn It Up,1247949,1247949,0,2000_boxofficemojo_rankings.csv,2000,1.0,0.0
9468,Goldengirl,1247376,1247376,0,1979_boxofficemojo_rankings.csv,1979,1.0,0.0
9469,The Ledge,1247188,9216,1237972,2011_boxofficemojo_rankings.csv,2011,0.007389423246535406,0.9926105767534646
9470,Losin' It,1246141,1246141,0,1983_boxofficemojo_rankings.csv,1983,1.0,0.0
9471,The Comfort of Strangers,1244381,1244381,0,1991_boxofficemojo_rankings.csv,1991,1.0,0.0
9472,Midnight's Children,1243980,190022,1053958,2012_boxofficemojo_rankings.csv,2012,0.15275325969870898,0.847246740301291
9473,Slumber,1243832,0,1243832,2017_boxofficemojo_rankings.csv,2017,0.0,1.0
9474,Slumber Party Massacre III,1242995,1242995,0,1990_boxofficemojo_rankings.csv,1990,1.0,0.0
9475,1945,1240663,1006193,234470,2017_boxofficemojo_rankings.csv,2017,0.811012337758118,0.18898766224188196
9476,Seducing Doctor Lewis 2004 Re-release,1239278,489838,749440,2004_boxofficemojo_rankings.csv,2004,0.3952607889432395,0.6047392110567604
9477,Bubba Ho-Tep,1239183,1239183,0,2003_boxofficemojo_rankings.csv,2003,1.0,0.0
9478,Picture Bride,1238905,1238905,0,1995_boxofficemojo_rankings.csv,1995,1.0,0.0
9479,Nuit de noces,1238180,1238180,0,2001_boxofficemojo_rankings.csv,2001,1.0,0.0
9480,"Car 54, Where Are You?",1238080,1238080,0,1994_boxofficemojo_rankings.csv,1994,1.0,0.0
9481,Three Colors: White,1237219,1237219,0,1994_boxofficemojo_rankings.csv,1994,1.0,0.0
9482,Queen of Hearts,1236844,1236844,0,1989_boxofficemojo_rankings.csv,1989,1.0,0.0
9483,Saving Face,1236518,1187266,49252,2005_boxofficemojo_rankings.csv,2005,0.9601687965723104,0.03983120342768969
9484,The Goonies 2020 Re-release,1236438,825000,411438,2020_boxofficemojo_rankings.csv,2020,0.6672392792845254,0.33276072071547463
9485,Beyond the Mask,1236094,1236094,0,2015_boxofficemojo_rankings.csv,2015,1.0,0.0
9486,The Blue Room,1232900,254666,978234,2014_boxofficemojo_rankings.csv,2014,0.2065585205612783,0.7934414794387217
9487,The Cut,1232140,28066,1204074,2014_boxofficemojo_rankings.csv,2014,0.02277825571769442,0.9772217442823056
9488,Honeyland,1231697,815082,416615,2019_boxofficemojo_rankings.csv,2019,0.6617552855937784,0.33824471440622167
9489,The Icicle Thief,1231622,1231622,0,1990_boxofficemojo_rankings.csv,1990,1.0,0.0
9490,Life,1231606,0,1231606,2015_boxofficemojo_rankings.csv,2015,0.0,1.0
9491,True to the Game,1231040,1231040,0,2017_boxofficemojo_rankings.csv,2017,1.0,0.0
9492,Exiled,1230135,51957,1178178,2006_boxofficemojo_rankings.csv,2006,0.04223682766525625,0.9577631723347437
9493,Steve McQueen: American Icon,1229782,1229782,0,2017_boxofficemojo_rankings.csv,2017,1.0,0.0
9494,The Perfect Candidate,1229580,0,1229580,2020_boxofficemojo_rankings.csv,2020,0.0,1.0
9495,Sex and Death 101,1229330,23624,1205706,2007_boxofficemojo_rankings.csv,2007,0.019216971846452945,0.980783028153547
9496,Toto the Hero,1228153,1228153,0,1992_boxofficemojo_rankings.csv,1992,1.0,0.0
9497,Slacker,1228108,1228108,0,1991_boxofficemojo_rankings.csv,1991,1.0,0.0
9498,The Funeral,1227324,1227324,0,1996_boxofficemojo_rankings.csv,1996,1.0,0.0
9499,Casablanca 2011 Re-release,1226808,1155330,71478,2011_boxofficemojo_rankings.csv,2011,0.9417366042608134,0.05826339573918657
9500,Rory O'Shea Was Here,1226577,23844,1202733,2004_boxofficemojo_rankings.csv,2004,0.01943946446085325,0.9805605355391468
9501,BTS World Tour 'Love Yourself: Speak Yourself' (The Final) Seoul Live Viewing,1226552,1226552,0,2019_boxofficemojo_rankings.csv,2019,1.0,0.0
9502,That Sugar Film,1226399,3500,1222899,2015_boxofficemojo_rankings.csv,2015,0.0028538836055802394,0.9971461163944197
9503,Vital Signs,1224605,1224605,0,1990_boxofficemojo_rankings.csv,1990,1.0,0.0
9504,The Revolution Has Begun,1223419,738525,484894,2013_boxofficemojo_rankings.csv,2013,0.6036566376686973,0.3963433623313027
9505,Patty Hearst,1223326,1223326,0,1988_boxofficemojo_rankings.csv,1988,1.0,0.0
9506,The Lonely Lady,1223200,1223200,0,1983_boxofficemojo_rankings.csv,1983,1.0,0.0
9507,One Tough Cop,1223034,1223034,0,1998_boxofficemojo_rankings.csv,1998,1.0,0.0
9508,Santa vs. the Snowman 3D 2005 Re-release,1222538,1222538,0,2005_boxofficemojo_rankings.csv,2005,1.0,0.0
9509,Mr. North,1221366,1221366,0,1988_boxofficemojo_rankings.csv,1988,1.0,0.0
9510,A Million to Juan,1220842,1220842,0,1994_boxofficemojo_rankings.csv,1994,1.0,0.0
9511,Lebanon,1220376,368088,852288,2009_boxofficemojo_rankings.csv,2009,0.30161851757163366,0.6983814824283663
9512,Seraphim Falls,1220058,418296,801762,2007_boxofficemojo_rankings.csv,2007,0.34284927437875906,0.657150725621241
9513,Without You I'm Nothing,1218730,1218730,0,1990_boxofficemojo_rankings.csv,1990,1.0,0.0
9514,Sister,1218174,154659,1063515,2012_boxofficemojo_rankings.csv,2012,0.12695969541297056,0.8730403045870294
9515,Alexandra's Project,1217812,752148,465664,2003_boxofficemojo_rankings.csv,2003,0.617622424479312,0.3823775755206879
9516,The Hairdresser's Husband,1217084,1217084,0,1992_boxofficemojo_rankings.csv,1992,1.0,0.0
9517,Ilo Ilo,1216181,56773,1159408,2013_boxofficemojo_rankings.csv,2013,0.04668137390733781,0.9533186260926622
9518,Dreamchild,1215923,1215923,0,1985_boxofficemojo_rankings.csv,1985,1.0,0.0
9519,King of the Hill,1214231,1214231,0,1993_boxofficemojo_rankings.csv,1993,1.0,0.0
9520,The General,1214198,1214198,0,1998_boxofficemojo_rankings.csv,1998,1.0,0.0
9521,When We Leave,1214076,19631,1194445,2010_boxofficemojo_rankings.csv,2010,0.016169498449849926,0.9838305015501501
9522,Woman Thou Art Loosed: On the 7th Day,1213128,1213128,0,2012_boxofficemojo_rankings.csv,2012,1.0,0.0
9523,A Time of Destiny,1212487,1212487,0,1988_boxofficemojo_rankings.csv,1988,1.0,0.0
9524,Clandestine Childhood,1212354,9017,1203337,2012_boxofficemojo_rankings.csv,2012,0.007437596609571132,0.9925624033904289
9525,Uncle Boonmee Who Can Recall His Past Lives,1212206,184292,1027914,2010_boxofficemojo_rankings.csv,2010,0.15203026548292947,0.8479697345170706
9526,Margaret Cho: I'm the One That I Want,1210967,1210967,0,2000_boxofficemojo_rankings.csv,2000,1.0,0.0
9527,Kochadaiiyaan,1210580,817192,393388,2014_boxofficemojo_rankings.csv,2014,0.6750417155413108,0.32495828445868924
9528,The Thin Blue Line,1209846,1209846,0,1988_boxofficemojo_rankings.csv,1988,1.0,0.0
9529,Casino Jack,1209709,1042959,166750,2010_boxofficemojo_rankings.csv,2010,0.862156931956363,0.13784306804363694
9530,The Way He Looks,1207841,101451,1106390,2014_boxofficemojo_rankings.csv,2014,0.08399367135243795,0.916006328647562
9531,Noble 2014 Re-release,1207386,347321,860065,2014_boxofficemojo_rankings.csv,2014,0.2876635972257422,0.7123364027742578
9532,From Mao to Mozart: Isaac Stern in China,1205934,1205934,0,1981_boxofficemojo_rankings.csv,1981,1.0,0.0
9533,Alone in Berlin,1205598,33125,1172473,2016_boxofficemojo_rankings.csv,2016,0.02747599116786856,0.9725240088321314
9534,Encounters at the End of the World,1205464,944933,260531,2008_boxofficemojo_rankings.csv,2008,0.7838749228512838,0.21612507714871618
9535,Inequality for All,1205273,1205273,0,2013_boxofficemojo_rankings.csv,2013,1.0,0.0
9536,Meek's Cutoff,1205257,977772,227485,2011_boxofficemojo_rankings.csv,2011,0.8112560225744385,0.1887439774255615
9537,In the Land of Blood and Honey,1203699,303877,899822,2011_boxofficemojo_rankings.csv,2011,0.25245264804573236,0.7475473519542677
9538,Mumbai Meri Jaan,1203043,16407,1186636,2008_boxofficemojo_rankings.csv,2008,0.013637916516699735,0.9863620834833002
9539,Boy A,1202375,113662,1088713,2008_boxofficemojo_rankings.csv,2008,0.09453124025366462,0.9054687597463353
9540,"Beats, Rhymes & Life: The Travels of A Tribe Called Quest",1200326,1200326,0,2011_boxofficemojo_rankings.csv,2011,1.0,0.0
9541,Army of Crime,1199877,37031,1162846,2009_boxofficemojo_rankings.csv,2009,0.030862330055497354,0.9691376699445027
9542,The Affair of the Necklace,1198113,471210,726903,2001_boxofficemojo_rankings.csv,2001,0.39329345395634635,0.6067065460436536
9543,Phantom,1197759,1034589,163170,2013_boxofficemojo_rankings.csv,2013,0.8637705915797752,0.13622940842022477
9544,No Entry,1197530,678000,519530,2005_boxofficemojo_rankings.csv,2005,0.5661653570265464,0.4338346429734537
9545,Spirited Away 2017 Re-release,1196791,1196791,0,2017_boxofficemojo_rankings.csv,2017,1.0,0.0
9546,The Captain,1196669,109226,1087443,2018_boxofficemojo_rankings.csv,2018,0.09127503094005109,0.9087249690599489
9547,Sammy and Rosie Get Laid,1196336,1196336,0,1987_boxofficemojo_rankings.csv,1987,1.0,0.0
9548,Yi Yi,1196218,1136776,59442,2000_boxofficemojo_rankings.csv,2000,0.9503083886047526,0.04969161139524735
9549,Great Performances at the Met: Saint-Saëns: Samson et Dalila,1195758,1195758,0,2018_boxofficemojo_rankings.csv,2018,1.0,0.0
9550,Repentance,1194961,1189612,5349,2014_boxofficemojo_rankings.csv,2014,0.9955237032840403,0.0044762967159597674
9551,The First Grader,1194710,332000,862710,2011_boxofficemojo_rankings.csv,2011,0.27789170593700563,0.7221082940629944
9552,When You're Strange,1194182,246078,948104,2010_boxofficemojo_rankings.csv,2010,0.20606406728622606,0.7939359327137739
9553,Joe Strummer: The Future Is Unwritten,1193491,248362,945129,2007_boxofficemojo_rankings.csv,2007,0.2080970866139753,0.7919029133860247
9554,Cool as Ice,1193062,1193062,0,1991_boxofficemojo_rankings.csv,1991,1.0,0.0
9555,Wendy and Lucy,1192655,865695,326960,2008_boxofficemojo_rankings.csv,2008,0.7258553395575418,0.2741446604424582
9556,Free Men,1192651,53810,1138841,2011_boxofficemojo_rankings.csv,2011,0.04511797667549015,0.9548820233245099
9557,High Hopes,1192322,1192322,0,1989_boxofficemojo_rankings.csv,1989,1.0,0.0
9558,Backstage,1191835,1191835,0,2000_boxofficemojo_rankings.csv,2000,1.0,0.0
9559,Dancers,1190416,1190416,0,1987_boxofficemojo_rankings.csv,1987,1.0,0.0
9560,Indigo,1190000,1190000,0,2005_boxofficemojo_rankings.csv,2005,1.0,0.0
9561,Tokyo!,1189862,351059,838803,2008_boxofficemojo_rankings.csv,2008,0.2950417779540821,0.704958222045918
9562,Return to Horror High,1189709,1189709,0,1987_boxofficemojo_rankings.csv,1987,1.0,0.0
9563,Time Out,1189692,448542,741150,2001_boxofficemojo_rankings.csv,2001,0.3770236330075347,0.6229763669924653
9564,The Lair of the White Worm,1189315,1189315,0,1988_boxofficemojo_rankings.csv,1988,1.0,0.0
9565,Kingdom Men Rising,1188936,1188936,0,2019_boxofficemojo_rankings.csv,2019,1.0,0.0
9566,Shubh Mangal Savdhan,1188541,689874,498667,2017_boxofficemojo_rankings.csv,2017,0.5804376963016,0.4195623036984
9567,Kill the Irishman,1188194,1188194,0,2011_boxofficemojo_rankings.csv,2011,1.0,0.0
9568,Dead Snow 2: Red vs. Dead,1187477,37473,1150004,2014_boxofficemojo_rankings.csv,2014,0.03155682173212618,0.9684431782678738
9569,The Cove,1187434,857005,330429,2009_boxofficemojo_rankings.csv,2009,0.721728533964835,0.2782714660351649
9570,Los Domirriqueños 2,1187280,1187280,0,2019_boxofficemojo_rankings.csv,2019,1.0,0.0
9571,The Violin,1186247,65298,1120949,2007_boxofficemojo_rankings.csv,2007,0.05504587155963303,0.944954128440367
9572,Year of the Gun,1182273,1182273,0,1991_boxofficemojo_rankings.csv,1991,1.0,0.0
9573,Chuck & Buck,1182065,1055671,126394,2000_boxofficemojo_rankings.csv,2000,0.8930735619445631,0.10692643805543689
9574,Remember 2016 Re-release,1181023,637555,543468,2016_boxofficemojo_rankings.csv,2016,0.5398328398346179,0.46016716016538206
9575,Videocracy,1179676,23720,1155956,2009_boxofficemojo_rankings.csv,2009,0.020107215879614403,0.9798927841203856
9576,Nightwatch,1179002,1179002,0,1998_boxofficemojo_rankings.csv,1998,1.0,0.0
9577,Alien 2019 Re-release,1178844,833658,345186,2014_boxofficemojo_rankings.csv,2014,0.7071826297627167,0.2928173702372833
9578,Fire at Sea,1178377,120933,1057444,2016_boxofficemojo_rankings.csv,2016,0.10262674848541681,0.8973732515145832
9579,House of Sand,1178175,539285,638890,2006_boxofficemojo_rankings.csv,2006,0.45772911494472385,0.5422708850552762
9580,Destiny Turns on the Radio,1176982,1176982,0,1995_boxofficemojo_rankings.csv,1995,1.0,0.0
9581,Any Body Can Dance 2,1176958,892133,284825,2015_boxofficemojo_rankings.csv,2015,0.7579990110097387,0.24200098899026135
9582,Owning Mahowny,1176302,1011871,164431,2003_boxofficemojo_rankings.csv,2003,0.860213618611547,0.13978638138845295
9583,Why Would I Lie?,1175855,1175855,0,1980_boxofficemojo_rankings.csv,1980,1.0,0.0
9584,December Boys,1175579,50715,1124864,2007_boxofficemojo_rankings.csv,2007,0.04314044398547439,0.9568595560145257
9585,Little Manhattan,1172444,385373,787071,2005_boxofficemojo_rankings.csv,2005,0.3286920313464865,0.6713079686535135
9586,The Boyfriend School,1171762,1171762,0,1990_boxofficemojo_rankings.csv,1990,1.0,0.0
9587,Raanjhanaa,1171761,903232,268529,2013_boxofficemojo_rankings.csv,2013,0.7708329599636786,0.2291670400363214
9588,Permanent Midnight,1171001,1171001,0,1998_boxofficemojo_rankings.csv,1998,1.0,0.0
9589,Vexille,1170351,3259,1167092,2007_boxofficemojo_rankings.csv,2007,0.002784634695061567,0.9972153653049385
9590,Night School,1169875,1169875,0,1981_boxofficemojo_rankings.csv,1981,1.0,0.0
9591,The Innkeepers,1169750,78396,1091354,2012_boxofficemojo_rankings.csv,2012,0.06701944860012823,0.9329805513998718
9592,Dark Tide,1167612,0,1167612,2012_boxofficemojo_rankings.csv,2012,0.0,1.0
9593,Great Performances at the Met: Verdi: Luisa Miller,1166858,1166858,0,2018_boxofficemojo_rankings.csv,2018,1.0,0.0
9594,Her & Him,1166781,857986,308795,2016_boxofficemojo_rankings.csv,2016,0.7353445076668201,0.2646554923331799
9595,You Ain't Seen Nothin' Yet,1166740,18929,1147811,2012_boxofficemojo_rankings.csv,2012,0.01622383735879459,0.9837761626412054
9596,Tulpan,1166344,158741,1007603,2009_boxofficemojo_rankings.csv,2009,0.13610135603218262,0.8638986439678173
9597,American Movie,1165795,1165795,0,1999_boxofficemojo_rankings.csv,1999,1.0,0.0
9598,The Emperor's New Clothes,1165545,661903,503642,2001_boxofficemojo_rankings.csv,2001,0.5678914156038591,0.43210858439614086
9599,Man About Town,1165186,0,1165186,2006_boxofficemojo_rankings.csv,2006,0.0,1.0
9600,The Best Two Years,1163450,1163450,0,2004_boxofficemojo_rankings.csv,2004,1.0,0.0
9601,Vaxxed: From Cover-Up to Catastrophe,1163265,1163265,0,2016_boxofficemojo_rankings.csv,2016,1.0,0.0
9602,Groove,1162001,1115313,46688,2000_boxofficemojo_rankings.csv,2000,0.959821032856254,0.040178967143746004
9603,Trois,1161843,1161843,0,2000_boxofficemojo_rankings.csv,2000,1.0,0.0
9604,To Sleep with Anger,1161135,1161135,0,1990_boxofficemojo_rankings.csv,1990,1.0,0.0
9605,Murmur of the Heart,1160784,1160784,0,1989_boxofficemojo_rankings.csv,1989,1.0,0.0
9606,Louder Than Bombs,1160724,163807,996917,2015_boxofficemojo_rankings.csv,2015,0.14112484966279668,0.8588751503372033
9607,The Final Season,1159691,1159691,0,2007_boxofficemojo_rankings.csv,2007,1.0,0.0
9608,The Unborn,1159578,1159578,0,1991_boxofficemojo_rankings.csv,1991,1.0,0.0
9609,Where Hope Grows,1159072,1156000,3072,2015_boxofficemojo_rankings.csv,2015,0.9973496038209878,0.002650396179012175
9610,The Wizard of Oz 2009 NCM Fathom Event,1158710,1140000,18710,2009_boxofficemojo_rankings.csv,2009,0.9838527327804196,0.016147267219580395
9611,Breathe,1158695,42297,1116398,2014_boxofficemojo_rankings.csv,2014,0.03650399803226906,0.9634960019677309
9612,Darling Companion,1157257,793815,363442,2012_boxofficemojo_rankings.csv,2012,0.6859452999636209,0.31405470003637914
9613,Napping Princess,1156847,48198,1108649,2017_boxofficemojo_rankings.csv,2017,0.041663245009927845,0.9583367549900722
9614,Embrace: The Documentary,1155263,629126,526137,2016_boxofficemojo_rankings.csv,2016,0.5445738329713667,0.4554261670286333
9615,Detective Jagga,1154862,861740,293122,2017_boxofficemojo_rankings.csv,2017,0.7461843925940935,0.25381560740590653
9616,"Olivier, Olivier",1154476,1154476,0,1993_boxofficemojo_rankings.csv,1993,1.0,0.0
9617,Get Real,1152979,1152979,0,1999_boxofficemojo_rankings.csv,1999,1.0,0.0
9618,Step,1152839,1146292,6547,2017_boxofficemojo_rankings.csv,2017,0.9943209763028489,0.00567902369715112
9619,The Wrong Guys,1152786,1152786,0,1988_boxofficemojo_rankings.csv,1988,1.0,0.0
9620,The Reckoning,1152528,257252,895276,2004_boxofficemojo_rankings.csv,2004,0.2232067246956256,0.7767932753043744
9621,Excessive Force,1152117,1152117,0,1993_boxofficemojo_rankings.csv,1993,1.0,0.0
9622,Liberal Arts,1150681,327345,823336,2012_boxofficemojo_rankings.csv,2012,0.28447936482830605,0.715520635171694
9623,Les aimants,1150414,1150414,0,2004_boxofficemojo_rankings.csv,2004,1.0,0.0
9624,Nightflyers,1149470,1149470,0,1987_boxofficemojo_rankings.csv,1987,1.0,0.0
9625,Humko Deewana Kar Gaye,1149417,250083,899334,2006_boxofficemojo_rankings.csv,2006,0.21757377870694447,0.7824262212930555
9626,Cartel Land,1145923,704352,441571,2015_boxofficemojo_rankings.csv,2015,0.6146591001315097,0.3853408998684903
9627,Miracle Mile,1145404,1145404,0,1989_boxofficemojo_rankings.csv,1989,1.0,0.0
9628,Sugar,1144438,1082124,62314,2009_boxofficemojo_rankings.csv,2009,0.945550567177951,0.0544494328220489
9629,The River Rat,1142944,1142944,0,1984_boxofficemojo_rankings.csv,1984,1.0,0.0
9630,Belizaire the Cajun,1142243,1142243,0,1986_boxofficemojo_rankings.csv,1986,1.0,0.0
9631,Elliot the Littlest Reindeer 2018 Re-release,1142187,24262,1117925,2018_boxofficemojo_rankings.csv,2018,0.021241705605124204,0.9787582943948758
9632,Two Much,1141556,1141556,0,1996_boxofficemojo_rankings.csv,1996,1.0,0.0
9633,House,1141018,575048,565970,2008_boxofficemojo_rankings.csv,2008,0.5039780266393694,0.4960219733606306
9634,Roma,1140769,0,1140769,2018_boxofficemojo_rankings.csv,2018,0.0,1.0
9635,The Song of Names,1138962,1077584,61378,2019_boxofficemojo_rankings.csv,2019,0.9461105813890192,0.05388941861098088
9636,The Hollars,1138609,1016985,121624,2016_boxofficemojo_rankings.csv,2016,0.8931819439333433,0.10681805606665677
9637,Fathom Premieres 6 Below: Miracle on the Mountain,1135531,14838,1120693,2017_boxofficemojo_rankings.csv,2017,0.01306701446283721,0.9869329855371628
9638,"Yoo-Hoo, Mrs. Goldberg",1134623,1134623,0,2009_boxofficemojo_rankings.csv,2009,1.0,0.0
9639,Cell,1133031,0,1133031,2016_boxofficemojo_rankings.csv,2016,0.0,1.0
9640,Miral,1132843,373420,759423,2010_boxofficemojo_rankings.csv,2010,0.3296308491114832,0.6703691508885168
9641,Valmont,1132112,1132112,0,1989_boxofficemojo_rankings.csv,1989,1.0,0.0
9642,Dancer,1131649,71917,1059732,2016_boxofficemojo_rankings.csv,2016,0.06355062391253825,0.9364493760874617
9643,Cold Souls,1131536,905209,226327,2009_boxofficemojo_rankings.csv,2009,0.7999825016614585,0.2000174983385416
9644,Half Moon Street,1131399,1131399,0,1986_boxofficemojo_rankings.csv,1986,1.0,0.0
9645,Stranger by the Lake,1131241,325196,806045,2013_boxofficemojo_rankings.csv,2013,0.2874683643891974,0.7125316356108027
9646,A Price Above Rubies,1130732,1130732,0,1998_boxofficemojo_rankings.csv,1998,1.0,0.0
9647,American Teen,1130270,942441,187829,2008_boxofficemojo_rankings.csv,2008,0.8338193528979801,0.16618064710201988
9648,Weekend,1128477,484592,643885,2011_boxofficemojo_rankings.csv,2011,0.4294212465118917,0.5705787534881083
9649,Red Road,1128345,154892,973453,2006_boxofficemojo_rankings.csv,2006,0.1372736175549145,0.8627263824450855
9650,Dil Bole Hadippa!,1128211,644046,484165,2009_boxofficemojo_rankings.csv,2009,0.5708559834995405,0.4291440165004596
9651,The Lady and the Duke,1128137,331051,797086,2001_boxofficemojo_rankings.csv,2001,0.29344928851726343,0.7065507114827366
9652,In the Name Of,1127938,9883,1118055,2013_boxofficemojo_rankings.csv,2013,0.008762006422338816,0.9912379935776612
9653,The Thief,1126506,1126506,0,1998_boxofficemojo_rankings.csv,1998,1.0,0.0
9654,Mute Witness,1125910,1125910,0,1995_boxofficemojo_rankings.csv,1995,1.0,0.0
9655,Tosca,1125058,69613,1055445,2001_boxofficemojo_rankings.csv,2001,0.06187503222056107,0.9381249677794389
9656,La Danse: The Paris Opera Ballet,1124838,567493,557345,2009_boxofficemojo_rankings.csv,2009,0.5045108717877597,0.49548912821224034
9657,Man-Thing,1123136,0,1123136,2005_boxofficemojo_rankings.csv,2005,0.0,1.0
9658,Paper Clips,1121744,1121744,0,2004_boxofficemojo_rankings.csv,2004,1.0,0.0
9659,The Stoning of Soraya M.,1120476,637421,483055,2009_boxofficemojo_rankings.csv,2009,0.5688841171073722,0.43111588289262776
9660,Look Away,1119537,0,1119537,2018_boxofficemojo_rankings.csv,2018,0.0,1.0
9661,Freddie as F.R.O.7.,1119368,1119368,0,1992_boxofficemojo_rankings.csv,1992,1.0,0.0
9662,Street Smart,1119112,1119112,0,1987_boxofficemojo_rankings.csv,1987,1.0,0.0
9663,Eyes of a Stranger,1118634,1118634,0,1981_boxofficemojo_rankings.csv,1981,1.0,0.0
9664,Papa Hemingway in Cuba,1117399,1115615,1784,2016_boxofficemojo_rankings.csv,2016,0.9984034351203106,0.00159656487968935
9665,Flashbacks of a Fool,1117269,1664,1115605,2008_boxofficemojo_rankings.csv,2008,0.0014893458961091734,0.9985106541038908
9666,The Mill and the Cross,1116180,312187,803993,2011_boxofficemojo_rankings.csv,2011,0.2796923435288215,0.7203076564711784
9667,Fraude: México 2006,1115939,3637,1112302,2007_boxofficemojo_rankings.csv,2007,0.003259138716363529,0.9967408612836365
9668,Surveillance,1115493,27349,1088144,2008_boxofficemojo_rankings.csv,2008,0.02451741068747182,0.9754825893125282
9669,Great Performances at the Met: Donizetti: L'Elisir d'Amore,1115018,1115018,0,2018_boxofficemojo_rankings.csv,2018,1.0,0.0
9670,A War,1114663,122902,991761,2015_boxofficemojo_rankings.csv,2015,0.11025933398704361,0.8897406660129564
9671,The Selfish Giant,1114027,12189,1101838,2013_boxofficemojo_rankings.csv,2013,0.01094138651935725,0.9890586134806427
9672,Possession,1113538,1113538,0,1983_boxofficemojo_rankings.csv,1983,1.0,0.0
9673,"Ciao, Professore!",1113435,1113435,0,1994_boxofficemojo_rankings.csv,1994,1.0,0.0
9674,The King of Masks,1113103,1113103,0,1999_boxofficemojo_rankings.csv,1999,1.0,0.0
9675,Walking With The Enemy,1112592,1112592,0,2014_boxofficemojo_rankings.csv,2014,1.0,0.0
9676,Jet Lag 2003 Re-release,1112018,544964,567054,2003_boxofficemojo_rankings.csv,2003,0.49006760681931405,0.509932393180686
9677,Living in Oblivion,1111790,1111790,0,1995_boxofficemojo_rankings.csv,1995,1.0,0.0
9678,The R.M.,1111615,1111615,0,2003_boxofficemojo_rankings.csv,2003,1.0,0.0
9679,Sordid Lives,1111273,1111273,0,2001_boxofficemojo_rankings.csv,2001,1.0,0.0
9680,The Overnight,1110522,1110522,0,2015_boxofficemojo_rankings.csv,2015,1.0,0.0
9681,Georgia,1110104,1110104,0,1995_boxofficemojo_rankings.csv,1995,1.0,0.0
9682,Heathers,1108462,1108462,0,1989_boxofficemojo_rankings.csv,1989,1.0,0.0
9683,Daddy Nostalgia,1108429,1108429,0,1991_boxofficemojo_rankings.csv,1991,1.0,0.0
9684,Sacred Planet,1108356,1108356,0,2004_boxofficemojo_rankings.csv,2004,1.0,0.0
9685,"Say Amen, Somebody",1108299,1108299,0,1983_boxofficemojo_rankings.csv,1983,1.0,0.0
9686,Intimate Stories,1108009,102897,1005112,2002_boxofficemojo_rankings.csv,2002,0.09286657418847681,0.9071334258115232
9687,Where the Heart Is,1106475,1106475,0,1990_boxofficemojo_rankings.csv,1990,1.0,0.0
9688,My Neighbor Totoro 2019 Re-release,1105564,1105564,0,2019_boxofficemojo_rankings.csv,2019,1.0,0.0
9689,"Peace, Love & Misunderstanding",1105020,590700,514320,2012_boxofficemojo_rankings.csv,2012,0.5345604604441548,0.46543953955584516
9690,American Desi,1104408,907835,196573,2001_boxofficemojo_rankings.csv,2001,0.822010525095798,0.17798947490420208
9691,The Heart Specialist,1103037,1103037,0,2011_boxofficemojo_rankings.csv,2011,1.0,0.0
9692,The Insanity of God,1102525,1102525,0,2016_boxofficemojo_rankings.csv,2016,1.0,0.0
9693,Mistress,1102469,1102469,0,1992_boxofficemojo_rankings.csv,1992,1.0,0.0
9694,El Coyote,1101470,1101470,0,2019_boxofficemojo_rankings.csv,2019,1.0,0.0
9695,The Passage,1101186,1101186,0,1979_boxofficemojo_rankings.csv,1979,1.0,0.0
9696,Chaar Sahibzaade 2: Rise of Banda Singh Bahadur 2016 Re-release,1100947,700723,400224,2016_boxofficemojo_rankings.csv,2016,0.6364729637303158,0.3635270362696842
9697,Temptress Moon,1100788,1100788,0,1997_boxofficemojo_rankings.csv,1997,1.0,0.0
9698,Beyond the Reach,1100432,45895,1054537,2015_boxofficemojo_rankings.csv,2015,0.04170634805240124,0.9582936519475987
9699,Waterland,1100218,1100218,0,1992_boxofficemojo_rankings.csv,1992,1.0,0.0
9700,The Salvation Poem,1097750,914818,182932,2009_boxofficemojo_rankings.csv,2009,0.8333573217945798,0.16664267820542017
9701,Heart of Dixie,1097333,1097333,0,1989_boxofficemojo_rankings.csv,1989,1.0,0.0
9702,Little Odessa,1095885,1095885,0,1995_boxofficemojo_rankings.csv,1995,1.0,0.0
9703,Blood and Wine,1094668,1094668,0,1997_boxofficemojo_rankings.csv,1997,1.0,0.0
9704,Yaadein...,1093819,1000229,93590,2001_boxofficemojo_rankings.csv,2001,0.9144373977778774,0.08556260222212267
9705,Columbus,1093077,1017107,75970,2017_boxofficemojo_rankings.csv,2017,0.9304989492963441,0.06950105070365582
9706,Swimming to Cambodia,1092911,1092911,0,1987_boxofficemojo_rankings.csv,1987,1.0,0.0
9707,Northern Soul,1092359,8886,1083473,2014_boxofficemojo_rankings.csv,2014,0.008134688321330259,0.9918653116786698
9708,Bombshell: The Hedy Lamarr Story,1092277,820300,271977,2017_boxofficemojo_rankings.csv,2017,0.7509999752809956,0.24900002471900443
9709,The Son of No One,1091132,30680,1060452,2011_boxofficemojo_rankings.csv,2011,0.028117587972857547,0.9718824120271424
9710,Snowboarder,1090565,27732,1062833,2003_boxofficemojo_rankings.csv,2003,0.02542902073695745,0.9745709792630426
9711,The Man Who Cried,1090432,747092,343340,2001_boxofficemojo_rankings.csv,2001,0.6851339652541378,0.31486603474586217
9712,The Goonies 2019 Re-release,1089463,864378,225085,2019_boxofficemojo_rankings.csv,2019,0.7933982154510983,0.2066017845489016
9713,Wired,1089000,1089000,0,1989_boxofficemojo_rankings.csv,1989,1.0,0.0
9714,The Sky Is Pink,1088641,652592,436049,2019_boxofficemojo_rankings.csv,2019,0.5994556515876216,0.40054434841237835
9715,The Music Teacher,1086894,1086894,0,1989_boxofficemojo_rankings.csv,1989,1.0,0.0
9716,Terror's Advocate,1086656,47724,1038932,2007_boxofficemojo_rankings.csv,2007,0.04391822251015961,0.9560817774898404
9717,Déjà Vu,1086181,1086181,0,1998_boxofficemojo_rankings.csv,1998,1.0,0.0
9718,Tycoon: A New Russian,1086121,123159,962962,2002_boxofficemojo_rankings.csv,2002,0.1133934432719743,0.8866065567280257
9719,This Is My Father,1083975,1083975,0,1999_boxofficemojo_rankings.csv,1999,1.0,0.0
9720,Winter Kills,1083799,1083799,0,1979_boxofficemojo_rankings.csv,1979,1.0,0.0
9721,84 Charing Cross Road,1083486,1083486,0,1987_boxofficemojo_rankings.csv,1987,1.0,0.0
9722,Sunset,1083299,164906,918393,2018_boxofficemojo_rankings.csv,2018,0.15222574746215034,0.8477742525378497
9723,Housekeeping,1083282,1083282,0,1987_boxofficemojo_rankings.csv,1987,1.0,0.0
9724,Undiscovered,1082784,1069318,13466,2005_boxofficemojo_rankings.csv,2005,0.9875635399119307,0.012436460088069274
9725,Jesus Is King,1082629,973000,109629,2019_boxofficemojo_rankings.csv,2019,0.8987381642280042,0.10126183577199577
9726,Mystify: Michael Hutchence,1082456,289573,792883,2019_boxofficemojo_rankings.csv,2019,0.2675147996777698,0.7324852003222302
9727,Of Unknown Origin,1080470,1080470,0,1983_boxofficemojo_rankings.csv,1983,1.0,0.0
9728,The Tango Lesson,1080192,1080192,0,1997_boxofficemojo_rankings.csv,1997,1.0,0.0
9729,Grace Is Gone,1080022,50899,1029123,2007_boxofficemojo_rankings.csv,2007,0.047127743694109936,0.9528722563058901
9730,The Statement,1079822,765637,314185,2003_boxofficemojo_rankings.csv,2003,0.7090400084458365,0.2909599915541636
9731,The Cup,1079108,1079108,0,2000_boxofficemojo_rankings.csv,2000,1.0,0.0
9732,Page One: Inside the New York Times,1077982,1067028,10954,2011_boxofficemojo_rankings.csv,2011,0.9898384203075747,0.010161579692425291
9733,Steeper & Deeper,1076685,1076685,0,1992_boxofficemojo_rankings.csv,1992,1.0,0.0
9734,Turtles Can Fly,1075553,258578,816975,2005_boxofficemojo_rankings.csv,2005,0.24041400098368002,0.75958599901632
9735,Merci pour tout,1073969,1073969,0,2019_boxofficemojo_rankings.csv,2019,1.0,0.0
9736,The Salton Sea,1073198,764554,308644,2002_boxofficemojo_rankings.csv,2002,0.7124072165620883,0.2875927834379117
9737,The First Monday in May,1072943,527474,545469,2016_boxofficemojo_rankings.csv,2016,0.4916141864013279,0.5083858135986721
9738,Killing Season,1071322,39881,1031441,2013_boxofficemojo_rankings.csv,2013,0.03722596940975729,0.9627740305902427
9739,Lolita,1071255,1071255,0,1998_boxofficemojo_rankings.csv,1998,1.0,0.0
9740,Chal Mera Putt 2,1070997,445000,625997,2020_boxofficemojo_rankings.csv,2020,0.4155006970140906,0.5844993029859094
9741,When Brendan Met Trudy,1069648,133376,936272,2001_boxofficemojo_rankings.csv,2001,0.12469148729301602,0.875308512706984
9742,Peaceful Warrior,1066748,1066748,0,2006_boxofficemojo_rankings.csv,2006,1.0,0.0
9743,September Dawn,1066555,1066555,0,2007_boxofficemojo_rankings.csv,2007,1.0,0.0
9744,Au nom de ma fille,1066493,1623,1064870,2016_boxofficemojo_rankings.csv,2016,0.001521810269734541,0.9984781897302655
9745,The Oogieloves in the Big Balloon Adventure,1065907,1065907,0,2012_boxofficemojo_rankings.csv,2012,1.0,0.0
9746,50 to 1,1064454,1064454,0,2014_boxofficemojo_rankings.csv,2014,1.0,0.0
9747,La Mission,1062941,1062941,0,2010_boxofficemojo_rankings.csv,2010,1.0,0.0
9748,Family Law,1062915,38605,1024310,2006_boxofficemojo_rankings.csv,2006,0.03631993150910468,0.9636800684908953
9749,Dangerous Ishq,1062825,0,1062825,2012_boxofficemojo_rankings.csv,2012,0.0,1.0
9750,The Girlfriend Experience,1060941,695840,365101,2009_boxofficemojo_rankings.csv,2009,0.6558705903532808,0.3441294096467193
9751,Mike's Murder,1059966,1059966,0,1984_boxofficemojo_rankings.csv,1984,1.0,0.0
9752,Carlos,1059369,145526,913843,2010_boxofficemojo_rankings.csv,2010,0.1373704535435717,0.8626295464564283
9753,Bamako,1059232,112351,946881,2006_boxofficemojo_rankings.csv,2006,0.1060683589619649,0.8939316410380351
9754,Kafka,1059071,1059071,0,1991_boxofficemojo_rankings.csv,1991,1.0,0.0
9755,Comfort and Joy,1057368,1057368,0,1984_boxofficemojo_rankings.csv,1984,1.0,0.0
9756,DEFCON-4,1057064,1057064,0,1985_boxofficemojo_rankings.csv,1985,1.0,0.0
9757,Bennett's War,1056416,1056416,0,2019_boxofficemojo_rankings.csv,2019,1.0,0.0
9758,Light Sleeper,1055987,1050861,5126,1992_boxofficemojo_rankings.csv,1992,0.9951457735748641,0.004854226425135916
9759,Bad Moon,1055525,1055525,0,1996_boxofficemojo_rankings.csv,1996,1.0,0.0
9760,An Angel at My Table,1054638,1054638,0,1991_boxofficemojo_rankings.csv,1991,1.0,0.0
9761,The Sender,1054328,1054328,0,1982_boxofficemojo_rankings.csv,1982,1.0,0.0
9762,Velvet Goldmine,1053788,1053788,0,1998_boxofficemojo_rankings.csv,1998,1.0,0.0
9763,Borgman,1052010,57474,994536,2013_boxofficemojo_rankings.csv,2013,0.05463256052699119,0.9453674394730088
9764,All Over the Guy,1051948,1022324,29624,2001_boxofficemojo_rankings.csv,2001,0.971838912189576,0.02816108781042409
9765,The Ten Commandments,1051907,952820,99087,2007_boxofficemojo_rankings.csv,2007,0.9058025091571783,0.09419749084282165
9766,Misbehaviour,1051083,0,1051083,2020_boxofficemojo_rankings.csv,2020,0.0,1.0
9767,No One Lives,1048704,74918,973786,2013_boxofficemojo_rankings.csv,2013,0.07143865189796167,0.9285613481020383
9768,Extremedays,1047553,1047553,0,2001_boxofficemojo_rankings.csv,2001,1.0,0.0
9769,Nijinsky,1047454,1047454,0,1980_boxofficemojo_rankings.csv,1980,1.0,0.0
9770,Princess Mononoke 2019 Re-release,1046446,1046446,0,2019_boxofficemojo_rankings.csv,2019,1.0,0.0
9771,Becky,1045873,1003700,42173,2020_boxofficemojo_rankings.csv,2020,0.9596767485153551,0.040323251484644884
9772,King of California,1045786,268461,777325,2007_boxofficemojo_rankings.csv,2007,0.2567073952032251,0.7432926047967748
9773,A Tale of Two Sisters,1045252,72541,972711,2003_boxofficemojo_rankings.csv,2003,0.06940048906866478,0.9305995109313352
9774,A Brilliant Young Mind,1043620,171793,871827,2015_boxofficemojo_rankings.csv,2015,0.16461259845537649,0.8353874015446235
9775,Made In Mexico,1042673,151133,891540,2012_boxofficemojo_rankings.csv,2012,0.14494764897527795,0.855052351024722
9776,Spark: A Space Tail,1040689,196458,844231,2017_boxofficemojo_rankings.csv,2017,0.18877685840822764,0.8112231415917723
9777,Befikre,1040421,498000,542421,2016_boxofficemojo_rankings.csv,2016,0.4786523916760619,0.5213476083239381
9778,Money for Nothing,1039824,1039824,0,1993_boxofficemojo_rankings.csv,1993,1.0,0.0
9779,Naked in New York,1038959,1038959,0,1994_boxofficemojo_rankings.csv,1994,1.0,0.0
9780,Dead Man,1037847,1037847,0,1996_boxofficemojo_rankings.csv,1996,1.0,0.0
9781,The Time That Remains,1037505,32869,1004636,2009_boxofficemojo_rankings.csv,2009,0.03168081117681361,0.9683191888231863
9782,The Dark Crystal 2018 Re-release,1036956,1036956,0,2018_boxofficemojo_rankings.csv,2018,1.0,0.0
9783,Another Day in Paradise,1036818,1036818,0,1998_boxofficemojo_rankings.csv,1998,1.0,0.0
9784,Swept Away,1036520,598645,437875,2002_boxofficemojo_rankings.csv,2002,0.5775527727395515,0.4224472272604484
9785,Noah,1035603,1035603,0,2019_boxofficemojo_rankings.csv,2019,1.0,0.0
9786,The Brothers Solomon,1035056,900926,134130,2007_boxofficemojo_rankings.csv,2007,0.8704128085823376,0.12958719141766242
9787,Unconditional,1034448,1005800,28648,2012_boxofficemojo_rankings.csv,2012,0.9723060028150279,0.02769399718497208
9788,Margaret Cho: Notorious C.H.O.,1033395,1033395,0,2002_boxofficemojo_rankings.csv,2002,1.0,0.0
9789,The Flower of My Secret,1032180,1032180,0,1996_boxofficemojo_rankings.csv,1996,1.0,0.0
9790,Urbania,1032075,1032075,0,2000_boxofficemojo_rankings.csv,2000,1.0,0.0
9791,Ain't Them Bodies Saints,1031243,396519,634724,2013_boxofficemojo_rankings.csv,2013,0.38450588270659775,0.6154941172934022
9792,We Are Family,1031070,638144,392926,2010_boxofficemojo_rankings.csv,2010,0.6189143317136567,0.3810856682863433
9793,Hidden Agenda,1030938,1030938,0,1990_boxofficemojo_rankings.csv,1990,1.0,0.0
9794,The Bubble,1029926,157121,872805,2007_boxofficemojo_rankings.csv,2007,0.15255562050089036,0.8474443794991097
9795,Welcome Home,1029822,1029822,0,1989_boxofficemojo_rankings.csv,1989,1.0,0.0
9796,The Thing Called Love,1029721,1029721,0,1993_boxofficemojo_rankings.csv,1993,1.0,0.0
9797,The Eyes of Tammy Faye,1029591,1029591,0,2000_boxofficemojo_rankings.csv,2000,1.0,0.0
9798,Up the Yangtze,1029211,783969,245242,2008_boxofficemojo_rankings.csv,2008,0.7617184425739717,0.2382815574260283
9799,Aria,1028679,1028679,0,1988_boxofficemojo_rankings.csv,1988,1.0,0.0
9800,Breaking News,1028420,0,1028420,2004_boxofficemojo_rankings.csv,2004,0.0,1.0
9801,La Bohème,1026897,54464,972433,2008_boxofficemojo_rankings.csv,2008,0.053037451662630235,0.9469625483373698
9802,French Twist,1026646,1026646,0,1996_boxofficemojo_rankings.csv,1996,1.0,0.0
9803,Knight of Cups,1026288,566006,460282,2015_boxofficemojo_rankings.csv,2015,0.5515079587796018,0.44849204122039815
9804,Ma tante Aline,1025852,1025852,0,2007_boxofficemojo_rankings.csv,2007,1.0,0.0
9805,Cross My Heart,1025762,1025762,0,1987_boxofficemojo_rankings.csv,1987,1.0,0.0
9806,Little Dorrit,1025228,1025228,0,1988_boxofficemojo_rankings.csv,1988,1.0,0.0
9807,Casablanca 2017 Re-release,1024560,1024560,0,2017_boxofficemojo_rankings.csv,2017,1.0,0.0
9808,Tangerines,1024132,144501,879631,2015_boxofficemojo_rankings.csv,2015,0.14109606964727203,0.8589039303527279
9809,Color Out of Space,1023510,765561,257949,2020_boxofficemojo_rankings.csv,2020,0.7479760823050092,0.2520239176949908
9810,Great Performances at the Met: Puccini: La Fanciulla del West,1023233,1023233,0,2018_boxofficemojo_rankings.csv,2018,1.0,0.0
9811,"The Bread, My Sweet",1023156,1023156,0,2001_boxofficemojo_rankings.csv,2001,1.0,0.0
9812,Pinjar,1022336,66290,956046,2003_boxofficemojo_rankings.csv,2003,0.06484169588080631,0.9351583041191937
9813,Ma mère,1022148,71616,950532,2004_boxofficemojo_rankings.csv,2004,0.07006421770624215,0.9299357822937578
9814,The Taste of Others,1021938,891369,130569,2000_boxofficemojo_rankings.csv,2000,0.8722339319997886,0.12776606800021137
9815,Conversations with God,1021803,425045,596758,2006_boxofficemojo_rankings.csv,2006,0.4159754864685267,0.5840245135314733
9816,Leaves of Grass,1018753,70066,948687,2010_boxofficemojo_rankings.csv,2010,0.06877623918653492,0.9312237608134651
9817,Thieves,1018682,1018682,0,1996_boxofficemojo_rankings.csv,1996,1.0,0.0
9818,The Oscar Nominated Short Films 2010: Live Action,1018169,1018169,0,2010_boxofficemojo_rankings.csv,2010,1.0,0.0
9819,On a Clear Day,1017257,191033,826224,2005_boxofficemojo_rankings.csv,2005,0.1877922688170246,0.8122077311829754
9820,Husband Material,1016545,567417,449128,2018_boxofficemojo_rankings.csv,2018,0.5581818807824543,0.4418181192175457
9821,Savage Messiah,1015671,1015671,0,2002_boxofficemojo_rankings.csv,2002,1.0,0.0
9822,Two Family House,1015122,1015122,0,2000_boxofficemojo_rankings.csv,2000,1.0,0.0
9823,Love Field,1014726,1014726,0,1993_boxofficemojo_rankings.csv,1993,1.0,0.0
9824,Jesus Camp,1013596,902544,111052,2006_boxofficemojo_rankings.csv,2006,0.8904376102510271,0.10956238974897296
9825,Assassination Tango,1013272,1013272,0,2003_boxofficemojo_rankings.csv,2003,1.0,0.0
9826,"We Love It!/The Man Who Yelled/The Stain/Billy Nayer/Little Wolf/The Square of Light/Prehistoric Beast/I Think I Was an Alcoholic/The Sandman/Words, Words, Words/Gahan Wilson's Diner",1012881,1012881,0,1993_boxofficemojo_rankings.csv,1993,1.0,0.0
9827,Big Stone Gap,1012804,1009301,3503,2015_boxofficemojo_rankings.csv,2015,0.9965412853819693,0.0034587146180307345
9828,Transit,1012747,815290,197457,2018_boxofficemojo_rankings.csv,2018,0.8050283042062825,0.19497169579371748
9829,Perfect Creature,1012639,0,1012639,2007_boxofficemojo_rankings.csv,2007,0.0,1.0
9830,Xiu Xiu: The Sent-Down Girl,1010933,1010933,0,1999_boxofficemojo_rankings.csv,1999,1.0,0.0
9831,L'attesa,1010766,55804,954962,2015_boxofficemojo_rankings.csv,2015,0.05520961330317799,0.944790386696822
9832,Elvis: The Comeback Special,1010657,1010657,0,2018_boxofficemojo_rankings.csv,2018,1.0,0.0
9833,Far from Men,1010485,5336,1005149,2015_boxofficemojo_rankings.csv,2015,0.0052806325675294535,0.9947193674324706
9834,Cold Blood,1009888,5083,1004805,2019_boxofficemojo_rankings.csv,2019,0.005033231407839285,0.9949667685921607
9835,Slam,1009819,1009819,0,1998_boxofficemojo_rankings.csv,1998,1.0,0.0
9836,The Bostonians,1009700,1009700,0,1984_boxofficemojo_rankings.csv,1984,1.0,0.0
9837,The Song,1009620,1009620,0,2014_boxofficemojo_rankings.csv,2014,1.0,0.0
9838,Wallace and Grommit Festival,1009577,1009577,0,1996_boxofficemojo_rankings.csv,1996,1.0,0.0
9839,The IMAX Nutcracker,1009291,1009291,0,1999_boxofficemojo_rankings.csv,1999,1.0,0.0
9840,Whore,1008404,1008404,0,1991_boxofficemojo_rankings.csv,1991,1.0,0.0
9841,Francofonia,1008154,307040,701114,2015_boxofficemojo_rankings.csv,2015,0.3045566451157264,0.6954433548842737
9842,Sidewalls,1008116,2377,1005739,2011_boxofficemojo_rankings.csv,2011,0.0023578635791912834,0.9976421364208087
9843,Shiloh,1007822,1007822,0,1997_boxofficemojo_rankings.csv,1997,1.0,0.0
9844,Lilya 4-Ever,1007747,184023,823724,2002_boxofficemojo_rankings.csv,2002,0.18260833324237136,0.8173916667576286
9845,Cobb,1007583,1007583,0,1994_boxofficemojo_rankings.csv,1994,1.0,0.0
9846,"I Have Given My Heart Away, Darling",1007446,1007446,0,1999_boxofficemojo_rankings.csv,1999,1.0,0.0
9847,Mystery Science Theater 3000: The Movie,1007306,1007306,0,1996_boxofficemojo_rankings.csv,1996,1.0,0.0
9848,Europa,1007001,1007001,0,1992_boxofficemojo_rankings.csv,1992,1.0,0.0
9849,Corporate Affairs,1006575,1006575,0,1990_boxofficemojo_rankings.csv,1990,1.0,0.0
9850,The Princess and the Warrior,1004858,872091,132767,2001_boxofficemojo_rankings.csv,2001,0.8678748639111198,0.1321251360888802
9851,Ghost House,1004155,0,1004155,2017_boxofficemojo_rankings.csv,2017,0.0,1.0
9852,Faith of Our Fathers,1004105,1004105,0,2015_boxofficemojo_rankings.csv,2015,1.0,0.0
9853,Kiki's Delivery Service 2019 Re-release,1004057,1004057,0,2019_boxofficemojo_rankings.csv,2019,1.0,0.0
9854,Valentin 2003 Re-release,1002172,275968,726204,2003_boxofficemojo_rankings.csv,2003,0.2753698965846182,0.7246301034153818
9855,Screenplay: Antonia and Jane,1002078,1002078,0,1991_boxofficemojo_rankings.csv,1991,1.0,0.0
9856,Ruby in Paradise,1001437,1001437,0,1993_boxofficemojo_rankings.csv,1993,1.0,0.0
9857,Meeting Venus,1000348,1000348,0,1991_boxofficemojo_rankings.csv,1991,1.0,0.0
9858,The Workshop,1000056,22061,977995,2017_boxofficemojo_rankings.csv,2017,0.022059764653179423,0.9779402353468206
9859,Herbie Goes to Monte Carlo 1981 Re-release,1000000,1000000,0,1981_boxofficemojo_rankings.csv,1981,1.0,0.0
9860,March or Die,1000000,1000000,0,1977_boxofficemojo_rankings.csv,1977,1.0,0.0
9861,Herbie Goes Bananas 1981 Re-release,1000000,1000000,0,1981_boxofficemojo_rankings.csv,1981,1.0,0.0
9862,Pumpkinhead 1989 Re-release,1000000,1000000,0,1989_boxofficemojo_rankings.csv,1989,1.0,0.0
9863,Yella,999588,30647,968941,2007_boxofficemojo_rankings.csv,2007,0.030659631768288533,0.9693403682317114
9864,In the Mood,999382,999382,0,1987_boxofficemojo_rankings.csv,1987,1.0,0.0
9865,Memories of Murder,999157,15357,983800,2003_boxofficemojo_rankings.csv,2003,0.015369956873644482,0.9846300431263555
9866,Gabbar is Back,998582,534601,463981,2015_boxofficemojo_rankings.csv,2015,0.5353601406794835,0.4646398593205165
9867,National Theatre Live: Antony & Cleopatra,998079,83672,914407,2018_boxofficemojo_rankings.csv,2018,0.08383304327613346,0.9161669567238665
9868,The Son,997544,70262,927282,2002_boxofficemojo_rankings.csv,2002,0.07043498833134178,0.9295650116686582
9869,"Polina, danser sa vie",996425,165203,831222,2016_boxofficemojo_rankings.csv,2016,0.16579571969792006,0.8342042803020799
9870,Photograph,996171,344534,651637,2019_boxofficemojo_rankings.csv,2019,0.34585829139776203,0.654141708602238
9871,Burn,996103,996103,0,2012_boxofficemojo_rankings.csv,2012,1.0,0.0
9872,Long Live Freedom 2014 Re-release,995990,48541,947449,2014_boxofficemojo_rankings.csv,2014,0.04873643309671784,0.9512635669032822
9873,Duma,994790,870067,124723,2005_boxofficemojo_rankings.csv,2005,0.8746237899456166,0.12537621005438335
9874,Child's Pose,994126,97170,896956,2013_boxofficemojo_rankings.csv,2013,0.09774414913200137,0.9022558508679986
9875,Labyrinth 2018 Re-release,993336,993336,0,2013_boxofficemojo_rankings.csv,2013,1.0,0.0
9876,Blue Ruin,993313,258384,734929,2014_boxofficemojo_rankings.csv,2014,0.2601234454799243,0.7398765545200757
9877,All Access: Front Row. Backstage. Live!,992683,992683,0,2001_boxofficemojo_rankings.csv,2001,1.0,0.0
9878,Beyond Skyline,992181,0,992181,2017_boxofficemojo_rankings.csv,2017,0.0,1.0
9879,Campus Man,989528,989528,0,1987_boxofficemojo_rankings.csv,1987,1.0,0.0
9880,Million Dollar Mystery,989033,989033,0,1987_boxofficemojo_rankings.csv,1987,1.0,0.0
9881,First Descent,988368,750805,237563,2005_boxofficemojo_rankings.csv,2005,0.7596411458080391,0.2403588541919609
9882,Blackthorn,987883,200558,787325,2011_boxofficemojo_rankings.csv,2011,0.20301796872706585,0.7969820312729341
9883,Twin Falls Idaho,985341,985341,0,1999_boxofficemojo_rankings.csv,1999,1.0,0.0
9884,The 11th Hour,985207,707343,277864,2007_boxofficemojo_rankings.csv,2007,0.717963839071383,0.28203616092861705
9885,The Greatest,985181,114766,870415,2010_boxofficemojo_rankings.csv,2010,0.1164922993845801,0.8835077006154199
9886,American Masters: Miles Davis: Birth of the Cool,984499,614201,370298,2019_boxofficemojo_rankings.csv,2019,0.6238716342017615,0.3761283657982385
9887,Being Flynn,983124,540152,442972,2012_boxofficemojo_rankings.csv,2012,0.5494240807873676,0.4505759192126324
9888,The Duchess of Langeais,982795,282749,700046,2007_boxofficemojo_rankings.csv,2007,0.28769885886680335,0.7123011411331966
9889,The Protector,981817,981817,0,1985_boxofficemojo_rankings.csv,1985,1.0,0.0
9890,Schindler's List 2018 Re-release,981489,833050,148439,2018_boxofficemojo_rankings.csv,2018,0.8487614226955167,0.15123857730448328
9891,Talkin' Dirty After Dark,978775,978775,0,1991_boxofficemojo_rankings.csv,1991,1.0,0.0
9892,Mr. Pip,977855,1714,976141,2013_boxofficemojo_rankings.csv,2013,0.0017528161128183626,0.9982471838871816
9893,Stuck in Love.,977671,81071,896600,2013_boxofficemojo_rankings.csv,2013,0.08292257824973841,0.9170774217502616
9894,Getting It On,975414,975414,0,1983_boxofficemojo_rankings.csv,1983,1.0,0.0
9895,Saraband,975181,645634,329547,2004_boxofficemojo_rankings.csv,2004,0.6620658113724529,0.3379341886275471
9896,Conversations with Other Women,973525,379418,594107,2006_boxofficemojo_rankings.csv,2006,0.3897362676870137,0.6102637323129864
9897,Who Killed Bambi?,973173,14532,958641,2003_boxofficemojo_rankings.csv,2003,0.014932596773646618,0.9850674032263533
9898,35 Shots of Rum,971841,177511,794330,2009_boxofficemojo_rankings.csv,2009,0.18265436424271048,0.8173456357572895
9899,Journey's End,970809,161796,809013,2018_boxofficemojo_rankings.csv,2018,0.166661001288616,0.8333389987113841
9900,An American Rhapsody,970676,850255,120421,2001_boxofficemojo_rankings.csv,2001,0.8759410967202238,0.12405890327977616
9901,Five Corners,969205,969205,0,1988_boxofficemojo_rankings.csv,1988,1.0,0.0
9902,The Irishman,968853,0,968853,2019_boxofficemojo_rankings.csv,2019,0.0,1.0
9903,Trishna,967672,240381,727291,2012_boxofficemojo_rankings.csv,2012,0.24841165188204267,0.7515883481179573
9904,Tyson,964920,887918,77002,2009_boxofficemojo_rankings.csv,2009,0.9201985656842018,0.0798014343157982
9905,Taxi Driver 1996 Re-release,962574,962574,0,1996_boxofficemojo_rankings.csv,1996,1.0,0.0
9906,Ryuichi Sakamoto: Coda,962139,117460,844679,2018_boxofficemojo_rankings.csv,2018,0.12208215237091521,0.8779178476290848
9907,Fanboys,961203,688529,272674,2009_boxofficemojo_rankings.csv,2009,0.716320069745933,0.283679930254067
9908,Separate Lives,961147,961147,0,1995_boxofficemojo_rankings.csv,1995,1.0,0.0
9909,More Than a Game,960387,950675,9712,2009_boxofficemojo_rankings.csv,2009,0.9898874099711887,0.010112590028811302
9910,Getting It Right,960385,960385,0,1989_boxofficemojo_rankings.csv,1989,1.0,0.0
9911,Rush: Cinema Strangiato 2019,960073,960073,0,2019_boxofficemojo_rankings.csv,2019,1.0,0.0
9912,Appointment with Death,960040,960040,0,1988_boxofficemojo_rankings.csv,1988,1.0,0.0
9913,A Prayer Before Dawn,958883,14453,944430,2018_boxofficemojo_rankings.csv,2018,0.015072746101453462,0.9849272538985465
9914,The Nightmare Before Christmas 2009 3D Release,957826,406085,551741,2009_boxofficemojo_rankings.csv,2009,0.42396531311532576,0.5760346868846743
9915,Eight Miles High,957744,2616,955128,2007_boxofficemojo_rankings.csv,2007,0.002731418834260512,0.9972685811657395
9916,The Endless,956425,272020,684405,2018_boxofficemojo_rankings.csv,2018,0.2844133099824869,0.7155866900175132
9917,The Fighting Preacher,954641,954641,0,2019_boxofficemojo_rankings.csv,2019,1.0,0.0
9918,Heart Beat,954046,954046,0,1980_boxofficemojo_rankings.csv,1980,1.0,0.0
9919,The Catcher Was a Spy,953953,725223,228730,2018_boxofficemojo_rankings.csv,2018,0.7602292775430236,0.2397707224569764
9920,The Farewell Party,951531,172860,778671,2015_boxofficemojo_rankings.csv,2015,0.1816651270426292,0.8183348729573708
9921,Anvil: The Story of Anvil,951380,667911,283469,2009_boxofficemojo_rankings.csv,2009,0.7020443986629948,0.2979556013370052
9922,Nelly & Monsieur Arnaud,950237,950237,0,1996_boxofficemojo_rankings.csv,1996,1.0,0.0
9923,Gimme Danger,950040,440627,509413,2016_boxofficemojo_rankings.csv,2016,0.4637983663845733,0.5362016336154267
9924,Come See the Paradise,947306,947306,0,1990_boxofficemojo_rankings.csv,1990,1.0,0.0
9925,Lookin' to Get Out,946461,946461,0,1982_boxofficemojo_rankings.csv,1982,1.0,0.0
9926,Under the Tree,944991,67596,877395,2017_boxofficemojo_rankings.csv,2017,0.07153083997625374,0.9284691600237462
9927,Paprika,944915,882267,62648,2007_boxofficemojo_rankings.csv,2007,0.9336998566008583,0.06630014339914173
9928,The Dinner,944808,7282,937526,2014_boxofficemojo_rankings.csv,2014,0.0077073860509225154,0.9922926139490775
9929,Gray Matters,944479,71561,872918,2007_boxofficemojo_rankings.csv,2007,0.0757676983818592,0.9242323016181409
9930,Rebel in the Rye,944370,378294,566076,2017_boxofficemojo_rankings.csv,2017,0.4005781632199244,0.5994218367800757
9931,Dark Horse 2016 Re-release,944061,940715,3346,2016_boxofficemojo_rankings.csv,2016,0.9964557375000133,0.0035442624999867593
9932,Afterimage,943029,33443,909586,2017_boxofficemojo_rankings.csv,2017,0.03546338447704153,0.9645366155229584
9933,The Tax Collector,942666,942666,0,2020_boxofficemojo_rankings.csv,2020,1.0,0.0
9934,Goodbye Solo,942209,870781,71428,2009_boxofficemojo_rankings.csv,2009,0.9241909173017876,0.07580908269821239
9935,The Road,942041,92476,849565,2011_boxofficemojo_rankings.csv,2011,0.0981655787805414,0.9018344212194586
9936,Heavy,941414,941414,0,1996_boxofficemojo_rankings.csv,1996,1.0,0.0
9937,Landline,940854,940854,0,2017_boxofficemojo_rankings.csv,2017,1.0,0.0
9938,Tokyo Sonata,940430,278356,662074,2008_boxofficemojo_rankings.csv,2008,0.2959880054868518,0.7040119945131482
9939,Watchers,940173,940173,0,1988_boxofficemojo_rankings.csv,1988,1.0,0.0
9940,The Taking of Beverly Hills,939277,939277,0,1991_boxofficemojo_rankings.csv,1991,1.0,0.0
9941,Becoming Astrid,938766,120486,818280,2018_boxofficemojo_rankings.csv,2018,0.12834508280018664,0.8716549171998134
9942,Sweetie,938065,938065,0,1990_boxofficemojo_rankings.csv,1990,1.0,0.0
9943,Revenge,938055,102091,835964,2018_boxofficemojo_rankings.csv,2018,0.10883263774512156,0.8911673622548785
9944,The Vigil,935484,0,935484,2020_boxofficemojo_rankings.csv,2020,0.0,1.0
9945,Kaili Blues,935236,32164,903072,2016_boxofficemojo_rankings.csv,2016,0.034391319410287884,0.9656086805897122
9946,Children of Heaven,933933,933933,0,1999_boxofficemojo_rankings.csv,1999,1.0,0.0
9947,Barely Lethal,933847,6075,927772,2015_boxofficemojo_rankings.csv,2015,0.006505348306521304,0.9934946516934787
9948,Perfect Sense,933352,2959,930393,2011_boxofficemojo_rankings.csv,2011,0.0031702937369824033,0.9968297062630176
9949,The Stolen Children,931280,931280,0,1993_boxofficemojo_rankings.csv,1993,1.0,0.0
9950,A Borrowed Identity,930958,281540,649418,2015_boxofficemojo_rankings.csv,2015,0.30241965802968557,0.6975803419703145
9951,Absolute Beginners,930211,930211,0,1986_boxofficemojo_rankings.csv,1986,1.0,0.0
9952,Simpatico,929606,929606,0,2000_boxofficemojo_rankings.csv,2000,1.0,0.0
9953,The Power,929162,929162,0,1984_boxofficemojo_rankings.csv,1984,1.0,0.0
9954,White Christmas 2018 Re-release,928298,928298,0,2018_boxofficemojo_rankings.csv,2018,1.0,0.0
9955,Santa vs. the Snowman 3D 2006 Re-release,928275,928275,0,2006_boxofficemojo_rankings.csv,2006,1.0,0.0
9956,Like Arrows,928265,817990,110275,2018_boxofficemojo_rankings.csv,2018,0.8812031047168642,0.11879689528313574
9957,Toni Morrison: The Pieces I Am,927495,903018,24477,2019_boxofficemojo_rankings.csv,2019,0.9736095612375268,0.026390438762473115
9958,Aimee & Jaguar,927107,927107,0,2000_boxofficemojo_rankings.csv,2000,1.0,0.0
9959,Female Perversions,926954,926954,0,1997_boxofficemojo_rankings.csv,1997,1.0,0.0
9960,How I Live Now,925762,60213,865549,2013_boxofficemojo_rankings.csv,2013,0.06504155495688957,0.9349584450431104
9961,Patterns of Evidence: Exodus,925576,925576,0,2015_boxofficemojo_rankings.csv,2015,1.0,0.0
9962,The White Balloon,924940,924940,0,1996_boxofficemojo_rankings.csv,1996,1.0,0.0
9963,Khakee,924170,587877,336293,2004_boxofficemojo_rankings.csv,2004,0.6361134856141186,0.3638865143858814
9964,The Yards,924036,889352,34684,2000_boxofficemojo_rankings.csv,2000,0.9624646658788186,0.03753533412118142
9965,Gentleman,923884,897876,26008,2016_boxofficemojo_rankings.csv,2016,0.9718492797797126,0.028150720220287397
9966,Knight Moves,923418,923418,0,1993_boxofficemojo_rankings.csv,1993,1.0,0.0
9967,35 Up,922872,922872,0,1992_boxofficemojo_rankings.csv,1992,1.0,0.0
9968,ATM,921752,3010,918742,2012_boxofficemojo_rankings.csv,2012,0.003265520443676824,0.9967344795563232
9969,Paradise,921242,14873,906369,2017_boxofficemojo_rankings.csv,2017,0.01614450926032465,0.9838554907396754
9970,A Man of No Importance,920916,920916,0,1994_boxofficemojo_rankings.csv,1994,1.0,0.0
9971,Hideaway,920225,34525,885700,2009_boxofficemojo_rankings.csv,2009,0.03751799831562933,0.9624820016843707
9972,Riverdance 25th Anniversary Show,919732,81879,837853,2020_boxofficemojo_rankings.csv,2020,0.08902484636828989,0.9109751536317101
9973,When Night Is Falling,919671,919671,0,1997_boxofficemojo_rankings.csv,1997,1.0,0.0
9974,Palo Alto,919591,767732,151859,2014_boxofficemojo_rankings.csv,2014,0.8348624551566947,0.16513754484330534
9975,Ruby,919286,919286,0,1992_boxofficemojo_rankings.csv,1992,1.0,0.0
9976,Back to 1942,918487,312954,605533,2012_boxofficemojo_rankings.csv,2012,0.3407277402946367,0.6592722597053633
9977,Brain Donors,918239,918239,0,1992_boxofficemojo_rankings.csv,1992,1.0,0.0
9978,Kirk Cameron: Connect,918127,918127,0,2018_boxofficemojo_rankings.csv,2018,1.0,0.0
9979,Faithless,918033,739055,178978,2001_boxofficemojo_rankings.csv,2001,0.8050418666867095,0.19495813331329048
9980,The Lodgers,916727,7362,909365,2018_boxofficemojo_rankings.csv,2018,0.00803074415829358,0.9919692558417064
9981,Gothic,916172,916172,0,1987_boxofficemojo_rankings.csv,1987,1.0,0.0
9982,The Ballad of Jack and Rose,916051,712275,203776,2005_boxofficemojo_rankings.csv,2005,0.7775495032481816,0.2224504967518184
9983,Stuart Saves His Family,912082,912082,0,1995_boxofficemojo_rankings.csv,1995,1.0,0.0
9984,Men with Guns,910773,910773,0,1998_boxofficemojo_rankings.csv,1998,1.0,0.0
9985,Jellyfish,910314,341221,569093,2007_boxofficemojo_rankings.csv,2007,0.374838791889392,0.6251612081106079
9986,Kings,910269,274635,635634,2018_boxofficemojo_rankings.csv,2018,0.3017075172284237,0.6982924827715763
9987,Battle in Seattle,908847,224169,684678,2008_boxofficemojo_rankings.csv,2008,0.2466520767521926,0.7533479232478074
9988,Strike!,907996,907996,0,1998_boxofficemojo_rankings.csv,1998,1.0,0.0
9989,Seymour: An Introduction,907742,743541,164201,2015_boxofficemojo_rankings.csv,2015,0.8191104961541936,0.1808895038458064
9990,Go Go Tales,907456,0,907456,2008_boxofficemojo_rankings.csv,2008,0.0,1.0
9991,Sholem Aleichem: Laughing in the Darkness,906666,906666,0,2011_boxofficemojo_rankings.csv,2011,1.0,0.0
9992,The Dead Lands,906158,5240,900918,2014_boxofficemojo_rankings.csv,2014,0.0057826560048026944,0.9942173439951973
9993,Jerichow,905600,60379,845221,2009_boxofficemojo_rankings.csv,2009,0.06667292402826855,0.9333270759717315
9994,The Dead Girl,905291,19875,885416,2006_boxofficemojo_rankings.csv,2006,0.021954266639124878,0.9780457333608751
9995,Bitter Harvest,904399,557241,347158,2017_boxofficemojo_rankings.csv,2017,0.6161450864054472,0.38385491359455287
9996,Guantanamera,903840,903840,0,1997_boxofficemojo_rankings.csv,1997,1.0,0.0
9997,The Celestine Prophecy,903680,617236,286444,2006_boxofficemojo_rankings.csv,2006,0.6830249645892351,0.3169750354107649
9998,Looking for Comedy in the Muslim World,902312,888975,13337,2006_boxofficemojo_rankings.csv,2006,0.9852190816480331,0.014780918351966947
9999,Rocky III 1983 Re-release,902228,902228,0,1983_boxofficemojo_rankings.csv,1983,1.0,0.0
10000,American Ninja 3: Blood Hunt,902152,902152,0,1989_boxofficemojo_rankings.csv,1989,1.0,0.0
10001,The War Room,901668,901668,0,1993_boxofficemojo_rankings.csv,1993,1.0,0.0
10002,Generation Iron,901649,849521,52128,2013_boxofficemojo_rankings.csv,2013,0.9421859282270595,0.05781407177294047
10003,Julia and Julia,901364,901364,0,1988_boxofficemojo_rankings.csv,1988,1.0,0.0
10004,The Great Buck Howard,900689,750587,150102,2009_boxofficemojo_rankings.csv,2009,0.833347581684688,0.16665241831531194
10005,A Song for Martin,900626,27983,872643,2001_boxofficemojo_rankings.csv,2001,0.031070610886205816,0.9689293891137942
10006,Starting Out in the Evening,898786,898786,0,2007_boxofficemojo_rankings.csv,2007,1.0,0.0
10007,The Wildest Dream,898137,898137,0,2010_boxofficemojo_rankings.csv,2010,1.0,0.0
10008,The Game Changers,897992,739711,158281,2019_boxofficemojo_rankings.csv,2019,0.8237389642669423,0.17626103573305776
10009,The Disappearance of Alice Creed,896919,166980,729939,2010_boxofficemojo_rankings.csv,2010,0.1861706575510163,0.8138293424489836
10010,A Woman's Life,895944,37626,858318,2016_boxofficemojo_rankings.csv,2016,0.04199592831694838,0.9580040716830516
10011,The Glass Menagerie,895904,895904,0,1987_boxofficemojo_rankings.csv,1987,1.0,0.0
10012,Place Vendôme,895788,895788,0,2000_boxofficemojo_rankings.csv,2000,1.0,0.0
10013,You're Not You,894964,11486,883478,2014_boxofficemojo_rankings.csv,2014,0.01283403578244488,0.9871659642175551
10014,Best of Enemies: Buckley vs. Vidal,892802,892802,0,2015_boxofficemojo_rankings.csv,2015,1.0,0.0
10015,Lucky: No Time for Love,891789,453507,438282,2005_boxofficemojo_rankings.csv,2005,0.5085362120411892,0.4914637879588109
10016,Personal Velocity,890502,811299,79203,2002_boxofficemojo_rankings.csv,2002,0.9110580324356374,0.08894196756436257
10017,Believe,890303,890303,0,2016_boxofficemojo_rankings.csv,2016,1.0,0.0
10018,Prisoner of the Mountains,890078,790078,100000,1997_boxofficemojo_rankings.csv,1997,0.8876502958167711,0.11234970418322889
10019,Mafia Inc,889863,889863,0,2020_boxofficemojo_rankings.csv,2020,1.0,0.0
10020,Alone Yet Not Alone,887851,887851,0,2013_boxofficemojo_rankings.csv,2013,1.0,0.0
10021,The Future,887172,568662,318510,2011_boxofficemojo_rankings.csv,2011,0.6409828082942203,0.3590171917057797
10022,La otra conquista,886410,886410,0,2000_boxofficemojo_rankings.csv,2000,1.0,0.0
10023,Revanche,886407,258388,628019,2008_boxofficemojo_rankings.csv,2008,0.29150040556990187,0.7084995944300981
10024,Code 46,886018,285585,600433,2004_boxofficemojo_rankings.csv,2004,0.3223241514280748,0.6776758485719252
10025,The Nightingale,885916,400209,485707,2019_boxofficemojo_rankings.csv,2019,0.4517459894617548,0.5482540105382452
10026,The Claim,885836,669258,216578,2000_boxofficemojo_rankings.csv,2000,0.7555100492641978,0.24448995073580213
10027,Gaz Bar Blues,884664,884664,0,2003_boxofficemojo_rankings.csv,2003,1.0,0.0
10028,Princess Kaiulani,883887,883887,0,2010_boxofficemojo_rankings.csv,2010,1.0,0.0
10029,The Blood of Heroes,882290,882290,0,1990_boxofficemojo_rankings.csv,1990,1.0,0.0
10030,Pandora's Box,881950,881950,0,2002_boxofficemojo_rankings.csv,2002,1.0,0.0
10031,Emma Smith: My Story,881787,881787,0,2008_boxofficemojo_rankings.csv,2008,1.0,0.0
10032,Venom,881779,881779,0,2005_boxofficemojo_rankings.csv,2005,1.0,0.0
10033,Ai Weiwei: Never Sorry,881661,534100,347561,2012_boxofficemojo_rankings.csv,2012,0.6057883925908031,0.394211607409197
10034,No One Knows About Persian Cats,879937,81768,798169,2009_boxofficemojo_rankings.csv,2009,0.09292483439155304,0.9070751656084469
10035,"Fast, Cheap & Out of Control",878960,878960,0,1997_boxofficemojo_rankings.csv,1997,1.0,0.0
10036,The Castle,877621,877621,0,1999_boxofficemojo_rankings.csv,1999,1.0,0.0
10037,The Hummingbird Project,876980,371784,505196,2019_boxofficemojo_rankings.csv,2019,0.423936691828776,0.576063308171224
10038,The Hit,876775,876775,0,1985_boxofficemojo_rankings.csv,1985,1.0,0.0
10039,Between Me and My Mind,875191,875191,0,2019_boxofficemojo_rankings.csv,2019,1.0,0.0
10040,The Polar Express 2017 IMAX Release,875150,875150,0,2017_boxofficemojo_rankings.csv,2017,1.0,0.0
10041,After Dark's Horrorfest 2,874635,874635,0,2007_boxofficemojo_rankings.csv,2007,1.0,0.0
10042,Real Men,873903,873903,0,1987_boxofficemojo_rankings.csv,1987,1.0,0.0
10043,My Favorite Season,873857,873857,0,1996_boxofficemojo_rankings.csv,1996,1.0,0.0
10044,La Cérémonie,873196,873196,0,1996_boxofficemojo_rankings.csv,1996,1.0,0.0
10045,Edge of Seventeen,871759,871759,0,1999_boxofficemojo_rankings.csv,1999,1.0,0.0
10046,Lajja,871706,376000,495706,2001_boxofficemojo_rankings.csv,2001,0.43133808875928353,0.5686619112407165
10047,Parents,870532,870532,0,1989_boxofficemojo_rankings.csv,1989,1.0,0.0
10048,The Winter Guest,870290,870290,0,1997_boxofficemojo_rankings.csv,1997,1.0,0.0
10049,Particle Fever,869838,869838,0,2014_boxofficemojo_rankings.csv,2014,1.0,0.0
10050,Death of a President,869352,519086,350266,2006_boxofficemojo_rankings.csv,2006,0.5970953077694651,0.40290469223053493
10051,Beastmaster 2: Through the Portal of Time,869325,869325,0,1991_boxofficemojo_rankings.csv,1991,1.0,0.0
10052,The Crossing Guard,868979,868979,0,1995_boxofficemojo_rankings.csv,1995,1.0,0.0
10053,Mirrormask,866999,866999,0,2005_boxofficemojo_rankings.csv,2005,1.0,0.0
10054,The Other Side of the Bed 2003 Re-release,866250,113543,752707,2003_boxofficemojo_rankings.csv,2003,0.1310741702741703,0.8689258297258298
10055,Bird People,866211,32111,834100,2014_boxofficemojo_rankings.csv,2014,0.037070644450370636,0.9629293555496293
10056,Songwriter,865915,865915,0,1984_boxofficemojo_rankings.csv,1984,1.0,0.0
10057,Howl's Moving Castle 2019 Re-release,865647,865647,0,2019_boxofficemojo_rankings.csv,2019,1.0,0.0
10058,Great Performances at the Met: Nico Muhly: Marnie,865551,849710,15841,2018_boxofficemojo_rankings.csv,2018,0.981698363239139,0.018301636760861002
10059,The Battle of Algiers 2004 Re-release,865058,822941,42117,2004_boxofficemojo_rankings.csv,2004,0.9513130911453336,0.048686908854666394
10060,Latter Days,865028,834685,30343,2004_boxofficemojo_rankings.csv,2004,0.9649225227391484,0.03507747726085167
10061,Crack House,862551,862551,0,1989_boxofficemojo_rankings.csv,1989,1.0,0.0
10062,The 23rd Tournee of Animation,862309,862309,0,1991_boxofficemojo_rankings.csv,1991,1.0,0.0
10063,Brave,861630,527193,334437,2010_boxofficemojo_rankings.csv,2010,0.6118554367884127,0.38814456321158736
10064,Love,861057,249083,611974,2015_boxofficemojo_rankings.csv,2015,0.2892758551408327,0.7107241448591672
10065,Rendezvous in Paris,859059,859059,0,1996_boxofficemojo_rankings.csv,1996,1.0,0.0
10066,Highway,858783,529136,329647,2014_boxofficemojo_rankings.csv,2014,0.6161463373168775,0.3838536626831225
10067,The Terror Within,858591,858591,0,1989_boxofficemojo_rankings.csv,1989,1.0,0.0
10068,Anna Karenina,858553,858553,0,1997_boxofficemojo_rankings.csv,1997,1.0,0.0
10069,Night Moves,858513,271755,586758,2014_boxofficemojo_rankings.csv,2014,0.3165415083988245,0.6834584916011756
10070,Sarah Landon and the Paranormal Hour,858415,858415,0,2007_boxofficemojo_rankings.csv,2007,1.0,0.0
10071,Wildfire: Feel the Heat 1999 Re-release,858356,858356,0,1999_boxofficemojo_rankings.csv,1999,1.0,0.0
10072,Tough Guys Don't Dance,858250,858250,0,1987_boxofficemojo_rankings.csv,1987,1.0,0.0
10073,Himalaya,857100,132007,725093,2000_boxofficemojo_rankings.csv,2000,0.15401586746003967,0.8459841325399603
10074,Angel Town,855810,855810,0,1990_boxofficemojo_rankings.csv,1990,1.0,0.0
10075,Steel Magnolias 2019 Re-release,855421,855421,0,2019_boxofficemojo_rankings.csv,2019,1.0,0.0
10076,Chain Letter,855185,138788,716397,2010_boxofficemojo_rankings.csv,2010,0.16229003081204652,0.8377099691879535
10077,A Touch of Sin,854891,154120,700771,2013_boxofficemojo_rankings.csv,2013,0.18028029304320667,0.8197197069567933
10078,Happythankyoumoreplease,853862,216110,637752,2011_boxofficemojo_rankings.csv,2011,0.2530971046843635,0.7469028953156365
10079,I'm Going Home,853526,140872,712654,2002_boxofficemojo_rankings.csv,2002,0.1650471104570921,0.8349528895429079
10080,Down in the Valley,852872,568932,283940,2006_boxofficemojo_rankings.csv,2006,0.6670778264499245,0.33292217355007553
10081,Marlene,852676,852676,0,1986_boxofficemojo_rankings.csv,1986,1.0,0.0
10082,Brigham City,852206,852206,0,2001_boxofficemojo_rankings.csv,2001,1.0,0.0
10083,Silent Light,851621,60200,791421,2007_boxofficemojo_rankings.csv,2007,0.07068872186101564,0.9293112781389844
10084,The Sea of Trees,850985,20444,830541,2016_boxofficemojo_rankings.csv,2016,0.02402392521607314,0.9759760747839269
10085,31,850419,779820,70599,2016_boxofficemojo_rankings.csv,2016,0.9169832753031153,0.08301672469688472
10086,The Adventures of Mark Twain,849915,849915,0,1986_boxofficemojo_rankings.csv,1986,1.0,0.0
10087,Wilson,848646,653951,194695,2017_boxofficemojo_rankings.csv,2017,0.7705816088215817,0.22941839117841833
10088,Atlas Shrugged: Who Is John Galt?,846704,846704,0,2014_boxofficemojo_rankings.csv,2014,1.0,0.0
10089,Monty Python's Life of Brian 2004 Re-release,846635,646951,199684,2004_boxofficemojo_rankings.csv,2004,0.7641439345172358,0.2358560654827641
10090,The Polar Express 2015 IMAX Release,846602,846602,0,2015_boxofficemojo_rankings.csv,2015,1.0,0.0
10091,Plastic Planet,846200,3164,843036,2009_boxofficemojo_rankings.csv,2009,0.003739068778066651,0.9962609312219334
10092,Lizzie,844786,642157,202629,2018_boxofficemojo_rankings.csv,2018,0.7601416216651318,0.23985837833486823
10093,Alone with Her,844377,10787,833590,2007_boxofficemojo_rankings.csv,2007,0.012775099274376256,0.9872249007256237
10094,American Masters: Sketches of Frank Gehry,844333,439309,405024,2006_boxofficemojo_rankings.csv,2006,0.5203030084101888,0.4796969915898111
10095,Fugitive Pieces,843945,635783,208162,2008_boxofficemojo_rankings.csv,2008,0.7533464858491963,0.24665351415080367
10096,Heartbeats,843423,68723,774700,2010_boxofficemojo_rankings.csv,2010,0.08148105991892561,0.9185189400810744
10097,Higher Ground 2011 Re-release,843370,841733,1637,2011_boxofficemojo_rankings.csv,2011,0.9980589776729075,0.001941022327092498
10098,Gunday,843232,0,843232,2014_boxofficemojo_rankings.csv,2014,0.0,1.0
10099,One-Trick Pony,843215,843215,0,1980_boxofficemojo_rankings.csv,1980,1.0,0.0
10100,Street Knight,841015,841015,0,1993_boxofficemojo_rankings.csv,1993,1.0,0.0
10101,"Come Back to the 5 & Dime Jimmy Dean, Jimmy Dean",840958,840958,0,1982_boxofficemojo_rankings.csv,1982,1.0,0.0
10102,Illuminata,840134,840134,0,1999_boxofficemojo_rankings.csv,1999,1.0,0.0
10103,Joseph Andrews,839865,839865,0,1977_boxofficemojo_rankings.csv,1977,1.0,0.0
10104,Mary Kom,839840,621300,218540,2014_boxofficemojo_rankings.csv,2014,0.739783768336826,0.2602162316631739
10105,BANDSTAND: The Broadway Musical on Screen,839554,839554,0,2018_boxofficemojo_rankings.csv,2018,1.0,0.0
10106,Children of the Revolution,838368,838368,0,1997_boxofficemojo_rankings.csv,1997,1.0,0.0
10107,Ginger and Fred,837623,837623,0,1986_boxofficemojo_rankings.csv,1986,1.0,0.0
10108,Hôtel Normandy,836709,4640,832069,2013_boxofficemojo_rankings.csv,2013,0.005545536142195196,0.9944544638578048
10109,Fool for Love,836156,836156,0,1985_boxofficemojo_rankings.csv,1985,1.0,0.0
10110,The Miracle,835519,835519,0,1991_boxofficemojo_rankings.csv,1991,1.0,0.0
10111,Khiladi 786,835095,379466,455629,2012_boxofficemojo_rankings.csv,2012,0.4543986013567319,0.5456013986432682
10112,The Exception,834572,708973,125599,2017_boxofficemojo_rankings.csv,2017,0.8495048959227005,0.1504951040772995
10113,Premam,834525,828278,6247,2016_boxofficemojo_rankings.csv,2016,0.9925143045445014,0.007485695455498637
10114,Blind Dating,834457,90560,743897,2007_boxofficemojo_rankings.csv,2007,0.10852566399466959,0.8914743360053304
10115,Children's Party,832150,6330,825820,2011_boxofficemojo_rankings.csv,2011,0.0076068016583548635,0.9923931983416452
10116,The Last Days of Chez Nous,831578,831578,0,1993_boxofficemojo_rankings.csv,1993,1.0,0.0
10117,Blow Dry,830286,637769,192517,2001_boxofficemojo_rankings.csv,2001,0.7681317040152429,0.23186829598475706
10118,Until the End of the World,829625,829625,0,1991_boxofficemojo_rankings.csv,1991,1.0,0.0
10119,Gold Diggers,829140,527000,302140,2004_boxofficemojo_rankings.csv,2004,0.6355983308005886,0.3644016691994114
10120,Byzantium,828284,89237,739047,2013_boxofficemojo_rankings.csv,2013,0.10773720124981287,0.8922627987501871
10121,Detective Byomkesh Bakshy!,827437,579055,248382,2015_boxofficemojo_rankings.csv,2015,0.6998176296201403,0.30018237037985973
10122,Mary,827179,0,827179,2005_boxofficemojo_rankings.csv,2005,0.0,1.0
10123,13 Sins,826913,13809,813104,2014_boxofficemojo_rankings.csv,2014,0.01669945931434141,0.9833005406856586
10124,I.O.U.S.A.,826799,821046,5753,2008_boxofficemojo_rankings.csv,2008,0.9930418396732459,0.006958160326754144
10125,Savage,826631,0,826631,2020_boxofficemojo_rankings.csv,2020,0.0,1.0
10126,The Shape of Things,826617,735992,90625,2003_boxofficemojo_rankings.csv,2003,0.890366397013369,0.10963360298663105
10127,Gekijouban K: Missing Kings,826323,33531,792792,2014_boxofficemojo_rankings.csv,2014,0.04057856310425826,0.9594214368957418
10128,Cut Throat City,825222,816188,9034,2020_boxofficemojo_rankings.csv,2020,0.989052642803997,0.010947357196003015
10129,The Saddest Music in the World,824777,699225,125552,2004_boxofficemojo_rankings.csv,2004,0.8477746105917114,0.15222538940828853
10130,Inside,824414,0,824414,2017_boxofficemojo_rankings.csv,2017,0.0,1.0
10131,Felicia's Journey,824295,824295,0,1999_boxofficemojo_rankings.csv,1999,1.0,0.0
10132,The Thing About My Folks,823337,816403,6934,2005_boxofficemojo_rankings.csv,2005,0.9915781751579243,0.008421824842075602
10133,Boyfriends and Girlfriends,823243,823243,0,1988_boxofficemojo_rankings.csv,1988,1.0,0.0
10134,Que Leones,822828,822828,0,2019_boxofficemojo_rankings.csv,2019,1.0,0.0
10135,Leonera,822504,14739,807765,2008_boxofficemojo_rankings.csv,2008,0.01791966969157597,0.982080330308424
10136,Grbavica: The Land of My Dreams,820170,43460,776710,2006_boxofficemojo_rankings.csv,2006,0.052989014472609335,0.9470109855273907
10137,The Groomsmen,818970,128911,690059,2006_boxofficemojo_rankings.csv,2006,0.15740625419734544,0.8425937458026546
10138,The Lord of the Rings: The Return of the King 2011 Re-release,818580,818580,0,2011_boxofficemojo_rankings.csv,2011,1.0,0.0
10139,Dirty Dancing 1997 Re-release,817925,507892,310033,1997_boxofficemojo_rankings.csv,1997,0.6209517987590549,0.37904820124094507
10140,Life Itself,815645,810454,5191,2014_boxofficemojo_rankings.csv,2014,0.9936357116147343,0.0063642883852656484
10141,Citizens Band,815530,815530,0,1977_boxofficemojo_rankings.csv,1977,1.0,0.0
10142,Saw 10th Anniversary Release,815324,815324,0,2014_boxofficemojo_rankings.csv,2014,1.0,0.0
10143,What If...,814906,814906,0,2010_boxofficemojo_rankings.csv,2010,1.0,0.0
10144,Tangerine,814868,702354,112514,2015_boxofficemojo_rankings.csv,2015,0.861923648983639,0.13807635101636093
10145,Charly,814666,814666,0,2002_boxofficemojo_rankings.csv,2002,1.0,0.0
10146,Age of Uprising: The Legend of Michael Kohlhaas,813550,3313,810237,2013_boxofficemojo_rankings.csv,2013,0.004072275828160531,0.9959277241718395
10147,The Heiresses,811196,78473,732723,2018_boxofficemojo_rankings.csv,2018,0.09673740994778081,0.9032625900522192
10148,Army of Shadows,810532,741766,68766,2006_boxofficemojo_rankings.csv,2006,0.9151594261546737,0.08484057384532628
10149,"Faraway, So Close!",810455,810455,0,1993_boxofficemojo_rankings.csv,1993,1.0,0.0
10150,Bangistan,810419,48694,761725,2015_boxofficemojo_rankings.csv,2015,0.06008496839289306,0.939915031607107
10151,Xi yang tian shi,810243,76584,733659,2002_boxofficemojo_rankings.csv,2002,0.094519792210485,0.905480207789515
10152,Bill W.,809590,809590,0,2012_boxofficemojo_rankings.csv,2012,1.0,0.0
10153,Joni 75: A Birthday Celebration,808831,752205,56626,2019_boxofficemojo_rankings.csv,2019,0.9299903193621412,0.07000968063785884
10154,The Whistlers,808743,55608,753135,2019_boxofficemojo_rankings.csv,2019,0.06875855494267029,0.9312414450573298
10155,Waiting for the Light,808690,808690,0,1990_boxofficemojo_rankings.csv,1990,1.0,0.0
10156,Waxwork,808114,808114,0,1988_boxofficemojo_rankings.csv,1988,1.0,0.0
10157,Bulletproof,807947,807947,0,1988_boxofficemojo_rankings.csv,1988,1.0,0.0
10158,Wild Reeds,807775,807775,0,1995_boxofficemojo_rankings.csv,1995,1.0,0.0
10159,Breathing,807436,4630,802806,2011_boxofficemojo_rankings.csv,2011,0.005734200605373057,0.9942657993946269
10160,Behind the Sun,805755,19861,785894,2001_boxofficemojo_rankings.csv,2001,0.02464893174724327,0.9753510682527567
10161,V/H/S/2,805574,21833,783741,2013_boxofficemojo_rankings.csv,2013,0.027102413930936202,0.9728975860690638
10162,C'est la vie,805472,805472,0,1990_boxofficemojo_rankings.csv,1990,1.0,0.0
10163,My Year Without Sex,805283,3119,802164,2009_boxofficemojo_rankings.csv,2009,0.0038731725368597127,0.9961268274631403
10164,American Playhouse: The Ballad of Gregorio Cortez,804963,804963,0,1983_boxofficemojo_rankings.csv,1983,1.0,0.0
10165,"Those Lips, Those Eyes",804713,804713,0,1980_boxofficemojo_rankings.csv,1980,1.0,0.0
10166,About Adam,802951,159668,643283,2001_boxofficemojo_rankings.csv,2001,0.19885148657888216,0.8011485134211178
10167,Mean Creek,802948,603951,198997,2004_boxofficemojo_rankings.csv,2004,0.7521670145513781,0.24783298544862184
10168,The Tillman Story,802535,802535,0,2010_boxofficemojo_rankings.csv,2010,1.0,0.0
10169,After Life,801985,801985,0,1999_boxofficemojo_rankings.csv,1999,1.0,0.0
10170,Last Summer in the Hamptons,801984,801984,0,1995_boxofficemojo_rankings.csv,1995,1.0,0.0
10171,The Wrecking Crew!,801606,801606,0,2015_boxofficemojo_rankings.csv,2015,1.0,0.0
10172,My Mother Likes Women 2004 Re-release,801048,82916,718132,2004_boxofficemojo_rankings.csv,2004,0.10350940268248594,0.896490597317514
10173,The Barbarians,800000,800000,0,1987_boxofficemojo_rankings.csv,1987,1.0,0.0
10174,Visions of Light,799856,799856,0,1993_boxofficemojo_rankings.csv,1993,1.0,0.0
10175,Chunhyang,798977,798977,0,2000_boxofficemojo_rankings.csv,2000,1.0,0.0
10176,Red Army,798680,694600,104080,2015_boxofficemojo_rankings.csv,2015,0.8696849802173586,0.13031501978264134
10177,Wakefield,798214,262599,535615,2017_boxofficemojo_rankings.csv,2017,0.32898320500517403,0.6710167949948259
10178,Kiss or Kill,796681,796681,0,1997_boxofficemojo_rankings.csv,1997,1.0,0.0
10179,Rampage,796368,796368,0,1992_boxofficemojo_rankings.csv,1992,1.0,0.0
10180,13 Tzameti,795223,121390,673833,2006_boxofficemojo_rankings.csv,2006,0.15264900537333553,0.8473509946266645
10181,Twin Sisters 2004 Re-release,794365,1563,792802,2004_boxofficemojo_rankings.csv,2004,0.001967609348347422,0.9980323906516526
10182,Little Monsters,793775,793775,0,1989_boxofficemojo_rankings.csv,1989,1.0,0.0
10183,Babyteeth,793453,4507,788946,2020_boxofficemojo_rankings.csv,2020,0.005680235628323291,0.9943197643716767
10184,Vita & Virginia,793439,42741,750698,2019_boxofficemojo_rankings.csv,2019,0.05386803522387985,0.9461319647761202
10185,The Toxic Avenger Part II,792966,792966,0,1989_boxofficemojo_rankings.csv,1989,1.0,0.0
10186,Santa vs. the Snowman 3D 2007 Re-release,792252,769405,22847,2007_boxofficemojo_rankings.csv,2007,0.9711619535198397,0.02883804648016035
10187,Tickled,790519,613956,176563,2016_boxofficemojo_rankings.csv,2016,0.7766492645970559,0.22335073540294414
10188,Thin Ice,790421,790421,0,2012_boxofficemojo_rankings.csv,2012,1.0,0.0
10189,The King of Kong: A Fistful of Quarters,790128,677914,112214,2007_boxofficemojo_rankings.csv,2007,0.857979972865156,0.14202002713484396
10190,Beyond Therapy,790000,790000,0,1987_boxofficemojo_rankings.csv,1987,1.0,0.0
10191,Lootera,789671,581813,207858,2013_boxofficemojo_rankings.csv,2013,0.7367789877050063,0.26322101229499373
10192,Momentum,789406,0,789406,2015_boxofficemojo_rankings.csv,2015,0.0,1.0
10193,Cabeza de Vaca,789127,789127,0,1992_boxofficemojo_rankings.csv,1992,1.0,0.0
10194,Trembling Before G-d,788896,788896,0,2001_boxofficemojo_rankings.csv,2001,1.0,0.0
10195,Chonda Pierce: Unashamed,787979,787979,0,2019_boxofficemojo_rankings.csv,2019,1.0,0.0
10196,Poison,787280,787280,0,1991_boxofficemojo_rankings.csv,1991,1.0,0.0
10197,Elf 2019 Re-release,786249,786249,0,2019_boxofficemojo_rankings.csv,2019,1.0,0.0
10198,The Ten,785528,769726,15802,2007_boxofficemojo_rankings.csv,2007,0.9798835942194295,0.020116405780570522
10199,Firelight,785482,785482,0,1998_boxofficemojo_rankings.csv,1998,1.0,0.0
10200,George Takei's Allegiance,784850,784850,0,2017_boxofficemojo_rankings.csv,2017,1.0,0.0
10201,City on Fire,784181,784181,0,1979_boxofficemojo_rankings.csv,1979,1.0,0.0
10202,Life During Wartime,783232,281447,501785,2010_boxofficemojo_rankings.csv,2010,0.3593405274554666,0.6406594725445334
10203,Box of Moonlight,782641,782641,0,1997_boxofficemojo_rankings.csv,1997,1.0,0.0
10204,Party Monster,782606,742898,39708,2003_boxofficemojo_rankings.csv,2003,0.9492618252351758,0.05073817476482419
10205,Redacted,782102,65388,716714,2007_boxofficemojo_rankings.csv,2007,0.08360546322602423,0.9163945367739758
10206,Nutcracker,781727,781727,0,1986_boxofficemojo_rankings.csv,1986,1.0,0.0
10207,The Paris Opera,781039,55482,725557,2017_boxofficemojo_rankings.csv,2017,0.07103614544216102,0.928963854557839
10208,The Wonder of It All,781016,781016,0,2009_boxofficemojo_rankings.csv,2009,1.0,0.0
10209,Futuro Beach,779835,20262,759573,2014_boxofficemojo_rankings.csv,2014,0.025982419357941103,0.9740175806420589
10210,Blonde and Blonder,779273,42183,737090,2008_boxofficemojo_rankings.csv,2008,0.054131222305918464,0.9458687776940815
10211,Panic,779137,779137,0,2000_boxofficemojo_rankings.csv,2000,1.0,0.0
10212,Foolproof,779036,458990,320046,2003_boxofficemojo_rankings.csv,2003,0.5891768801441782,0.4108231198558218
10213,Turtle Beach,778535,778535,0,1992_boxofficemojo_rankings.csv,1992,1.0,0.0
10214,Mrs. Hyde,778142,18627,759515,2018_boxofficemojo_rankings.csv,2018,0.023937790274782753,0.9760622097252173
10215,Laura Cadieux... la suite,777477,777477,0,1999_boxofficemojo_rankings.csv,1999,1.0,0.0
10216,Without Limits,777423,777423,0,1998_boxofficemojo_rankings.csv,1998,1.0,0.0
10217,Lonely Hearts,777087,777087,0,1983_boxofficemojo_rankings.csv,1983,1.0,0.0
10218,Listen Up: The Lives of Quincy Jones,776699,776699,0,1990_boxofficemojo_rankings.csv,1990,1.0,0.0
10219,Enter the Void,775385,336467,438918,2010_boxofficemojo_rankings.csv,2010,0.43393539983363105,0.566064600166369
10220,Ordinary Love,774877,323688,451189,2019_boxofficemojo_rankings.csv,2019,0.41772823299697887,0.5822717670030211
10221,The D Train,774780,673151,101629,2015_boxofficemojo_rankings.csv,2015,0.8688285706910349,0.13117142930896514
10222,New Waterford Girl,774469,774469,0,2000_boxofficemojo_rankings.csv,2000,1.0,0.0
10223,Mindwalk,774048,774048,0,1991_boxofficemojo_rankings.csv,1991,1.0,0.0
10224,Morvern Callar,772336,267907,504429,2002_boxofficemojo_rankings.csv,2002,0.34687881958111494,0.653121180418885
10225,The Church,772000,772000,0,2019_boxofficemojo_rankings.csv,2019,1.0,0.0
10226,The Girl Next Door,771792,771792,0,2000_boxofficemojo_rankings.csv,2000,1.0,0.0
10227,Grand Masti,770535,413903,356632,2013_boxofficemojo_rankings.csv,2013,0.5371631398963058,0.4628368601036942
10228,For All Mankind,770132,770132,0,1989_boxofficemojo_rankings.csv,1989,1.0,0.0
10229,The Accompanist,769983,769983,0,1993_boxofficemojo_rankings.csv,1993,1.0,0.0
10230,Pariah,769552,769552,0,2011_boxofficemojo_rankings.csv,2011,1.0,0.0
10231,Passion of Mind,769272,769272,0,2000_boxofficemojo_rankings.csv,2000,1.0,0.0
10232,The Lord of the Rings: The Fellowship of the Ring 2011 Re-release,768580,768580,0,2011_boxofficemojo_rankings.csv,2011,1.0,0.0
10233,Theeb,768449,283024,485425,2015_boxofficemojo_rankings.csv,2015,0.3683055088886836,0.6316944911113165
10234,22nd Annual International Tournée of Animation,768304,768304,0,1990_boxofficemojo_rankings.csv,1990,1.0,0.0
10235,Little Ashes,767567,481586,285981,2009_boxofficemojo_rankings.csv,2009,0.6274188442181594,0.37258115578184053
10236,Yalom's Cure,766974,1164,765810,2014_boxofficemojo_rankings.csv,2014,0.0015176524888718523,0.9984823475111282
10237,A Small Circle of Friends,766760,766760,0,1980_boxofficemojo_rankings.csv,1980,1.0,0.0
10238,The Sum of Us,766464,766464,0,1995_boxofficemojo_rankings.csv,1995,1.0,0.0
10239,Lo and Behold: Reveries of the Connected World,765796,594912,170884,2016_boxofficemojo_rankings.csv,2016,0.7768544103129293,0.2231455896870707
10240,Fat Girl,765705,725854,39851,2001_boxofficemojo_rankings.csv,2001,0.9479551524412143,0.052044847558785697
10241,DanTDM Presents The Contest,765363,307484,457879,2019_boxofficemojo_rankings.csv,2019,0.4017492353301636,0.5982507646698364
10242,Patterns of Evidence: Moses Controversy,765361,765361,0,2019_boxofficemojo_rankings.csv,2019,1.0,0.0
10243,The Polar Express 2016 IMAX Release,765154,765154,0,2016_boxofficemojo_rankings.csv,2016,1.0,0.0
10244,Strapless,764794,764794,0,1990_boxofficemojo_rankings.csv,1990,1.0,0.0
10245,"Bodies, Rest & Motion",764724,764724,0,1993_boxofficemojo_rankings.csv,1993,1.0,0.0
10246,The Lord of the Rings: The Two Towers 2011 Re-release,764607,764607,0,2011_boxofficemojo_rankings.csv,2011,1.0,0.0
10247,Kahlil Gibran's The Prophet,764498,355343,409155,2015_boxofficemojo_rankings.csv,2015,0.4648056633241683,0.5351943366758317
10248,The Invisibles,764250,407373,356877,2018_boxofficemojo_rankings.csv,2018,0.5330363101079489,0.466963689892051
10249,Before the Rain,763847,763847,0,1995_boxofficemojo_rankings.csv,1995,1.0,0.0
10250,Chronicle of an Escape,763742,2370,761372,2006_boxofficemojo_rankings.csv,2006,0.0031031421605725493,0.9968968578394275
10251,Texas Rangers,763740,623374,140366,2001_boxofficemojo_rankings.csv,2001,0.8162123235656114,0.18378767643438867
10252,Pick of the Litter,763688,578717,184971,2018_boxofficemojo_rankings.csv,2018,0.7577924492724778,0.24220755072752223
10253,Museo,762284,148505,613779,2018_boxofficemojo_rankings.csv,2018,0.19481584291418946,0.8051841570858106
10254,Fire and Ice,760883,760883,0,1983_boxofficemojo_rankings.csv,1983,1.0,0.0
10255,Broken Wings,760318,421454,338864,2003_boxofficemojo_rankings.csv,2003,0.5543128006965506,0.44568719930344936
10256,The Shining 2017 Re-release,760309,421572,338737,2017_boxofficemojo_rankings.csv,2017,0.5544745623161109,0.445525437683889
10257,The Hanoi Hilton,760000,760000,0,1987_boxofficemojo_rankings.csv,1987,1.0,0.0
10258,Rocket Science,759676,714943,44733,2007_boxofficemojo_rankings.csv,2007,0.9411156861609423,0.058884313839057706
10259,Double Happiness,759393,759393,0,1995_boxofficemojo_rankings.csv,1995,1.0,0.0
10260,Bombay Velvet,758478,450692,307786,2015_boxofficemojo_rankings.csv,2015,0.59420576470247,0.40579423529753006
10261,Jaws 2020 Re-release,758367,758300,67,2020_boxofficemojo_rankings.csv,2020,0.999911652273899,8.834772610095112e-05
10262,Shortcut,758223,758223,0,2020_boxofficemojo_rankings.csv,2020,1.0,0.0
10263,Amateur,757088,757088,0,1995_boxofficemojo_rankings.csv,1995,1.0,0.0
10264,Uzak,757008,96293,660715,2003_boxofficemojo_rankings.csv,2003,0.12720209033458035,0.8727979096654197
10265,Boundaries,755977,703438,52539,2018_boxofficemojo_rankings.csv,2018,0.9305018538923803,0.06949814610761967
10266,Love Potion No. 9,754935,754935,0,1992_boxofficemojo_rankings.csv,1992,1.0,0.0
10267,I Love Lucy: A Colorized Celebration,754323,754323,0,2019_boxofficemojo_rankings.csv,2019,1.0,0.0
10268,Middle Men,754301,754301,0,2010_boxofficemojo_rankings.csv,2010,1.0,0.0
10269,How About You,754184,78234,675950,2007_boxofficemojo_rankings.csv,2007,0.10373330646102277,0.8962666935389773
10270,Body Shots,752122,752122,0,1999_boxofficemojo_rankings.csv,1999,1.0,0.0
10271,Nights of Cabiria 1998 Re-release,752045,752045,0,1998_boxofficemojo_rankings.csv,1998,1.0,0.0
10272,Professione: reporter 2005 Re-release,751607,620155,131452,2005_boxofficemojo_rankings.csv,2005,0.825105407480239,0.174894592519761
10273,American Playhouse: Waiting for the Moon,751555,751555,0,1987_boxofficemojo_rankings.csv,1987,1.0,0.0
10274,Tommy's Honour,751345,569306,182039,2017_boxofficemojo_rankings.csv,2017,0.7577158296122287,0.24228417038777125
10275,Little Secrets,750582,405792,344790,2002_boxofficemojo_rankings.csv,2002,0.5406364661023046,0.4593635338976954
10276,Defense of the Realm,750000,750000,0,1986_boxofficemojo_rankings.csv,1986,1.0,0.0
10277,Trees Lounge,749741,749741,0,1996_boxofficemojo_rankings.csv,1996,1.0,0.0
10278,A Five Star Life 2014 Re-release,749653,306917,442736,2014_boxofficemojo_rankings.csv,2014,0.4094120879927113,0.5905879120072887
10279,Cronicas,749607,300322,449285,2005_boxofficemojo_rankings.csv,2005,0.40063926830992774,0.5993607316900723
10280,Everybody's Everything,748539,547207,201332,2019_boxofficemojo_rankings.csv,2019,0.731033386369982,0.26896661363001795
10281,Hobo with a Shotgun,748453,703372,45081,2011_boxofficemojo_rankings.csv,2011,0.9397677609682906,0.060232239031709406
10282,Arthur Newman,747140,207853,539287,2013_boxofficemojo_rankings.csv,2013,0.27819819578659954,0.7218018042134005
10283,The Girl in a Swing,747013,747013,0,1989_boxofficemojo_rankings.csv,1989,1.0,0.0
10284,Another Gay Movie,745327,654132,91195,2006_boxofficemojo_rankings.csv,2006,0.8776443091421617,0.12235569085783823
10285,Holy Rollers,744266,303064,441202,2010_boxofficemojo_rankings.csv,2010,0.40719850161098314,0.5928014983890169
10286,C.S.A.: The Confederate States of America,744165,672156,72009,2005_boxofficemojo_rankings.csv,2005,0.9032351696196408,0.0967648303803592
10287,Saturday's Warrior,744046,744046,0,2016_boxofficemojo_rankings.csv,2016,1.0,0.0
10288,"Sister, Sister",743445,743445,0,1988_boxofficemojo_rankings.csv,1988,1.0,0.0
10289,Fade to Black,742076,728921,13155,2004_boxofficemojo_rankings.csv,2004,0.9822727052215676,0.0177272947784324
10290,The Cross,741557,741557,0,2009_boxofficemojo_rankings.csv,2009,1.0,0.0
10291,The Story of Boys & Girls,741221,741221,0,1991_boxofficemojo_rankings.csv,1991,1.0,0.0
10292,The King,740210,282183,458027,2006_boxofficemojo_rankings.csv,2006,0.3812201942691939,0.6187798057308062
10293,Les Misérables,740048,740048,0,1995_boxofficemojo_rankings.csv,1995,1.0,0.0
10294,Scarface 2003 Re-release,739905,739905,0,2003_boxofficemojo_rankings.csv,2003,1.0,0.0
10295,"Kumiko, The Treasure Hunter",739623,623383,116240,2015_boxofficemojo_rankings.csv,2015,0.8428388516852504,0.15716114831474953
10296,Forks Over Knives,739561,739561,0,2011_boxofficemojo_rankings.csv,2011,1.0,0.0
10297,Rosencrantz & Guildenstern Are Dead,739104,739104,0,1991_boxofficemojo_rankings.csv,1991,1.0,0.0
10298,Vicky Donor,739085,549001,190084,2012_boxofficemojo_rankings.csv,2012,0.7428117198968995,0.25718828010310046
10299,Mother's Boys,737548,737548,0,1994_boxofficemojo_rankings.csv,1994,1.0,0.0
10300,Kadosh,736812,736812,0,2000_boxofficemojo_rankings.csv,2000,1.0,0.0
10301,Ramen Shop,735008,88455,646553,2018_boxofficemojo_rankings.csv,2018,0.12034562889111411,0.8796543711088859
10302,Wiener-Dog,734729,477453,257276,2016_boxofficemojo_rankings.csv,2016,0.6498355175853955,0.35016448241460457
10303,Drop Squad,734693,734693,0,1994_boxofficemojo_rankings.csv,1994,1.0,0.0
10304,David Crosby: Remember My Name,732793,732793,0,2019_boxofficemojo_rankings.csv,2019,1.0,0.0
10305,Once I Was a Beehive,732655,732655,0,2015_boxofficemojo_rankings.csv,2015,1.0,0.0
10306,Tabloid,731925,696921,35004,2011_boxofficemojo_rankings.csv,2011,0.9521754278102265,0.04782457218977354
10307,The Polar Express 2018 Re-release,731018,731018,0,2018_boxofficemojo_rankings.csv,2018,1.0,0.0
10308,Slaughterhouse Rulez,730762,4665,726097,2018_boxofficemojo_rankings.csv,2018,0.006383747376026668,0.9936162526239734
10309,How I Ended This Summer,730412,8733,721679,2010_boxofficemojo_rankings.csv,2010,0.011956265778765957,0.988043734221234
10310,The British Invasion Returns,729102,729102,0,1991_boxofficemojo_rankings.csv,1991,1.0,0.0
10311,Lust in the Dust,727639,727639,0,1985_boxofficemojo_rankings.csv,1985,1.0,0.0
10312,Land Ho!,727594,727594,0,2014_boxofficemojo_rankings.csv,2014,1.0,0.0
10313,Peggy Guggenheim: Art Addict,727591,498428,229163,2015_boxofficemojo_rankings.csv,2015,0.6850387099345648,0.3149612900654351
10314,Deep Water,727202,271143,456059,2006_boxofficemojo_rankings.csv,2006,0.372857885429358,0.627142114570642
10315,Liz and the Blue Bird,726454,63204,663250,2018_boxofficemojo_rankings.csv,2018,0.08700344412722623,0.9129965558727737
10316,Motherhood,726354,93388,632966,2009_boxofficemojo_rankings.csv,2009,0.128570917211167,0.871429082788833
10317,Bullett Raja,725588,0,725588,2013_boxofficemojo_rankings.csv,2013,0.0,1.0
10318,May It Last,725286,725286,0,2017_boxofficemojo_rankings.csv,2017,1.0,0.0
10319,Vampire's Kiss,725131,725131,0,1989_boxofficemojo_rankings.csv,1989,1.0,0.0
10320,A Tale of Love and Darkness,724885,572212,152673,2015_boxofficemojo_rankings.csv,2015,0.7893831435331121,0.21061685646688785
10321,Levity,723040,209695,513345,2003_boxofficemojo_rankings.csv,2003,0.2900185328612525,0.7099814671387475
10322,The Act of Killing,722714,486919,235795,2013_boxofficemojo_rankings.csv,2013,0.6737367755432992,0.3262632244567007
10323,Where's My Roy Cohn?,722603,705274,17329,2019_boxofficemojo_rankings.csv,2019,0.9760186437089245,0.023981356291075458
10324,Singham,722451,350864,371587,2011_boxofficemojo_rankings.csv,2011,0.4856578508438635,0.5143421491561365
10325,12 Days,722049,5204,716845,2017_boxofficemojo_rankings.csv,2017,0.007207267096831379,0.9927927329031686
10326,Time,721712,16070,705642,2006_boxofficemojo_rankings.csv,2006,0.022266499656372625,0.9777335003436274
10327,Effie Gray,721143,352534,368609,2014_boxofficemojo_rankings.csv,2014,0.4888544990383322,0.5111455009616678
10328,The Big One,720074,720074,0,1998_boxofficemojo_rankings.csv,1998,1.0,0.0
10329,Joshua,719968,482355,237613,2007_boxofficemojo_rankings.csv,2007,0.6699672763233921,0.33003272367660785
10330,Forever Strong,719556,719556,0,2008_boxofficemojo_rankings.csv,2008,1.0,0.0
10331,Chuck Berry Hail! Hail! Rock 'n' Roll,719323,719323,0,1987_boxofficemojo_rankings.csv,1987,1.0,0.0
10332,Revive Us 2,718607,718607,0,2017_boxofficemojo_rankings.csv,2017,1.0,0.0
10333,Kicking and Screaming,718490,718490,0,1995_boxofficemojo_rankings.csv,1995,1.0,0.0
10334,Thousand Pieces of Gold,717772,717772,0,1991_boxofficemojo_rankings.csv,1991,1.0,0.0
10335,2001: A Space Odyssey 2014 Re-release,717744,214618,503126,2014_boxofficemojo_rankings.csv,2014,0.299017476983437,0.700982523016563
10336,And God Created Woman,717376,717376,0,1988_boxofficemojo_rankings.csv,1988,1.0,0.0
10337,Garage Days,716888,32500,684388,2002_boxofficemojo_rankings.csv,2002,0.045334836125029296,0.9546651638749707
10338,Free Style,716355,141108,575247,2008_boxofficemojo_rankings.csv,2008,0.19698054735431456,0.8030194526456854
10339,Coupe de Ville,715983,715983,0,1990_boxofficemojo_rankings.csv,1990,1.0,0.0
10340,The Shining 2012 Re-release,715736,342749,372987,2012_boxofficemojo_rankings.csv,2012,0.4788762895816335,0.5211237104183666
10341,Passion,713616,92181,621435,2013_boxofficemojo_rankings.csv,2013,0.12917451402434924,0.8708254859756508
10342,Strangeland,713239,713239,0,1998_boxofficemojo_rankings.csv,1998,1.0,0.0
10343,Holy Matrimony,713234,713234,0,1994_boxofficemojo_rankings.csv,1994,1.0,0.0
10344,Gerhard Richter Painting,713188,242646,470542,2011_boxofficemojo_rankings.csv,2011,0.34022726125509684,0.6597727387449032
10345,Shanghai Ghetto,712446,712446,0,2002_boxofficemojo_rankings.csv,2002,1.0,0.0
10346,Household Saints,712418,712418,0,1993_boxofficemojo_rankings.csv,1993,1.0,0.0
10347,The Van,712095,712095,0,1997_boxofficemojo_rankings.csv,1997,1.0,0.0
10348,Shootout at Wadala,711366,369573,341793,2013_boxofficemojo_rankings.csv,2013,0.5195258137161461,0.48047418628385385
10349,The Polar Express 2011 IMAX Release,711168,711168,0,2011_boxofficemojo_rankings.csv,2011,1.0,0.0
10350,Extraction,710636,16775,693861,2015_boxofficemojo_rankings.csv,2015,0.023605615251690037,0.97639438474831
10351,Inside Deep Throat,709832,691880,17952,2005_boxofficemojo_rankings.csv,2005,0.974709508728826,0.025290491271174026
10352,Kaal,709777,345091,364686,2005_boxofficemojo_rankings.csv,2005,0.4861963687186257,0.5138036312813743
10353,Muscle Shoals,709415,696241,13174,2013_boxofficemojo_rankings.csv,2013,0.9814297695988948,0.018570230401105135
10354,Paris Countdown,708757,1055,707702,2013_boxofficemojo_rankings.csv,2013,0.001488521453756365,0.9985114785462437
10355,Gori Tere Pyaar Mein!,708440,342184,366256,2013_boxofficemojo_rankings.csv,2013,0.48301055841002766,0.5169894415899723
10356,$9.99,708354,52384,655970,2008_boxofficemojo_rankings.csv,2008,0.07395172470262044,0.9260482752973795
10357,Head On,708334,379384,328950,1999_boxofficemojo_rankings.csv,1999,0.5356004370819416,0.46439956291805845
10358,HBO Boxing: Canelo Alvarez vs. Gennady Golovkin II,707875,707875,0,2018_boxofficemojo_rankings.csv,2018,1.0,0.0
10359,Passione,707460,255355,452105,2010_boxofficemojo_rankings.csv,2010,0.3609462019054081,0.639053798094592
10360,Palindromes,707269,553368,153901,2005_boxofficemojo_rankings.csv,2005,0.7824010383602279,0.21759896163977213
10361,Bread and Roses,706876,533479,173397,2001_boxofficemojo_rankings.csv,2001,0.7546995512650027,0.24530044873499737
10362,Contempt,706604,706604,0,1997_boxofficemojo_rankings.csv,1997,1.0,0.0
10363,The Lost Medallion: The Adventures of Billy Stone,705854,549632,156222,2013_boxofficemojo_rankings.csv,2013,0.7786766101771755,0.22132338982282454
10364,Itzhak,704968,607290,97678,2018_boxofficemojo_rankings.csv,2018,0.8614433562941864,0.1385566437058136
10365,Blaze,704955,704955,0,2018_boxofficemojo_rankings.csv,2018,1.0,0.0
10366,Bully,704808,480811,223997,2001_boxofficemojo_rankings.csv,2001,0.6821872055935801,0.3178127944064199
10367,The Shining 2019 Re-release,704716,551257,153459,2019_boxofficemojo_rankings.csv,2019,0.7822399377905426,0.21776006220945743
10368,Crossing the Bridge: The Sound of Istanbul,704094,70685,633409,2005_boxofficemojo_rankings.csv,2005,0.1003914250085926,0.8996085749914075
10369,Countdown to Canelo vs. Golovkin,703396,703396,0,2017_boxofficemojo_rankings.csv,2017,1.0,0.0
10370,Outsourced,703324,163561,539763,2007_boxofficemojo_rankings.csv,2007,0.23255427086236216,0.7674457291376379
10371,Buena Vista Social Club: Adios,701575,123445,578130,2017_boxofficemojo_rankings.csv,2017,0.1759541032676478,0.8240458967323522
10372,Le Quattro Volte,701334,152530,548804,2010_boxofficemojo_rankings.csv,2010,0.21748553470956777,0.7825144652904322
10373,56 Up,701278,701278,0,2013_boxofficemojo_rankings.csv,2013,1.0,0.0
10374,Our Children,700215,23203,677012,2012_boxofficemojo_rankings.csv,2012,0.033136965075012674,0.9668630349249874
10375,Siesta,700000,700000,0,1987_boxofficemojo_rankings.csv,1987,1.0,0.0
10376,The Greatest Movie Ever Sold,698249,638476,59773,2011_boxofficemojo_rankings.csv,2011,0.914395867376824,0.08560413262317597
10377,49 Up,696975,241772,455203,2006_boxofficemojo_rankings.csv,2006,0.3468876215072277,0.6531123784927724
10378,Look What's Happened Now,696718,336909,359809,2004_boxofficemojo_rankings.csv,2004,0.48356580424217543,0.5164341957578246
10379,Patterns of Evidence: The Red Sea Miracle,696191,696191,0,2020_boxofficemojo_rankings.csv,2020,1.0,0.0
10380,Frankie & Alice 2014 Re-release,695876,695876,0,2014_boxofficemojo_rankings.csv,2014,1.0,0.0
10381,Deewane Huye Paagal,695849,364357,331492,2005_boxofficemojo_rankings.csv,2005,0.5236150371704206,0.47638496282957943
10382,Split Decisions,695822,695822,0,1988_boxofficemojo_rankings.csv,1988,1.0,0.0
10383,Frankie,695680,171781,523899,2019_boxofficemojo_rankings.csv,2019,0.24692531048758048,0.7530746895124195
10384,The Least of These: The Graham Staines Story,695164,607015,88149,2019_boxofficemojo_rankings.csv,2019,0.8731968283743117,0.12680317162568833
10385,The Congress 2013 Re-release,695131,137815,557316,2013_boxofficemojo_rankings.csv,2013,0.19825759461166312,0.8017424053883369
10386,Jim Henson's Holiday Special with Fraggle Rock and Emmet Otter,695130,695130,0,2018_boxofficemojo_rankings.csv,2018,1.0,0.0
10387,The Secret Scripture,694981,0,694981,2017_boxofficemojo_rankings.csv,2017,0.0,1.0
10388,Delgo,694782,694782,0,2008_boxofficemojo_rankings.csv,2008,1.0,0.0
10389,In the Aisles,694586,28394,666192,2018_boxofficemojo_rankings.csv,2018,0.04087902721909166,0.9591209727809084
10390,Christmas in Wonderland,694509,689,693820,2007_boxofficemojo_rankings.csv,2007,0.0009920677773794149,0.9990079322226206
10391,The Pirates of Penzance,694497,694497,0,1983_boxofficemojo_rankings.csv,1983,1.0,0.0
10392,Edward II,694438,694438,0,1992_boxofficemojo_rankings.csv,1992,1.0,0.0
10393,Donkey Punch,694422,19367,675055,2008_boxofficemojo_rankings.csv,2008,0.027889381384806358,0.9721106186151937
10394,Raise Hell: The Life & Times of Molly Ivins,694410,694410,0,2019_boxofficemojo_rankings.csv,2019,1.0,0.0
10395,Chris Brown: Welcome To My Life,693984,693984,0,2017_boxofficemojo_rankings.csv,2017,1.0,0.0
10396,Titanic 2017 Re-release,693626,691642,1984,2017_boxofficemojo_rankings.csv,2017,0.997139668928212,0.0028603310717879664
10397,Polish Wedding,692588,692588,0,1998_boxofficemojo_rankings.csv,1998,1.0,0.0
10398,The Living End,692585,692585,0,1992_boxofficemojo_rankings.csv,1992,1.0,0.0
10399,Heartbeat Detector,692575,5309,687266,2007_boxofficemojo_rankings.csv,2007,0.0076655957838501244,0.9923344042161498
10400,Stonewall,692400,692400,0,1996_boxofficemojo_rankings.csv,1996,1.0,0.0
10401,Hope Gap,692134,104732,587402,2020_boxofficemojo_rankings.csv,2020,0.15131751943987726,0.8486824805601227
10402,Close Your Eyes,691495,41392,650103,2004_boxofficemojo_rankings.csv,2004,0.059858711921272026,0.940141288078728
10403,The Opposite Sex and How to Live with Them,690966,690966,0,1993_boxofficemojo_rankings.csv,1993,1.0,0.0
10404,Ferrari Ki Sawaari,689861,434107,255754,2012_boxofficemojo_rankings.csv,2012,0.6292673451608367,0.37073265483916323
10405,"The Prize Winner of Defiance, Ohio",689028,627844,61184,2005_boxofficemojo_rankings.csv,2005,0.9112024475057617,0.08879755249423826
10406,Feast,688854,56131,632723,2006_boxofficemojo_rankings.csv,2006,0.08148461067221792,0.9185153893277821
10407,Romeo Akbar Walter,688719,236299,452420,2019_boxofficemojo_rankings.csv,2019,0.34309929013138885,0.6569007098686112
10408,Happy Accidents,688523,688523,0,2001_boxofficemojo_rankings.csv,2001,1.0,0.0
10409,"Distant Voices, Still Lives",688329,688329,0,1989_boxofficemojo_rankings.csv,1989,1.0,0.0
10410,Mama's Boy,688145,0,688145,2007_boxofficemojo_rankings.csv,2007,0.0,1.0
10411,Cobain: Montage of Heck,687649,0,687649,2015_boxofficemojo_rankings.csv,2015,0.0,1.0
10412,Vettai,687636,204373,483263,2012_boxofficemojo_rankings.csv,2012,0.29721102443734765,0.7027889755626523
10413,Daniel,687475,687475,0,1983_boxofficemojo_rankings.csv,1983,1.0,0.0
10414,Tony Manero,687406,20677,666729,2008_boxofficemojo_rankings.csv,2008,0.03007974908569317,0.9699202509143068
10415,Never Forever,687229,14485,672744,2007_boxofficemojo_rankings.csv,2007,0.021077399236644555,0.9789226007633555
10416,The Caveman's Valentine,687194,687194,0,2001_boxofficemojo_rankings.csv,2001,1.0,0.0
10417,A Chef in Love,686704,686704,0,1997_boxofficemojo_rankings.csv,1997,1.0,0.0
10418,Wigstock: The Movie,686152,686152,0,1995_boxofficemojo_rankings.csv,1995,1.0,0.0
10419,Mr. Church,685780,685780,0,2016_boxofficemojo_rankings.csv,2016,1.0,0.0
10420,Spun,685608,411119,274489,2003_boxofficemojo_rankings.csv,2003,0.5996414860970117,0.4003585139029883
10421,Bloodsport 2,684351,684351,0,1996_boxofficemojo_rankings.csv,1996,1.0,0.0
10422,Bethany Hamilton: Unstoppable,684078,590671,93407,2019_boxofficemojo_rankings.csv,2019,0.8634556293288193,0.13654437067118078
10423,"A Man, a Woman and a Bank",683353,683353,0,1979_boxofficemojo_rankings.csv,1979,1.0,0.0
10424,Stefan Zweig: Farewell to Europe 2017 Re-release,683063,78372,604691,2017_boxofficemojo_rankings.csv,2017,0.11473612243672984,0.8852638775632702
10425,Masti,683021,308566,374455,2004_boxofficemojo_rankings.csv,2004,0.45176649034217103,0.548233509657829
10426,Brigsby Bear,681632,532669,148963,2017_boxofficemojo_rankings.csv,2017,0.7814612576874325,0.21853874231256748
10427,"Right Now, Wrong Then",680728,24470,656258,2015_boxofficemojo_rankings.csv,2015,0.035946809885886874,0.9640531901141132
10428,3 Generations,680351,155936,524415,2016_boxofficemojo_rankings.csv,2016,0.2291993397525689,0.7708006602474311
10429,Timber Falls,680299,0,680299,2007_boxofficemojo_rankings.csv,2007,0.0,1.0
10430,A Matter of Faith,680113,680113,0,2014_boxofficemojo_rankings.csv,2014,1.0,0.0
10431,I Spit on Your Grave 2,678604,809,677795,2013_boxofficemojo_rankings.csv,2013,0.0011921533029572474,0.9988078466970427
10432,All I See Is You,678150,217644,460506,2017_boxofficemojo_rankings.csv,2017,0.32093784560937844,0.6790621543906216
10433,"Dancer, Texas Pop. 81",676631,676631,0,1998_boxofficemojo_rankings.csv,1998,1.0,0.0
10434,Baaghi,676602,438207,238395,2016_boxofficemojo_rankings.csv,2016,0.6476584461766297,0.3523415538233703
10435,Where the River Runs Black,676166,676166,0,1986_boxofficemojo_rankings.csv,1986,1.0,0.0
10436,Tyrannosaur,676111,22321,653790,2011_boxofficemojo_rankings.csv,2011,0.03301380986258173,0.9669861901374183
10437,Towelhead,675662,372124,303538,2008_boxofficemojo_rankings.csv,2008,0.5507546672744656,0.44924533272553435
10438,Manderlay,674918,78378,596540,2005_boxofficemojo_rankings.csv,2005,0.11612966315908006,0.88387033684092
10439,Anamorph,674839,6950,667889,2008_boxofficemojo_rankings.csv,2008,0.010298752739542321,0.9897012472604577
10440,5 to 7,674579,162685,511894,2015_boxofficemojo_rankings.csv,2015,0.24116523046225868,0.7588347695377413
10441,Beyond the Hills,673493,124919,548574,2012_boxofficemojo_rankings.csv,2012,0.18547928486264892,0.8145207151373511
10442,Some Mother's Son,671437,671437,0,1996_boxofficemojo_rankings.csv,1996,1.0,0.0
10443,Maniac Cop,671382,671382,0,1988_boxofficemojo_rankings.csv,1988,1.0,0.0
10444,The Trump Prophecy,671198,671198,0,2018_boxofficemojo_rankings.csv,2018,1.0,0.0
10445,"Cry, the Beloved Country",670727,670727,0,1995_boxofficemojo_rankings.csv,1995,1.0,0.0
10446,Anna and the Apocalypse,670430,545597,124833,2018_boxofficemojo_rankings.csv,2018,0.8138015900243127,0.18619840997568723
10447,The Polar Express 2012 IMAX Release,669289,669289,0,2012_boxofficemojo_rankings.csv,2012,1.0,0.0
10448,The Thief and the Cobbler,669276,669276,0,1995_boxofficemojo_rankings.csv,1995,1.0,0.0
10449,Bright Days Ahead 2013 Re-release,669085,21770,647315,2013_boxofficemojo_rankings.csv,2013,0.03253697213358542,0.9674630278664146
10450,The Torn Poster Let Out a Hero,669070,410526,258544,2013_boxofficemojo_rankings.csv,2013,0.6135770547177425,0.38642294528225746
10451,Travelers and Magicians,668639,506793,161846,2004_boxofficemojo_rankings.csv,2004,0.7579471134648144,0.24205288653518564
10452,Tai Chi 2: The Hero Rises,668484,35067,633417,2012_boxofficemojo_rankings.csv,2012,0.05245750085267561,0.9475424991473244
10453,Kurt & Courtney,668228,668228,0,1998_boxofficemojo_rankings.csv,1998,1.0,0.0
10454,The House Where Evil Dwells,667863,667863,0,1982_boxofficemojo_rankings.csv,1982,1.0,0.0
10455,Girlfriend Boyfriend,667626,64414,603212,2012_boxofficemojo_rankings.csv,2012,0.09648216216863933,0.9035178378313606
10456,Alias Betty,667087,208400,458687,2001_boxofficemojo_rankings.csv,2001,0.31240302988965457,0.6875969701103454
10457,My Mexican Shivah,666553,13042,653511,2007_boxofficemojo_rankings.csv,2007,0.01956633606029828,0.9804336639397018
10458,Balzac and the Little Chinese Seamstress 2005 Re-release,666327,666327,0,2005_boxofficemojo_rankings.csv,2005,1.0,0.0
10459,My First Wedding,666154,14982,651172,2006_boxofficemojo_rankings.csv,2006,0.022490295036883365,0.9775097049631166
10460,Beer for My Horses,666045,666045,0,2008_boxofficemojo_rankings.csv,2008,1.0,0.0
10461,A Bottle in the Gaza Sea,666011,5872,660139,2012_boxofficemojo_rankings.csv,2012,0.008816671196121385,0.9911833288038786
10462,Mr. Gaga: A True Story of Love and Dance,665617,173994,491623,2016_boxofficemojo_rankings.csv,2016,0.2614025783596272,0.7385974216403728
10463,Stockholm,665527,292590,372937,2019_boxofficemojo_rankings.csv,2019,0.43963655869709267,0.5603634413029073
10464,American Buffalo,665450,665450,0,1996_boxofficemojo_rankings.csv,1996,1.0,0.0
10465,The Stanford Prison Experiment,663114,660561,2553,2015_boxofficemojo_rankings.csv,2015,0.9961499832607967,0.0038500167392032138
10466,Savage Nights,662341,662341,0,1994_boxofficemojo_rankings.csv,1994,1.0,0.0
10467,Yes,661946,396760,265186,2005_boxofficemojo_rankings.csv,2005,0.5993842398020383,0.40061576019796175
10468,Star Maps,661465,661465,0,1997_boxofficemojo_rankings.csv,1997,1.0,0.0
10469,Max,660763,539879,120884,2002_boxofficemojo_rankings.csv,2002,0.8170539209973924,0.1829460790026076
10470,City of Gold,660445,640979,19466,2016_boxofficemojo_rankings.csv,2016,0.9705259332722634,0.0294740667277366
10471,Camille Claudel 1915,660355,35296,625059,2013_boxofficemojo_rankings.csv,2013,0.05345003823700888,0.9465499617629911
10472,Grace of My Heart,660313,660313,0,1996_boxofficemojo_rankings.csv,1996,1.0,0.0
10473,Baadshah,660216,660216,0,1999_boxofficemojo_rankings.csv,1999,1.0,0.0
10474,Another Happy Day,659937,8464,651473,2011_boxofficemojo_rankings.csv,2011,0.012825466673333969,0.987174533326666
10475,The Visitors,659810,659810,0,1996_boxofficemojo_rankings.csv,1996,1.0,0.0
10476,The Woman in the Fifth,659769,113800,545969,2011_boxofficemojo_rankings.csv,2011,0.1724846120384559,0.8275153879615441
10477,Delirious,659589,86460,573129,2007_boxofficemojo_rankings.csv,2007,0.13108162810477433,0.8689183718952257
10478,Play the Game,659483,659483,0,2009_boxofficemojo_rankings.csv,2009,1.0,0.0
10479,Dragon Ball Z: Broly - The Legendary Super Saiyan,658982,658982,0,2018_boxofficemojo_rankings.csv,2018,1.0,0.0
10480,Madame Bovary,658532,44235,614297,2015_boxofficemojo_rankings.csv,2015,0.06717213438375053,0.9328278656162495
10481,Spellbinder,657446,657446,0,1988_boxofficemojo_rankings.csv,1988,1.0,0.0
10482,SubUrbia,656747,656747,0,1997_boxofficemojo_rankings.csv,1997,1.0,0.0
10483,Terri,655802,655802,0,2011_boxofficemojo_rankings.csv,2011,1.0,0.0
10484,Dekalog,655720,655720,0,2000_boxofficemojo_rankings.csv,2000,1.0,0.0
10485,The Patience Stone,654587,148671,505916,2013_boxofficemojo_rankings.csv,2013,0.22712183407247624,0.7728781659275238
10486,No Problem,654369,285468,368901,2010_boxofficemojo_rankings.csv,2010,0.4362492721996305,0.5637507278003695
10487,Whisky Galore,653866,20991,632875,2017_boxofficemojo_rankings.csv,2017,0.032102907935265025,0.967897092064735
10488,Ponyo 2018 Re-release,653072,653072,0,2018_boxofficemojo_rankings.csv,2018,1.0,0.0
10489,Rascals,652756,273829,378927,2011_boxofficemojo_rankings.csv,2011,0.4194967185288224,0.5805032814711776
10490,In Secret,652228,444179,208049,2013_boxofficemojo_rankings.csv,2013,0.6810179875748972,0.3189820124251029
10491,Where in the World Is Osama Bin Laden?,651778,384955,266823,2008_boxofficemojo_rankings.csv,2008,0.5906228807968358,0.4093771192031643
10492,Salinger,650675,583633,67042,2013_boxofficemojo_rankings.csv,2013,0.8969654589464786,0.10303454105352135
10493,Metropolis 2002 Re-release,650422,650422,0,2002_boxofficemojo_rankings.csv,2002,1.0,0.0
10494,The Extra Man,649626,453377,196249,2010_boxofficemojo_rankings.csv,2010,0.6979046405162355,0.3020953594837645
10495,The Family Fang,649555,262921,386634,2016_boxofficemojo_rankings.csv,2016,0.4047709585793351,0.5952290414206649
10496,Journey from the Fall,648483,641039,7444,2007_boxofficemojo_rankings.csv,2007,0.9885209018586455,0.011479098141354515
10497,The Oh in Ohio,648183,418689,229494,2006_boxofficemojo_rankings.csv,2006,0.6459425810303572,0.3540574189696428
10498,Jodorowsky's Dune,647280,647280,0,2014_boxofficemojo_rankings.csv,2014,1.0,0.0
10499,American Masters: The Life and Times of Allen Ginsberg 2004 Re-release,646951,646951,0,2004_boxofficemojo_rankings.csv,2004,1.0,0.0
10500,Storage 24,646175,72,646103,2012_boxofficemojo_rankings.csv,2012,0.00011142492358881108,0.9998885750764112
10501,Miss Minoes 2004 Re-release,645970,256770,389200,2004_boxofficemojo_rankings.csv,2004,0.3974952397170147,0.6025047602829853
10502,Focus,645418,645418,0,2001_boxofficemojo_rankings.csv,2001,1.0,0.0
10503,The Public,644740,573503,71237,2019_boxofficemojo_rankings.csv,2019,0.889510500356733,0.11048949964326706
10504,The Oscar Nominated Short Films 2009: Live Action,644635,644635,0,2009_boxofficemojo_rankings.csv,2009,1.0,0.0
10505,Da,644532,644532,0,1988_boxofficemojo_rankings.csv,1988,1.0,0.0
10506,Dracula 3D,643758,8139,635619,2012_boxofficemojo_rankings.csv,2012,0.012642949679848638,0.9873570503201513
10507,The Inheritance 2003 Re-release,642318,68215,574103,2003_boxofficemojo_rankings.csv,2003,0.10620128970385385,0.8937987102961461
10508,Love and Honor,641929,19684,622245,2012_boxofficemojo_rankings.csv,2012,0.030663827308004467,0.9693361726919956
10509,Five Days from Home,641768,641768,0,1979_boxofficemojo_rankings.csv,1979,1.0,0.0
10510,Marjaavaan,641154,174164,466990,2019_boxofficemojo_rankings.csv,2019,0.2716414465167495,0.7283585534832505
10511,Dust to Glory,640013,640013,0,2005_boxofficemojo_rankings.csv,2005,1.0,0.0
10512,Museum Hours,639121,561457,77664,2012_boxofficemojo_rankings.csv,2012,0.87848310413834,0.12151689586166
10513,Aquarela,638907,307346,331561,2019_boxofficemojo_rankings.csv,2019,0.48104966763550877,0.5189503323644913
10514,The Wild Bunch 1995 Re-release,638641,638641,0,1995_boxofficemojo_rankings.csv,1995,1.0,0.0
10515,Sleeping Dogs Lie,638627,15745,622882,2006_boxofficemojo_rankings.csv,2006,0.02465445400836482,0.9753455459916351
10516,Beautiful Boxer,638317,133920,504397,2003_boxofficemojo_rankings.csv,2003,0.20980171294200217,0.7901982870579979
10517,Jack Goes Boating,637479,541992,95487,2010_boxofficemojo_rankings.csv,2010,0.8502115363800219,0.14978846361997808
10518,Dice Rules,637327,637327,0,1991_boxofficemojo_rankings.csv,1991,1.0,0.0
10519,Welcome to Me,636819,608852,27967,2015_boxofficemojo_rankings.csv,2015,0.9560832826910001,0.04391671730899989
10520,One from the Heart,636796,636796,0,1982_boxofficemojo_rankings.csv,1982,1.0,0.0
10521,The Virginity Hit,636706,636706,0,2010_boxofficemojo_rankings.csv,2010,1.0,0.0
10522,Not Fade Away,636399,610792,25607,2012_boxofficemojo_rankings.csv,2012,0.9597626646176377,0.04023733538236232
10523,Elsa & Fred,635901,285863,350038,2014_boxofficemojo_rankings.csv,2014,0.4495401013679802,0.5504598986320197
10524,Batti Gul Meter Chalu,635869,249539,386330,2018_boxofficemojo_rankings.csv,2018,0.39243775054295776,0.6075622494570423
10525,My Life So Far,635620,635620,0,1999_boxofficemojo_rankings.csv,1999,1.0,0.0
10526,Goya in Bordeaux,635361,635361,0,2000_boxofficemojo_rankings.csv,2000,1.0,0.0
10527,The Last Lions,635325,635325,0,2011_boxofficemojo_rankings.csv,2011,1.0,0.0
10528,Kaboom,635162,118919,516243,2010_boxofficemojo_rankings.csv,2010,0.18722625094070489,0.8127737490592951
10529,Ride with the Devil,635096,635096,0,1999_boxofficemojo_rankings.csv,1999,1.0,0.0
10530,A Beautiful Life,634784,66171,568613,2011_boxofficemojo_rankings.csv,2011,0.10424175782628421,0.8957582421737158
10531,Dinner Rush,634566,634566,0,2001_boxofficemojo_rankings.csv,2001,1.0,0.0
10532,No One Killed Jessica,634297,440525,193772,2011_boxofficemojo_rankings.csv,2011,0.6945090391409703,0.30549096085902977
10533,Wassup Rockers,634074,221574,412500,2006_boxofficemojo_rankings.csv,2006,0.34944501745853007,0.6505549825414699
10534,The Black Prince,632823,0,632823,2017_boxofficemojo_rankings.csv,2017,0.0,1.0
10535,Grey Owl,632617,632617,0,1999_boxofficemojo_rankings.csv,1999,1.0,0.0
10536,Grace Jones: Bloodlight and Bami,632394,375208,257186,2017_boxofficemojo_rankings.csv,2017,0.5933136620524546,0.4066863379475454
10537,Guinevere,632283,632283,0,1999_boxofficemojo_rankings.csv,1999,1.0,0.0
10538,The Great Alaskan Race,632157,485603,146554,2019_boxofficemojo_rankings.csv,2019,0.7681683505837948,0.23183164941620515
10539,Summer of '04,632017,20474,611543,2006_boxofficemojo_rankings.csv,2006,0.03239469824387635,0.9676053017561237
10540,Jonah: The Musical,631154,631154,0,2017_boxofficemojo_rankings.csv,2017,1.0,0.0
10541,Mera Pind: My Home,630370,176976,453394,2008_boxofficemojo_rankings.csv,2008,0.28074940114535907,0.7192505988546409
10542,Shut Up and Play the Hits,629107,510334,118773,2012_boxofficemojo_rankings.csv,2012,0.8112038174746108,0.18879618252538916
10543,Short Peace,628807,22862,605945,2013_boxofficemojo_rankings.csv,2013,0.03635773774783042,0.9636422622521695
10544,Black Water: Abyss,628683,0,628683,2020_boxofficemojo_rankings.csv,2020,0.0,1.0
10545,The Trumpet of the Swan,628387,102202,526185,2001_boxofficemojo_rankings.csv,2001,0.1626418114951455,0.8373581885048544
10546,Water Lilies,628258,85440,542818,2007_boxofficemojo_rankings.csv,2007,0.1359950848218407,0.8640049151781592
10547,Pumping Iron II: The Women,628050,628050,0,1985_boxofficemojo_rankings.csv,1985,1.0,0.0
10548,Asako I & II,627102,25559,601543,2019_boxofficemojo_rankings.csv,2019,0.04075732496467879,0.9592426750353212
10549,Korkoro,627088,8242,618846,2010_boxofficemojo_rankings.csv,2010,0.013143290893782054,0.9868567091062179
10550,I'm Still Here,626396,408983,217413,2010_boxofficemojo_rankings.csv,2010,0.652914450283846,0.347085549716154
10551,"Love, Gilda",626318,626318,0,2018_boxofficemojo_rankings.csv,2018,1.0,0.0
10552,Johnny Stecchino,626057,626057,0,1992_boxofficemojo_rankings.csv,1992,1.0,0.0
10553,The House of Yes,626057,626057,0,1997_boxofficemojo_rankings.csv,1997,1.0,0.0
10554,Sleepless Night,624913,3358,621555,2011_boxofficemojo_rankings.csv,2011,0.005373547997881305,0.9946264520021187
10555,Give Me Liberty,624818,242734,382084,2019_boxofficemojo_rankings.csv,2019,0.3884875275680278,0.6115124724319722
10556,Wuthering Heights,624643,624643,0,1989_boxofficemojo_rankings.csv,1989,1.0,0.0
10557,Our Lady of the Assassins,624525,525330,99195,2001_boxofficemojo_rankings.csv,2001,0.8411672871382251,0.15883271286177494
10558,The Sound of Music 2018 Re-release,624392,616171,8221,2018_boxofficemojo_rankings.csv,2018,0.9868335917180233,0.013166408281976707
10559,Character,623983,623983,0,1998_boxofficemojo_rankings.csv,1998,1.0,0.0
10560,Winter in Wartime 2010 Re-release,623392,543100,80292,2010_boxofficemojo_rankings.csv,2010,0.8712014270314665,0.12879857296853345
10561,Spike of Bensonhurst,623112,623112,0,1988_boxofficemojo_rankings.csv,1988,1.0,0.0
10562,Nancy Drew and the Hidden Staircase,623088,623088,0,2019_boxofficemojo_rankings.csv,2019,1.0,0.0
10563,Dirty Dancing 2019 Re-release,622968,622968,0,2019_boxofficemojo_rankings.csv,2019,1.0,0.0
10564,Sherrybaby,622806,199176,423630,2006_boxofficemojo_rankings.csv,2006,0.31980424080692865,0.6801957591930714
10565,It's My Party,622503,622503,0,1996_boxofficemojo_rankings.csv,1996,1.0,0.0
10566,Les séducteurs,621931,621931,0,1981_boxofficemojo_rankings.csv,1981,1.0,0.0
10567,Range 15,621738,621738,0,2016_boxofficemojo_rankings.csv,2016,1.0,0.0
10568,The Grey Zone,621592,517872,103720,2001_boxofficemojo_rankings.csv,2001,0.8331381356259411,0.16686186437405887
10569,Cronos,621392,621392,0,1994_boxofficemojo_rankings.csv,1994,1.0,0.0
10570,LOC: Kargil,621103,621103,0,2003_boxofficemojo_rankings.csv,2003,1.0,0.0
10571,Ghostbusters 2020 Re-release,620883,605000,15883,2020_boxofficemojo_rankings.csv,2020,0.974418690800038,0.025581309199961988
10572,Die Hard 30th Anniversary Release,620525,510241,110284,2018_boxofficemojo_rankings.csv,2018,0.822273075218565,0.17772692478143506
10573,Better Than Sex,620388,19521,600867,2000_boxofficemojo_rankings.csv,2000,0.031465792375094295,0.9685342076249057
10574,"Happy, Happy",620238,45154,575084,2010_boxofficemojo_rankings.csv,2010,0.0728010860347157,0.9271989139652843
10575,Killerman,619855,291477,328378,2019_boxofficemojo_rankings.csv,2019,0.470234167668245,0.529765832331755
10576,The Transformers,619597,619597,0,2018_boxofficemojo_rankings.csv,2018,1.0,0.0
10577,Nowitzki: The Perfect Shot,619517,41340,578177,2014_boxofficemojo_rankings.csv,2014,0.06672940371289246,0.9332705962871075
10578,Fever Pitch,618847,618847,0,1985_boxofficemojo_rankings.csv,1985,1.0,0.0
10579,Paradise: Faith,618696,6508,612188,2013_boxofficemojo_rankings.csv,2013,0.010518897810879656,0.9894811021891203
10580,The Third Man,618173,618173,0,1999_boxofficemojo_rankings.csv,1999,1.0,0.0
10581,London Dreams,618067,300293,317774,2009_boxofficemojo_rankings.csv,2009,0.4858583292749815,0.5141416707250185
10582,Paulo Coelho's Best Story,617377,8808,608569,2014_boxofficemojo_rankings.csv,2014,0.014266809421147856,0.9857331905788521
10583,The Butterfly 2003 Re-release,616355,38438,577917,2003_boxofficemojo_rankings.csv,2003,0.06236341069675755,0.9376365893032425
10584,The Monster,615826,615826,0,1996_boxofficemojo_rankings.csv,1996,1.0,0.0
10585,The Bronze,615816,615816,0,2016_boxofficemojo_rankings.csv,2016,1.0,0.0
10586,Lost River,615500,45431,570069,2015_boxofficemojo_rankings.csv,2015,0.07381153533712428,0.9261884646628757
10587,"A White, White Day",614674,0,614674,2019_boxofficemojo_rankings.csv,2019,0.0,1.0
10588,Omar,614444,356000,258444,2013_boxofficemojo_rankings.csv,2013,0.5793855908756534,0.42061440912434656
10589,Going Upriver: The Long War of John Kerry,614138,614138,0,2004_boxofficemojo_rankings.csv,2004,1.0,0.0
10590,Queens Logic,612781,612781,0,1991_boxofficemojo_rankings.csv,1991,1.0,0.0
10591,Walking the Camino: Six Ways to Santiago,612717,612717,0,2013_boxofficemojo_rankings.csv,2013,1.0,0.0
10592,The Returned,612521,0,612521,2013_boxofficemojo_rankings.csv,2013,0.0,1.0
10593,The Wizard of Oz 1989 Re-release,612300,612300,0,1989_boxofficemojo_rankings.csv,1989,1.0,0.0
10594,The Filth and the Fury,612192,612192,0,2000_boxofficemojo_rankings.csv,2000,1.0,0.0
10595,Leolo,611703,611703,0,1993_boxofficemojo_rankings.csv,1993,1.0,0.0
10596,In Another Country,611365,25079,586286,2012_boxofficemojo_rankings.csv,2012,0.04102132114203463,0.9589786788579654
10597,The Muppet Movie 2019 Re-release,610475,610475,0,2019_boxofficemojo_rankings.csv,2019,1.0,0.0
10598,The Return of Superfly,610402,610402,0,1990_boxofficemojo_rankings.csv,1990,1.0,0.0
10599,Henry: Portrait of a Serial Killer,609939,609939,0,1990_boxofficemojo_rankings.csv,1990,1.0,0.0
10600,Project Nim,609880,411184,198696,2011_boxofficemojo_rankings.csv,2011,0.6742047615924445,0.3257952384075556
10601,Friday Night,609542,156918,452624,2002_boxofficemojo_rankings.csv,2002,0.25743591089703416,0.7425640891029658
10602,Dead Before Dawn 3D,608881,0,608881,2012_boxofficemojo_rankings.csv,2012,0.0,1.0
10603,Ruby Cairo,608866,608866,0,1993_boxofficemojo_rankings.csv,1993,1.0,0.0
10604,The Last Suit,608209,73548,534661,2017_boxofficemojo_rankings.csv,2017,0.12092553710977641,0.8790744628902236
10605,Gunner Palace,607844,607844,0,2005_boxofficemojo_rankings.csv,2005,1.0,0.0
10606,The Last Shift,607605,607605,0,2020_boxofficemojo_rankings.csv,2020,1.0,0.0
10607,Mr. Right,607595,34694,572901,2016_boxofficemojo_rankings.csv,2016,0.057100535718694195,0.9428994642813058
10608,Dear Wendy,607229,23106,584123,2005_boxofficemojo_rankings.csv,2005,0.038051542334111184,0.9619484576658888
10609,The Reports on Sarah and Saleem,607206,117479,489727,2018_boxofficemojo_rankings.csv,2018,0.1934747021603871,0.8065252978396129
10610,Life in a Day,607169,252788,354381,2011_boxofficemojo_rankings.csv,2011,0.4163387788243471,0.5836612211756529
10611,Bolshoi Ballet: The Sleeping Beauty,606872,311368,295504,2019_boxofficemojo_rankings.csv,2019,0.513070301480378,0.4869296985196219
10612,Neither Wolf Nor Dog,606511,606511,0,2017_boxofficemojo_rankings.csv,2017,1.0,0.0
10613,The Walking Dead: Wrath/The Walking Dead/Fear the Walking Dead: What's Your Story?/Fear the Walking Dead,605764,605764,0,2018_boxofficemojo_rankings.csv,2018,1.0,0.0
10614,Summer in February,605403,1624,603779,2013_boxofficemojo_rankings.csv,2013,0.0026825106581896685,0.9973174893418103
10615,Shortcut to Happiness,605294,0,605294,2007_boxofficemojo_rankings.csv,2007,0.0,1.0
10616,Blue Collar Comedy Tour: The Movie,604856,604856,0,2003_boxofficemojo_rankings.csv,2003,1.0,0.0
10617,Modern Girls,604849,604849,0,1986_boxofficemojo_rankings.csv,1986,1.0,0.0
10618,Auntie Danielle,604624,604624,0,1991_boxofficemojo_rankings.csv,1991,1.0,0.0
10619,Love Serenade,604523,604523,0,1997_boxofficemojo_rankings.csv,1997,1.0,0.0
10620,The Golden Glove,604479,6160,598319,2019_boxofficemojo_rankings.csv,2019,0.010190593883327626,0.9898094061166723
10621,Wild West Comedy Show: 30 Days & 30 Nights - Hollywood to the Heartland,603894,603894,0,2008_boxofficemojo_rankings.csv,2008,1.0,0.0
10622,The Holy Land,603520,603520,0,2003_boxofficemojo_rankings.csv,2003,1.0,0.0
10623,"DCI 2019: Big, Loud & Live 16",603320,603320,0,2018_boxofficemojo_rankings.csv,2018,1.0,0.0
10624,The Advocate,602329,602329,0,1994_boxofficemojo_rankings.csv,1994,1.0,0.0
10625,Orgazmo,602302,602302,0,1998_boxofficemojo_rankings.csv,1998,1.0,0.0
10626,Undertow,602059,108620,493439,2010_boxofficemojo_rankings.csv,2010,0.1804142118961763,0.8195857881038238
10627,A Talking Picture,601815,20237,581578,2003_boxofficemojo_rankings.csv,2003,0.033626612829524026,0.9663733871704759
10628,Knights of the City,601451,601451,0,1986_boxofficemojo_rankings.csv,1986,1.0,0.0
10629,The Little Death,601162,18238,582924,2014_boxofficemojo_rankings.csv,2014,0.03033791224328883,0.9696620877567111
10630,The Grateful Dead Meet-Up 2018,600554,600554,0,2018_boxofficemojo_rankings.csv,2018,1.0,0.0
10631,Chungking Express,600200,600200,0,1996_boxofficemojo_rankings.csv,1996,1.0,0.0
10632,Oh Lucy!,600145,375391,224754,2018_boxofficemojo_rankings.csv,2018,0.6255005040448558,0.37449949595514415
10633,Code Name: Wild Geese,600000,600000,0,1986_boxofficemojo_rankings.csv,1986,1.0,0.0
10634,Jimi: All Is by My Side,599840,340911,258929,2014_boxofficemojo_rankings.csv,2014,0.568336556415044,0.431663443584956
10635,The Fencer 2016 Re-release,599537,95952,503585,2016_boxofficemojo_rankings.csv,2016,0.1600435002343475,0.8399564997656525
10636,The Fluffer,599523,563373,36150,2001_boxofficemojo_rankings.csv,2001,0.9397020631401964,0.060297936859803544
10637,Road Scholar,597564,597564,0,1993_boxofficemojo_rankings.csv,1993,1.0,0.0
10638,The One I Love,596933,513447,83486,2014_boxofficemojo_rankings.csv,2014,0.8601417579527351,0.13985824204726494
10639,Fiza,596591,596591,0,2000_boxofficemojo_rankings.csv,2000,1.0,0.0
10640,Trust,595802,120016,475786,2011_boxofficemojo_rankings.csv,2011,0.20143604754599684,0.7985639524540031
10641,Where the Rivers Flow North,595505,595505,0,1994_boxofficemojo_rankings.csv,1994,1.0,0.0
10642,Skin Trade,595268,1242,594026,2015_boxofficemojo_rankings.csv,2015,0.002086455176491933,0.997913544823508
10643,Blue Like Jazz,595018,595018,0,2012_boxofficemojo_rankings.csv,2012,1.0,0.0
10644,My First Mister,595005,568762,26243,2001_boxofficemojo_rankings.csv,2001,0.955894488281611,0.04410551171838892
10645,Ixcanul,594836,295157,299679,2015_boxofficemojo_rankings.csv,2015,0.4961989523162687,0.5038010476837314
10646,Are You Here,594396,0,594396,2014_boxofficemojo_rankings.csv,2014,0.0,1.0
10647,The Armstrong Lie,594394,383294,211100,2013_boxofficemojo_rankings.csv,2013,0.644848366571668,0.35515163342833206
10648,Boss,594283,0,594283,2013_boxofficemojo_rankings.csv,2013,0.0,1.0
10649,The Big Lebowski 2018 Re-release,592832,582585,10247,2018_boxofficemojo_rankings.csv,2018,0.9827151705710893,0.01728482942891072
10650,Not One Less,592586,592586,0,2000_boxofficemojo_rankings.csv,2000,1.0,0.0
10651,The Promise,592543,592543,0,1997_boxofficemojo_rankings.csv,1997,1.0,0.0
10652,To Kill a Mockingbird 2019 Re-release,592237,592237,0,2019_boxofficemojo_rankings.csv,2019,1.0,0.0
10653,Compliance,592116,319285,272831,2012_boxofficemojo_rankings.csv,2012,0.5392271109039445,0.4607728890960555
10654,Tarnation,592014,592014,0,2004_boxofficemojo_rankings.csv,2004,1.0,0.0
10655,The Cure: Anniversary 1978-2018 Live in Hyde Park,591904,378405,213499,2019_boxofficemojo_rankings.csv,2019,0.6393013056171271,0.3606986943828729
10656,The Wonderland,591857,50876,540981,2019_boxofficemojo_rankings.csv,2019,0.08595995316436233,0.9140400468356377
10657,Night of the Creeps,591366,591366,0,1986_boxofficemojo_rankings.csv,1986,1.0,0.0
10658,Last Night,591165,591165,0,1999_boxofficemojo_rankings.csv,1999,1.0,0.0
10659,The Third Miracle,591142,591142,0,1999_boxofficemojo_rankings.csv,1999,1.0,0.0
10660,The Human Resources Manager,590567,64014,526553,2010_boxofficemojo_rankings.csv,2010,0.10839413648239743,0.8916058635176026
10661,The Walker,590416,79698,510718,2007_boxofficemojo_rankings.csv,2007,0.13498617923633505,0.865013820763665
10662,Refugee,590000,590000,0,2000_boxofficemojo_rankings.csv,2000,1.0,0.0
10663,Storm Surfers 3D,589945,117090,472855,2012_boxofficemojo_rankings.csv,2012,0.19847612913068166,0.8015238708693183
10664,Prefontaine,589304,589304,0,1997_boxofficemojo_rankings.csv,1997,1.0,0.0
10665,Starry Starry Night,589299,10033,579266,2011_boxofficemojo_rankings.csv,2011,0.01702531312627376,0.9829746868737262
10666,Powaqqatsi,589244,589244,0,1988_boxofficemojo_rankings.csv,1988,1.0,0.0
10667,The Painted Bird,588749,1460,587289,2019_boxofficemojo_rankings.csv,2019,0.002479834360652842,0.9975201656393472
10668,Twelfth Night or What You Will,588621,588621,0,1996_boxofficemojo_rankings.csv,1996,1.0,0.0
10669,Phir Bhi Dil Hai Hindustani,588606,588606,0,2000_boxofficemojo_rankings.csv,2000,1.0,0.0
10670,Elvis on Tour,587818,587818,0,2010_boxofficemojo_rankings.csv,2010,1.0,0.0
10671,A Time for Drunken Horses,587654,587654,0,2000_boxofficemojo_rankings.csv,2000,1.0,0.0
10672,Thunderstruck,587211,587211,0,2012_boxofficemojo_rankings.csv,2012,1.0,0.0
10673,Upstream Color,587174,444098,143076,2013_boxofficemojo_rankings.csv,2013,0.7563311727017885,0.24366882729821143
10674,Pound Puppies and the Legend of Big Paw,586938,586938,0,1988_boxofficemojo_rankings.csv,1988,1.0,0.0
10675,Seberg,585845,434702,151143,2020_boxofficemojo_rankings.csv,2020,0.7420085517500363,0.25799144824996373
10676,The Piano Player,585604,585604,0,2003_boxofficemojo_rankings.csv,2003,1.0,0.0
10677,Klimt,584991,97656,487335,2006_boxofficemojo_rankings.csv,2006,0.166935901577973,0.833064098422027
10678,The Black Panthers: Vanguard of the Revolution,584109,516893,67216,2015_boxofficemojo_rankings.csv,2015,0.8849255875187679,0.1150744124812321
10679,The Opportunists,584054,584054,0,2000_boxofficemojo_rankings.csv,2000,1.0,0.0
10680,Undefeated,583844,562218,21626,2012_boxofficemojo_rankings.csv,2012,0.9629592836442611,0.03704071635573886
10681,Oviri,583800,583800,0,1987_boxofficemojo_rankings.csv,1987,1.0,0.0
10682,Gleason,583664,583664,0,2016_boxofficemojo_rankings.csv,2016,1.0,0.0
10683,The Flat,583443,471842,111601,2012_boxofficemojo_rankings.csv,2012,0.8087199606473983,0.1912800393526017
10684,Forgive Me Father,582787,582787,0,2001_boxofficemojo_rankings.csv,2001,1.0,0.0
10685,The Pope Must Diet,582510,582510,0,1991_boxofficemojo_rankings.csv,1991,1.0,0.0
10686,White God,581904,282358,299546,2014_boxofficemojo_rankings.csv,2014,0.48523124089196845,0.5147687591080315
10687,Three Times,581875,151922,429953,2005_boxofficemojo_rankings.csv,2005,0.261090440386681,0.7389095596133191
10688,Touch of Pink,581055,564535,16520,2004_boxofficemojo_rankings.csv,2004,0.9715689564671158,0.02843104353288415
10689,Novitiate,580346,580346,0,2017_boxofficemojo_rankings.csv,2017,1.0,0.0
10690,All the Real Girls,579986,549666,30320,2003_boxofficemojo_rankings.csv,2003,0.9477228760694224,0.05227712393057764
10691,Bedeviled,579942,0,579942,2017_boxofficemojo_rankings.csv,2017,0.0,1.0
10692,The Search for Signs of Intelligent Life in the Universe,579854,579854,0,1991_boxofficemojo_rankings.csv,1991,1.0,0.0
10693,And Then We Danced,579574,177262,402312,2019_boxofficemojo_rankings.csv,2019,0.30584877858565085,0.6941512214143492
10694,Viva Pedro!,579539,579539,0,2006_boxofficemojo_rankings.csv,2006,1.0,0.0
10695,Around the Bend,579350,193637,385713,2004_boxofficemojo_rankings.csv,2004,0.3342314662984379,0.6657685337015621
10696,Harry & Snowman,578820,561460,17360,2016_boxofficemojo_rankings.csv,2016,0.9700079472029302,0.0299920527970699
10697,Tibet: Cry of the Snow Lion,578241,578241,0,2003_boxofficemojo_rankings.csv,2003,1.0,0.0
10698,Bilal: A New Breed of Hero 2018 Re-release,576805,490973,85832,2018_boxofficemojo_rankings.csv,2018,0.8511940777212402,0.14880592227875972
10699,Blizzard,576320,504600,71720,2003_boxofficemojo_rankings.csv,2003,0.8755552470849528,0.1244447529150472
10700,Rosalie Goes Shopping,574080,574080,0,1990_boxofficemojo_rankings.csv,1990,1.0,0.0
10701,Fados,574044,129150,444894,2007_boxofficemojo_rankings.csv,2007,0.22498275393523842,0.7750172460647616
10702,Bar Girls,573953,573953,0,1995_boxofficemojo_rankings.csv,1995,1.0,0.0
10703,Wild Orchid II: Two Shades of Blue,573904,573904,0,1992_boxofficemojo_rankings.csv,1992,1.0,0.0
10704,Mesrine Part 1: Killer Instinct 2010 Re-release,572790,551697,21093,2010_boxofficemojo_rankings.csv,2010,0.9631749855968156,0.03682501440318441
10705,The Twilight Samurai 2004 Re-release,572565,559765,12800,2004_boxofficemojo_rankings.csv,2004,0.9776444595810083,0.02235554041899173
10706,Deceiver,572433,572433,0,1998_boxofficemojo_rankings.csv,1998,1.0,0.0
10707,Das Boot 1997 Director's Cut,572426,572426,0,1997_boxofficemojo_rankings.csv,1997,1.0,0.0
10708,The Room 2017 Re-release,572340,549602,22738,2017_boxofficemojo_rankings.csv,2017,0.9602718663731349,0.03972813362686515
10709,My Father My Lord,571566,203708,367858,2008_boxofficemojo_rankings.csv,2008,0.3564032850099551,0.6435967149900449
10710,Wondrous Oblivion 2006 Re-release,571562,88560,483002,2006_boxofficemojo_rankings.csv,2006,0.15494382061788572,0.8450561793821143
10711,The Falling,569498,0,569498,2015_boxofficemojo_rankings.csv,2015,0.0,1.0
10712,Youth,567746,331166,236580,2004_boxofficemojo_rankings.csv,2004,0.5832995741053217,0.41670042589467826
10713,The Passion of the Christ Recut Release,567692,508326,59366,2005_boxofficemojo_rankings.csv,2005,0.895425688577609,0.10457431142239101
10714,Tideland,566611,66453,500158,2006_boxofficemojo_rankings.csv,2006,0.11728152118472815,0.8827184788152719
10715,Goodbye to Language,566423,401889,164534,2014_boxofficemojo_rankings.csv,2014,0.7095209763727814,0.2904790236272185
10716,Sangre de mi sangre,565024,55730,509294,2007_boxofficemojo_rankings.csv,2007,0.09863297842215552,0.9013670215778444
10717,Margaret,564864,46495,518369,2011_boxofficemojo_rankings.csv,2011,0.08231184851574892,0.9176881514842511
10718,The Weather Underground,564632,564632,0,2003_boxofficemojo_rankings.csv,2003,1.0,0.0
10719,Palm Springs,564597,164000,400597,2020_boxofficemojo_rankings.csv,2020,0.2904726734290122,0.7095273265709878
10720,The Cat Returns 2018 Re-release,563718,563718,0,2018_boxofficemojo_rankings.csv,2018,1.0,0.0
10721,Poolhall Junkies,563711,563711,0,2003_boxofficemojo_rankings.csv,2003,1.0,0.0
10722,Ira & Abby,563611,221096,342515,2007_boxofficemojo_rankings.csv,2007,0.39228474958792503,0.607715250412075
10723,Hands on a Hardbody: The Documentary,563482,563482,0,1998_boxofficemojo_rankings.csv,1998,1.0,0.0
10724,Nobody's Fool,563358,563358,0,1986_boxofficemojo_rankings.csv,1986,1.0,0.0
10725,Like Someone in Love,562878,239056,323822,2012_boxofficemojo_rankings.csv,2012,0.4247030439988772,0.5752969560011229
10726,Beetlejuice 2018 Re-release,562613,512947,49666,2018_boxofficemojo_rankings.csv,2018,0.911722622833102,0.08827737716689803
10727,The Happiest Day in the Life of Olli Maki,562537,0,562537,2016_boxofficemojo_rankings.csv,2016,0.0,1.0
10728,Steel Dawn,562187,562187,0,1987_boxofficemojo_rankings.csv,1987,1.0,0.0
10729,Kurosawa & Mifune Festival,561692,561692,0,2002_boxofficemojo_rankings.csv,2002,1.0,0.0
10730,Code Name: Emerald,561548,561548,0,1985_boxofficemojo_rankings.csv,1985,1.0,0.0
10731,Kitchen Stories 2004 Re-release,561380,351235,210145,2004_boxofficemojo_rankings.csv,2004,0.6256635434108804,0.3743364565891197
10732,Rich Girl,561000,561000,0,1991_boxofficemojo_rankings.csv,1991,1.0,0.0
10733,Me You Them,560943,323923,237020,2001_boxofficemojo_rankings.csv,2001,0.577461524611235,0.422538475388765
10734,My Fair Lady 2019 Re-release,560711,560711,0,2019_boxofficemojo_rankings.csv,2019,1.0,0.0
10735,Bottle Rocket,560069,560069,0,1996_boxofficemojo_rankings.csv,1996,1.0,0.0
10736,The Grass Harp,559771,559771,0,1996_boxofficemojo_rankings.csv,1996,1.0,0.0
10737,Fiddler: A Miracle of Miracles,558816,549386,9430,2019_boxofficemojo_rankings.csv,2019,0.9831250357899559,0.016874964210044092
10738,The Dance of Reality,558636,293680,264956,2013_boxofficemojo_rankings.csv,2013,0.5257090484680543,0.47429095153194567
10739,The Wedding Song,558489,31160,527329,2008_boxofficemojo_rankings.csv,2008,0.05579339969095184,0.9442066003090481
10740,Kusama: Infinity,558052,360931,197121,2018_boxofficemojo_rankings.csv,2018,0.6467694766795926,0.35323052332040744
10741,Forrest Gump 2014 IMAX Release,557683,557683,0,2014_boxofficemojo_rankings.csv,2014,1.0,0.0
10742,Castle in the Sky 2018 Re-release,557541,523664,33877,2018_boxofficemojo_rankings.csv,2018,0.9392385492726095,0.060761450727390455
10743,Rojo,557092,94757,462335,2018_boxofficemojo_rankings.csv,2018,0.1700921930309536,0.8299078069690464
10744,Tony Takitani,556268,129783,426485,2005_boxofficemojo_rankings.csv,2005,0.23331020299567834,0.7666897970043216
10745,Samaritan's Purse presents Facing Darkness,555533,555533,0,2017_boxofficemojo_rankings.csv,2017,1.0,0.0
10746,Circumstance,555511,454121,101390,2011_boxofficemojo_rankings.csv,2011,0.8174833621656457,0.18251663783435432
10747,Dolores,555309,555309,0,2017_boxofficemojo_rankings.csv,2017,1.0,0.0
10748,Every Thing Will Be Fine,554953,9233,545720,2015_boxofficemojo_rankings.csv,2015,0.01663744497281752,0.9833625550271825
10749,Endless Poetry,554706,153440,401266,2016_boxofficemojo_rankings.csv,2016,0.2766149996574762,0.7233850003425238
10750,American Violet,554434,554434,0,2009_boxofficemojo_rankings.csv,2009,1.0,0.0
10751,Timecrimes,553198,39127,514071,2008_boxofficemojo_rankings.csv,2008,0.07072874450016088,0.9292712554998391
10752,Viral,551760,0,551760,2016_boxofficemojo_rankings.csv,2016,0.0,1.0
10753,Open Windows,550108,1750,548358,2014_boxofficemojo_rankings.csv,2014,0.0031811935110923673,0.9968188064889076
10754,Dhadak,549628,0,549628,2018_boxofficemojo_rankings.csv,2018,0.0,1.0
10755,From Mexico with Love,549495,548787,708,2009_boxofficemojo_rankings.csv,2009,0.9987115442360713,0.0012884557639286983
10756,23 Blast,549185,549185,0,2014_boxofficemojo_rankings.csv,2014,1.0,0.0
10757,Amazon Women on the Moon,548696,548696,0,1987_boxofficemojo_rankings.csv,1987,1.0,0.0
10758,Followed,548608,538179,10429,2020_boxofficemojo_rankings.csv,2020,0.9809900694120391,0.019009930587960803
10759,Commandments,548561,548561,0,1997_boxofficemojo_rankings.csv,1997,1.0,0.0
10760,We Are X,548126,45270,502856,2016_boxofficemojo_rankings.csv,2016,0.0825904992647676,0.9174095007352324
10761,Beyond the Reef,547525,547525,0,1981_boxofficemojo_rankings.csv,1981,1.0,0.0
10762,Devil in the Flesh,546904,546904,0,1987_boxofficemojo_rankings.csv,1987,1.0,0.0
10763,Planetarium,546584,3262,543322,2016_boxofficemojo_rankings.csv,2016,0.005967975645097551,0.9940320243549025
10764,Heavy Metal,546545,546545,0,1996_boxofficemojo_rankings.csv,1996,1.0,0.0
10765,A Girl Walks Home Alone at Night,546352,491910,54442,2014_boxofficemojo_rankings.csv,2014,0.9003536181802209,0.0996463818197792
10766,My Generation,546183,0,546183,2018_boxofficemojo_rankings.csv,2018,0.0,1.0
10767,Rudderless,546149,58293,487856,2014_boxofficemojo_rankings.csv,2014,0.10673460905357329,0.8932653909464268
10768,Masked and Anonymous,546106,533569,12537,2003_boxofficemojo_rankings.csv,2003,0.9770429184077817,0.022957081592218362
10769,"DCI 2019: Big, Loud & Live 16",546060,546060,0,2019_boxofficemojo_rankings.csv,2019,1.0,0.0
10770,Cet amour-là,545905,72844,473061,2002_boxofficemojo_rankings.csv,2002,0.13343713649810865,0.8665628635018914
10771,Life Is Beautiful Dubbed,545880,315880,230000,1998_boxofficemojo_rankings.csv,1998,0.5786619769912801,0.42133802300871986
10772,Nobel Son,545582,540382,5200,2008_boxofficemojo_rankings.csv,2008,0.9904688937684895,0.00953110623151057
10773,Private Property,545473,62897,482576,2007_boxofficemojo_rankings.csv,2007,0.11530726543751936,0.8846927345624807
10774,Primer,545436,424760,120676,2004_boxofficemojo_rankings.csv,2004,0.778753144273572,0.22124685572642802
10775,Boarding Gate,545436,49333,496103,2007_boxofficemojo_rankings.csv,2007,0.09044690852822329,0.9095530914717767
10776,Dog Days,545059,13031,532028,2002_boxofficemojo_rankings.csv,2002,0.02390750359135433,0.9760924964086457
10777,A Map of the World,544965,544965,0,1999_boxofficemojo_rankings.csv,1999,1.0,0.0
10778,Honeydripper,544925,267880,277045,2007_boxofficemojo_rankings.csv,2007,0.4915905858604395,0.5084094141395605
10779,The Art of the Steal,544890,544890,0,2010_boxofficemojo_rankings.csv,2010,1.0,0.0
10780,He's Out There,544674,0,544674,2018_boxofficemojo_rankings.csv,2018,0.0,1.0
10781,Once Upon a Time in the Midlands,544512,172564,371948,2002_boxofficemojo_rankings.csv,2002,0.3169149623883404,0.6830850376116596
10782,The Day Shall Come,543993,26972,517021,2019_boxofficemojo_rankings.csv,2019,0.04958152035044568,0.9504184796495543
10783,Love & Sex,543896,543896,0,2000_boxofficemojo_rankings.csv,2000,1.0,0.0
10784,Dream with the Fishes,543708,543708,0,1997_boxofficemojo_rankings.csv,1997,1.0,0.0
10785,Beauty and the Beast 2020 Re-release,543260,467000,76260,2020_boxofficemojo_rankings.csv,2020,0.859625225490557,0.140374774509443
10786,The Ballad of Little Jo,543091,543091,0,1993_boxofficemojo_rankings.csv,1993,1.0,0.0
10787,On Any Sunday: The Next Chapter,543044,543044,0,2014_boxofficemojo_rankings.csv,2014,1.0,0.0
10788,Love & Human Remains,542985,542985,0,1995_boxofficemojo_rankings.csv,1995,1.0,0.0
10789,Joshua Then and Now,542420,542420,0,1985_boxofficemojo_rankings.csv,1985,1.0,0.0
10790,20 Dates,541636,541636,0,1999_boxofficemojo_rankings.csv,1999,1.0,0.0
10791,Strike It Rich,541626,541626,0,1990_boxofficemojo_rankings.csv,1990,1.0,0.0
10792,The Club,541515,52761,488754,2015_boxofficemojo_rankings.csv,2015,0.09743220409406941,0.9025677959059306
10793,Broken English,541377,541377,0,1997_boxofficemojo_rankings.csv,1997,1.0,0.0
10794,Saathiya,541367,317564,223803,2002_boxofficemojo_rankings.csv,2002,0.5865965232457834,0.4134034767542166
10795,Passionada,540833,540833,0,2003_boxofficemojo_rankings.csv,2003,1.0,0.0
10796,Dragon Ball Z: Bardock - The Father of Goku/Dragon Ball Z: Fusion Reborn,540707,540707,0,2018_boxofficemojo_rankings.csv,2018,1.0,0.0
10797,On the Way to School 2015 Re-release,540658,7424,533234,2015_boxofficemojo_rankings.csv,2015,0.013731416163267722,0.9862685838367323
10798,Lymelife,540403,421307,119096,2009_boxofficemojo_rankings.csv,2009,0.7796163233734824,0.22038367662651762
10799,Buster,540000,540000,0,1988_boxofficemojo_rankings.csv,1988,1.0,0.0
10800,Lawless Heart,539596,330067,209529,2003_boxofficemojo_rankings.csv,2003,0.6116928220372279,0.38830717796277214
10801,Tom & Viv,538534,538534,0,1994_boxofficemojo_rankings.csv,1994,1.0,0.0
10802,The Last Shot,538526,464275,74251,2004_boxofficemojo_rankings.csv,2004,0.8621217917055073,0.13787820829449274
10803,Clockwatchers,537948,537948,0,1998_boxofficemojo_rankings.csv,1998,1.0,0.0
10804,Lila dit ça,537871,121365,416506,2005_boxofficemojo_rankings.csv,2005,0.22563960503540811,0.7743603949645919
10805,Kids in America,537667,537667,0,2005_boxofficemojo_rankings.csv,2005,1.0,0.0
10806,Grateful Dead Meet-Up 2019,537153,537153,0,2019_boxofficemojo_rankings.csv,2019,1.0,0.0
10807,Pretty Persuasion,537126,305800,231326,2005_boxofficemojo_rankings.csv,2005,0.5693263777958989,0.4306736222041011
10808,Incident at Oglala,536848,536848,0,1992_boxofficemojo_rankings.csv,1992,1.0,0.0
10809,The Young Poisoner's Handbook,536825,536825,0,1996_boxofficemojo_rankings.csv,1996,1.0,0.0
10810,CatVideoFest,536566,470923,65643,2019_boxofficemojo_rankings.csv,2019,0.8776609028525848,0.12233909714741523
10811,Karwaan,536525,182009,354516,2018_boxofficemojo_rankings.csv,2018,0.3392367550440334,0.6607632449559666
10812,Eddie and the Cruisers II: Eddie Lives!,536508,536508,0,1989_boxofficemojo_rankings.csv,1989,1.0,0.0
10813,Once Were Brothers: Robbie Robertson and the Band,536317,449561,86756,2020_boxofficemojo_rankings.csv,2020,0.8382374603079895,0.16176253969201052
10814,Poltergeist 1983 Re-release,536108,536108,0,1983_boxofficemojo_rankings.csv,1983,1.0,0.0
10815,The Underneath,536023,536023,0,1995_boxofficemojo_rankings.csv,1995,1.0,0.0
10816,Intacto 2002 Re-release,535420,307333,228087,2002_boxofficemojo_rankings.csv,2002,0.5740035859698928,0.4259964140301072
10817,Cattle Annie and Little Britches,534816,534816,0,1981_boxofficemojo_rankings.csv,1981,1.0,0.0
10818,Hard Country,534653,534653,0,1981_boxofficemojo_rankings.csv,1981,1.0,0.0
10819,Hungry Hearts,534549,6921,527628,2015_boxofficemojo_rankings.csv,2015,0.012947363104224308,0.9870526368957757
10820,Traveller,534010,534010,0,1997_boxofficemojo_rankings.csv,1997,1.0,0.0
10821,Wild Man Blues,533759,533759,0,1998_boxofficemojo_rankings.csv,1998,1.0,0.0
10822,What They Had,533579,260136,273443,2018_boxofficemojo_rankings.csv,2018,0.4875304312950847,0.5124695687049153
10823,Creature,533235,508714,24521,2011_boxofficemojo_rankings.csv,2011,0.9540146464504393,0.0459853535495607
10824,Kill Your Friends,533147,0,533147,2015_boxofficemojo_rankings.csv,2015,0.0,1.0
10825,Hangin' with the Homeboys,532933,532933,0,1991_boxofficemojo_rankings.csv,1991,1.0,0.0
10826,Noah's Arc: Jumping the Broom,532878,532878,0,2008_boxofficemojo_rankings.csv,2008,1.0,0.0
10827,Kahaani 2,532877,350703,182174,2016_boxofficemojo_rankings.csv,2016,0.6581312385409767,0.3418687614590234
10828,Everybody Wants to Be Italian,532726,351416,181310,2008_boxofficemojo_rankings.csv,2008,0.6596561834789366,0.3403438165210634
10829,Boys Life 2,532654,532654,0,1997_boxofficemojo_rankings.csv,1997,1.0,0.0
10830,Gabbeh,532629,532629,0,1997_boxofficemojo_rankings.csv,1997,1.0,0.0
10831,Funny Bones,532268,532268,0,1995_boxofficemojo_rankings.csv,1995,1.0,0.0
10832,Standing Ovation,531806,531806,0,2010_boxofficemojo_rankings.csv,2010,1.0,0.0
10833,Sex Is...,530833,530833,0,1993_boxofficemojo_rankings.csv,1993,1.0,0.0
10834,"Sex, Drugs, Rock & Roll",530392,530392,0,1991_boxofficemojo_rankings.csv,1991,1.0,0.0
10835,Possessor Uncut,529855,529855,0,2020_boxofficemojo_rankings.csv,2020,1.0,0.0
10836,Things to Do in Denver When You're Dead,529766,529766,0,1995_boxofficemojo_rankings.csv,1995,1.0,0.0
10837,Metropolis 2010 Re-release,529603,529603,0,2010_boxofficemojo_rankings.csv,2010,1.0,0.0
10838,Margaret Atwood: Live in Cinemas,529285,93690,435595,2019_boxofficemojo_rankings.csv,2019,0.177012384632098,0.822987615367902
10839,Evil,528245,15530,512715,2003_boxofficemojo_rankings.csv,2003,0.029399237096423062,0.9706007629035769
10840,A Great Day in Harlem,527034,527034,0,1995_boxofficemojo_rankings.csv,1995,1.0,0.0
10841,Willy Wonka & the Chocolate Factory 2016 Re-release,526954,526633,321,2016_boxofficemojo_rankings.csv,2016,0.9993908386690299,0.0006091613309700657
10842,Scandalous,526805,526805,0,1984_boxofficemojo_rankings.csv,1984,1.0,0.0
10843,Dil Ka Rishta,526571,352128,174443,2003_boxofficemojo_rankings.csv,2003,0.6687189381868732,0.33128106181312683
10844,Only Yesterday 2016 Re-release,525958,453243,72715,2016_boxofficemojo_rankings.csv,2016,0.8617475159613506,0.13825248403864948
10845,The Innocent,525955,525955,0,1995_boxofficemojo_rankings.csv,1995,1.0,0.0
10846,Casa de los babys,525715,478031,47684,2003_boxofficemojo_rankings.csv,2003,0.9092968623683935,0.09070313763160648
10847,Still Crazy,524864,524864,0,1999_boxofficemojo_rankings.csv,1999,1.0,0.0
10848,Proof,524668,524668,0,1992_boxofficemojo_rankings.csv,1992,1.0,0.0
10849,The Weavers: Wasn't That a Time,524203,524203,0,1982_boxofficemojo_rankings.csv,1982,1.0,0.0
10850,12:08 East of Bucharest,523703,91881,431822,2006_boxofficemojo_rankings.csv,2006,0.17544486092308045,0.8245551390769196
10851,The Audience 2019 Re-release,523432,106529,416903,2019_boxofficemojo_rankings.csv,2019,0.20352022803344083,0.7964797719665592
10852,Of Time and the City,523417,32677,490740,2008_boxofficemojo_rankings.csv,2008,0.06243014651797706,0.9375698534820229
10853,The Myth of Fingerprints,523025,523025,0,1997_boxofficemojo_rankings.csv,1997,1.0,0.0
10854,Trouble the Water,522766,520151,2615,2008_boxofficemojo_rankings.csv,2008,0.994997761904944,0.0050022380950559145
10855,Bolshoi Ballet: Carmen Suite/Petrushka,522179,207523,314656,2019_boxofficemojo_rankings.csv,2019,0.39741736071347183,0.6025826392865282
10856,The Cremaster Cycle,522029,514622,7407,2003_boxofficemojo_rankings.csv,2003,0.9858111330979696,0.014188866902030348
10857,The Trials of Henry Kissinger,521266,516726,4540,2002_boxofficemojo_rankings.csv,2002,0.9912904352096626,0.008709564790337371
10858,Hawayein,521260,409978,111282,2003_boxofficemojo_rankings.csv,2003,0.7865134481832483,0.21348655181675172
10859,Sound City,521181,422853,98328,2013_boxofficemojo_rankings.csv,2013,0.8113361768752123,0.18866382312478774
10860,Shadowboxer,519802,370627,149175,2006_boxofficemojo_rankings.csv,2006,0.7130157252184486,0.2869842747815514
10861,Man on Fire,519596,519596,0,1987_boxofficemojo_rankings.csv,1987,1.0,0.0
10862,The Spy Behind Home Plate,519525,519525,0,2019_boxofficemojo_rankings.csv,2019,1.0,0.0
10863,Wild Nights with Emily,519487,519487,0,2019_boxofficemojo_rankings.csv,2019,1.0,0.0
10864,The Circle 2001 Re-release,519354,440554,78800,2001_boxofficemojo_rankings.csv,2001,0.8482730469005726,0.15172695309942735
10865,"Thelonious Monk: Straight, No Chaser",518918,518918,0,1989_boxofficemojo_rankings.csv,1989,1.0,0.0
10866,Scatter My Ashes at Bergdorf's,518342,518342,0,2013_boxofficemojo_rankings.csv,2013,1.0,0.0
10867,Leo and Loree,517988,517988,0,1980_boxofficemojo_rankings.csv,1980,1.0,0.0
10868,Madison,517262,517262,0,2005_boxofficemojo_rankings.csv,2005,1.0,0.0
10869,Trespass Against Us,517197,5711,511486,2017_boxofficemojo_rankings.csv,2017,0.011042214088635472,0.9889577859113645
10870,Grave of the Fireflies,516962,516962,0,2018_boxofficemojo_rankings.csv,2018,1.0,0.0
10871,Voyager,516517,516517,0,1992_boxofficemojo_rankings.csv,1992,1.0,0.0
10872,Rhapsody in August,516431,516431,0,1991_boxofficemojo_rankings.csv,1991,1.0,0.0
10873,Boys,516349,516349,0,1996_boxofficemojo_rankings.csv,1996,1.0,0.0
10874,Listen to Me Marlon,516337,425831,90506,2015_boxofficemojo_rankings.csv,2015,0.824715253797423,0.175284746202577
10875,The Sandlot 2018 Re-release,516130,516130,0,2018_boxofficemojo_rankings.csv,2018,1.0,0.0
10876,Ghost in the Shell,515905,515905,0,1996_boxofficemojo_rankings.csv,1996,1.0,0.0
10877,"Love, Wedding, Marriage",515823,1926,513897,2011_boxofficemojo_rankings.csv,2011,0.003733838933122408,0.9962661610668776
10878,The Big Ugly,515399,514107,1292,2020_boxofficemojo_rankings.csv,2020,0.9974932042941488,0.002506795705851195
10879,Preacher's Kid,515065,515065,0,2010_boxofficemojo_rankings.csv,2010,1.0,0.0
10880,A Hard Day's Night 2014 Re-release,515005,515005,0,2014_boxofficemojo_rankings.csv,2014,1.0,0.0
10881,Goodbye First Love,514913,95000,419913,2011_boxofficemojo_rankings.csv,2011,0.18449718690341863,0.8155028130965813
10882,Federal Hill,514775,514775,0,1994_boxofficemojo_rankings.csv,1994,1.0,0.0
10883,The Polar Express 2009 IMAX Release,514354,514354,0,2009_boxofficemojo_rankings.csv,2009,1.0,0.0
10884,Black Panther 2020 Re-release,513326,367000,146326,2020_boxofficemojo_rankings.csv,2020,0.7149452784390427,0.28505472156095735
10885,Big Eden,512451,512451,0,2001_boxofficemojo_rankings.csv,2001,1.0,0.0
10886,Mifune,512434,512434,0,2000_boxofficemojo_rankings.csv,2000,1.0,0.0
10887,The Assault,512403,512403,0,1986_boxofficemojo_rankings.csv,1986,1.0,0.0
10888,Safe,512245,512245,0,1995_boxofficemojo_rankings.csv,1995,1.0,0.0
10889,Bullitt 2018 Re-release,511350,511350,0,2018_boxofficemojo_rankings.csv,2018,1.0,0.0
10890,Black Butler: Book of the Atlantic,511132,248286,262846,2017_boxofficemojo_rankings.csv,2017,0.4857571038401039,0.514242896159896
10891,Monsters and Men,510967,500101,10866,2018_boxofficemojo_rankings.csv,2018,0.9787344388189453,0.021265561181054746
10892,Unsullied,510957,510957,0,2016_boxofficemojo_rankings.csv,2016,1.0,0.0
10893,The Tall Guy,510712,510712,0,1990_boxofficemojo_rankings.csv,1990,1.0,0.0
10894,Splinter,510358,14154,496204,2008_boxofficemojo_rankings.csv,2008,0.027733473365755018,0.972266526634245
10895,Bol,509872,188850,321022,2011_boxofficemojo_rankings.csv,2011,0.3703870775410299,0.62961292245897
10896,Karmina 2,508969,508969,0,2001_boxofficemojo_rankings.csv,2001,1.0,0.0
10897,The 2007 Academy Award Nominated Short Films: Live Action,508695,508695,0,2008_boxofficemojo_rankings.csv,2008,1.0,0.0
10898,Saving Private Ryan 2019 Re-release,508694,508694,0,2019_boxofficemojo_rankings.csv,2019,1.0,0.0
10899,Una,508169,22815,485354,2017_boxofficemojo_rankings.csv,2017,0.04489648128870514,0.9551035187112948
10900,The Good Night,508084,22441,485643,2007_boxofficemojo_rankings.csv,2007,0.04416789349792554,0.9558321065020745
10901,"Mr. Death: The Rise and Fall of Fred A. Leuchter, Jr.",507941,507941,0,1999_boxofficemojo_rankings.csv,1999,1.0,0.0
10902,The Other End of the Line,507534,115592,391942,2008_boxofficemojo_rankings.csv,2008,0.22775222940729095,0.7722477705927091
10903,The Inevitable Defeat of Mister & Pete,506303,494608,11695,2013_boxofficemojo_rankings.csv,2013,0.9769011836785482,0.02309881632145178
10904,Our Last Tango,505885,100086,405799,2015_boxofficemojo_rankings.csv,2015,0.19784338337764512,0.8021566166223549
10905,Gabriel and the Mountain,505769,18415,487354,2017_boxofficemojo_rankings.csv,2017,0.03640990254444223,0.9635900974555578
10906,A Town Called Panic,505699,165509,340190,2009_boxofficemojo_rankings.csv,2009,0.3272875762063995,0.6727124237936005
10907,Manna from Heaven,505675,505675,0,2002_boxofficemojo_rankings.csv,2002,1.0,0.0
10908,Pippi Longstocking,505335,505335,0,1997_boxofficemojo_rankings.csv,1997,1.0,0.0
10909,Have a Nice Day,504003,79393,424610,2018_boxofficemojo_rankings.csv,2018,0.15752485600284125,0.8424751439971587
10910,Girls Town,503667,503667,0,1996_boxofficemojo_rankings.csv,1996,1.0,0.0
10911,Letters From Baghdad,502941,359735,143206,2017_boxofficemojo_rankings.csv,2017,0.7152628240688271,0.2847371759311728
10912,Mishima: A Life in Four Chapters,502758,437547,65211,1985_boxofficemojo_rankings.csv,1985,0.8702934612676476,0.12970653873235236
10913,Chuck,502518,320725,181793,2017_boxofficemojo_rankings.csv,2017,0.6382358442881648,0.3617641557118352
10914,Amadeus Director's Cut,502511,408749,93762,2002_boxofficemojo_rankings.csv,2002,0.8134130397145535,0.1865869602854465
10915,Shaadi No. 1,502389,336772,165617,2005_boxofficemojo_rankings.csv,2005,0.6703411101755811,0.32965888982441893
10916,Manny & Lo,502313,502313,0,1996_boxofficemojo_rankings.csv,1996,1.0,0.0
10917,Deli Man,502294,502294,0,2015_boxofficemojo_rankings.csv,2015,1.0,0.0
10918,Dream Lover,502237,502237,0,1986_boxofficemojo_rankings.csv,1986,1.0,0.0
10919,Cube,501818,501818,0,1998_boxofficemojo_rankings.csv,1998,1.0,0.0
10920,The Triumph of Love,501442,447267,54175,2002_boxofficemojo_rankings.csv,2002,0.8919615827952186,0.10803841720478141
10921,Bride Flight 2011 Re-release,501360,501360,0,2011_boxofficemojo_rankings.csv,2011,1.0,0.0
10922,Synonyms,501223,206003,295220,2019_boxofficemojo_rankings.csv,2019,0.411000692306618,0.5889993076933819
10923,His Secret Life,500930,215449,285481,2001_boxofficemojo_rankings.csv,2001,0.430098017687102,0.569901982312898
10924,Alice and Martin,500896,500896,0,2000_boxofficemojo_rankings.csv,2000,1.0,0.0
10925,The Killing Time,500283,500283,0,1987_boxofficemojo_rankings.csv,1987,1.0,0.0
10926,Fireworks,500000,500000,0,1998_boxofficemojo_rankings.csv,1998,1.0,0.0
10927,CQ,499891,414358,85533,2002_boxofficemojo_rankings.csv,2002,0.8288966994804867,0.17110330051951325
10928,Smashed,499725,376597,123128,2012_boxofficemojo_rankings.csv,2012,0.7536084846665666,0.2463915153334334
10929,Home of the Brave,499620,51708,447912,2006_boxofficemojo_rankings.csv,2006,0.10349465593851327,0.8965053440614867
10930,The Burnt Orange Heresy,499391,144201,355190,2020_boxofficemojo_rankings.csv,2020,0.28875370200904704,0.711246297990953
10931,Time of the Wolf,499149,61439,437710,2003_boxofficemojo_rankings.csv,2003,0.12308749491634763,0.8769125050836524
10932,Hamari Adhuri Kahani,498774,235361,263413,2015_boxofficemojo_rankings.csv,2015,0.4718790474242843,0.5281209525757157
10933,Whisper of the Heart 2019 Re-release,498156,498156,0,2019_boxofficemojo_rankings.csv,2019,1.0,0.0
10934,The Five Senses,497091,497091,0,2000_boxofficemojo_rankings.csv,2000,1.0,0.0
10935,Color Me Kubrick,497009,71190,425819,2006_boxofficemojo_rankings.csv,2006,0.14323684279359125,0.8567631572064087
10936,Kahlil Gibran's The Prophet 2015 Re-release,496914,370146,126768,2015_boxofficemojo_rankings.csv,2015,0.7448894577331289,0.25511054226687113
10937,Felix and Meira,496714,447353,49361,2015_boxofficemojo_rankings.csv,2015,0.9006249068880684,0.09937509311193161
10938,Bent,496059,496059,0,1997_boxofficemojo_rankings.csv,1997,1.0,0.0
10939,April and the Extraordinary World,495879,295488,200391,2015_boxofficemojo_rankings.csv,2015,0.5958873031525836,0.4041126968474164
10940,Nausicaä of the Valley of the Wind 2019 Re-release,495770,495770,0,2019_boxofficemojo_rankings.csv,2019,1.0,0.0
10941,Idiocracy,495303,444093,51210,2006_boxofficemojo_rankings.csv,2006,0.8966087425273015,0.10339125747269853
10942,Eden,494949,65460,429489,2014_boxofficemojo_rankings.csv,2014,0.13225605062339757,0.8677439493766025
10943,Uncle Joe Shannon,494797,494797,0,1978_boxofficemojo_rankings.csv,1978,1.0,0.0
10944,The Invisible Circus,494630,77578,417052,2001_boxofficemojo_rankings.csv,2001,0.1568404666114065,0.8431595333885935
10945,Steve Jobs: The Man in the Machine,494506,494506,0,2015_boxofficemojo_rankings.csv,2015,1.0,0.0
10946,Monty Python's Life of Brian 2019 Re-release,494444,161507,332937,2019_boxofficemojo_rankings.csv,2019,0.32664366439879944,0.6733563356012006
10947,À Tout de Suite,494030,248565,245465,2004_boxofficemojo_rankings.csv,2004,0.503137461287776,0.49686253871222397
10948,L'incomparable mademoiselle C.,493905,493905,0,2004_boxofficemojo_rankings.csv,2004,1.0,0.0
10949,The Polar Express 2013 IMAX Release,493776,493776,0,2013_boxofficemojo_rankings.csv,2013,1.0,0.0
10950,Rain,492661,455164,37497,2002_boxofficemojo_rankings.csv,2002,0.9238888403993821,0.07611115960061787
10951,Two Night Stand,492332,18612,473720,2014_boxofficemojo_rankings.csv,2014,0.03780375843942705,0.9621962415605729
10952,Man of Iron,492035,492035,0,1981_boxofficemojo_rankings.csv,1981,1.0,0.0
10953,Soul on a String,491294,3669,487625,2017_boxofficemojo_rankings.csv,2017,0.007468033397517576,0.9925319666024824
10954,Beyond the Gates 2006 Re-release,491155,40848,450307,2006_boxofficemojo_rankings.csv,2006,0.08316722826806201,0.916832771731938
10955,Wolves,491154,12139,479015,2014_boxofficemojo_rankings.csv,2014,0.024715262422783893,0.9752847375772161
10956,I'll Sleep When I'm Dead,490964,360759,130205,2004_boxofficemojo_rankings.csv,2004,0.734797256010624,0.265202743989376
10957,Tape,490475,490475,0,2001_boxofficemojo_rankings.csv,2001,1.0,0.0
10958,Joker,490291,169181,321110,2012_boxofficemojo_rankings.csv,2012,0.34506242211258215,0.6549375778874179
10959,Open Grave,489812,0,489812,2013_boxofficemojo_rankings.csv,2013,0.0,1.0
10960,Brothers,489706,389220,100486,2004_boxofficemojo_rankings.csv,2004,0.7948034126598408,0.2051965873401592
10961,Zama,489692,200600,289092,2017_boxofficemojo_rankings.csv,2017,0.40964524639977784,0.5903547536002222
10962,L'amour fou,489126,312494,176632,2010_boxofficemojo_rankings.csv,2010,0.638882414756116,0.361117585243884
10963,What Richard Did,488327,2749,485578,2012_boxofficemojo_rankings.csv,2012,0.0056294245454377905,0.9943705754545622
10964,Asa Nu Maan Watna Da: In Search of Our Roots,487893,235075,252818,2004_boxofficemojo_rankings.csv,2004,0.4818167098113726,0.5181832901886274
10965,At Any Price,487455,380594,106861,2013_boxofficemojo_rankings.csv,2013,0.7807777128145162,0.21922228718548378
10966,London Fields,487420,252676,234744,2018_boxofficemojo_rankings.csv,2018,0.5183948135078577,0.4816051864921423
10967,The Browning Version,487391,487391,0,1994_boxofficemojo_rankings.csv,1994,1.0,0.0
10968,Full of It,486722,14273,472449,2007_boxofficemojo_rankings.csv,2007,0.02932474800810319,0.9706752519918969
10969,Beach Rats,486623,473771,12852,2017_boxofficemojo_rankings.csv,2017,0.973589411104695,0.02641058889530499
10970,September,486434,486434,0,1987_boxofficemojo_rankings.csv,1987,1.0,0.0
10971,Meet the Applegates,485772,485772,0,1991_boxofficemojo_rankings.csv,1991,1.0,0.0
10972,Kisna: The Warrior Poet,485613,147000,338613,2005_boxofficemojo_rankings.csv,2005,0.3027101827998839,0.6972898172001162
10973,Cooties,485544,60058,425486,2015_boxofficemojo_rankings.csv,2015,0.12369218855551711,0.8763078114444829
10974,The Russian Five,485049,485049,0,2019_boxofficemojo_rankings.csv,2019,1.0,0.0
10975,In Praise of Love,485003,252074,232929,2001_boxofficemojo_rankings.csv,2001,0.5197369913175794,0.4802630086824205
10976,10 Questions for the Dalai Lama,484487,224546,259941,2007_boxofficemojo_rankings.csv,2007,0.46347167209852896,0.5365283279014711
10977,Dynamite Warrior,483737,52292,431445,2006_boxofficemojo_rankings.csv,2006,0.10810006263734219,0.8918999373626578
10978,63 Up,483684,483684,0,2019_boxofficemojo_rankings.csv,2019,1.0,0.0
10979,Our Little Sister 2016 Re-release,483559,467555,16004,2016_boxofficemojo_rankings.csv,2016,0.9669037283971552,0.03309627160284474
10980,Lawrence of Arabia 2019 Re-release,482281,482281,0,2019_boxofficemojo_rankings.csv,2019,1.0,0.0
10981,The Journey,482209,155475,326734,2017_boxofficemojo_rankings.csv,2017,0.32242243508520163,0.6775775649147984
10982,I Origins,481234,336472,144762,2014_boxofficemojo_rankings.csv,2014,0.6991858430617953,0.3008141569382047
10983,Breathe In,481079,89661,391418,2013_boxofficemojo_rankings.csv,2013,0.1863747949920907,0.8136252050079094
10984,Flamenco,480941,480941,0,1997_boxofficemojo_rankings.csv,1997,1.0,0.0
10985,Father of My Children,480834,144022,336812,2010_boxofficemojo_rankings.csv,2010,0.29952540793704274,0.7004745920629573
10986,The Cuckoo,480578,243936,236642,2002_boxofficemojo_rankings.csv,2002,0.5075887785125411,0.49241122148745886
10987,Crossing the Bridge,479676,479676,0,1992_boxofficemojo_rankings.csv,1992,1.0,0.0
10988,Just Another Girl on the I.R.T.,479169,479169,0,1993_boxofficemojo_rankings.csv,1993,1.0,0.0
10989,The Third Man 2015 Re-release,478945,449191,29754,2015_boxofficemojo_rankings.csv,2015,0.9378759565294553,0.062124043470544635
10990,Brotherly Love,478595,478595,0,2015_boxofficemojo_rankings.csv,2015,1.0,0.0
10991,The Last September,478053,478053,0,2000_boxofficemojo_rankings.csv,2000,1.0,0.0
10992,Liam Gallagher: As It Was,477009,0,477009,2019_boxofficemojo_rankings.csv,2019,0.0,1.0
10993,Blue Car,476551,465310,11241,2003_boxofficemojo_rankings.csv,2003,0.9764117586575204,0.02358824134247961
10994,Heart of a Dog,476384,420813,55571,2015_boxofficemojo_rankings.csv,2015,0.8833483072479345,0.11665169275206556
10995,The Babymakers,475511,7889,467622,2012_boxofficemojo_rankings.csv,2012,0.016590573088740325,0.9834094269112597
10996,Gorillaz: Reject False Icons,475465,453687,21778,2019_boxofficemojo_rankings.csv,2019,0.9541964182431935,0.045803581756806495
10997,Plunkett & Macleane,474900,474900,0,1999_boxofficemojo_rankings.csv,1999,1.0,0.0
10998,Producing Adults,474752,935,473817,2004_boxofficemojo_rankings.csv,2004,0.001969449312483149,0.9980305506875169
10999,The Stone Angel,473993,459166,14827,2008_boxofficemojo_rankings.csv,2008,0.9687189473262263,0.031281052673773665
11000,Humpday,473980,407377,66603,2009_boxofficemojo_rankings.csv,2009,0.8594814127178362,0.1405185872821638
11001,The Shawshank Redemption 2019 Re-release,473776,358507,115269,2019_boxofficemojo_rankings.csv,2019,0.7567014791800345,0.24329852081996556
11002,On the Job,472890,164620,308270,2013_boxofficemojo_rankings.csv,2013,0.34811478356488823,0.6518852164351118
11003,Party Girl,472370,472370,0,1995_boxofficemojo_rankings.csv,1995,1.0,0.0
11004,Beer League,472185,472185,0,2006_boxofficemojo_rankings.csv,2006,1.0,0.0
11005,Pearl Jam Twenty,471334,471334,0,2011_boxofficemojo_rankings.csv,2011,1.0,0.0
11006,Reconstruction,471107,73516,397591,2003_boxofficemojo_rankings.csv,2003,0.15604947496004093,0.843950525039959
11007,Darbareye Elly 2015 Re-release,470760,470760,0,2015_boxofficemojo_rankings.csv,2015,1.0,0.0
11008,Kelly,469777,469777,0,1981_boxofficemojo_rankings.csv,1981,1.0,0.0
11009,White Bird in a Blizzard,469701,33821,435880,2014_boxofficemojo_rankings.csv,2014,0.07200538214736608,0.9279946178526339
11010,A Midwinter's Tale,469571,469571,0,1996_boxofficemojo_rankings.csv,1996,1.0,0.0
11011,When the Road Bends... Tales of a Gypsy Caravan,469507,442936,26571,2007_boxofficemojo_rankings.csv,2007,0.9434065945768647,0.05659340542313533
11012,Matangi/Maya/M.I.A,469489,230808,238681,2018_boxofficemojo_rankings.csv,2018,0.49161535201037726,0.5083846479896228
11013,Maybe... Maybe Not,468930,468930,0,1996_boxofficemojo_rankings.csv,1996,1.0,0.0
11014,Joe Gould's Secret,468684,468684,0,2000_boxofficemojo_rankings.csv,2000,1.0,0.0
11015,DCI 2017 Tour Premeire,467817,467817,0,2017_boxofficemojo_rankings.csv,2017,1.0,0.0
11016,Time Freak,467693,10003,457690,2018_boxofficemojo_rankings.csv,2018,0.021387961761240814,0.9786120382387592
11017,Hail Satan?,467361,424284,43077,2019_boxofficemojo_rankings.csv,2019,0.9078292797216713,0.09217072027832875
11018,True History of the Kelly Gang,467198,33817,433381,2020_boxofficemojo_rankings.csv,2020,0.07238258725422626,0.9276174127457737
11019,Tully,466664,466664,0,2002_boxofficemojo_rankings.csv,2002,1.0,0.0
11020,The Broken Line,466309,466309,0,2008_boxofficemojo_rankings.csv,2008,1.0,0.0
11021,Last Days in Vietnam,466114,466114,0,2014_boxofficemojo_rankings.csv,2014,1.0,0.0
11022,Neighboring Sounds,465082,60255,404827,2012_boxofficemojo_rankings.csv,2012,0.1295577984097428,0.8704422015902572
11023,Venus Beauty,465080,465080,0,2000_boxofficemojo_rankings.csv,2000,1.0,0.0
11024,Church Ball,464991,464991,0,2006_boxofficemojo_rankings.csv,2006,1.0,0.0
11025,Ghanchakkar,464803,203044,261759,2013_boxofficemojo_rankings.csv,2013,0.43683883279582963,0.5631611672041704
11026,Puffs: Filmed Live Off Broadway,464483,464483,0,2018_boxofficemojo_rankings.csv,2018,1.0,0.0
11027,Colonel Chabert,464284,464284,0,1994_boxofficemojo_rankings.csv,1994,1.0,0.0
11028,Slaves of New York,463972,463972,0,1989_boxofficemojo_rankings.csv,1989,1.0,0.0
11029,Rififi 2000 Re-release,463593,460226,3367,2000_boxofficemojo_rankings.csv,2000,0.9927371638484619,0.0072628361515380945
11030,The Second Chance,463542,463542,0,2006_boxofficemojo_rankings.csv,2006,1.0,0.0
11031,Romeo & Juliet: Sealed with a Kiss,463002,463002,0,2006_boxofficemojo_rankings.csv,2006,1.0,0.0
11032,Demonlover,462976,232044,230932,2002_boxofficemojo_rankings.csv,2002,0.5012009261819187,0.4987990738180813
11033,Deepsea Challenge,462959,235659,227300,2014_boxofficemojo_rankings.csv,2014,0.5090277972779447,0.4909722027220553
11034,Before We Go,462875,37151,425724,2015_boxofficemojo_rankings.csv,2015,0.08026140966783689,0.9197385903321631
11035,The Bag Man,461780,56574,405206,2014_boxofficemojo_rankings.csv,2014,0.12251288492355668,0.8774871150764433
11036,MFKZ,461724,229423,232301,2018_boxofficemojo_rankings.csv,2018,0.4968834195320148,0.5031165804679852
11037,Scotty and the Secret History of Hollywood,461689,461689,0,2018_boxofficemojo_rankings.csv,2018,1.0,0.0
11038,Outfoxed: Rupert Murdoch's War on Journalism,461572,461572,0,2004_boxofficemojo_rankings.csv,2004,1.0,0.0
11039,Bully,461405,279202,182203,2012_boxofficemojo_rankings.csv,2012,0.6051126450732003,0.39488735492679966
11040,Disorder,460997,51879,409118,2015_boxofficemojo_rankings.csv,2015,0.11253652409885531,0.8874634759011447
11041,The Dark Knight 2018 Re-release,460178,375589,84589,2018_boxofficemojo_rankings.csv,2018,0.8161819991394634,0.18381800086053657
11042,Inside Out 2020 Re-release,460176,460000,176,2020_boxofficemojo_rankings.csv,2020,0.9996175376377734,0.0003824623622266263
11043,Alexandra,460139,128222,331917,2007_boxofficemojo_rankings.csv,2007,0.2786592746974284,0.7213407253025717
11044,The House on Carroll Street,459824,459824,0,1988_boxofficemojo_rankings.csv,1988,1.0,0.0
11045,The Last Supper,459749,459749,0,1996_boxofficemojo_rankings.csv,1996,1.0,0.0
11046,Manglehorn,459636,143101,316535,2015_boxofficemojo_rankings.csv,2015,0.3113354915628889,0.6886645084371111
11047,Christmas Jars,459462,459462,0,2019_boxofficemojo_rankings.csv,2019,1.0,0.0
11048,Eric Clapton: A Life in 12 Bars,459088,0,459088,2017_boxofficemojo_rankings.csv,2017,0.0,1.0
11049,The Legend of Suriyothai,458564,454736,3828,2003_boxofficemojo_rankings.csv,2003,0.991652201219459,0.008347798780540993
11050,Brooklyn Rules,458232,458232,0,2007_boxofficemojo_rankings.csv,2007,1.0,0.0
11051,Shade,458144,25032,433112,2004_boxofficemojo_rankings.csv,2004,0.054637843123559404,0.9453621568764405
11052,The Memory of a Killer 2005 Re-release,458042,333707,124335,2005_boxofficemojo_rankings.csv,2005,0.7285510935678388,0.27144890643216124
11053,South Pacific 2018 Re-release,458000,458000,0,2018_boxofficemojo_rankings.csv,2018,1.0,0.0
11054,The Promotion,457690,408709,48981,2008_boxofficemojo_rankings.csv,2008,0.8929821494898293,0.10701785051017064
11055,We Steal Secrets,457517,166243,291274,2013_boxofficemojo_rankings.csv,2013,0.3633591757246179,0.6366408242753822
11056,Life Partner,457340,110240,347100,2009_boxofficemojo_rankings.csv,2009,0.24104604889141557,0.7589539511085844
11057,Paradise: Hope,457132,6701,450431,2013_boxofficemojo_rankings.csv,2013,0.014658785646159096,0.9853412143538409
11058,Sound of Noise,456366,24565,431801,2010_boxofficemojo_rankings.csv,2010,0.05382741045564306,0.9461725895443569
11059,Staying Vertical,456271,12158,444113,2016_boxofficemojo_rankings.csv,2016,0.026646444766377876,0.9733535552336221
11060,McBain,456127,456127,0,1991_boxofficemojo_rankings.csv,1991,1.0,0.0
11061,Lola Versus,455754,252603,203151,2012_boxofficemojo_rankings.csv,2012,0.5542529522505563,0.4457470477494438
11062,Alone,455148,428111,27037,2020_boxofficemojo_rankings.csv,2020,0.9405973441605807,0.05940265583941927
11063,The Gospel According to André,454550,400713,53837,2018_boxofficemojo_rankings.csv,2018,0.881559784402156,0.11844021559784403
11064,The Little Traitor,454481,402088,52393,2009_boxofficemojo_rankings.csv,2009,0.8847190531617384,0.11528094683826166
11065,Wristcutters: A Love Story,454026,446165,7861,2007_boxofficemojo_rankings.csv,2007,0.982686013576315,0.017313986423684986
11066,The Most Dangerous Man in America: Daniel Ellsberg and the Pentagon Papers,453993,453993,0,2010_boxofficemojo_rankings.csv,2010,1.0,0.0
11067,Warm Water Under a Red Bridge,453754,71094,382660,2001_boxofficemojo_rankings.csv,2001,0.15667961053786852,0.8433203894621315
11068,Kajillionaire,453705,453705,0,2020_boxofficemojo_rankings.csv,2020,1.0,0.0
11069,The Safety of Objects,453292,319299,133993,2002_boxofficemojo_rankings.csv,2002,0.7044002541408187,0.29559974585918125
11070,Ten,452895,105990,346905,2002_boxofficemojo_rankings.csv,2002,0.23402775477759746,0.7659722452224026
11071,Leaning Into The Wind,452372,400530,51842,2018_boxofficemojo_rankings.csv,2018,0.8853996268557736,0.11460037314422643
11072,Sailor Moon R: The Movie: The Promise of the Rose,452053,452053,0,2017_boxofficemojo_rankings.csv,2017,1.0,0.0
11073,The Perfect Host,450885,48764,402121,2011_boxofficemojo_rankings.csv,2011,0.10815174601062355,0.8918482539893764
11074,Fear(s) of the Dark,450813,77876,372937,2008_boxofficemojo_rankings.csv,2008,0.17274568390884912,0.8272543160911509
11075,Full Moon in Blue Water,450726,450726,0,1988_boxofficemojo_rankings.csv,1988,1.0,0.0
11076,Perfect Blue 2017 Re-release,450594,446062,4532,2017_boxofficemojo_rankings.csv,2017,0.9899421652307843,0.010057834769215747
11077,Danzón,450501,450501,0,1992_boxofficemojo_rankings.csv,1992,1.0,0.0
11078,Kill List,450275,29063,421212,2011_boxofficemojo_rankings.csv,2011,0.06454500027760812,0.9354549997223919
11079,Pearl Jam: Let's Play Two,450273,348833,101440,2017_boxofficemojo_rankings.csv,2017,0.7747144510108313,0.2252855489891688
11080,Azúcar amarga,450060,450060,0,1996_boxofficemojo_rankings.csv,1996,1.0,0.0
11081,"The Wonderful, Horrible Life of Leni Riefenstahl",449707,449707,0,1994_boxofficemojo_rankings.csv,1994,1.0,0.0
11082,Hesher,449702,382946,66756,2011_boxofficemojo_rankings.csv,2011,0.8515550297752734,0.1484449702247266
11083,London to Brighton,449681,6700,442981,2006_boxofficemojo_rankings.csv,2006,0.014899450944113716,0.9851005490558863
11084,17 Girls,449626,15123,434503,2011_boxofficemojo_rankings.csv,2011,0.033634620773709704,0.9663653792262903
11085,Lockdown,449482,449482,0,2003_boxofficemojo_rankings.csv,2003,1.0,0.0
11086,The Rocket,449064,56823,392241,2013_boxofficemojo_rankings.csv,2013,0.1265365293143071,0.8734634706856929
11087,Before We Vanish,448829,52087,396742,2017_boxofficemojo_rankings.csv,2017,0.11605087906530104,0.8839491209346989
11088,The Heart of the Game,446446,445374,1072,2006_boxofficemojo_rankings.csv,2006,0.9975988137423115,0.0024011862576885
11089,The Sleeping Beauty,446131,29066,417065,2011_boxofficemojo_rankings.csv,2011,0.06515126722868395,0.9348487327713161
11090,I Am Trying to Break Your Heart,445522,445522,0,2002_boxofficemojo_rankings.csv,2002,1.0,0.0
11091,Cruel Intentions 2019 Re-release,445218,445218,0,2019_boxofficemojo_rankings.csv,2019,1.0,0.0
11092,Fast Charlie... the Moonbeam Rider,444334,444334,0,1979_boxofficemojo_rankings.csv,1979,1.0,0.0
11093,Baise-moi,444243,420224,24019,2000_boxofficemojo_rankings.csv,2000,0.9459327440162254,0.05406725598377465
11094,The Rainbow,444055,444055,0,1989_boxofficemojo_rankings.csv,1989,1.0,0.0
11095,Charlie Countryman,443990,11650,432340,2013_boxofficemojo_rankings.csv,2013,0.026239329714633212,0.9737606702853668
11096,The Hammer,443591,443591,0,2008_boxofficemojo_rankings.csv,2008,1.0,0.0
11097,Modern Times 2003 Re-release,443427,163577,279850,2003_boxofficemojo_rankings.csv,2003,0.3688927376997792,0.6311072623002207
11098,It's All About Love,443400,6140,437260,2003_boxofficemojo_rankings.csv,2003,0.013847541723049165,0.9861524582769509
11099,Nadja,443169,443169,0,1995_boxofficemojo_rankings.csv,1995,1.0,0.0
11100,Porco Rosso 2018 Re-release,443059,443059,0,2018_boxofficemojo_rankings.csv,2018,1.0,0.0
11101,StarDog and TurboCat,443030,80490,362540,2019_boxofficemojo_rankings.csv,2019,0.1816806988240074,0.8183193011759926
11102,The Beautiful Country 2005 Re-release,442813,442813,0,2005_boxofficemojo_rankings.csv,2005,1.0,0.0
11103,Especially on Sunday,442676,442676,0,1993_boxofficemojo_rankings.csv,1993,1.0,0.0
11104,As You Like It,442515,0,442515,2006_boxofficemojo_rankings.csv,2006,0.0,1.0
11105,Prince Avalanche,442313,205139,237174,2013_boxofficemojo_rankings.csv,2013,0.46378695629565486,0.5362130437043451
11106,Elf 2018 Re-release,442073,442073,0,2018_boxofficemojo_rankings.csv,2018,1.0,0.0
11107,"'night, Mother",441863,441863,0,1986_boxofficemojo_rankings.csv,1986,1.0,0.0
11108,Morons from Outer Space,441137,441137,0,1985_boxofficemojo_rankings.csv,1985,1.0,0.0
11109,Aitraaz,440684,91998,348686,2004_boxofficemojo_rankings.csv,2004,0.20876183387642847,0.7912381661235716
11110,Bastards,439935,24525,415410,2013_boxofficemojo_rankings.csv,2013,0.05574687169695523,0.9442531283030448
11111,Short Cut to Nirvana: Kumbh Mela,439651,381225,58426,2004_boxofficemojo_rankings.csv,2004,0.8671082290271147,0.13289177097288532
11112,Bitch Slap,439587,17365,422222,2010_boxofficemojo_rankings.csv,2010,0.03950298803194817,0.9604970119680518
11113,Akira,439162,439162,0,1989_boxofficemojo_rankings.csv,1989,1.0,0.0
11114,Santa vs. the Snowman 3D 2008 Re-release,438385,433797,4588,2008_boxofficemojo_rankings.csv,2008,0.9895343134459437,0.010465686554056367
11115,Desert Dancer,438165,155271,282894,2014_boxofficemojo_rankings.csv,2014,0.3543665057683749,0.6456334942316251
11116,CatVideoFest 2020,437625,437625,0,2020_boxofficemojo_rankings.csv,2020,1.0,0.0
11117,Offside,437055,180530,256525,2006_boxofficemojo_rankings.csv,2006,0.41306014117216366,0.5869398588278363
11118,Dorm Daze,436365,56127,380238,2003_boxofficemojo_rankings.csv,2003,0.12862397305008422,0.8713760269499158
11119,My Kingdom,435759,36533,399226,2011_boxofficemojo_rankings.csv,2011,0.08383762584364293,0.916162374156357
11120,The Singing Detective,435625,337174,98451,2003_boxofficemojo_rankings.csv,2003,0.7740005738880918,0.22599942611190818
11121,The Wayward Cloud,435251,0,435251,2005_boxofficemojo_rankings.csv,2005,0.0,1.0
11122,We the Animals,434743,400961,33782,2018_boxofficemojo_rankings.csv,2018,0.9222943210126443,0.07770567898735575
11123,Moolaadé,434553,215646,218907,2004_boxofficemojo_rankings.csv,2004,0.4962478684993545,0.5037521315006455
11124,What We Left Behind: Star Trek DS9,434437,382457,51980,2019_boxofficemojo_rankings.csv,2019,0.8803508909231949,0.11964910907680515
11125,Chaos 2002 Re-release,434432,206789,227643,2002_boxofficemojo_rankings.csv,2002,0.47599854522687096,0.5240014547731291
11126,DCI 2018 Tour Premeire,434008,434008,0,2018_boxofficemojo_rankings.csv,2018,1.0,0.0
11127,Rosenwald,433924,433924,0,2015_boxofficemojo_rankings.csv,2015,1.0,0.0
11128,The Shining 40th Anniversary,433807,0,433807,2020_boxofficemojo_rankings.csv,2020,0.0,1.0
11129,Bjork: Biophilia Live,433686,127754,305932,2014_boxofficemojo_rankings.csv,2014,0.29457718256987775,0.7054228174301223
11130,I Want Your Money,433588,433588,0,2010_boxofficemojo_rankings.csv,2010,1.0,0.0
11131,The Sower,433112,36233,396879,2018_boxofficemojo_rankings.csv,2018,0.08365734498236022,0.9163426550176398
11132,The Devil and Daniel Johnston,432339,334450,97889,2006_boxofficemojo_rankings.csv,2006,0.7735827672266439,0.2264172327733561
11133,La petite Jérusalem,431623,53580,378043,2005_boxofficemojo_rankings.csv,2005,0.12413610952150372,0.8758638904784963
11134,When Do We Eat?,431513,431513,0,2006_boxofficemojo_rankings.csv,2006,1.0,0.0
11135,Promises,430862,247948,182914,2002_boxofficemojo_rankings.csv,2002,0.5754696399311149,0.42453036006888517
11136,Harmony,430568,23248,407320,2015_boxofficemojo_rankings.csv,2015,0.0539937942438825,0.9460062057561175
11137,Ghostbusters 2019 Re-release,430435,369612,60823,2019_boxofficemojo_rankings.csv,2019,0.8586941117706506,0.1413058882293494
11138,Just the Ticket,430404,430404,0,1999_boxofficemojo_rankings.csv,1999,1.0,0.0
11139,Andy Irons: Kissed by God,430393,285933,144460,2018_boxofficemojo_rankings.csv,2018,0.6643532771211428,0.3356467228788572
11140,Iron Man 2020 Re-release,430000,430000,0,2020_boxofficemojo_rankings.csv,2020,1.0,0.0
11141,Go Goa Gone,429350,298457,130893,2013_boxofficemojo_rankings.csv,2013,0.6951368347502038,0.30486316524979623
11142,On the Beach at Night Alone,429159,37489,391670,2017_boxofficemojo_rankings.csv,2017,0.08735457021756506,0.9126454297824349
11143,Infamous,429148,429148,0,2020_boxofficemojo_rankings.csv,2020,1.0,0.0
11144,Track 29,429028,429028,0,1988_boxofficemojo_rankings.csv,1988,1.0,0.0
11145,Body Snatchers,428868,428868,0,1994_boxofficemojo_rankings.csv,1994,1.0,0.0
11146,Revolver 2007 Re-release,428620,84738,343882,2007_boxofficemojo_rankings.csv,2007,0.19769959404600812,0.8023004059539919
11147,"A Woman, a Gun and a Noodle Shop",428249,190946,237303,2009_boxofficemojo_rankings.csv,2009,0.4458761141298637,0.5541238858701363
11148,The Singing Revolution,426855,426855,0,2007_boxofficemojo_rankings.csv,2007,1.0,0.0
11149,Blackway,426491,27079,399412,2016_boxofficemojo_rankings.csv,2016,0.06349254732221782,0.9365074526777821
11150,Happy Bhaag Jayegi 2016 Re-release,426345,351840,74505,2016_boxofficemojo_rankings.csv,2016,0.825247158990958,0.17475284100904198
11151,Josh,426318,426318,0,2000_boxofficemojo_rankings.csv,2000,1.0,0.0
11152,Fido,426224,304533,121691,2007_boxofficemojo_rankings.csv,2007,0.7144905026464957,0.2855094973535043
11153,Luck,426221,149333,276888,2009_boxofficemojo_rankings.csv,2009,0.35036518613583095,0.6496348138641691
11154,Killing Sarai,425332,425332,0,2019_boxofficemojo_rankings.csv,2019,1.0,0.0
11155,Vertigo 2018 Re-release,425152,394212,30940,2018_boxofficemojo_rankings.csv,2018,0.9272260273972602,0.07277397260273973
11156,Earth,424798,424798,0,1999_boxofficemojo_rankings.csv,1999,1.0,0.0
11157,Drowning by Numbers,424773,424773,0,1991_boxofficemojo_rankings.csv,1991,1.0,0.0
11158,8 ½ Women,424123,424123,0,2000_boxofficemojo_rankings.csv,2000,1.0,0.0
11159,Sound of My Voice,424088,408015,16073,2012_boxofficemojo_rankings.csv,2012,0.9620998472015242,0.037900152798475785
11160,Viva,423976,178008,245968,2016_boxofficemojo_rankings.csv,2016,0.41985395399739606,0.5801460460026039
11161,God Help the Girl,423306,102757,320549,2014_boxofficemojo_rankings.csv,2014,0.2427487444071192,0.7572512555928808
11162,Taking Sides,422832,188952,233880,2002_boxofficemojo_rankings.csv,2002,0.44687251674423883,0.5531274832557611
11163,Cirque du Soleil in Cinema: KURIOS - Cabinet of Curiosities,422760,413039,9721,2018_boxofficemojo_rankings.csv,2018,0.9770058662125083,0.02299413378749172
11164,Mississippi Grind,422746,130541,292205,2015_boxofficemojo_rankings.csv,2015,0.3087929868053157,0.6912070131946842
11165,Behaving Badly,422697,0,422697,2014_boxofficemojo_rankings.csv,2014,0.0,1.0
11166,Tiger Warsaw,422667,422667,0,1988_boxofficemojo_rankings.csv,1988,1.0,0.0
11167,Ben-Hur 2019 Re-release,422622,422622,0,2019_boxofficemojo_rankings.csv,2019,1.0,0.0
11168,Super,422618,327716,94902,2011_boxofficemojo_rankings.csv,2011,0.7754425982802436,0.22455740171975638
11169,Storyville,422503,422503,0,1992_boxofficemojo_rankings.csv,1992,1.0,0.0
11170,Settai,422247,87838,334409,2013_boxofficemojo_rankings.csv,2013,0.20802516062873153,0.7919748393712684
11171,Mad Max: Fury Road 2016 Re-release,421986,421986,0,2016_boxofficemojo_rankings.csv,2016,1.0,0.0
11172,She's Beautiful When She's Angry,421573,421573,0,2014_boxofficemojo_rankings.csv,2014,1.0,0.0
11173,Porn Star: The Legend of Ron Jeremy,421516,421516,0,2001_boxofficemojo_rankings.csv,2001,1.0,0.0
11174,The Last Days,421432,421432,0,1999_boxofficemojo_rankings.csv,1999,1.0,0.0
11175,The Bounce Back,421404,321910,99494,2016_boxofficemojo_rankings.csv,2016,0.7638987764710349,0.23610122352896507
11176,The Good Father,421201,421201,0,1987_boxofficemojo_rankings.csv,1987,1.0,0.0
11177,The Cold Blue,420177,420177,0,2019_boxofficemojo_rankings.csv,2019,1.0,0.0
11178,Voiceless,419952,419952,0,2016_boxofficemojo_rankings.csv,2016,1.0,0.0
11179,Madame Satã,419046,198309,220737,2002_boxofficemojo_rankings.csv,2002,0.47323921478787534,0.5267607852121247
11180,Killing Zoe,418961,418961,0,1994_boxofficemojo_rankings.csv,1994,1.0,0.0
11181,Amandla! A Revolution in Four Part Harmony,418941,405331,13610,2003_boxofficemojo_rankings.csv,2003,0.9675133252653715,0.032486674734628504
11182,True Colors,418807,418807,0,1991_boxofficemojo_rankings.csv,1991,1.0,0.0
11183,Strength and Honour,418721,51933,366788,2007_boxofficemojo_rankings.csv,2007,0.12402769385820152,0.8759723061417984
11184,The Eel,418480,418480,0,1998_boxofficemojo_rankings.csv,1998,1.0,0.0
11185,Aloha Summer,418379,418379,0,1988_boxofficemojo_rankings.csv,1988,1.0,0.0
11186,How to Get Ahead in Advertising,418053,418053,0,1989_boxofficemojo_rankings.csv,1989,1.0,0.0
11187,Frankenstein 2018 Re-release,417783,417783,0,2018_boxofficemojo_rankings.csv,2018,1.0,0.0
11188,My Son the Fanatic,417683,417683,0,1999_boxofficemojo_rankings.csv,1999,1.0,0.0
11189,Happy Phirr Bhag Jayegi,417669,103385,314284,2018_boxofficemojo_rankings.csv,2018,0.2475285453313509,0.7524714546686491
11190,Bolshoi Ballet: Le Corsaire,417152,190192,226960,2019_boxofficemojo_rankings.csv,2019,0.4559297330469469,0.544070266953053
11191,In the Realms of the Unreal,417120,417120,0,2004_boxofficemojo_rankings.csv,2004,1.0,0.0
11192,Dirty Wars,416853,384473,32380,2013_boxofficemojo_rankings.csv,2013,0.922322737271892,0.07767726272810799
11193,Tales of Halloween,416792,0,416792,2015_boxofficemojo_rankings.csv,2015,0.0,1.0
11194,Killer of Sheep,416509,404508,12001,2007_boxofficemojo_rankings.csv,2007,0.9711866970461622,0.028813302953837733
11195,Desert Bloom,416393,416393,0,1986_boxofficemojo_rankings.csv,1986,1.0,0.0
11196,Manifesto,416389,161101,255288,2017_boxofficemojo_rankings.csv,2017,0.3869002303134809,0.6130997696865191
11197,Status Update,416178,4764,411414,2018_boxofficemojo_rankings.csv,2018,0.011447025071003272,0.9885529749289967
11198,Sand Storm,414698,86800,327898,2016_boxofficemojo_rankings.csv,2016,0.20930894289338264,0.7906910571066174
11199,Snow Angels,414404,402858,11546,2008_boxofficemojo_rankings.csv,2008,0.9721382998233608,0.02786170017663922
11200,Wonderland,414254,414254,0,2000_boxofficemojo_rankings.csv,2000,1.0,0.0
11201,The Ottoman Lieutenant,413844,240978,172866,2017_boxofficemojo_rankings.csv,2017,0.5822918780989939,0.4177081219010062
11202,3 Ninjas: Knuckle Up,413479,413479,0,1995_boxofficemojo_rankings.csv,1995,1.0,0.0
11203,Bobby Z,413454,0,413454,2007_boxofficemojo_rankings.csv,2007,0.0,1.0
11204,The Mafia Kills Only in Summer 2015 Re-release,413236,37134,376102,2015_boxofficemojo_rankings.csv,2015,0.08986148351063315,0.9101385164893668
11205,The Climb,413161,0,413161,2020_boxofficemojo_rankings.csv,2020,0.0,1.0
11206,Bugs Bunny Film Festival,413076,413076,0,1998_boxofficemojo_rankings.csv,1998,1.0,0.0
11207,The Moth Diaries,413035,3838,409197,2012_boxofficemojo_rankings.csv,2012,0.009292190734441392,0.9907078092655586
11208,Unbranded,412792,410185,2607,2015_boxofficemojo_rankings.csv,2015,0.9936844706292758,0.006315529370724239
11209,Dogtooth,412728,110248,302480,2009_boxofficemojo_rankings.csv,2009,0.26712023414936714,0.7328797658506329
11210,Godzilla,412520,412520,0,2004_boxofficemojo_rankings.csv,2004,1.0,0.0
11211,Rage,411967,5594,406373,2010_boxofficemojo_rankings.csv,2010,0.013578757521840342,0.9864212424781597
11212,Tuvalu,411678,411678,0,2001_boxofficemojo_rankings.csv,2001,1.0,0.0
11213,Number One with a Bullet,410952,410952,0,1987_boxofficemojo_rankings.csv,1987,1.0,0.0
11214,R... Rajkumar,410495,166503,243992,2013_boxofficemojo_rankings.csv,2013,0.4056151719265764,0.5943848280734235
11215,El bonaerense,410474,9470,401004,2002_boxofficemojo_rankings.csv,2002,0.023070888777364705,0.9769291112226353
11216,Free Zone,410392,32381,378011,2005_boxofficemojo_rankings.csv,2005,0.07890261018733309,0.9210973898126669
11217,Mobsters and Mormons,409604,409604,0,2005_boxofficemojo_rankings.csv,2005,1.0,0.0
11218,Badlapur,409166,409166,0,2015_boxofficemojo_rankings.csv,2015,1.0,0.0
11219,Jude,409144,409144,0,1996_boxofficemojo_rankings.csv,1996,1.0,0.0
11220,Song One,408918,32251,376667,2015_boxofficemojo_rankings.csv,2015,0.0788691131229244,0.9211308868770756
11221,Triumph of the Spirit,408839,408839,0,1989_boxofficemojo_rankings.csv,1989,1.0,0.0
11222,The Reliant,408747,408747,0,2019_boxofficemojo_rankings.csv,2019,1.0,0.0
11223,Sleeping Beauty,408680,36578,372102,2011_boxofficemojo_rankings.csv,2011,0.08950278946853284,0.9104972105314671
11224,The 5th Quarter,408159,408159,0,2011_boxofficemojo_rankings.csv,2011,1.0,0.0
11225,Back to the Future 2020 Re-release,407977,247000,160977,2020_boxofficemojo_rankings.csv,2020,0.6054262862857465,0.3945737137142535
11226,Le Cercle Rouge,407878,369970,37908,2002_boxofficemojo_rankings.csv,2002,0.9070604445446923,0.09293955545530772
11227,"Love, Kennedy",407871,407871,0,2017_boxofficemojo_rankings.csv,2017,1.0,0.0
11228,Mister Lonely,407674,167396,240278,2008_boxofficemojo_rankings.csv,2008,0.4106124010851808,0.5893875989148192
11229,Slam Dance,406881,406881,0,1987_boxofficemojo_rankings.csv,1987,1.0,0.0
11230,Cinema Paradiso 2002 Re-release,406809,406809,0,2002_boxofficemojo_rankings.csv,2002,1.0,0.0
11231,Please Stand By,406732,9868,396864,2018_boxofficemojo_rankings.csv,2018,0.024261675993037184,0.9757383240069628
11232,Chasing Trane: The John Coltrane Documentary,406284,406284,0,2017_boxofficemojo_rankings.csv,2017,1.0,0.0
11233,Gabrielle,406256,5534,400722,2013_boxofficemojo_rankings.csv,2013,0.013621952660391477,0.9863780473396085
11234,Every Heart That Loves,406235,406235,0,2000_boxofficemojo_rankings.csv,2000,1.0,0.0
11235,The Square 2010 Re-release,406116,406116,0,2010_boxofficemojo_rankings.csv,2010,1.0,0.0
11236,The Hunting Ground,405917,405917,0,2015_boxofficemojo_rankings.csv,2015,1.0,0.0
11237,The Tempest,405861,277943,127918,2010_boxofficemojo_rankings.csv,2010,0.6848231291008497,0.3151768708991502
11238,Stake Land,405380,33245,372135,2011_boxofficemojo_rankings.csv,2011,0.08200947259361586,0.9179905274063841
11239,Happy Magic,405268,10697,394571,2011_boxofficemojo_rankings.csv,2011,0.02639487943780412,0.9736051205621958
11240,Tezz,405214,229931,175283,2012_boxofficemojo_rankings.csv,2012,0.5674310364400046,0.43256896355999547
11241,Preaching to the Choir,405191,405191,0,2006_boxofficemojo_rankings.csv,2006,1.0,0.0
11242,Marilyn Hotchkiss' Ballroom Dancing & Charm School,404870,349132,55738,2006_boxofficemojo_rankings.csv,2006,0.8623311186306716,0.13766888136932842
11243,The Philadelphia Story 2018 Re-release,404524,404524,0,2018_boxofficemojo_rankings.csv,2018,1.0,0.0
11244,Wanted,404099,349637,54462,2009_boxofficemojo_rankings.csv,2009,0.8652260955854877,0.13477390441451229
11245,God's Pocket,403713,169976,233737,2014_boxofficemojo_rankings.csv,2014,0.4210317725711087,0.5789682274288913
11246,Mother Night,403701,403701,0,1996_boxofficemojo_rankings.csv,1996,1.0,0.0
11247,Meet Me in St. Louis 75th Anniversary,403521,403521,0,2019_boxofficemojo_rankings.csv,2019,1.0,0.0
11248,A Wake in Providence,403069,403069,0,2005_boxofficemojo_rankings.csv,2005,1.0,0.0
11249,24 City,402917,30800,372117,2009_boxofficemojo_rankings.csv,2009,0.07644254275694498,0.923557457243055
11250,The Apu Trilogy,402723,402723,0,2015_boxofficemojo_rankings.csv,2015,1.0,0.0
11251,The School of Flesh,402668,402668,0,1999_boxofficemojo_rankings.csv,1999,1.0,0.0
11252,The Brown Bunny,402599,366301,36298,2004_boxofficemojo_rankings.csv,2004,0.9098408093413048,0.09015919065869513
11253,Flanders,402252,22788,379464,2006_boxofficemojo_rankings.csv,2006,0.05665105456281137,0.9433489454371886
11254,Raju Chacha,402226,194698,207528,2000_boxofficemojo_rankings.csv,2000,0.48405125476722044,0.5159487452327796
11255,Gang Land,402000,402000,0,2000_boxofficemojo_rankings.csv,2000,1.0,0.0
11256,Drinking Buddies,401914,343341,58573,2013_boxofficemojo_rankings.csv,2013,0.8542648427275487,0.14573515727245132
11257,The Oath,401463,401463,0,2018_boxofficemojo_rankings.csv,2018,1.0,0.0
11258,The Signal,401462,251150,150312,2008_boxofficemojo_rankings.csv,2008,0.6255884741270655,0.3744115258729344
11259,Some Girls,401421,401421,0,1988_boxofficemojo_rankings.csv,1988,1.0,0.0
11260,Freetown,401328,401328,0,2015_boxofficemojo_rankings.csv,2015,1.0,0.0
11261,An Affair of Love,401299,359050,42249,2000_boxofficemojo_rankings.csv,2000,0.8947193987525511,0.10528060124744891
11262,Dillagi,401245,401245,0,1999_boxofficemojo_rankings.csv,1999,1.0,0.0
11263,"Hello, Dolly!",400881,400881,0,2019_boxofficemojo_rankings.csv,2019,1.0,0.0
11264,Crimson Gold,400768,148959,251809,2004_boxofficemojo_rankings.csv,2004,0.37168386697540723,0.6283161330245928
11265,Racer and the Jailbird,400026,46337,353689,2017_boxofficemojo_rankings.csv,2017,0.11583497072690276,0.8841650292730973
11266,Mafioso,400019,400019,0,2007_boxofficemojo_rankings.csv,2007,1.0,0.0
11267,Bandit Queen,399748,399748,0,1995_boxofficemojo_rankings.csv,1995,1.0,0.0
11268,The Beautiful Troublemaker,399516,399516,0,1991_boxofficemojo_rankings.csv,1991,1.0,0.0
11269,The Mystic Masseur,399110,399110,0,2002_boxofficemojo_rankings.csv,2002,1.0,0.0
11270,West Side Story 2018 Re-release,398670,398670,0,2018_boxofficemojo_rankings.csv,2018,1.0,0.0
11271,Space Mutiny,397887,397887,0,2018_boxofficemojo_rankings.csv,2018,1.0,0.0
11272,Berlin Syndrome,397783,28660,369123,2017_boxofficemojo_rankings.csv,2017,0.07204933343053876,0.9279506665694612
11273,Transylmania,397641,397641,0,2009_boxofficemojo_rankings.csv,2009,1.0,0.0
11274,Four Days in September,397517,397517,0,1998_boxofficemojo_rankings.csv,1998,1.0,0.0
11275,Krull 2018 Re-release,397157,397157,0,2018_boxofficemojo_rankings.csv,2018,1.0,0.0
11276,Swept from the Sea,397020,397020,0,1998_boxofficemojo_rankings.csv,1998,1.0,0.0
11277,Lost and Delirious,396897,307233,89664,2001_boxofficemojo_rankings.csv,2001,0.7740874836544493,0.2259125163455506
11278,Still We Believe: The Boston Red Sox Movie,396803,396803,0,2004_boxofficemojo_rankings.csv,2004,1.0,0.0
11279,The Adjuster,396573,396573,0,1992_boxofficemojo_rankings.csv,1992,1.0,0.0
11280,Very Annie Mary,396090,46352,349738,2002_boxofficemojo_rankings.csv,2002,0.11702390870761696,0.8829760912923831
11281,13 Minutes 2015 Re-release,395557,161531,234026,2015_boxofficemojo_rankings.csv,2015,0.40836339642579955,0.5916366035742004
11282,Pauline and Paulette,395175,139789,255386,2001_boxofficemojo_rankings.csv,2001,0.3537394825077497,0.6462605174922502
11283,Golden Gate,395105,395105,0,1994_boxofficemojo_rankings.csv,1994,1.0,0.0
11284,Dogfight,394631,394631,0,1991_boxofficemojo_rankings.csv,1991,1.0,0.0
11285,Keane,394390,33256,361134,2005_boxofficemojo_rankings.csv,2005,0.08432262481300236,0.9156773751869977
11286,The Yes Men,394154,255364,138790,2004_boxofficemojo_rankings.csv,2004,0.6478787479005668,0.35212125209943324
11287,Lucie Aubrac,394079,394079,0,1999_boxofficemojo_rankings.csv,1999,1.0,0.0
11288,God Bless America,393880,122550,271330,2012_boxofficemojo_rankings.csv,2012,0.3111353711790393,0.6888646288209607
11289,The Holcroft Covenant,393825,393825,0,1985_boxofficemojo_rankings.csv,1985,1.0,0.0
11290,Into the Abyss,393714,223880,169834,2011_boxofficemojo_rankings.csv,2011,0.5686361165719278,0.43136388342807214
11291,Millennium Mambo,393351,14904,378447,2001_boxofficemojo_rankings.csv,2001,0.037889823592669146,0.9621101764073309
11292,Jee Aayan Nu,393117,393117,0,2002_boxofficemojo_rankings.csv,2002,1.0,0.0
11293,Cuban Fury 2014 Re-release,392705,92384,300321,2014_boxofficemojo_rankings.csv,2014,0.235250378783056,0.764749621216944
11294,Hamara Dil Aapke Paas Hai,392076,392076,0,2000_boxofficemojo_rankings.csv,2000,1.0,0.0
11295,Three,391957,331507,60450,2016_boxofficemojo_rankings.csv,2016,0.8457738986674559,0.15422610133254414
11296,End of the Century,391950,391950,0,2004_boxofficemojo_rankings.csv,2004,1.0,0.0
11297,Tiny Furniture,391674,391674,0,2010_boxofficemojo_rankings.csv,2010,1.0,0.0
11298,Bittersweet Motel,391653,391653,0,2000_boxofficemojo_rankings.csv,2000,1.0,0.0
11299,While She Was Out,391410,0,391410,2008_boxofficemojo_rankings.csv,2008,0.0,1.0
11300,The Escape,390881,14018,376863,2018_boxofficemojo_rankings.csv,2018,0.03586257710147078,0.9641374228985292
11301,Subway,390659,390659,0,1985_boxofficemojo_rankings.csv,1985,1.0,0.0
11302,The Marc Pease Experience,390584,4033,386551,2009_boxofficemojo_rankings.csv,2009,0.010325563771173423,0.9896744362288266
11303,Where the Day Takes You,390152,390152,0,1992_boxofficemojo_rankings.csv,1992,1.0,0.0
11304,Hell Ride,390128,213608,176520,2008_boxofficemojo_rankings.csv,2008,0.5475331173358488,0.45246688266415125
11305,Detropia,390024,390024,0,2012_boxofficemojo_rankings.csv,2012,1.0,0.0
11306,Shortkut - The Con Is On,389832,100304,289528,2009_boxofficemojo_rankings.csv,2009,0.25730058076299533,0.7426994192370047
11307,Search and Destroy,389503,389503,0,1995_boxofficemojo_rankings.csv,1995,1.0,0.0
11308,Once Upon a Time in Mumbaai Dobara,389237,0,389237,2013_boxofficemojo_rankings.csv,2013,0.0,1.0
11309,House of D,389199,388532,667,2005_boxofficemojo_rankings.csv,2005,0.9982862237569984,0.0017137762430016522
11310,The Game of Their Lives,388998,375750,13248,2005_boxofficemojo_rankings.csv,2005,0.9659432696312064,0.03405673036879367
11311,Singh Saab the Great,388622,225668,162954,2013_boxofficemojo_rankings.csv,2013,0.580687660503008,0.4193123394969919
11312,The Last Sin Eater,388390,388390,0,2007_boxofficemojo_rankings.csv,2007,1.0,0.0
11313,Keep the Lights On,388331,246112,142219,2012_boxofficemojo_rankings.csv,2012,0.6337686149187163,0.3662313850812838
11314,The Escapist,388174,13439,374735,2008_boxofficemojo_rankings.csv,2008,0.034621071993487455,0.9653789280065126
11315,Times and Winds,387396,6176,381220,2006_boxofficemojo_rankings.csv,2006,0.015942343235345744,0.9840576567646543
11316,Touch,387069,387069,0,1997_boxofficemojo_rankings.csv,1997,1.0,0.0
11317,"Westwood: Punk, Icon, Activist",386856,58979,327877,2018_boxofficemojo_rankings.csv,2018,0.15245724507310213,0.8475427549268979
11318,The End of Violence,386673,386673,0,1997_boxofficemojo_rankings.csv,1997,1.0,0.0
11319,Hitchcock/Truffaut,386471,260430,126041,2015_boxofficemojo_rankings.csv,2015,0.6738668619378945,0.3261331380621056
11320,The Wedding Guest,386166,386166,0,2019_boxofficemojo_rankings.csv,2019,1.0,0.0
11321,How to Talk to Girls at Parties,385733,84809,300924,2018_boxofficemojo_rankings.csv,2018,0.21986451768451235,0.7801354823154877
11322,Sylvester,385687,385687,0,1985_boxofficemojo_rankings.csv,1985,1.0,0.0
11323,Steam: The Turkish Bath,384793,384793,0,1998_boxofficemojo_rankings.csv,1998,1.0,0.0
11324,Samurai Cop,384756,384756,0,2017_boxofficemojo_rankings.csv,2017,1.0,0.0
11325,Bethlehem,384670,201700,182970,2014_boxofficemojo_rankings.csv,2014,0.5243455429329035,0.47565445706709647
11326,Adoration,384659,294244,90415,2009_boxofficemojo_rankings.csv,2009,0.7649476549359303,0.23505234506406975
11327,The Embalmer,384336,56878,327458,2002_boxofficemojo_rankings.csv,2002,0.1479903001540319,0.8520096998459681
11328,The Secret World of Arrietty 2019 Re-release,384289,384289,0,2019_boxofficemojo_rankings.csv,2019,1.0,0.0
11329,"Scotland, Pa.",384098,384098,0,2002_boxofficemojo_rankings.csv,2002,1.0,0.0
11330,American Heart,384048,384048,0,1993_boxofficemojo_rankings.csv,1993,1.0,0.0
11331,Imagining Argentina,383106,8899,374207,2003_boxofficemojo_rankings.csv,2003,0.02322855815361806,0.976771441846382
11332,Swimming with Sharks,382928,382928,0,1995_boxofficemojo_rankings.csv,1995,1.0,0.0
11333,Into the Arms of Strangers,382807,382807,0,2000_boxofficemojo_rankings.csv,2000,1.0,0.0
11334,Sweet Talker,382510,382510,0,1991_boxofficemojo_rankings.csv,1991,1.0,0.0
11335,First Snow,382267,214864,167403,2007_boxofficemojo_rankings.csv,2007,0.5620783379156453,0.4379216620843547
11336,The Informers,382174,300000,82174,2009_boxofficemojo_rankings.csv,2009,0.7849827565454479,0.21501724345455211
11337,Digimon Adventure tri. Part 5: Coexistence,382119,52339,329780,2017_boxofficemojo_rankings.csv,2017,0.1369704202094112,0.8630295797905888
11338,Z for Zachariah,381839,121461,260378,2015_boxofficemojo_rankings.csv,2015,0.3180947991169053,0.6819052008830947
11339,The Children of the Century,381624,56611,325013,2002_boxofficemojo_rankings.csv,2002,0.14834234744146071,0.8516576525585393
11340,The Quiet,381420,381420,0,2006_boxofficemojo_rankings.csv,2006,1.0,0.0
11341,Flower,380553,328188,52365,2018_boxofficemojo_rankings.csv,2018,0.8623976161007797,0.13760238389922033
11342,Tulsa,380456,380456,0,2020_boxofficemojo_rankings.csv,2020,1.0,0.0
11343,Jane and Emma,380030,380030,0,2018_boxofficemojo_rankings.csv,2018,1.0,0.0
11344,Daughter of Mine,379010,10628,368382,2018_boxofficemojo_rankings.csv,2018,0.02804147647819319,0.9719585235218068
11345,I'll Push You: A Real-Life Inspiration,378899,378899,0,2017_boxofficemojo_rankings.csv,2017,1.0,0.0
11346,Streamers,378452,378452,0,1983_boxofficemojo_rankings.csv,1983,1.0,0.0
11347,Blind Spot. Hitler's Secretary,378382,378382,0,2003_boxofficemojo_rankings.csv,2003,1.0,0.0
11348,Close to Eden,377832,377832,0,1992_boxofficemojo_rankings.csv,1992,1.0,0.0
11349,Shahid,377803,12153,365650,2013_boxofficemojo_rankings.csv,2013,0.03216755822478911,0.9678324417752109
11350,Miss Hokusai,377702,222670,155032,2015_boxofficemojo_rankings.csv,2015,0.589538842791407,0.410461157208593
11351,Attack on Titan: Smoke Signal,377334,377334,0,2018_boxofficemojo_rankings.csv,2018,1.0,0.0
11352,Pride and Prejudice,377271,377271,0,2003_boxofficemojo_rankings.csv,2003,1.0,0.0
11353,Hochelaga,376714,376714,0,2000_boxofficemojo_rankings.csv,2000,1.0,0.0
11354,The Hunting of the President,376612,376612,0,2004_boxofficemojo_rankings.csv,2004,1.0,0.0
11355,The Nightmare Before Christmas 2000 Re-release,376586,376586,0,2000_boxofficemojo_rankings.csv,2000,1.0,0.0
11356,Le talent de mes amis,376522,889,375633,2015_boxofficemojo_rankings.csv,2015,0.0023610838144915835,0.9976389161855084
11357,Born Romantic,376090,15545,360545,2001_boxofficemojo_rankings.csv,2001,0.04133319152330559,0.9586668084766944
11358,American Hardcore,376057,279665,96392,2006_boxofficemojo_rankings.csv,2006,0.7436771553248577,0.2563228446751423
11359,The Human Factor,376050,376050,0,1979_boxofficemojo_rankings.csv,1979,1.0,0.0
11360,3 Ninjas: High Noon at Mega Mountain,375805,375805,0,1998_boxofficemojo_rankings.csv,1998,1.0,0.0
11361,The Whole Wide World,375757,375757,0,1996_boxofficemojo_rankings.csv,1996,1.0,0.0
11362,Britannia Hospital,375713,375713,0,1983_boxofficemojo_rankings.csv,1983,1.0,0.0
11363,Hurricane Streets,375634,375634,0,1998_boxofficemojo_rankings.csv,1998,1.0,0.0
11364,Great Performances at the Met: Puccini: Turandot,375295,0,375295,2019_boxofficemojo_rankings.csv,2019,0.0,1.0
11365,Shooting Fish,375261,375261,0,1998_boxofficemojo_rankings.csv,1998,1.0,0.0
11366,Southland Tales,374743,275380,99363,2007_boxofficemojo_rankings.csv,2007,0.7348502840613433,0.2651497159386566
11367,Chronic,374704,9033,365671,2016_boxofficemojo_rankings.csv,2016,0.024107028481147787,0.9758929715188522
11368,Genghis Blues,374550,374550,0,1999_boxofficemojo_rankings.csv,1999,1.0,0.0
11369,Annie Brocoli dans les fonds marins,374360,374360,0,2003_boxofficemojo_rankings.csv,2003,1.0,0.0
11370,Waking Up in Reno,374312,267109,107203,2002_boxofficemojo_rankings.csv,2002,0.713599884588258,0.2864001154117421
11371,Jurassic Park 2018 Re-release,374238,374238,0,2018_boxofficemojo_rankings.csv,2018,1.0,0.0
11372,The Decline of Western Civilization Part II: The Metal Years,373743,373743,0,1988_boxofficemojo_rankings.csv,1988,1.0,0.0
11373,How to Cook Your Life,373727,87370,286357,2007_boxofficemojo_rankings.csv,2007,0.23378027276594948,0.7662197272340505
11374,Keep the River on Your Right: A Modern Cannibal Tale,373366,373366,0,2001_boxofficemojo_rankings.csv,2001,1.0,0.0
11375,Everything Is Fine,373360,336569,36791,2008_boxofficemojo_rankings.csv,2008,0.9014597171630597,0.09854028283694022
11376,Nico and Dani,372850,370562,2288,2001_boxofficemojo_rankings.csv,2001,0.9938634839747887,0.006136516025211211
11377,Movers & Shakers,372438,372438,0,1985_boxofficemojo_rankings.csv,1985,1.0,0.0
11378,Pom Poko 2018 Re-release,372405,372405,0,2018_boxofficemojo_rankings.csv,2018,1.0,0.0
11379,Eloise,372137,0,372137,2017_boxofficemojo_rankings.csv,2017,0.0,1.0
11380,The Star Maker,371674,371674,0,1996_boxofficemojo_rankings.csv,1996,1.0,0.0
11381,Fanny,371657,8735,362922,2013_boxofficemojo_rankings.csv,2013,0.023502853437443665,0.9764971465625564
11382,Havoc,371000,0,371000,2005_boxofficemojo_rankings.csv,2005,0.0,1.0
11383,7 Boxes,370892,38106,332786,2013_boxofficemojo_rankings.csv,2013,0.10274149887298728,0.8972585011270127
11384,Open Your Eyes,370720,370720,0,1999_boxofficemojo_rankings.csv,1999,1.0,0.0
11385,Gandahar,370698,370698,0,1988_boxofficemojo_rankings.csv,1988,1.0,0.0
11386,The Minus Man,370668,370668,0,1999_boxofficemojo_rankings.csv,1999,1.0,0.0
11387,Hava Nagila,370218,370218,0,2013_boxofficemojo_rankings.csv,2013,1.0,0.0
11388,Me Myself I,369975,369975,0,2000_boxofficemojo_rankings.csv,2000,1.0,0.0
11389,"Ruben Brandt, Collector 2018 Re-release",369809,117963,251846,2018_boxofficemojo_rankings.csv,2018,0.31898358341738575,0.6810164165826142
11390,Unmistaken Child,369742,306140,63602,2009_boxofficemojo_rankings.csv,2009,0.8279827555430543,0.17201724445694566
11391,Me Without You,369226,304909,64317,2001_boxofficemojo_rankings.csv,2001,0.825805874992552,0.17419412500744802
11392,Mooz-Lum,369129,369129,0,2011_boxofficemojo_rankings.csv,2011,1.0,0.0
11393,When Comedy Went to School,369065,369065,0,2013_boxofficemojo_rankings.csv,2013,1.0,0.0
11394,The Void,368372,151042,217330,2017_boxofficemojo_rankings.csv,2017,0.41002573485498356,0.5899742651450165
11395,Dark Awakening,367925,0,367925,2015_boxofficemojo_rankings.csv,2015,0.0,1.0
11396,Room 237,367406,296359,71047,2012_boxofficemojo_rankings.csv,2012,0.8066253681213699,0.1933746318786302
11397,The Big White,367241,0,367241,2005_boxofficemojo_rankings.csv,2005,0.0,1.0
11398,The Basket,367098,367098,0,1999_boxofficemojo_rankings.csv,1999,1.0,0.0
11399,INXS: Baby Live at Wembly Stadium,366425,161750,204675,2019_boxofficemojo_rankings.csv,2019,0.44142730435969163,0.5585726956403084
11400,The Animation Show,366344,366344,0,2003_boxofficemojo_rankings.csv,2003,1.0,0.0
11401,Blindsight,366247,89169,277078,2007_boxofficemojo_rankings.csv,2007,0.24346684068401925,0.7565331593159808
11402,Grease 2010 Sing-a-long,365802,365802,0,2010_boxofficemojo_rankings.csv,2010,1.0,0.0
11403,Baadasssss!,365727,365727,0,2004_boxofficemojo_rankings.csv,2004,1.0,0.0
11404,Eat That Question,365540,355074,10466,2016_boxofficemojo_rankings.csv,2016,0.9713683864966899,0.02863161350331017
11405,Glen Campbell: I'll Be Me,365422,365422,0,2014_boxofficemojo_rankings.csv,2014,1.0,0.0
11406,Lords of Chaos,365353,253184,112169,2019_boxofficemojo_rankings.csv,2019,0.692984592982677,0.307015407017323
11407,Your Magical Spell Worked,365318,365318,0,2000_boxofficemojo_rankings.csv,2000,1.0,0.0
11408,Palookaville,365284,365284,0,1996_boxofficemojo_rankings.csv,1996,1.0,0.0
11409,Clemency,364952,364716,236,2019_boxofficemojo_rankings.csv,2019,0.9993533396172647,0.0006466603827352638
11410,Cunningham,364727,265102,99625,2019_boxofficemojo_rankings.csv,2019,0.7268504936568996,0.2731495063431005
11411,Real Life,364642,364642,0,1979_boxofficemojo_rankings.csv,1979,1.0,0.0
11412,BOSTON: An American Running Story,364369,364369,0,2017_boxofficemojo_rankings.csv,2017,1.0,0.0
11413,Five Minutes of Heaven,364355,15676,348679,2009_boxofficemojo_rankings.csv,2009,0.04302397387163618,0.9569760261283639
11414,Nostradamus,364164,364164,0,1994_boxofficemojo_rankings.csv,1994,1.0,0.0
11415,The Toxic Avenger Part III: The Last Temptation of Toxie,363561,363561,0,1989_boxofficemojo_rankings.csv,1989,1.0,0.0
11416,The Adventures of Felix,363409,363409,0,2001_boxofficemojo_rankings.csv,2001,1.0,0.0
11417,Jig,363320,183790,179530,2011_boxofficemojo_rankings.csv,2011,0.5058626004624023,0.4941373995375977
11418,The Breadwinner,363307,312381,50926,2017_boxofficemojo_rankings.csv,2017,0.8598265378866908,0.14017346211330914
11419,Scorched,363057,8000,355057,2003_boxofficemojo_rankings.csv,2003,0.022035107434920688,0.9779648925650793
11420,Breathless 2010 Re-release,363031,363031,0,2010_boxofficemojo_rankings.csv,2010,1.0,0.0
11421,The Source: The Story of the Beats and the Beat Generation,362649,362649,0,1999_boxofficemojo_rankings.csv,1999,1.0,0.0
11422,Happy Times,361000,240093,120907,2002_boxofficemojo_rankings.csv,2002,0.6650775623268698,0.3349224376731302
11423,The Tobacconist,360996,0,360996,2019_boxofficemojo_rankings.csv,2019,0.0,1.0
11424,Grateful Dawg,360251,360251,0,2001_boxofficemojo_rankings.csv,2001,1.0,0.0
11425,These Final Hours,360234,0,360234,2014_boxofficemojo_rankings.csv,2014,0.0,1.0
11426,Souvenir,359798,11411,348387,2016_boxofficemojo_rankings.csv,2016,0.031715017871138805,0.9682849821288612
11427,Disney Junior HalloVeen Party!,359745,359745,0,2017_boxofficemojo_rankings.csv,2017,1.0,0.0
11428,Happy Ending,359542,313770,45772,2014_boxofficemojo_rankings.csv,2014,0.8726935935161956,0.1273064064838044
11429,K-12,359377,303230,56147,2019_boxofficemojo_rankings.csv,2019,0.8437657390428436,0.15623426095715642
11430,Government 3,358928,249588,109340,2017_boxofficemojo_rankings.csv,2017,0.695370659296572,0.304629340703428
11431,Revolution,358574,358574,0,1985_boxofficemojo_rankings.csv,1985,1.0,0.0
11432,Love in Space,358486,34787,323699,2011_boxofficemojo_rankings.csv,2011,0.09703865701868414,0.9029613429813159
11433,Everly,358156,0,358156,2015_boxofficemojo_rankings.csv,2015,0.0,1.0
11434,American Ninja 4: The Annihilation,358047,358047,0,1991_boxofficemojo_rankings.csv,1991,1.0,0.0
11435,Welcome to the Rileys,358014,158898,199116,2010_boxofficemojo_rankings.csv,2010,0.4438318054601217,0.5561681945398783
11436,Crazy Love,357659,301027,56632,2007_boxofficemojo_rankings.csv,2007,0.8416592340749149,0.15834076592508506
11437,Bel Canto,357462,125569,231893,2018_boxofficemojo_rankings.csv,2018,0.3512792968203613,0.6487207031796387
11438,Artemisia,356749,356749,0,1998_boxofficemojo_rankings.csv,1998,1.0,0.0
11439,Trust,356122,356122,0,1991_boxofficemojo_rankings.csv,1991,1.0,0.0
11440,Iron & Silk,356077,356077,0,1991_boxofficemojo_rankings.csv,1991,1.0,0.0
11441,National Gallery,354971,253941,101030,2014_boxofficemojo_rankings.csv,2014,0.715385200481166,0.28461479951883395
11442,My Name Is Joe,354952,354952,0,1999_boxofficemojo_rankings.csv,1999,1.0,0.0
11443,Hello I Must Be Going,354939,106709,248230,2012_boxofficemojo_rankings.csv,2012,0.3006403917292831,0.699359608270717
11444,The Invitation,354835,231737,123098,2016_boxofficemojo_rankings.csv,2016,0.6530838276945623,0.34691617230543775
11445,Kaashmora,354631,327959,26672,2016_boxofficemojo_rankings.csv,2016,0.9247894290121281,0.0752105709878719
11446,Filth and Wisdom,354628,22406,332222,2008_boxofficemojo_rankings.csv,2008,0.06318170026055472,0.9368182997394453
11447,Las Acacias,354391,6000,348391,2011_boxofficemojo_rankings.csv,2011,0.016930452522778514,0.9830695474772215
11448,The Tomorrow Man,354103,354103,0,2019_boxofficemojo_rankings.csv,2019,1.0,0.0
11449,Love Is the Devil: Study for a Portrait of Francis Bacon,354004,354004,0,1998_boxofficemojo_rankings.csv,1998,1.0,0.0
11450,"Broadway: The Golden Age, by the Legends Who Were There",353580,353580,0,2004_boxofficemojo_rankings.csv,2004,1.0,0.0
11451,How My Mother Gave Birth to Me During Menopause,353275,353275,0,2003_boxofficemojo_rankings.csv,2003,1.0,0.0
11452,Bab'Aziz: The Prince That Contemplated His Soul,353119,89672,263447,2007_boxofficemojo_rankings.csv,2007,0.25394272185863687,0.7460572781413631
11453,Like Dandelion Dust,352810,352810,0,2010_boxofficemojo_rankings.csv,2010,1.0,0.0
11454,Lumumba,352296,352296,0,2001_boxofficemojo_rankings.csv,2001,1.0,0.0
11455,Five Fingers,352089,0,352089,2006_boxofficemojo_rankings.csv,2006,0.0,1.0
11456,Long Strange Trip - The Untold Story of The Grateful Dead,351957,351957,0,2017_boxofficemojo_rankings.csv,2017,1.0,0.0
11457,The Wizard of Oz 2018 Re-release,351839,351839,0,2018_boxofficemojo_rankings.csv,2018,1.0,0.0
11458,Yossi & Jagger,351707,267005,84702,2003_boxofficemojo_rankings.csv,2003,0.7591688536196323,0.24083114638036776
11459,Weekend Warriors,351623,351623,0,1986_boxofficemojo_rankings.csv,1986,1.0,0.0
11460,"Black Cat, White Cat",351447,351447,0,1999_boxofficemojo_rankings.csv,1999,1.0,0.0
11461,The Chumscrubber,351401,52597,298804,2005_boxofficemojo_rankings.csv,2005,0.14967800319293342,0.8503219968070665
11462,Summer Heat,350481,350481,0,1987_boxofficemojo_rankings.csv,1987,1.0,0.0
11463,Aferim!,350110,108110,242000,2015_boxofficemojo_rankings.csv,2015,0.3087886664191254,0.6912113335808746
11464,Howards End 2016 Re-release,349993,160282,189711,2016_boxofficemojo_rankings.csv,2016,0.45795773058318306,0.5420422694168169
11465,Tehran Taboo,349886,74758,275128,2017_boxofficemojo_rankings.csv,2017,0.21366387909204712,0.7863361209079529
11466,Two Evil Eyes,349618,349618,0,1991_boxofficemojo_rankings.csv,1991,1.0,0.0
11467,Manufactured Landscapes,349220,240239,108981,2007_boxofficemojo_rankings.csv,2007,0.687930244544986,0.31206975545501403
11468,Satanic,349183,252,348931,2016_boxofficemojo_rankings.csv,2016,0.0007216846180942371,0.9992783153819058
11469,Marie's Story 2014 Re-release,348906,11720,337186,2014_boxofficemojo_rankings.csv,2014,0.03359070924547013,0.9664092907545299
11470,Serious Moonlight,348327,25339,322988,2009_boxofficemojo_rankings.csv,2009,0.07274486330373471,0.9272551366962652
11471,The Merry Gentleman,347977,347977,0,2009_boxofficemojo_rankings.csv,2009,1.0,0.0
11472,Suicide the Ripple Effect,347468,347468,0,2018_boxofficemojo_rankings.csv,2018,1.0,0.0
11473,Billy: The Early Years,347328,347328,0,2008_boxofficemojo_rankings.csv,2008,1.0,0.0
11474,The Good Heart,346851,20930,325921,2010_boxofficemojo_rankings.csv,2010,0.06034291381601898,0.939657086183981
11475,The Family,346730,346730,0,1988_boxofficemojo_rankings.csv,1988,1.0,0.0
11476,The Vault,346729,5728,341001,2017_boxofficemojo_rankings.csv,2017,0.016520106480853922,0.9834798935191461
11477,Summerland,346723,58498,288225,2020_boxofficemojo_rankings.csv,2020,0.16871681428690916,0.8312831857130909
11478,Meet Bill,346592,62597,283995,2008_boxofficemojo_rankings.csv,2008,0.18060716923645093,0.8193928307635491
11479,The Deceivers,346297,346297,0,1988_boxofficemojo_rankings.csv,1988,1.0,0.0
11480,Star Trek: The Motion Picture 2019 Re-release,346243,346243,0,2019_boxofficemojo_rankings.csv,2019,1.0,0.0
11481,She Dies Tomorrow,346079,346079,0,2020_boxofficemojo_rankings.csv,2020,1.0,0.0
11482,The Second Jungle Book: Mowgli & Baloo,346056,346056,0,1997_boxofficemojo_rankings.csv,1997,1.0,0.0
11483,A Pyromaniac's Love Story,345972,345972,0,1995_boxofficemojo_rankings.csv,1995,1.0,0.0
11484,Triple Threat,345900,76289,269611,2019_boxofficemojo_rankings.csv,2019,0.2205521827117664,0.7794478172882336
11485,Billabong Odyssey,345708,156000,189708,2003_boxofficemojo_rankings.csv,2003,0.4512478739282863,0.5487521260717138
11486,Prison,345704,345704,0,1988_boxofficemojo_rankings.csv,1988,1.0,0.0
11487,Bear Cub,345693,100133,245560,2004_boxofficemojo_rankings.csv,2004,0.2896587434515596,0.7103412565484404
11488,I Think I Do,345478,345478,0,1998_boxofficemojo_rankings.csv,1998,1.0,0.0
11489,Anatomy of Hell,345365,34506,310859,2004_boxofficemojo_rankings.csv,2004,0.09991168763482113,0.9000883123651788
11490,La Cage aux Folles 3: The Wedding,345280,345280,0,1986_boxofficemojo_rankings.csv,1986,1.0,0.0
11491,Tera Mera Ki Rishta,345063,271942,73121,2009_boxofficemojo_rankings.csv,2009,0.788093768384324,0.21190623161567598
11492,The Dying Gaul,345041,342747,2294,2005_boxofficemojo_rankings.csv,2005,0.9933515147475228,0.006648485252477242
11493,American Adobo,344992,344992,0,2002_boxofficemojo_rankings.csv,2002,1.0,0.0
11494,It Takes Two,344375,344375,0,1988_boxofficemojo_rankings.csv,1988,1.0,0.0
11495,Windy City,343890,343890,0,1984_boxofficemojo_rankings.csv,1984,1.0,0.0
11496,The United States of Leland,343847,343847,0,2004_boxofficemojo_rankings.csv,2004,1.0,0.0
11497,Tapeheads,343786,343786,0,1988_boxofficemojo_rankings.csv,1988,1.0,0.0
11498,Countdown to Canelo vs. Chavez Jr.,343387,343387,0,2017_boxofficemojo_rankings.csv,2017,1.0,0.0
11499,El Bulli: Cooking in Progress,343116,237181,105935,2011_boxofficemojo_rankings.csv,2011,0.6912560183727952,0.3087439816272048
11500,The Idol,343059,0,343059,2016_boxofficemojo_rankings.csv,2016,0.0,1.0
11501,Koch,342941,342941,0,2013_boxofficemojo_rankings.csv,2013,1.0,0.0
11502,"Life, Animated",342664,255388,87276,2016_boxofficemojo_rankings.csv,2016,0.7453015198561856,0.25469848014381435
11503,Lawrence of Arabia 2002 Re-release,342481,342481,0,2002_boxofficemojo_rankings.csv,2002,1.0,0.0
11504,Bolshoi Ballet: Swan Lake,342391,88905,253486,2018_boxofficemojo_rankings.csv,2018,0.25965927842729514,0.7403407215727049
11505,Nureyev: Lifting the Curtain,342255,165203,177052,2018_boxofficemojo_rankings.csv,2018,0.482689807307417,0.517310192692583
11506,Knife + Heart,341847,32516,309331,2018_boxofficemojo_rankings.csv,2018,0.09511857643916723,0.9048814235608328
11507,Dangerous People,341280,341280,0,2002_boxofficemojo_rankings.csv,2002,1.0,0.0
11508,Total Eclipse,340139,340139,0,1995_boxofficemojo_rankings.csv,1995,1.0,0.0
11509,This Film Is Not Yet Rated,339609,306845,32764,2006_boxofficemojo_rankings.csv,2006,0.9035243471168314,0.09647565288316859
11510,The Lady in the Car with Glasses and a Gun,339461,2167,337294,2015_boxofficemojo_rankings.csv,2015,0.006383649373565741,0.9936163506264343
11511,Albino Alligator,339379,339379,0,1997_boxofficemojo_rankings.csv,1997,1.0,0.0
11512,The Green Prince,339208,258237,80971,2014_boxofficemojo_rankings.csv,2014,0.7612939553312422,0.2387060446687578
11513,Happy People: A Year in the Taiga,338987,338987,0,2013_boxofficemojo_rankings.csv,2013,1.0,0.0
11514,Red Hook Summer,338803,338803,0,2012_boxofficemojo_rankings.csv,2012,1.0,0.0
11515,Is It Wrong to Try to Pick Up Girls in a Dungeon - Arrow of the Orion,338632,271489,67143,2019_boxofficemojo_rankings.csv,2019,0.80172281414633,0.19827718585367007
11516,Silencio,338596,158723,179873,2018_boxofficemojo_rankings.csv,2018,0.46876808940448206,0.531231910595518
11517,Night Game,337812,337812,0,1989_boxofficemojo_rankings.csv,1989,1.0,0.0
11518,Winter Solstice,337617,319355,18262,2005_boxofficemojo_rankings.csv,2005,0.9459091218747872,0.05409087812521289
11519,Ran 2000 Re-release,337587,337587,0,2000_boxofficemojo_rankings.csv,2000,1.0,0.0
11520,Dark Horse,337150,166228,170922,2012_boxofficemojo_rankings.csv,2012,0.4930387068070592,0.5069612931929408
11521,The Last Waltz 2002 Re-release,337085,322313,14772,2002_boxofficemojo_rankings.csv,2002,0.956177225328923,0.04382277467107703
11522,Voyage of Time: The IMAX Experience,337038,55409,281629,2016_boxofficemojo_rankings.csv,2016,0.16439985995644407,0.8356001400435559
11523,Dark Obsession,336811,336811,0,1991_boxofficemojo_rankings.csv,1991,1.0,0.0
11524,First Love,336756,218329,118427,2019_boxofficemojo_rankings.csv,2019,0.6483299480929813,0.3516700519070187
11525,Talent for the Game,336396,336396,0,1991_boxofficemojo_rankings.csv,1991,1.0,0.0
11526,Kings of Pastry,336386,336386,0,2010_boxofficemojo_rankings.csv,2010,1.0,0.0
11527,Diane,336166,336166,0,2019_boxofficemojo_rankings.csv,2019,1.0,0.0
11528,Wooly Boys,335726,335726,0,2004_boxofficemojo_rankings.csv,2004,1.0,0.0
11529,Sailor Moon R: The Movie: The Promise of the Rose/Sailor Moon S: The Movie - Hearts in Ice,335697,335697,0,2018_boxofficemojo_rankings.csv,2018,1.0,0.0
11530,The 2006 Academy Award Nominated Short Films: Live Action,335090,335090,0,2007_boxofficemojo_rankings.csv,2007,1.0,0.0
11531,Freaks,335050,276591,58459,2019_boxofficemojo_rankings.csv,2019,0.8255215639456798,0.17447843605432026
11532,Russ Taff: I Still Believe,334983,334983,0,2018_boxofficemojo_rankings.csv,2018,1.0,0.0
11533,Roger Corman's Frankenstein Unbound,334748,334748,0,1990_boxofficemojo_rankings.csv,1990,1.0,0.0
11534,Bhavesh Joshi Superhero,334723,57376,277347,2018_boxofficemojo_rankings.csv,2018,0.1714133776286661,0.828586622371334
11535,Welcome to Sarajevo,334319,334319,0,1997_boxofficemojo_rankings.csv,1997,1.0,0.0
11536,Bicycle Thieves 1998 Re-release,334293,334293,0,1998_boxofficemojo_rankings.csv,1998,1.0,0.0
11537,Anthropocene: The Human Epoch,334162,104806,229356,2019_boxofficemojo_rankings.csv,2019,0.3136382951981374,0.6863617048018625
11538,A Silent Voice: The Movie 2019 Re-release,333984,333984,0,2019_boxofficemojo_rankings.csv,2019,1.0,0.0
11539,Dark Days,333843,309648,24195,2000_boxofficemojo_rankings.csv,2000,0.9275258130318743,0.07247418696812574
11540,Monument Ave.,333760,333760,0,1998_boxofficemojo_rankings.csv,1998,1.0,0.0
11541,Ballet 422,333554,333554,0,2015_boxofficemojo_rankings.csv,2015,1.0,0.0
11542,Shine,333388,333388,0,2018_boxofficemojo_rankings.csv,2018,1.0,0.0
11543,Something from Nothing: The Art of Rap,333388,288000,45388,2012_boxofficemojo_rankings.csv,2012,0.8638583272343335,0.13614167276566644
11544,Linsanity,332990,302645,30345,2013_boxofficemojo_rankings.csv,2013,0.9088711372713896,0.09112886272861047
11545,The Assignment,332597,332597,0,1997_boxofficemojo_rankings.csv,1997,1.0,0.0
11546,Don't Hang Up,332571,0,332571,2017_boxofficemojo_rankings.csv,2017,0.0,1.0
11547,Zinda,332491,332491,0,2006_boxofficemojo_rankings.csv,2006,1.0,0.0
11548,Shamitabh,331821,324597,7224,2015_boxofficemojo_rankings.csv,2015,0.9782292259983545,0.021770774001645465
11549,Private Resort,331816,331816,0,1985_boxofficemojo_rankings.csv,1985,1.0,0.0
11550,Shaadi Se Pehle,331676,111678,219998,2006_boxofficemojo_rankings.csv,2006,0.336708112736526,0.663291887263474
11551,Cheech,329972,329972,0,2006_boxofficemojo_rankings.csv,2006,1.0,0.0
11552,I Am David,329577,288552,41025,2004_boxofficemojo_rankings.csv,2004,0.8755222603519056,0.12447773964809437
11553,Kissed,329211,329211,0,1997_boxofficemojo_rankings.csv,1997,1.0,0.0
11554,Bukowski: Born into This,329097,318816,10281,2004_boxofficemojo_rankings.csv,2004,0.968759970464635,0.031240029535364953
11555,The Big Fight Live: IBF Welterweight Title: Errol Spence Jr. vs. Mikey Garcia,328979,328979,0,2019_boxofficemojo_rankings.csv,2019,1.0,0.0
11556,Ladies vs. Ricky Bahl,328870,0,328870,2011_boxofficemojo_rankings.csv,2011,0.0,1.0
11557,The Last Sentence,328005,62506,265499,2012_boxofficemojo_rankings.csv,2012,0.19056416822914285,0.8094358317708572
11558,Monty Python Live at the Hollywood Bowl,327958,327958,0,1982_boxofficemojo_rankings.csv,1982,1.0,0.0
11559,Burden,327838,139270,188568,2020_boxofficemojo_rankings.csv,2020,0.4248134749479926,0.5751865250520074
11560,Elaine Stritch: Shoot Me,327452,327452,0,2014_boxofficemojo_rankings.csv,2014,1.0,0.0
11561,Deliver Us from Evil,327205,201275,125930,2006_boxofficemojo_rankings.csv,2006,0.615134243058633,0.38486575694136704
11562,Come Undone,326484,326484,0,2001_boxofficemojo_rankings.csv,2001,1.0,0.0
11563,You Will Be My Son 2012 Re-release,326061,285151,40910,2012_boxofficemojo_rankings.csv,2012,0.8745326794679523,0.12546732053204768
11564,Formosa Betrayed,326034,225341,100693,2010_boxofficemojo_rankings.csv,2010,0.6911579773888613,0.3088420226111387
11565,Lucy in the Sky,325950,319976,5974,2019_boxofficemojo_rankings.csv,2019,0.9816720355882804,0.018327964411719588
11566,The Central Park Five,325653,325653,0,2012_boxofficemojo_rankings.csv,2012,1.0,0.0
11567,The Opera House,325235,320079,5156,2018_boxofficemojo_rankings.csv,2018,0.9841468476639968,0.015853152336003196
11568,Camp,324977,324977,0,2013_boxofficemojo_rankings.csv,2013,1.0,0.0
11569,Juan of the Dead,324834,18000,306834,2012_boxofficemojo_rankings.csv,2012,0.05541291859842258,0.9445870814015774
11570,Teefa In Trouble,324633,0,324633,2018_boxofficemojo_rankings.csv,2018,0.0,1.0
11571,Red Hill,324424,21087,303337,2010_boxofficemojo_rankings.csv,2010,0.06499827386383251,0.9350017261361675
11572,Standard Operating Procedure,324217,229117,95100,2008_boxofficemojo_rankings.csv,2008,0.7066779348399375,0.29332206516006254
11573,The Children of the Marshland,324006,324006,0,1999_boxofficemojo_rankings.csv,1999,1.0,0.0
11574,World Gone Wild,323947,323947,0,1988_boxofficemojo_rankings.csv,1988,1.0,0.0
11575,The Bolshoi Ballet: Live From Moscow - The Nutcracker,323928,323928,0,2018_boxofficemojo_rankings.csv,2018,1.0,0.0
11576,The Boys of Baraka,323860,323860,0,2005_boxofficemojo_rankings.csv,2005,1.0,0.0
11577,The Cured,323776,26630,297146,2018_boxofficemojo_rankings.csv,2018,0.08224822099229097,0.917751779007709
11578,Three Worlds,323748,3952,319796,2012_boxofficemojo_rankings.csv,2012,0.012207025217144198,0.9877929747828558
11579,The Education of Little Tree,323411,323411,0,1997_boxofficemojo_rankings.csv,1997,1.0,0.0
11580,Sword of Trust,323369,322421,948,2019_boxofficemojo_rankings.csv,2019,0.9970683646236962,0.002931635376303851
11581,Damsel,323235,305136,18099,2018_boxofficemojo_rankings.csv,2018,0.944006682444661,0.055993317555339
11582,Citizen Jane: Battle for the City,323124,313411,9713,2017_boxofficemojo_rankings.csv,2017,0.9699403325039304,0.03005966749606962
11583,Winter Sleepers,323041,323041,0,2000_boxofficemojo_rankings.csv,2000,1.0,0.0
11584,The Cement Garden,322975,322975,0,1994_boxofficemojo_rankings.csv,1994,1.0,0.0
11585,House of Cards,322871,322871,0,1993_boxofficemojo_rankings.csv,1993,1.0,0.0
11586,The Day He Arrives,322348,13746,308602,2011_boxofficemojo_rankings.csv,2011,0.042643354387184036,0.957356645612816
11587,In This World,322097,84299,237798,2003_boxofficemojo_rankings.csv,2003,0.26171929574010316,0.7382807042598969
11588,Fatima,322016,0,322016,2020_boxofficemojo_rankings.csv,2020,0.0,1.0
11589,Nocturama,321768,30157,291611,2016_boxofficemojo_rankings.csv,2016,0.09372280649411999,0.90627719350588
11590,The Weight of Water,321279,109130,212149,2001_boxofficemojo_rankings.csv,2001,0.33967361701200516,0.6603263829879948
11591,Double Trouble,321081,44788,276293,2012_boxofficemojo_rankings.csv,2012,0.13949128101631675,0.8605087189836832
11592,Woodstock,320610,126562,194048,2019_boxofficemojo_rankings.csv,2019,0.39475375066279905,0.605246249337201
11593,A Film Unfinished,320486,320486,0,2010_boxofficemojo_rankings.csv,2010,1.0,0.0
11594,Happy Together,320319,320319,0,1997_boxofficemojo_rankings.csv,1997,1.0,0.0
11595,TerrorVision,320256,320256,0,1986_boxofficemojo_rankings.csv,1986,1.0,0.0
11596,"Die, Mommie, Die!",320092,320092,0,2003_boxofficemojo_rankings.csv,2003,1.0,0.0
11597,The English Teacher,320013,104810,215203,2013_boxofficemojo_rankings.csv,2013,0.3275179445835013,0.6724820554164987
11598,Beats,319595,0,319595,2019_boxofficemojo_rankings.csv,2019,0.0,1.0
11599,Meeting Gorbachev,319230,251837,67393,2019_boxofficemojo_rankings.csv,2019,0.7888888888888889,0.2111111111111111
11600,Trading Mom,319123,319123,0,1994_boxofficemojo_rankings.csv,1994,1.0,0.0
11601,Steve Harvey: Don't Trip... He Ain't Through with Me Yet,319021,319021,0,2006_boxofficemojo_rankings.csv,2006,1.0,0.0
11602,You Are Here: A Come From Away Story,318885,318885,0,2019_boxofficemojo_rankings.csv,2019,1.0,0.0
11603,Neal 'n' Nikki,318860,111551,207309,2005_boxofficemojo_rankings.csv,2005,0.34984319136925296,0.650156808630747
11604,Bride of the Wind,318823,318823,0,2001_boxofficemojo_rankings.csv,2001,1.0,0.0
11605,Telling Lies in America,318809,318809,0,1997_boxofficemojo_rankings.csv,1997,1.0,0.0
11606,Steep,318763,260586,58177,2007_boxofficemojo_rankings.csv,2007,0.8174913650580525,0.18250863494194747
11607,The Yellow Handkerchief,318623,318623,0,2010_boxofficemojo_rankings.csv,2010,1.0,0.0
11608,West of Memphis,318317,310154,8163,2012_boxofficemojo_rankings.csv,2012,0.9743557522846722,0.025644247715327802
11609,Trekkies,318246,318246,0,1999_boxofficemojo_rankings.csv,1999,1.0,0.0
11610,Ask Dr. Ruth,318230,297195,21035,2019_boxofficemojo_rankings.csv,2019,0.9339000094271439,0.06609999057285611
11611,The Student,318123,1126,316997,2016_boxofficemojo_rankings.csv,2016,0.003539511446830314,0.9964604885531697
11612,Not Today,318121,318121,0,2013_boxofficemojo_rankings.csv,2013,1.0,0.0
11613,Today's Special,317831,317831,0,2010_boxofficemojo_rankings.csv,2010,1.0,0.0
11614,Inch'Allah,317656,9840,307816,2013_boxofficemojo_rankings.csv,2013,0.030976905835243155,0.9690230941647568
11615,Sauvage / Wild,317536,61604,255932,2018_boxofficemojo_rankings.csv,2018,0.19400634888642548,0.8059936511135746
11616,Lovers of the Arctic Circle,317422,317422,0,1999_boxofficemojo_rankings.csv,1999,1.0,0.0
11617,6 Days,316946,0,316946,2017_boxofficemojo_rankings.csv,2017,0.0,1.0
11618,5 Days of War,316944,17479,299465,2011_boxofficemojo_rankings.csv,2011,0.05514854359129689,0.9448514564087032
11619,AmeriGeddon,316554,316554,0,2016_boxofficemojo_rankings.csv,2016,1.0,0.0
11620,The Aryan Couple,316527,290211,26316,2005_boxofficemojo_rankings.csv,2005,0.9168601730658048,0.0831398269341952
11621,Corpo Celeste 2011 Re-release,316504,8919,307585,2011_boxofficemojo_rankings.csv,2011,0.028179738644693274,0.9718202613553067
11622,Promised Land,316199,316199,0,1988_boxofficemojo_rankings.csv,1988,1.0,0.0
11623,Poison Friends,316184,13665,302519,2006_boxofficemojo_rankings.csv,2006,0.04321850568023682,0.9567814943197632
11624,The Riot and the Dance,316103,316103,0,2018_boxofficemojo_rankings.csv,2018,1.0,0.0
11625,David and Goliath,316100,316100,0,2015_boxofficemojo_rankings.csv,2015,1.0,0.0
11626,Le dernier souffle,316043,316043,0,1999_boxofficemojo_rankings.csv,1999,1.0,0.0
11627,Under the Sun,316020,316020,0,2001_boxofficemojo_rankings.csv,2001,1.0,0.0
11628,Crusoe,315421,315421,0,1989_boxofficemojo_rankings.csv,1989,1.0,0.0
11629,Josh Groban Bridges Live from Madison Square Garden,315173,315173,0,2019_boxofficemojo_rankings.csv,2019,1.0,0.0
11630,Obit.,315049,315049,0,2017_boxofficemojo_rankings.csv,2017,1.0,0.0
11631,What's Your Zodiac Sign?,314881,257868,57013,2009_boxofficemojo_rankings.csv,2009,0.8189379479866997,0.18106205201330025
11632,Call,314701,314701,0,2000_boxofficemojo_rankings.csv,2000,1.0,0.0
11633,America's Heart & Soul,314402,314402,0,2004_boxofficemojo_rankings.csv,2004,1.0,0.0
11634,Elevator to the Gallows,314387,263404,50983,2005_boxofficemojo_rankings.csv,2005,0.8378336254361662,0.16216637456383376
11635,Time Out of Mind,314082,166775,147307,2015_boxofficemojo_rankings.csv,2015,0.5309919065721691,0.46900809342783095
11636,The Music of Chance,313967,313967,0,1993_boxofficemojo_rankings.csv,1993,1.0,0.0
11637,Russian Doll,313901,127103,186798,2001_boxofficemojo_rankings.csv,2001,0.40491428826285997,0.5950857117371401
11638,Christine,313465,298525,14940,2016_boxofficemojo_rankings.csv,2016,0.9523391766225895,0.04766082337741056
11639,War Witch,313387,70544,242843,2012_boxofficemojo_rankings.csv,2012,0.22510187084977998,0.77489812915022
11640,The Bolshoi Ballet: Live From Moscow - Romeo and Juliet,313088,313088,0,2018_boxofficemojo_rankings.csv,2018,1.0,0.0
11641,Grass,313039,313039,0,2000_boxofficemojo_rankings.csv,2000,1.0,0.0
11642,Berberian Sound Studio,312757,38493,274264,2012_boxofficemojo_rankings.csv,2012,0.1230763819834568,0.8769236180165432
11643,For the Bible Tells Me So,312751,312751,0,2007_boxofficemojo_rankings.csv,2007,1.0,0.0
11644,The Hornet's Nest,312706,312706,0,2014_boxofficemojo_rankings.csv,2014,1.0,0.0
11645,The Gatekeeper,312434,312434,0,2003_boxofficemojo_rankings.csv,2003,1.0,0.0
11646,David Lynch: The Art Life,311470,171419,140051,2017_boxofficemojo_rankings.csv,2017,0.5503547693196776,0.44964523068032236
11647,Plácido Domingo Gala,311246,52502,258744,2019_boxofficemojo_rankings.csv,2019,0.16868329231540324,0.8313167076845968
11648,Monster in a Box,311245,311245,0,1992_boxofficemojo_rankings.csv,1992,1.0,0.0
11649,Dancing in Jaffa,311001,151098,159903,2014_boxofficemojo_rankings.csv,2014,0.48584409696431846,0.5141559030356816
11650,Being Elmo: A Puppeteer's Journey,310812,304052,6760,2011_boxofficemojo_rankings.csv,2011,0.9782505179980181,0.021749482001981905
11651,Swear on India,310330,310330,0,1999_boxofficemojo_rankings.csv,1999,1.0,0.0
11652,I Am Eleven 2014 Re-release,310116,310116,0,2014_boxofficemojo_rankings.csv,2014,1.0,0.0
11653,The Panama Deception,309596,309596,0,1992_boxofficemojo_rankings.csv,1992,1.0,0.0
11654,The Darwin Awards,309408,0,309408,2007_boxofficemojo_rankings.csv,2007,0.0,1.0
11655,Adam & Steve,309404,309404,0,2006_boxofficemojo_rankings.csv,2006,1.0,0.0
11656,Bohemian Rhapsody 2020 Re-release,308715,240000,68715,2020_boxofficemojo_rankings.csv,2020,0.7774160633594092,0.22258393664059084
11657,Bigger Stronger Faster*,308575,308575,0,2008_boxofficemojo_rankings.csv,2008,1.0,0.0
11658,Pumpkin,308552,308552,0,2002_boxofficemojo_rankings.csv,2002,1.0,0.0
11659,The Slingshot,308368,308368,0,1994_boxofficemojo_rankings.csv,1994,1.0,0.0
11660,The Amazing Catfish,308349,11342,297007,2014_boxofficemojo_rankings.csv,2014,0.03678299589101959,0.9632170041089804
11661,Merchants of Doubt,308156,308156,0,2015_boxofficemojo_rankings.csv,2015,1.0,0.0
11662,Great Performances at the Met: MET Opera: Magic Flute,307686,307686,0,2018_boxofficemojo_rankings.csv,2018,1.0,0.0
11663,Never Again,307631,307631,0,2002_boxofficemojo_rankings.csv,2002,1.0,0.0
11664,Dot the I,307486,307486,0,2005_boxofficemojo_rankings.csv,2005,1.0,0.0
11665,The Addiction,307308,307308,0,1995_boxofficemojo_rankings.csv,1995,1.0,0.0
11666,Whatever,307037,307037,0,1998_boxofficemojo_rankings.csv,1998,1.0,0.0
11667,Okko's Inn,306927,134787,172140,2018_boxofficemojo_rankings.csv,2018,0.43915002590192453,0.5608499740980755
11668,Nico Icon,306691,306691,0,1995_boxofficemojo_rankings.csv,1995,1.0,0.0
11669,The Trip,306567,306567,0,2003_boxofficemojo_rankings.csv,2003,1.0,0.0
11670,Constellation,306533,306533,0,2007_boxofficemojo_rankings.csv,2007,1.0,0.0
11671,Half of a Yellow Sun,306393,54529,251864,2014_boxofficemojo_rankings.csv,2014,0.17797077609475412,0.8220292239052459
11672,Hard Promises,306319,306319,0,1992_boxofficemojo_rankings.csv,1992,1.0,0.0
11673,The Mercy 2018 Re-release,306205,29538,276667,2018_boxofficemojo_rankings.csv,2018,0.09646478666253,0.90353521333747
11674,Boarding School,306061,306061,0,1983_boxofficemojo_rankings.csv,1983,1.0,0.0
11675,Monsters: Dark Continent,306004,0,306004,2015_boxofficemojo_rankings.csv,2015,0.0,1.0
11676,Under the Sun,305993,105036,200957,2016_boxofficemojo_rankings.csv,2016,0.3432627543767341,0.6567372456232659
11677,The Headless Woman,305766,100177,205589,2008_boxofficemojo_rankings.csv,2008,0.327626354794189,0.672373645205811
11678,The Third Wife,305755,84933,220822,2019_boxofficemojo_rankings.csv,2019,0.27778123006982713,0.7222187699301729
11679,Hair Show,305281,305281,0,2004_boxofficemojo_rankings.csv,2004,1.0,0.0
11680,Happiness,305205,305205,0,2003_boxofficemojo_rankings.csv,2003,1.0,0.0
11681,Eleni,305102,305102,0,1985_boxofficemojo_rankings.csv,1985,1.0,0.0
11682,Rapa Nui,305070,305070,0,1994_boxofficemojo_rankings.csv,1994,1.0,0.0
11683,The Kingmaker,304840,122587,182253,2019_boxofficemojo_rankings.csv,2019,0.4021355465162052,0.5978644534837948
11684,Showtime Championship Boxing: Deontay Wilder vs. Tyson Fury,304482,304482,0,2018_boxofficemojo_rankings.csv,2018,1.0,0.0
11685,Belle toujours,303867,10921,292946,2006_boxofficemojo_rankings.csv,2006,0.03594006588408745,0.9640599341159125
11686,Microbe & Gasoline,303787,63802,239985,2015_boxofficemojo_rankings.csv,2015,0.21002215368004556,0.7899778463199545
11687,The Chocolate War,303624,303624,0,1988_boxofficemojo_rankings.csv,1988,1.0,0.0
11688,N.H 10,303587,303587,0,2015_boxofficemojo_rankings.csv,2015,1.0,0.0
11689,Alamar,303574,61613,241961,2010_boxofficemojo_rankings.csv,2010,0.20295875140822336,0.7970412485917766
11690,Shrink,303431,189621,113810,2009_boxofficemojo_rankings.csv,2009,0.6249229643642212,0.3750770356357788
11691,Chalk,302845,302845,0,2007_boxofficemojo_rankings.csv,2007,1.0,0.0
11692,The Bolshoi Ballet: Live From Moscow - Giselle,302681,302681,0,2018_boxofficemojo_rankings.csv,2018,1.0,0.0
11693,101 Reykjavík 2001 Re-release,301882,126404,175478,2001_boxofficemojo_rankings.csv,2001,0.4187198971783677,0.5812801028216323
11694,Mr. Jealousy,301796,301796,0,1998_boxofficemojo_rankings.csv,1998,1.0,0.0
11695,The Unknown Known,301604,276497,25107,2014_boxofficemojo_rankings.csv,2014,0.9167550828238352,0.08324491717616478
11696,Lilies,301548,301548,0,1997_boxofficemojo_rankings.csv,1997,1.0,0.0
11697,God Grew Tired of Us,301447,301447,0,2007_boxofficemojo_rankings.csv,2007,1.0,0.0
11698,Old Joy,301047,255923,45124,2006_boxofficemojo_rankings.csv,2006,0.8501097835221743,0.14989021647782572
11699,42 Up,300880,300880,0,1999_boxofficemojo_rankings.csv,1999,1.0,0.0
11700,White Water Summer,300859,300859,0,1987_boxofficemojo_rankings.csv,1987,1.0,0.0
11701,Cliffs of Freedom,300842,72476,228366,2019_boxofficemojo_rankings.csv,2019,0.2409105111653293,0.7590894888346706
11702,Different for Girls,300645,300645,0,1997_boxofficemojo_rankings.csv,1997,1.0,0.0
11703,The Wedding Curse,300454,300454,0,2006_boxofficemojo_rankings.csv,2006,1.0,0.0
11704,Planet B-Boy,300447,273870,26577,2008_boxofficemojo_rankings.csv,2008,0.9115418027139562,0.08845819728604379
11705,Series 7: The Contenders,300086,195065,105021,2001_boxofficemojo_rankings.csv,2001,0.6500303246402698,0.3499696753597302
11706,Freaky Friday 1981 Re-release,300000,300000,0,1981_boxofficemojo_rankings.csv,1981,1.0,0.0
11707,Love's Labour's Lost,299792,299792,0,2000_boxofficemojo_rankings.csv,2000,1.0,0.0
11708,Sunset Blvd. 2018 Re-release,299645,299645,0,2018_boxofficemojo_rankings.csv,2018,1.0,0.0
11709,SLC Punk!,299569,299569,0,1999_boxofficemojo_rankings.csv,1999,1.0,0.0
11710,Cotton Mary,299432,299432,0,2000_boxofficemojo_rankings.csv,2000,1.0,0.0
11711,Kedma,299293,10067,289226,2002_boxofficemojo_rankings.csv,2002,0.033635935354318344,0.9663640646456817
11712,Festival in Cannes,299171,299171,0,2002_boxofficemojo_rankings.csv,2002,1.0,0.0
11713,Zhou Yu's Train 2004 Re-release,298429,142562,155867,2004_boxofficemojo_rankings.csv,2004,0.4777082656176176,0.5222917343823824
11714,Killer,297415,297415,0,1994_boxofficemojo_rankings.csv,1994,1.0,0.0
11715,Jinn,297381,202348,95033,2014_boxofficemojo_rankings.csv,2014,0.6804335179449931,0.3195664820550069
11716,Kaptaan,296715,203790,92925,2016_boxofficemojo_rankings.csv,2016,0.6868206865173652,0.31317931348263484
11717,Black Dynamite,296557,242578,53979,2009_boxofficemojo_rankings.csv,2009,0.8179810289421595,0.18201897105784048
11718,Bonhoeffer,296181,296181,0,2003_boxofficemojo_rankings.csv,2003,1.0,0.0
11719,Ethan Frome,296081,296081,0,1993_boxofficemojo_rankings.csv,1993,1.0,0.0
11720,The We and the I,295930,42172,253758,2012_boxofficemojo_rankings.csv,2012,0.1425066738755787,0.8574933261244213
11721,Harry Potter and the Sorcerer's Stone 2018 Re-release,295917,295917,0,2018_boxofficemojo_rankings.csv,2018,1.0,0.0
11722,Trixie,295683,295683,0,2000_boxofficemojo_rankings.csv,2000,1.0,0.0
11723,Freeway,295493,295493,0,1996_boxofficemojo_rankings.csv,1996,1.0,0.0
11724,Riff-Raff,295444,295444,0,1993_boxofficemojo_rankings.csv,1993,1.0,0.0
11725,Chic!,295295,5587,289708,2015_boxofficemojo_rankings.csv,2015,0.018920062987859598,0.9810799370121404
11726,Wet Hot American Summer,295206,295206,0,2001_boxofficemojo_rankings.csv,2001,1.0,0.0
11727,Gremlins 2020 Re-release,295159,295000,159,2020_boxofficemojo_rankings.csv,2020,0.99946130729539,0.0005386927046100576
11728,The Tenth Man,295129,63564,231565,2016_boxofficemojo_rankings.csv,2016,0.21537700463187284,0.7846229953681272
11729,Rent-a-Cop,295000,295000,0,1988_boxofficemojo_rankings.csv,1988,1.0,0.0
11730,Mickey,294758,294758,0,2004_boxofficemojo_rankings.csv,2004,1.0,0.0
11731,Aftershock,294696,58510,236186,2013_boxofficemojo_rankings.csv,2013,0.19854358389662569,0.8014564161033744
11732,Shakira in Concert: El Dorado World Tour,294677,271586,23091,2019_boxofficemojo_rankings.csv,2019,0.9216396257597301,0.07836037424026986
11733,Khodorkovsky,294599,39522,255077,2011_boxofficemojo_rankings.csv,2011,0.1341552415317092,0.8658447584682908
11734,Special Treatment,294483,8856,285627,2010_boxofficemojo_rankings.csv,2010,0.0300730432656554,0.9699269567343446
11735,Taxi to the Dark Side,294309,274661,19648,2008_boxofficemojo_rankings.csv,2008,0.9332402339038222,0.06675976609617783
11736,Out Cold,294266,294266,0,1989_boxofficemojo_rankings.csv,1989,1.0,0.0
11737,44 Inch Chest 2010 Re-release,294245,39033,255212,2010_boxofficemojo_rankings.csv,2010,0.1326547604887084,0.8673452395112916
11738,Surfwise,294236,269994,24242,2008_boxofficemojo_rankings.csv,2008,0.9176103535937139,0.08238964640628611
11739,Love and Other Catastrophes,294212,294212,0,1997_boxofficemojo_rankings.csv,1997,1.0,0.0
11740,Bliss,294064,294064,0,1997_boxofficemojo_rankings.csv,1997,1.0,0.0
11741,Feast of July,293274,293274,0,1995_boxofficemojo_rankings.csv,1995,1.0,0.0
11742,The Giant Spider Invasion,293053,293053,0,2019_boxofficemojo_rankings.csv,2019,1.0,0.0
11743,Pianomania,292870,49852,243018,2010_boxofficemojo_rankings.csv,2010,0.17021886843992215,0.8297811315600778
11744,Taxi No. 9 2 11: Nau Do Gyarah,292794,292794,0,2006_boxofficemojo_rankings.csv,2006,1.0,0.0
11745,Stonewall,292669,187674,104995,2015_boxofficemojo_rankings.csv,2015,0.6412500128131097,0.35874998718689033
11746,All Over Me,292577,292577,0,1997_boxofficemojo_rankings.csv,1997,1.0,0.0
11747,Luminarias,292309,292309,0,2000_boxofficemojo_rankings.csv,2000,1.0,0.0
11748,Simon Sez,292152,292152,0,1999_boxofficemojo_rankings.csv,1999,1.0,0.0
11749,Mesrine Part 2: Public Enemy #1 2010 Re-release,292150,275387,16763,2010_boxofficemojo_rankings.csv,2010,0.9426219407838439,0.05737805921615608
11750,Passage to Zarahemla,292102,292102,0,2007_boxofficemojo_rankings.csv,2007,1.0,0.0
11751,The Last Five Years,292092,145427,146665,2015_boxofficemojo_rankings.csv,2015,0.4978808046779782,0.5021191953220219
11752,Dreams of a Life,291898,8405,283493,2011_boxofficemojo_rankings.csv,2011,0.02879430485991682,0.9712056951400831
11753,The Godfather: Part II 45th Anniversary,291754,291754,0,2019_boxofficemojo_rankings.csv,2019,1.0,0.0
11754,The Man in 3B,291513,291513,0,2015_boxofficemojo_rankings.csv,2015,1.0,0.0
11755,I'm Dancing as Fast as I Can,291390,291390,0,1982_boxofficemojo_rankings.csv,1982,1.0,0.0
11756,Waste Land,291307,187716,103591,2010_boxofficemojo_rankings.csv,2010,0.644392342099572,0.3556076579004281
11757,Big Bad Wolves,291239,33232,258007,2014_boxofficemojo_rankings.csv,2014,0.11410559712126467,0.8858944028787353
11758,Imaginary Heroes,291118,228767,62351,2004_boxofficemojo_rankings.csv,2004,0.7858222439010986,0.21417775609890147
11759,Carried Away,290978,290978,0,1996_boxofficemojo_rankings.csv,1996,1.0,0.0
11760,Power and Terror: Noam Chomsky in Our Times,290767,290767,0,2002_boxofficemojo_rankings.csv,2002,1.0,0.0
11761,Fraternity Row,290674,290674,0,1977_boxofficemojo_rankings.csv,1977,1.0,0.0
11762,More Than Funny,290498,290498,0,2018_boxofficemojo_rankings.csv,2018,1.0,0.0
11763,Illégal,290108,651,289457,2010_boxofficemojo_rankings.csv,2010,0.0022439918926744525,0.9977560081073256
11764,Jimmy Vestvood: Amerikan Hero,290080,230069,60011,2016_boxofficemojo_rankings.csv,2016,0.7931225868725869,0.20687741312741312
11765,Best F(r)iends: Volume 1,290064,252410,37654,2018_boxofficemojo_rankings.csv,2018,0.8701872690164929,0.1298127309835071
11766,Scratch,289885,289885,0,2002_boxofficemojo_rankings.csv,2002,1.0,0.0
11767,The Zoya Factor,289631,128831,160800,2019_boxofficemojo_rankings.csv,2019,0.4448108109974416,0.5551891890025584
11768,Best Night Ever,289511,0,289511,2014_boxofficemojo_rankings.csv,2014,0.0,1.0
11769,Chaos Theory,289458,240476,48982,2008_boxofficemojo_rankings.csv,2008,0.8307802859136731,0.16921971408632686
11770,The Silence of Others,289455,67986,221469,2018_boxofficemojo_rankings.csv,2018,0.2348758874436441,0.7651241125563559
11771,Plain Clothes,289323,289323,0,1988_boxofficemojo_rankings.csv,1988,1.0,0.0
11772,Welcome to New York,288837,0,288837,2014_boxofficemojo_rankings.csv,2014,0.0,1.0
11773,Antarctica: A Year on Ice,288757,288757,0,2014_boxofficemojo_rankings.csv,2014,1.0,0.0
11774,Above and Beyond,288751,288751,0,2015_boxofficemojo_rankings.csv,2015,1.0,0.0
11775,Fervour,288733,288733,0,1999_boxofficemojo_rankings.csv,1999,1.0,0.0
11776,The Last of Robin Hood,288545,288545,0,2014_boxofficemojo_rankings.csv,2014,1.0,0.0
11777,Saga of Tanya the Evil - The Movie,288460,288460,0,2019_boxofficemojo_rankings.csv,2019,1.0,0.0
11778,Last Train Home,288328,288328,0,2010_boxofficemojo_rankings.csv,2010,1.0,0.0
11779,American Pimp,287724,287724,0,2000_boxofficemojo_rankings.csv,2000,1.0,0.0
11780,Countdown to Zero,287711,272040,15671,2010_boxofficemojo_rankings.csv,2010,0.9455321485796511,0.05446785142034889
11781,Generation Wealth,287709,237709,50000,2018_boxofficemojo_rankings.csv,2018,0.8262132919025821,0.17378670809741786
11782,The Lucky Ones,287567,266967,20600,2008_boxofficemojo_rankings.csv,2008,0.9283645202683201,0.07163547973167993
11783,Skate Kitchen,287307,236799,50508,2018_boxofficemojo_rankings.csv,2018,0.824201986028882,0.175798013971118
11784,Outrage,287198,287198,0,2009_boxofficemojo_rankings.csv,2009,1.0,0.0
11785,Post Mortem,286702,9750,276952,2010_boxofficemojo_rankings.csv,2010,0.03400743629273601,0.9659925637072639
11786,The Interrupters,286457,282448,4009,2011_boxofficemojo_rankings.csv,2011,0.9860048803136248,0.013995119686375268
11787,Cold Steel,285885,285885,0,1987_boxofficemojo_rankings.csv,1987,1.0,0.0
11788,My Winnipeg,285469,159363,126106,2008_boxofficemojo_rankings.csv,2008,0.5582497574167423,0.44175024258325774
11789,Notre musique,285354,139922,145432,2004_boxofficemojo_rankings.csv,2004,0.4903453254553993,0.5096546745446008
11790,But Deliver Us from Evil,285169,285169,0,2018_boxofficemojo_rankings.csv,2018,1.0,0.0
11791,Citizen Ruth,285112,285112,0,1996_boxofficemojo_rankings.csv,1996,1.0,0.0
11792,Wind Chill,285060,36804,248256,2007_boxofficemojo_rankings.csv,2007,0.1291096611239739,0.8708903388760261
11793,Marius and Jeannette,285038,285038,0,1998_boxofficemojo_rankings.csv,1998,1.0,0.0
11794,Only Human 2006 Re-release,284961,284961,0,2006_boxofficemojo_rankings.csv,2006,1.0,0.0
11795,Dil Kya Kare,284856,284856,0,1999_boxofficemojo_rankings.csv,1999,1.0,0.0
11796,The Doom Generation,284785,284785,0,1995_boxofficemojo_rankings.csv,1995,1.0,0.0
11797,Cyclo,284692,284692,0,1996_boxofficemojo_rankings.csv,1996,1.0,0.0
11798,The Silence 2012 Re-release,284471,100214,184257,2012_boxofficemojo_rankings.csv,2012,0.35228195492686426,0.6477180450731358
11799,Khalid: Free Spirit,284229,284229,0,2019_boxofficemojo_rankings.csv,2019,1.0,0.0
11800,South of the Border,284214,198600,85614,2010_boxofficemojo_rankings.csv,2010,0.6987692372648778,0.3012307627351221
11801,The Anonymous People,284147,284147,0,2013_boxofficemojo_rankings.csv,2013,1.0,0.0
11802,The Kindergarten Teacher,284065,36190,247875,2014_boxofficemojo_rankings.csv,2014,0.12740041891820533,0.8725995810817947
11803,George Washington,283846,247406,36440,2000_boxofficemojo_rankings.csv,2000,0.8716205266235917,0.12837947337640834
11804,Powwow Highway,283747,283747,0,1989_boxofficemojo_rankings.csv,1989,1.0,0.0
11805,Kill Me Again,283694,283694,0,1989_boxofficemojo_rankings.csv,1989,1.0,0.0
11806,Valhalla Rising,282737,30638,252099,2009_boxofficemojo_rankings.csv,2009,0.10836218818195001,0.89163781181805
11807,The Heart of Me,282519,196067,86452,2003_boxofficemojo_rankings.csv,2003,0.6939958020522513,0.30600419794774864
11808,Disney's Newsies: The Broadway Musical! 2018 Re-release,282429,282429,0,2018_boxofficemojo_rankings.csv,2018,1.0,0.0
11809,Irma Vep,282310,282310,0,1997_boxofficemojo_rankings.csv,1997,1.0,0.0
11810,Resistance,282228,7464,274764,2020_boxofficemojo_rankings.csv,2020,0.026446702665929675,0.9735532973340704
11811,Wide Awake,282175,282175,0,1998_boxofficemojo_rankings.csv,1998,1.0,0.0
11812,Created Equal: Clarence Thomas in His Own Words,282149,282149,0,2020_boxofficemojo_rankings.csv,2020,1.0,0.0
11813,Tumbledown,282083,135026,147057,2016_boxofficemojo_rankings.csv,2016,0.47867471630690256,0.5213252836930974
11814,Ho Mann Jahaan,281926,208611,73315,2016_boxofficemojo_rankings.csv,2016,0.7399494902917787,0.2600505097082213
11815,Green Dragon,281803,281803,0,2002_boxofficemojo_rankings.csv,2002,1.0,0.0
11816,That Evening Sun,281350,281350,0,2009_boxofficemojo_rankings.csv,2009,1.0,0.0
11817,Mike Wallace Is Here,281245,281245,0,2019_boxofficemojo_rankings.csv,2019,1.0,0.0
11818,Zus & Zo,281219,49468,231751,2002_boxofficemojo_rankings.csv,2002,0.17590561092956022,0.8240943890704397
11819,Brand Upon the Brain! A Remembrance in 12 Chapters,281091,263200,17891,2007_boxofficemojo_rankings.csv,2007,0.9363515729781459,0.06364842702185414
11820,"If I Want to Whistle, I Whistle",280892,12135,268757,2010_boxofficemojo_rankings.csv,2010,0.04320165757657748,0.9567983424234225
11821,La Haine,280859,280859,0,1996_boxofficemojo_rankings.csv,1996,1.0,0.0
11822,The Body,280777,36849,243928,2001_boxofficemojo_rankings.csv,2001,0.13123938214312425,0.8687606178568757
11823,Octaman,280710,280710,0,2019_boxofficemojo_rankings.csv,2019,1.0,0.0
11824,I Do... Until I Don't,280668,280668,0,2017_boxofficemojo_rankings.csv,2017,1.0,0.0
11825,Who Is Cletis Tout?,280458,252706,27752,2002_boxofficemojo_rankings.csv,2002,0.9010475721854966,0.09895242781450342
11826,The Battle of Shaker Heights,280351,280351,0,2003_boxofficemojo_rankings.csv,2003,1.0,0.0
11827,Lola Montès,280314,120306,160008,2008_boxofficemojo_rankings.csv,2008,0.4291829876495644,0.5708170123504356
11828,That's Entertainment! III,280163,280163,0,1994_boxofficemojo_rankings.csv,1994,1.0,0.0
11829,The Black Power Mixtape 1967-1975,280025,273749,6276,2011_boxofficemojo_rankings.csv,2011,0.9775877153825552,0.02241228461744487
11830,Twice Upon a Yesterday,279757,279757,0,1999_boxofficemojo_rankings.csv,1999,1.0,0.0
11831,Equinox,279627,279627,0,1993_boxofficemojo_rankings.csv,1993,1.0,0.0
11832,Wonders of the Sea,279415,100780,178635,2018_boxofficemojo_rankings.csv,2018,0.360682139469964,0.6393178605300359
11833,Havenhurst,279372,0,279372,2016_boxofficemojo_rankings.csv,2016,0.0,1.0
11834,Christmas in the Clouds,279225,279225,0,2005_boxofficemojo_rankings.csv,2005,1.0,0.0
11835,"Lovely, Still",279170,127564,151606,2010_boxofficemojo_rankings.csv,2010,0.4569402156392163,0.5430597843607837
11836,De fem benspænd,279032,165845,113187,2004_boxofficemojo_rankings.csv,2004,0.5943583531637948,0.4056416468362052
11837,"Lou Andreas-Salomé, The Audacity to be Free",278982,12875,266107,2017_boxofficemojo_rankings.csv,2017,0.04614993081990953,0.9538500691800905
11838,Wrestling Ernest Hemingway,278720,278720,0,1993_boxofficemojo_rankings.csv,1993,1.0,0.0
11839,Every Time We Say Goodbye,278623,278623,0,1986_boxofficemojo_rankings.csv,1986,1.0,0.0
11840,Smiling Fish & Goat on Fire,278492,278492,0,2000_boxofficemojo_rankings.csv,2000,1.0,0.0
11841,10 Years,278336,203373,74963,2012_boxofficemojo_rankings.csv,2012,0.730674436652104,0.2693255633478961
11842,Tokyo Decadence,277845,277845,0,1993_boxofficemojo_rankings.csv,1993,1.0,0.0
11843,The Nest,277800,135163,142637,2020_boxofficemojo_rankings.csv,2020,0.4865478761699064,0.5134521238300936
11844,Bolshoi Ballet: The Golden Age,277666,171916,105750,2019_boxofficemojo_rankings.csv,2019,0.6191467446500472,0.38085325534995285
11845,The Summit,277651,243550,34101,2013_boxofficemojo_rankings.csv,2013,0.8771803451095079,0.12281965489049201
11846,Lady Jane,277646,277646,0,1986_boxofficemojo_rankings.csv,1986,1.0,0.0
11847,Solas,277596,277596,0,2000_boxofficemojo_rankings.csv,2000,1.0,0.0
11848,Willy/Milly,277405,277405,0,1986_boxofficemojo_rankings.csv,1986,1.0,0.0
11849,Science Fair,277338,276195,1143,2018_boxofficemojo_rankings.csv,2018,0.9958786751184475,0.004121324881552474
11850,Wonderful Town,277233,4487,272746,2008_boxofficemojo_rankings.csv,2008,0.016184941908070107,0.9838150580919299
11851,See You Soon,277126,0,277126,2019_boxofficemojo_rankings.csv,2019,0.0,1.0
11852,Eyes Wide Open,276576,26258,250318,2009_boxofficemojo_rankings.csv,2009,0.09493954645377763,0.9050604535462223
11853,True Grit 2019 Re-release,276418,276418,0,2019_boxofficemojo_rankings.csv,2019,1.0,0.0
11854,Beefcake,276259,276259,0,1999_boxofficemojo_rankings.csv,1999,1.0,0.0
11855,Seven Samurai 2002 Re-release,275965,271841,4124,2002_boxofficemojo_rankings.csv,2002,0.9850560759516606,0.014943924048339463
11856,Dr. Strangelove or: How I Learned to Stop Worrying and Love the Bomb 1994 Re-release,275902,275902,0,1994_boxofficemojo_rankings.csv,1994,1.0,0.0
11857,Morning Light,275776,275497,279,2008_boxofficemojo_rankings.csv,2008,0.998988309352518,0.0010116906474820144
11858,Piñero,275171,275171,0,2001_boxofficemojo_rankings.csv,2001,1.0,0.0
11859,The Boy in Blue,275000,275000,0,1986_boxofficemojo_rankings.csv,1986,1.0,0.0
11860,Life After Beth,274717,88273,186444,2014_boxofficemojo_rankings.csv,2014,0.3213233982607556,0.6786766017392444
11861,Hey Ram,274675,274675,0,2000_boxofficemojo_rankings.csv,2000,1.0,0.0
11862,Café au lait,274596,274596,0,1994_boxofficemojo_rankings.csv,1994,1.0,0.0
11863,Lovely Molly,274480,18464,256016,2012_boxofficemojo_rankings.csv,2012,0.06726901777907315,0.9327309822209269
11864,Swallow,274259,33419,240840,2020_boxofficemojo_rankings.csv,2020,0.1218519720410269,0.8781480279589731
11865,Dirty,274245,274245,0,2006_boxofficemojo_rankings.csv,2006,1.0,0.0
11866,The Swan Princess: Escape from Castle Mountain,273644,273644,0,1997_boxofficemojo_rankings.csv,1997,1.0,0.0
11867,The Rules of the Game,273641,273641,0,2006_boxofficemojo_rankings.csv,2006,1.0,0.0
11868,The King,273601,259291,14310,2018_boxofficemojo_rankings.csv,2018,0.9476975595849431,0.05230244041505696
11869,A Man Apart,273364,213143,60221,2005_boxofficemojo_rankings.csv,2005,0.7797039844310151,0.22029601556898495
11870,Empire Records,273188,273188,0,1995_boxofficemojo_rankings.csv,1995,1.0,0.0
11871,P.S.,273023,180503,92520,2004_boxofficemojo_rankings.csv,2004,0.6611274508008482,0.3388725491991517
11872,Becoming Colette,272931,272931,0,1992_boxofficemojo_rankings.csv,1992,1.0,0.0
11873,Slayer: The Repentless Killogy,272874,268727,4147,2019_boxofficemojo_rankings.csv,2019,0.9848025095831776,0.015197490416822416
11874,Chavela,272842,148666,124176,2017_boxofficemojo_rankings.csv,2017,0.5448794540429992,0.45512054595700074
11875,Stander,272791,31651,241140,2003_boxofficemojo_rankings.csv,2003,0.11602655512828502,0.883973444871715
11876,Paraíso Perdido,272750,272750,0,1996_boxofficemojo_rankings.csv,1996,1.0,0.0
11877,Unhook the Stars,272542,272542,0,1996_boxofficemojo_rankings.csv,1996,1.0,0.0
11878,Black Death,272445,22554,249891,2010_boxofficemojo_rankings.csv,2010,0.0827836811099488,0.9172163188900512
11879,Heavy Petting,272371,272371,0,1989_boxofficemojo_rankings.csv,1989,1.0,0.0
11880,Heart Like a Wheel,272278,272278,0,1983_boxofficemojo_rankings.csv,1983,1.0,0.0
11881,One Child Nation,271841,270128,1713,2019_boxofficemojo_rankings.csv,2019,0.993698522297961,0.0063014777020390595
11882,Come Out and Play,271735,2638,269097,2013_boxofficemojo_rankings.csv,2013,0.009707987561410933,0.9902920124385891
11883,The Tale of The Princess Kaguya 2019 Re-release,271681,271681,0,2019_boxofficemojo_rankings.csv,2019,1.0,0.0
11884,Big Girls Don't Cry... They Get Even,271327,271327,0,1992_boxofficemojo_rankings.csv,1992,1.0,0.0
11885,Aloft,270971,53086,217885,2015_boxofficemojo_rankings.csv,2015,0.19591026345992746,0.8040897365400725
11886,Around a Small Mountain,270930,33216,237714,2009_boxofficemojo_rankings.csv,2009,0.12259993356217473,0.8774000664378253
11887,Rishtey,270929,119537,151392,2002_boxofficemojo_rankings.csv,2002,0.44121153512543876,0.5587884648745612
11888,Deep in the Woods,270890,56119,214771,2000_boxofficemojo_rankings.csv,2000,0.2071652700358079,0.7928347299641921
11889,Waking the Dead,270745,270745,0,2000_boxofficemojo_rankings.csv,2000,1.0,0.0
11890,Call of the Wild,270210,28682,241528,2009_boxofficemojo_rankings.csv,2009,0.10614707079678769,0.8938529292032124
11891,The Canyons,270185,56825,213360,2013_boxofficemojo_rankings.csv,2013,0.21031885559894148,0.7896811444010585
11892,This Old Cub,270014,270014,0,2004_boxofficemojo_rankings.csv,2004,1.0,0.0
11893,Exposed,269915,0,269915,2016_boxofficemojo_rankings.csv,2016,0.0,1.0
11894,Stalker,269881,269881,0,2017_boxofficemojo_rankings.csv,2017,1.0,0.0
11895,Shirin Farhad Ki Toh Nikal Padi,269845,155758,114087,2012_boxofficemojo_rankings.csv,2012,0.5772128444106802,0.4227871555893198
11896,American Dream,269823,269823,0,1992_boxofficemojo_rankings.csv,1992,1.0,0.0
11897,Fierce People,269755,85410,184345,2006_boxofficemojo_rankings.csv,2006,0.3166206372449074,0.6833793627550926
11898,Boy Culture,269589,220409,49180,2007_boxofficemojo_rankings.csv,2007,0.8175741591830528,0.18242584081694727
11899,Save Yourselves!,269467,269467,0,2020_boxofficemojo_rankings.csv,2020,1.0,0.0
11900,Foxfire,269300,269300,0,1996_boxofficemojo_rankings.csv,1996,1.0,0.0
11901,The Loneliest Planet,268933,129579,139354,2012_boxofficemojo_rankings.csv,2012,0.4818263284907393,0.5181736715092606
11902,The World Before Your Feet,268644,268644,0,2018_boxofficemojo_rankings.csv,2018,1.0,0.0
11903,Harvard Beats Yale 29-29,268431,268431,0,2008_boxofficemojo_rankings.csv,2008,1.0,0.0
11904,Taxi,268254,268254,0,1998_boxofficemojo_rankings.csv,1998,1.0,0.0
11905,Psycho Beach Party,268117,268117,0,2000_boxofficemojo_rankings.csv,2000,1.0,0.0
11906,Meri Pyaari Bindu,268067,0,268067,2017_boxofficemojo_rankings.csv,2017,0.0,1.0
11907,The Carer,267995,6208,261787,2016_boxofficemojo_rankings.csv,2016,0.023164611280061195,0.9768353887199388
11908,Conan O'Brien Can't Stop,267965,267965,0,2011_boxofficemojo_rankings.csv,2011,1.0,0.0
11909,An American in Paris 2020 Re-release,267824,267824,0,2020_boxofficemojo_rankings.csv,2020,1.0,0.0
11910,Falcon Rising,267476,11774,255702,2014_boxofficemojo_rankings.csv,2014,0.04401890263051638,0.9559810973694837
11911,Gilles' Wife,267402,32799,234603,2004_boxofficemojo_rankings.csv,2004,0.12265802050844796,0.877341979491552
11912,Pastime,267265,267265,0,1991_boxofficemojo_rankings.csv,1991,1.0,0.0
11913,The Gospel According to Vic,267249,267249,0,1986_boxofficemojo_rankings.csv,1986,1.0,0.0
11914,Munger Road,266689,266689,0,2011_boxofficemojo_rankings.csv,2011,1.0,0.0
11915,Rosetta,266665,266665,0,1999_boxofficemojo_rankings.csv,1999,1.0,0.0
11916,Nil by Mouth,266130,266130,0,1998_boxofficemojo_rankings.csv,1998,1.0,0.0
11917,Never Rarely Sometimes Always,265808,16565,249243,2020_boxofficemojo_rankings.csv,2020,0.062319418527659064,0.9376805814723409
11918,Hollow Reed,265732,265732,0,1997_boxofficemojo_rankings.csv,1997,1.0,0.0
11919,Luzia: Cirque du Soleil in Cinema,265673,265673,0,2019_boxofficemojo_rankings.csv,2019,1.0,0.0
11920,Félicité,265495,12433,253062,2017_boxofficemojo_rankings.csv,2017,0.04682950714702725,0.9531704928529727
11921,Out of Liberty,265279,265279,0,2019_boxofficemojo_rankings.csv,2019,1.0,0.0
11922,The TV Set,265198,265198,0,2007_boxofficemojo_rankings.csv,2007,1.0,0.0
11923,Amongst Friends,265000,265000,0,1993_boxofficemojo_rankings.csv,1993,1.0,0.0
11924,Asbury Park: Riot Redemption Rock 'n Roll,264983,167684,97299,2019_boxofficemojo_rankings.csv,2019,0.6328104067053358,0.36718959329466416
11925,Doctor Who,264629,264629,0,2018_boxofficemojo_rankings.csv,2018,1.0,0.0
11926,Shoot on Sight,264617,0,264617,2008_boxofficemojo_rankings.csv,2008,0.0,1.0
11927,Riding the Bullet,264505,134711,129794,2004_boxofficemojo_rankings.csv,2004,0.5092947203266479,0.4907052796733521
11928,Little Girl,264498,1350,263148,2009_boxofficemojo_rankings.csv,2009,0.005104008347889209,0.9948959916521108
11929,Beautiful People,264292,264292,0,2000_boxofficemojo_rankings.csv,2000,1.0,0.0
11930,The Secrets,264006,122094,141912,2008_boxofficemojo_rankings.csv,2008,0.46246676211904275,0.5375332378809573
11931,Phil Ochs: There But for Fortune,263723,263723,0,2011_boxofficemojo_rankings.csv,2011,1.0,0.0
11932,Split Image,263635,263635,0,1982_boxofficemojo_rankings.csv,1982,1.0,0.0
11933,The Producers 2018 Re-release,263277,216807,46470,2018_boxofficemojo_rankings.csv,2018,0.8234938866668946,0.17650611333310542
11934,Flirt,263192,263192,0,1996_boxofficemojo_rankings.csv,1996,1.0,0.0
11935,Life and Debt,263107,263107,0,2001_boxofficemojo_rankings.csv,2001,1.0,0.0
11936,My Date with Drew,262770,181041,81729,2005_boxofficemojo_rankings.csv,2005,0.6889713437607032,0.3110286562392967
11937,Raja,262643,13000,249643,2003_boxofficemojo_rankings.csv,2003,0.04949684552796001,0.95050315447204
11938,Grand départ,262412,677,261735,2013_boxofficemojo_rankings.csv,2013,0.0025799125040013413,0.9974200874959986
11939,Augustine,262390,107352,155038,2013_boxofficemojo_rankings.csv,2013,0.40913144555813863,0.5908685544418614
11940,The Final Year,262286,191900,70386,2018_boxofficemojo_rankings.csv,2018,0.73164408317638,0.26835591682362003
11941,Bubble,261966,145626,116340,2006_boxofficemojo_rankings.csv,2006,0.5558965667300336,0.4441034332699663
11942,Minimalism: A Documentary About the Important Things,261865,261865,0,2016_boxofficemojo_rankings.csv,2016,1.0,0.0
11943,Any Day Now,261747,201395,60352,2012_boxofficemojo_rankings.csv,2012,0.7694262016374591,0.23057379836254094
11944,Journey of Hope,261718,261718,0,1991_boxofficemojo_rankings.csv,1991,1.0,0.0
11945,Half Girlfriend,261597,0,261597,2017_boxofficemojo_rankings.csv,2017,0.0,1.0
11946,Circuit,261155,235087,26068,2002_boxofficemojo_rankings.csv,2002,0.9001818843215715,0.09981811567842852
11947,The Stone Boy,261033,261033,0,1984_boxofficemojo_rankings.csv,1984,1.0,0.0
11948,Requiem 2006 Re-release,260877,9600,251277,2006_boxofficemojo_rankings.csv,2006,0.03679895122988995,0.96320104877011
11949,Eating You Alive,260534,260534,0,2018_boxofficemojo_rankings.csv,2018,1.0,0.0
11950,Stone Reader,260523,260523,0,2003_boxofficemojo_rankings.csv,2003,1.0,0.0
11951,Her Smell,260481,255599,4882,2019_boxofficemojo_rankings.csv,2019,0.9812577500854189,0.0187422499145811
11952,Star Raiders: The Adventures of Saber Raine,260234,260234,0,2019_boxofficemojo_rankings.csv,2019,1.0,0.0
11953,An Awfully Big Adventure,259724,259724,0,1995_boxofficemojo_rankings.csv,1995,1.0,0.0
11954,The Wind Will Carry Us,259510,259510,0,2000_boxofficemojo_rankings.csv,2000,1.0,0.0
11955,Chattahoochee,259486,259486,0,1990_boxofficemojo_rankings.csv,1990,1.0,0.0
11956,The Graduate 1997 Re-release,259279,259279,0,1997_boxofficemojo_rankings.csv,1997,1.0,0.0
11957,James' Journey to Jerusalem,259026,64967,194059,2004_boxofficemojo_rankings.csv,2004,0.25081265973299977,0.7491873402670002
11958,Illegally Yours,259019,259019,0,1988_boxofficemojo_rankings.csv,1988,1.0,0.0
11959,Closet Land,259012,259012,0,1991_boxofficemojo_rankings.csv,1991,1.0,0.0
11960,The Cave,258921,62625,196296,2019_boxofficemojo_rankings.csv,2019,0.24186914155282885,0.7581308584471711
11961,Malevolence,258782,127287,131495,2004_boxofficemojo_rankings.csv,2004,0.4918696045319999,0.5081303954680001
11962,The Unspoken,258760,0,258760,2016_boxofficemojo_rankings.csv,2016,0.0,1.0
11963,Across the Universe 2018 Re-release,258618,258618,0,2018_boxofficemojo_rankings.csv,2018,1.0,0.0
11964,What Time Is It There?,258592,195760,62832,2001_boxofficemojo_rankings.csv,2001,0.7570226457121644,0.24297735428783565
11965,Big 2018 Re-release,258507,258507,0,2018_boxofficemojo_rankings.csv,2018,1.0,0.0
11966,My Kid Could Paint That,258316,231574,26742,2007_boxofficemojo_rankings.csv,2007,0.8964756344941854,0.10352436550581458
11967,The Music Never Stopped,258223,258223,0,2011_boxofficemojo_rankings.csv,2011,1.0,0.0
11968,Mrs. Worthington's Party,257868,257868,0,2007_boxofficemojo_rankings.csv,2007,1.0,0.0
11969,Mayor of the Sunset Strip,257315,257315,0,2004_boxofficemojo_rankings.csv,2004,1.0,0.0
11970,Mysteries of Lisbon,257065,110507,146558,2010_boxofficemojo_rankings.csv,2010,0.42987960243518175,0.5701203975648182
11971,Spiders,257019,0,257019,2013_boxofficemojo_rankings.csv,2013,0.0,1.0
11972,Raja Natwarlal,256978,131105,125873,2014_boxofficemojo_rankings.csv,2014,0.5101798597545315,0.4898201402454685
11973,Helicopter Eela,256952,71971,184981,2018_boxofficemojo_rankings.csv,2018,0.2800951150409415,0.7199048849590585
11974,Dancemaker,256780,256780,0,1999_boxofficemojo_rankings.csv,1999,1.0,0.0
11975,Alive Inside: A Story of Music and Memory,256682,256682,0,2014_boxofficemojo_rankings.csv,2014,1.0,0.0
11976,Twenty-One,256521,256521,0,1991_boxofficemojo_rankings.csv,1991,1.0,0.0
11977,Dream Lover,256264,256264,0,1994_boxofficemojo_rankings.csv,1994,1.0,0.0
11978,In the Soup,256249,256249,0,1992_boxofficemojo_rankings.csv,1992,1.0,0.0
11979,Jean-Michel Basquiat: The Radiant Child,256242,256242,0,2010_boxofficemojo_rankings.csv,2010,1.0,0.0
11980,Greendale,255947,255947,0,2004_boxofficemojo_rankings.csv,2004,1.0,0.0
11981,Beaufort,255780,102591,153189,2008_boxofficemojo_rankings.csv,2008,0.4010907811400422,0.5989092188599577
11982,Officer Down,255080,1463,253617,2013_boxofficemojo_rankings.csv,2013,0.005735455543358946,0.994264544456641
11983,Sex with Strangers,254852,254852,0,2002_boxofficemojo_rankings.csv,2002,1.0,0.0
11984,Gerry,254683,254683,0,2003_boxofficemojo_rankings.csv,2003,1.0,0.0
11985,Soul Power,254582,207121,47461,2009_boxofficemojo_rankings.csv,2009,0.8135728370426817,0.18642716295731826
11986,Dean,254536,254536,0,2017_boxofficemojo_rankings.csv,2017,1.0,0.0
11987,The Robber,254489,83451,171038,2010_boxofficemojo_rankings.csv,2010,0.3279159413569938,0.6720840586430061
11988,The War Zone,254441,254441,0,1999_boxofficemojo_rankings.csv,1999,1.0,0.0
11989,Maelstrom,254380,254380,0,2000_boxofficemojo_rankings.csv,2000,1.0,0.0
11990,Civil Brand,254293,254293,0,2003_boxofficemojo_rankings.csv,2003,1.0,0.0
11991,The War Tapes,254190,254190,0,2006_boxofficemojo_rankings.csv,2006,1.0,0.0
11992,Cemetery Man,253986,253986,0,1996_boxofficemojo_rankings.csv,1996,1.0,0.0
11993,Fall in Love Like a Star 2015 Re-release,253785,212508,41277,2015_boxofficemojo_rankings.csv,2015,0.8373544535729062,0.1626455464270938
11994,Battle in Heaven,253751,70899,182852,2005_boxofficemojo_rankings.csv,2005,0.27940382500955663,0.7205961749904434
11995,Theremin: An Electronic Odyssey,253311,253311,0,1995_boxofficemojo_rankings.csv,1995,1.0,0.0
11996,Mistaken for Strangers,253285,138991,114294,2014_boxofficemojo_rankings.csv,2014,0.5487533805791894,0.45124661942081057
11997,The Call,253272,253272,0,2020_boxofficemojo_rankings.csv,2020,1.0,0.0
11998,Battlefield America,252805,172000,80805,2012_boxofficemojo_rankings.csv,2012,0.6803662902236902,0.3196337097763098
11999,Love's Abiding Joy,252726,252726,0,2006_boxofficemojo_rankings.csv,2006,1.0,0.0
12000,A Place Called Chiapas,252546,252546,0,1998_boxofficemojo_rankings.csv,1998,1.0,0.0
12001,Broken Bridges,252539,252539,0,2006_boxofficemojo_rankings.csv,2006,1.0,0.0
12002,Orphans,252430,252430,0,1987_boxofficemojo_rankings.csv,1987,1.0,0.0
12003,When Harry Met Sally... 30th Anniversary,252320,252320,0,2019_boxofficemojo_rankings.csv,2019,1.0,0.0
12004,I Got the Hook Up 2,252293,252293,0,2019_boxofficemojo_rankings.csv,2019,1.0,0.0
12005,The Human Centipede (First Sequence),252207,181467,70740,2010_boxofficemojo_rankings.csv,2010,0.7195161117653356,0.28048388823466436
12006,Caterpillar,251922,4157,247765,2010_boxofficemojo_rankings.csv,2010,0.01650113924151126,0.9834988607584887
12007,Canal Street,251917,251917,0,2019_boxofficemojo_rankings.csv,2019,1.0,0.0
12008,Call Me,251819,251819,0,1988_boxofficemojo_rankings.csv,1988,1.0,0.0
12009,Gook,251541,250130,1411,2017_boxofficemojo_rankings.csv,2017,0.994390576486537,0.005609423513463014
12010,Dominion,251495,251495,0,2005_boxofficemojo_rankings.csv,2005,1.0,0.0
12011,Happenstance,251444,251444,0,2001_boxofficemojo_rankings.csv,2001,1.0,0.0
12012,Drawing Restraint 9,251009,234743,16266,2006_boxofficemojo_rankings.csv,2006,0.9351975427175918,0.0648024572824082
12013,The 13th Alley,250992,250992,0,2008_boxofficemojo_rankings.csv,2008,1.0,0.0
12014,The Swindle,250899,250899,0,1998_boxofficemojo_rankings.csv,1998,1.0,0.0
12015,Passion in the Desert,250897,250897,0,1998_boxofficemojo_rankings.csv,1998,1.0,0.0
12016,Dedication,250182,92853,157329,2007_boxofficemojo_rankings.csv,2007,0.3711418087632204,0.6288581912367797
12017,Dog Park,250147,250147,0,1999_boxofficemojo_rankings.csv,1999,1.0,0.0
12018,Games of Love and Chance 2005 Re-release,249616,8085,241531,2005_boxofficemojo_rankings.csv,2005,0.032389750657009164,0.9676102493429908
12019,Gay Sex in the 70s,249565,249565,0,2005_boxofficemojo_rankings.csv,2005,1.0,0.0
12020,May,249300,150277,99023,2003_boxofficemojo_rankings.csv,2003,0.602795828319294,0.397204171680706
12021,Skins,249204,249204,0,2002_boxofficemojo_rankings.csv,2002,1.0,0.0
12022,The National Film Board of Canada's Animation Festival,249167,249167,0,1991_boxofficemojo_rankings.csv,1991,1.0,0.0
12023,Half Moon,248749,2528,246221,2007_boxofficemojo_rankings.csv,2007,0.010162854926049954,0.98983714507395
12024,The Twilight Zone: A 60th Anniversary Celebration,248514,248514,0,2019_boxofficemojo_rankings.csv,2019,1.0,0.0
12025,Band Aid,248370,248370,0,2017_boxofficemojo_rankings.csv,2017,1.0,0.0
12026,The Attacks of 26/11,248346,248346,0,2013_boxofficemojo_rankings.csv,2013,1.0,0.0
12027,Testosterone,248128,185078,63050,2004_boxofficemojo_rankings.csv,2004,0.7458972788238328,0.2541027211761671
12028,Wild Oats,247949,40598,207351,2016_boxofficemojo_rankings.csv,2016,0.16373528427216888,0.8362647157278311
12029,Doctor Who: The End of Time: Part One,247798,247798,0,2019_boxofficemojo_rankings.csv,2019,1.0,0.0
12030,Marcel Proust's Time Regained,247728,247728,0,2000_boxofficemojo_rankings.csv,2000,1.0,0.0
12031,Charlotte Sometimes,247554,150445,97109,2002_boxofficemojo_rankings.csv,2002,0.607725991096892,0.392274008903108
12032,Lilting,247377,27054,220323,2014_boxofficemojo_rankings.csv,2014,0.10936344122533623,0.8906365587746637
12033,Rough Magic,247202,247202,0,1997_boxofficemojo_rankings.csv,1997,1.0,0.0
12034,The Galapagos Affair: Satan Came to Eden,247159,247159,0,2014_boxofficemojo_rankings.csv,2014,1.0,0.0
12035,Enlighten Up!,246649,246649,0,2008_boxofficemojo_rankings.csv,2008,1.0,0.0
12036,My Dog Tulip,246574,246574,0,2010_boxofficemojo_rankings.csv,2010,1.0,0.0
12037,The Notebook 2013 Re-release,246557,66559,179998,2013_boxofficemojo_rankings.csv,2013,0.2699538037857372,0.7300461962142628
12038,The Animation Show 2005 Re-release,246520,246520,0,2005_boxofficemojo_rankings.csv,2005,1.0,0.0
12039,The Love Witch,246218,228894,17324,2016_boxofficemojo_rankings.csv,2016,0.9296395876824602,0.07036041231753974
12040,Friendsgiving Day #1,246168,246168,0,2019_boxofficemojo_rankings.csv,2019,1.0,0.0
12041,Hot Summer Nights,246133,0,246133,2018_boxofficemojo_rankings.csv,2018,0.0,1.0
12042,Watermarks,246094,246094,0,2005_boxofficemojo_rankings.csv,2005,1.0,0.0
12043,Larger Than Life in 3D,246042,246042,0,2009_boxofficemojo_rankings.csv,2009,1.0,0.0
12044,Stepping Out,246000,246000,0,1991_boxofficemojo_rankings.csv,1991,1.0,0.0
12045,Play the Flute,245943,245943,0,2019_boxofficemojo_rankings.csv,2019,1.0,0.0
12046,"Tuesday, After Christmas",245833,27813,218020,2010_boxofficemojo_rankings.csv,2010,0.1131377805258041,0.8868622194741959
12047,Battle for Haditha,245521,10310,235211,2007_boxofficemojo_rankings.csv,2007,0.04199233466791028,0.9580076653320897
12048,Harry Potter and the Chamber of Secrets 2018 Re-release,245501,245501,0,2018_boxofficemojo_rankings.csv,2018,1.0,0.0
12049,American Woman,245416,236637,8779,2019_boxofficemojo_rankings.csv,2019,0.9642280861883495,0.03577191381165042
12050,The Foot Fist Way,245292,234286,11006,2008_boxofficemojo_rankings.csv,2008,0.9551310275100696,0.04486897248993037
12051,The New Age,245217,245217,0,1994_boxofficemojo_rankings.csv,1994,1.0,0.0
12052,Hello Brother,245034,245034,0,1999_boxofficemojo_rankings.csv,1999,1.0,0.0
12053,The Fireflies Are Gone,245006,245006,0,2018_boxofficemojo_rankings.csv,2018,1.0,0.0
12054,The Waiting Room,244951,244951,0,2012_boxofficemojo_rankings.csv,2012,1.0,0.0
12055,The Harmonists,244861,244861,0,1999_boxofficemojo_rankings.csv,1999,1.0,0.0
12056,This Is Spinal Tap 2000 Re-release,244557,244557,0,2000_boxofficemojo_rankings.csv,2000,1.0,0.0
12057,Time and Tide,243978,10770,233208,2001_boxofficemojo_rankings.csv,2001,0.044143324398101466,0.9558566756018986
12058,Term Life,243793,21256,222537,2016_boxofficemojo_rankings.csv,2016,0.08718872157937266,0.9128112784206274
12059,The Legend of God's Gun,243768,243768,0,2008_boxofficemojo_rankings.csv,2008,1.0,0.0
12060,My Uncle Rafael,243616,243616,0,2012_boxofficemojo_rankings.csv,2012,1.0,0.0
12061,Edmond,243524,131719,111805,2006_boxofficemojo_rankings.csv,2006,0.5408871404871799,0.4591128595128201
12062,Rangeelay,243246,148418,94828,2013_boxofficemojo_rankings.csv,2013,0.6101559737878526,0.38984402621214737
12063,Do Knot Disturb,243176,213525,29651,2009_boxofficemojo_rankings.csv,2009,0.8780677369477251,0.12193226305227489
12064,Santitos,243000,243000,0,2000_boxofficemojo_rankings.csv,2000,1.0,0.0
12065,Pathfinder,242994,10628,232366,1990_boxofficemojo_rankings.csv,1990,0.043737705457747925,0.9562622945422521
12066,Out of Blue,242847,18779,224068,2019_boxofficemojo_rankings.csv,2019,0.07732852372069657,0.9226714762793035
12067,Audition,242759,131296,111463,2001_boxofficemojo_rankings.csv,2001,0.5408491549231954,0.4591508450768046
12068,My Perestroika,242707,242707,0,2011_boxofficemojo_rankings.csv,2011,1.0,0.0
12069,Dead Alive,242623,242623,0,1993_boxofficemojo_rankings.csv,1993,1.0,0.0
12070,Tevar,242453,236002,6451,2015_boxofficemojo_rankings.csv,2015,0.9733927812813205,0.026607218718679496
12071,Archive,242195,139593,102602,2020_boxofficemojo_rankings.csv,2020,0.576366151241768,0.423633848758232
12072,Ophelia,242115,50722,191393,2019_boxofficemojo_rankings.csv,2019,0.2094954876814737,0.7905045123185264
12073,The Yes Men Fix the World,241868,194533,47335,2009_boxofficemojo_rankings.csv,2009,0.8042940777614236,0.1957059222385764
12074,Pyare Mohan,241841,150198,91643,2006_boxofficemojo_rankings.csv,2006,0.6210609450010545,0.3789390549989456
12075,Paperhouse,241278,241278,0,1989_boxofficemojo_rankings.csv,1989,1.0,0.0
12076,Iraq in Fragments,240888,204462,36426,2006_boxofficemojo_rankings.csv,2006,0.8487844973597689,0.15121550264023115
12077,Brotherhood,240887,8979,231908,2010_boxofficemojo_rankings.csv,2010,0.03727473877793322,0.9627252612220668
12078,Darshan,240819,66032,174787,2005_boxofficemojo_rankings.csv,2005,0.2741976339076236,0.7258023660923765
12079,Road to Ninja - Naruto the Movie 2014 Re-release,240687,43171,197516,2014_boxofficemojo_rankings.csv,2014,0.17936573225807792,0.820634267741922
12080,Boulevard,240450,126150,114300,2015_boxofficemojo_rankings.csv,2015,0.5246412975670618,0.47535870243293826
12081,Lie Down with Dogs,240280,240280,0,1995_boxofficemojo_rankings.csv,1995,1.0,0.0
12082,Carter High,240214,240214,0,2015_boxofficemojo_rankings.csv,2015,1.0,0.0
12083,One Man's Hero,240067,240067,0,1999_boxofficemojo_rankings.csv,1999,1.0,0.0
12084,Of Horses and Men,239969,11894,228075,2013_boxofficemojo_rankings.csv,2013,0.04956473544499498,0.950435264555005
12085,2001: A Space Odyssey 2003 Re-release,239621,239621,0,2003_boxofficemojo_rankings.csv,2003,1.0,0.0
12086,Dark River,239182,7714,231468,2018_boxofficemojo_rankings.csv,2018,0.03225159083877549,0.9677484091612245
12087,Uncovered: The War on Iraq,238924,238924,0,2004_boxofficemojo_rankings.csv,2004,1.0,0.0
12088,Nina's Tragedies,238831,238831,0,2005_boxofficemojo_rankings.csv,2005,1.0,0.0
12089,311 Enlarged to Show Detail 3,238791,238791,0,2019_boxofficemojo_rankings.csv,2019,1.0,0.0
12090,La bûche,238754,238754,0,2000_boxofficemojo_rankings.csv,2000,1.0,0.0
12091,The Abyss 1993 Special Edition,238737,238737,0,1993_boxofficemojo_rankings.csv,1993,1.0,0.0
12092,Crown Heights,238558,238558,0,2017_boxofficemojo_rankings.csv,2017,1.0,0.0
12093,The Land Girls,238497,238497,0,1998_boxofficemojo_rankings.csv,1998,1.0,0.0
12094,The Independent,238431,238431,0,2001_boxofficemojo_rankings.csv,2001,1.0,0.0
12095,RWBY: Argus Limited,238379,238379,0,2018_boxofficemojo_rankings.csv,2018,1.0,0.0
12096,"Ram Dass, Fierce Grace",238260,238260,0,2002_boxofficemojo_rankings.csv,2002,1.0,0.0
12097,Red Obsession,238223,13199,225024,2013_boxofficemojo_rankings.csv,2013,0.05540606910331916,0.9445939308966809
12098,American Satan,237708,237708,0,2017_boxofficemojo_rankings.csv,2017,1.0,0.0
12099,Tokyo Godfathers 2020 Re-release,237571,237571,0,2020_boxofficemojo_rankings.csv,2020,1.0,0.0
12100,Alien Intrusion: Unmasking a Deception,237411,237411,0,2018_boxofficemojo_rankings.csv,2018,1.0,0.0
12101,Shuddh Desi Romance,237249,0,237249,2013_boxofficemojo_rankings.csv,2013,0.0,1.0
12102,New York Doll,237136,219672,17464,2005_boxofficemojo_rankings.csv,2005,0.9263544969975035,0.07364550300249646
12103,Puberty Blues,237000,237000,0,1983_boxofficemojo_rankings.csv,1983,1.0,0.0
12104,Middle of Nowhere,236806,236806,0,2012_boxofficemojo_rankings.csv,2012,1.0,0.0
12105,Chopper,236185,236185,0,2001_boxofficemojo_rankings.csv,2001,1.0,0.0
12106,The Far Side of the Moon,235926,235926,0,2003_boxofficemojo_rankings.csv,2003,1.0,0.0
12107,India's Most Wanted,235351,176858,58493,2019_boxofficemojo_rankings.csv,2019,0.7514648333765312,0.24853516662346878
12108,Varda by Agnès,235262,160765,74497,2019_boxofficemojo_rankings.csv,2019,0.683344526527871,0.31665547347212897
12109,The Exorcist Extended Director's Cut,235134,235134,0,2010_boxofficemojo_rankings.csv,2010,1.0,0.0
12110,Diamantino,235041,70088,164953,2018_boxofficemojo_rankings.csv,2018,0.29819478303785296,0.701805216962147
12111,Art and Craft,235037,235037,0,2014_boxofficemojo_rankings.csv,2014,1.0,0.0
12112,Big Fan,234540,234540,0,2009_boxofficemojo_rankings.csv,2009,1.0,0.0
12113,Blind Eyes Opened,234505,234505,0,2020_boxofficemojo_rankings.csv,2020,1.0,0.0
12114,After the Ball,234417,161820,72597,2015_boxofficemojo_rankings.csv,2015,0.6903082967532218,0.3096917032467782
12115,Swimming,234287,234287,0,2002_boxofficemojo_rankings.csv,2002,1.0,0.0
12116,Little Shop of Horrors 2017 Re-release,233865,233865,0,2017_boxofficemojo_rankings.csv,2017,1.0,0.0
12117,Fear of a Black Hat,233824,233824,0,1994_boxofficemojo_rankings.csv,1994,1.0,0.0
12118,Superman 2018 Re-release,233585,233585,0,2018_boxofficemojo_rankings.csv,2018,1.0,0.0
12119,The Trip to Greece,233014,8340,224674,2020_boxofficemojo_rankings.csv,2020,0.03579184083359798,0.964208159166402
12120,Weapons of the Spirit,232981,232981,0,1989_boxofficemojo_rankings.csv,1989,1.0,0.0
12121,Premier Boxing Champions: PBC on FOX: Spence vs. Porter,232973,232973,0,2019_boxofficemojo_rankings.csv,2019,1.0,0.0
12122,Lost and Found in Armenia,232857,122305,110552,2012_boxofficemojo_rankings.csv,2012,0.5252365185500114,0.47476348144998864
12123,CSNY/Déjà Vu,232260,65025,167235,2008_boxofficemojo_rankings.csv,2008,0.27996641694652546,0.7200335830534745
12124,Falling from Grace,231826,231826,0,1992_boxofficemojo_rankings.csv,1992,1.0,0.0
12125,Down and Derby,231609,231609,0,2005_boxofficemojo_rankings.csv,2005,1.0,0.0
12126,Bishôjo senshi Sailor Moon Super S Special,231434,231434,0,2018_boxofficemojo_rankings.csv,2018,1.0,0.0
12127,The World,231383,64123,167260,2005_boxofficemojo_rankings.csv,2005,0.27712926187317133,0.7228707381268287
12128,A Place at the Table,231378,231378,0,2013_boxofficemojo_rankings.csv,2013,1.0,0.0
12129,The Great Role,231162,11419,219743,2004_boxofficemojo_rankings.csv,2004,0.04939825749906992,0.9506017425009301
12130,Les Destinees,230900,230900,0,2002_boxofficemojo_rankings.csv,2002,1.0,0.0
12131,DAZN Boxing: Canelo Alvarez vs. Daniel Jacobs,230703,230703,0,2019_boxofficemojo_rankings.csv,2019,1.0,0.0
12132,(Untitled),230600,230600,0,2009_boxofficemojo_rankings.csv,2009,1.0,0.0
12133,"Life, Above All",230529,134461,96068,2011_boxofficemojo_rankings.csv,2011,0.5832715189845963,0.4167284810154037
12134,Father,230422,199228,31194,2009_boxofficemojo_rankings.csv,2009,0.8646223016899428,0.1353776983100572
12135,Chakravyuh,230136,151778,78358,2012_boxofficemojo_rankings.csv,2012,0.6595143741092224,0.34048562589077763
12136,A Single Girl,230049,230049,0,1996_boxofficemojo_rankings.csv,1996,1.0,0.0
12137,"Belle and Sebastian, Friends for Life 2018 Re-release",229983,105890,124093,2018_boxofficemojo_rankings.csv,2018,0.4604253357856885,0.5395746642143114
12138,Judgement in Berlin,229556,229556,0,1988_boxofficemojo_rankings.csv,1988,1.0,0.0
12139,Wrecked,229532,8020,221512,2011_boxofficemojo_rankings.csv,2011,0.03494066186849764,0.9650593381315024
12140,Luv Shuv Tey Chicken Khurana,229136,143507,85629,2012_boxofficemojo_rankings.csv,2012,0.6262961734515746,0.3737038265484254
12141,Fifty/Fifty,229041,229041,0,1993_boxofficemojo_rankings.csv,1993,1.0,0.0
12142,Miss Conception,228928,2134,226794,2008_boxofficemojo_rankings.csv,2008,0.009321708135308918,0.990678291864691
12143,Dig!,228828,127067,101761,2004_boxofficemojo_rankings.csv,2004,0.5552948065796144,0.4447051934203856
12144,Land and Freedom,228800,228800,0,1996_boxofficemojo_rankings.csv,1996,1.0,0.0
12145,Fast Food Fast Women,228787,17131,211656,2001_boxofficemojo_rankings.csv,2001,0.07487750615201039,0.9251224938479896
12146,The Last Tree,228676,10128,218548,2019_boxofficemojo_rankings.csv,2019,0.04428973744511886,0.9557102625548811
12147,Doctor Who Live Q&A And Screening,228615,228615,0,2020_boxofficemojo_rankings.csv,2020,1.0,0.0
12148,Still Breathing,228455,228455,0,1998_boxofficemojo_rankings.csv,1998,1.0,0.0
12149,City of Ghosts,228225,128015,100210,2017_boxofficemojo_rankings.csv,2017,0.560915762953226,0.439084237046774
12150,Jeremiah Tower: The Last Magnificent,228153,228153,0,2017_boxofficemojo_rankings.csv,2017,1.0,0.0
12151,InAPPropriate Comedy,228004,228004,0,2013_boxofficemojo_rankings.csv,2013,1.0,0.0
12152,Insomnia,227569,227569,0,1998_boxofficemojo_rankings.csv,1998,1.0,0.0
12153,Babar: King of the Elephants,227374,227374,0,1999_boxofficemojo_rankings.csv,1999,1.0,0.0
12154,Like Water,227332,0,227332,2012_boxofficemojo_rankings.csv,2012,0.0,1.0
12155,Guiana 1838,227241,227241,0,2004_boxofficemojo_rankings.csv,2004,1.0,0.0
12156,Black Gold,227105,93477,133628,2006_boxofficemojo_rankings.csv,2006,0.41160256269126616,0.5883974373087338
12157,Studio 54,227062,199767,27295,2018_boxofficemojo_rankings.csv,2018,0.879790541790348,0.120209458209652
12158,Bellman and True,226944,226944,0,1988_boxofficemojo_rankings.csv,1988,1.0,0.0
12159,This So-Called Disaster: Sam Shepard Directs the Late Henry Moss,226658,226658,0,2004_boxofficemojo_rankings.csv,2004,1.0,0.0
12160,Mine 9,226421,226421,0,2019_boxofficemojo_rankings.csv,2019,1.0,0.0
12161,The Agronomist,226189,226189,0,2004_boxofficemojo_rankings.csv,2004,1.0,0.0
12162,Blue Gate Crossing,226067,6242,219825,2003_boxofficemojo_rankings.csv,2003,0.02761128338059071,0.9723887166194093
12163,I Don't Want to Sleep Alone,226026,19292,206734,2007_boxofficemojo_rankings.csv,2007,0.0853530124852893,0.9146469875147107
12164,Rumble: The Indians Who Rocked The World,226006,226006,0,2017_boxofficemojo_rankings.csv,2017,1.0,0.0
12165,The Keeper: The Legend of Omar Khayyam,225863,225863,0,2005_boxofficemojo_rankings.csv,2005,1.0,0.0
12166,The Ballad of Ramblin' Jack,225682,225682,0,2000_boxofficemojo_rankings.csv,2000,1.0,0.0
12167,Young Soul Rebels,225664,225664,0,1991_boxofficemojo_rankings.csv,1991,1.0,0.0
12168,Dr. Cabbie,225490,225490,0,2014_boxofficemojo_rankings.csv,2014,1.0,0.0
12169,The Beauty Academy of Kabul,225448,225448,0,2005_boxofficemojo_rankings.csv,2005,1.0,0.0
12170,Murderous Maids,225390,225390,0,2002_boxofficemojo_rankings.csv,2002,1.0,0.0
12171,Square Dance,225358,225358,0,1987_boxofficemojo_rankings.csv,1987,1.0,0.0
12172,Millennium Actress 2019 Re-release,225250,225250,0,2019_boxofficemojo_rankings.csv,2019,1.0,0.0
12173,Live-In Maid 2007 Re-release,224836,200433,24403,2007_boxofficemojo_rankings.csv,2007,0.8914631108897152,0.10853688911028483
12174,Sixty Six 2008 Re-release,224614,224614,0,2008_boxofficemojo_rankings.csv,2008,1.0,0.0
12175,The Black Waters of Echo's Pond,224409,224409,0,2010_boxofficemojo_rankings.csv,2010,1.0,0.0
12176,Funny Girl 2001 Re-release,224263,223306,957,2001_boxofficemojo_rankings.csv,2001,0.9957326888519283,0.004267311148071684
12177,Experimenter,224145,155575,68570,2015_boxofficemojo_rankings.csv,2015,0.6940819558767762,0.3059180441232238
12178,Unidentified,224099,224099,0,2006_boxofficemojo_rankings.csv,2006,1.0,0.0
12179,Tampopo,224097,224097,0,2016_boxofficemojo_rankings.csv,2016,1.0,0.0
12180,Extra Ordinary,223898,164346,59552,2019_boxofficemojo_rankings.csv,2019,0.7340217420432519,0.2659782579567482
12181,Premier Boxing Champions: PBC on FOX PPV: Pacquiao vs. Thurman,223858,223858,0,2019_boxofficemojo_rankings.csv,2019,1.0,0.0
12182,The Genius Club,223827,0,223827,2006_boxofficemojo_rankings.csv,2006,0.0,1.0
12183,Crystal Fairy & the Magical Cactus,223821,202370,21451,2013_boxofficemojo_rankings.csv,2013,0.9041600207308519,0.09583997926914811
12184,BuyBust,223720,178471,45249,2018_boxofficemojo_rankings.csv,2018,0.7977427141069193,0.20225728589308065
12185,Tim and Eric's Billion Dollar Movie,223580,201436,22144,2012_boxofficemojo_rankings.csv,2012,0.9009571518024868,0.09904284819751319
12186,Love Liza,223426,213137,10289,2002_boxofficemojo_rankings.csv,2002,0.9539489584918497,0.04605104150815035
12187,Take Every Wave: The Life of Laird Hamilton,223301,176076,47225,2017_boxofficemojo_rankings.csv,2017,0.7885141580198924,0.21148584198010756
12188,Surviving My Mother,223000,223000,0,2007_boxofficemojo_rankings.csv,2007,1.0,0.0
12189,Never Surrender: A Galaxy Quest Documentary,222971,222971,0,2019_boxofficemojo_rankings.csv,2019,1.0,0.0
12190,Aida,222927,222927,0,2007_boxofficemojo_rankings.csv,2007,1.0,0.0
12191,Chop Shop,222776,125045,97731,2008_boxofficemojo_rankings.csv,2008,0.5613037311020935,0.4386962688979064
12192,Spirit of the Game,222565,222565,0,2016_boxofficemojo_rankings.csv,2016,1.0,0.0
12193,Hard Eight,222559,222559,0,1997_boxofficemojo_rankings.csv,1997,1.0,0.0
12194,10.000 Km,222530,12423,210107,2014_boxofficemojo_rankings.csv,2014,0.055826180739675546,0.9441738192603244
12195,Secret Things,222396,105090,117306,2002_boxofficemojo_rankings.csv,2002,0.4725354772567852,0.5274645227432148
12196,Bus 174,222247,217201,5046,2003_boxofficemojo_rankings.csv,2003,0.9772955315482323,0.02270446845176763
12197,No Looking Back,222099,222099,0,1998_boxofficemojo_rankings.csv,1998,1.0,0.0
12198,World's Greatest Dad,221805,221805,0,2009_boxofficemojo_rankings.csv,2009,1.0,0.0
12199,High School,221590,139034,82556,2012_boxofficemojo_rankings.csv,2012,0.627438061284354,0.372561938715646
12200,Under Suspicion,221295,221295,0,1992_boxofficemojo_rankings.csv,1992,1.0,0.0
12201,Critical Care,221193,221193,0,1997_boxofficemojo_rankings.csv,1997,1.0,0.0
12202,Neil Young Journeys,221082,215026,6056,2012_boxofficemojo_rankings.csv,2012,0.9726074488198949,0.02739255118010512
12203,Phantom Boy,221016,34362,186654,2015_boxofficemojo_rankings.csv,2015,0.15547290693886415,0.8445270930611358
12204,Little Pink House,220948,220948,0,2018_boxofficemojo_rankings.csv,2018,1.0,0.0
12205,Chance Pe Dance,220619,168643,51976,2010_boxofficemojo_rankings.csv,2010,0.7644083238524334,0.23559167614756663
12206,Mela,220524,220524,0,2000_boxofficemojo_rankings.csv,2000,1.0,0.0
12207,The Song of Sparrows,220360,116372,103988,2008_boxofficemojo_rankings.csv,2008,0.528099473588673,0.4719005264113269
12208,Santa with Muscles,220198,220198,0,1996_boxofficemojo_rankings.csv,1996,1.0,0.0
12209,The Sea Wolves,220181,220181,0,1981_boxofficemojo_rankings.csv,1981,1.0,0.0
12210,The Cockettes,220165,220165,0,2002_boxofficemojo_rankings.csv,2002,1.0,0.0
12211,Supermensch: The Legend of Shep Gordon,220065,213064,7001,2014_boxofficemojo_rankings.csv,2014,0.9681866721196011,0.03181332788039897
12212,Radioactive Dreams,220038,220038,0,1986_boxofficemojo_rankings.csv,1986,1.0,0.0
12213,Lower City,219814,130794,89020,2005_boxofficemojo_rankings.csv,2005,0.5950212452346074,0.4049787547653926
12214,Great Performances at the Met: Puccini: Turandot,219619,172627,46992,2016_boxofficemojo_rankings.csv,2016,0.7860294418971037,0.2139705581028964
12215,Brooklyn Castle,219407,219407,0,2012_boxofficemojo_rankings.csv,2012,1.0,0.0
12216,Fragments of Truth,219342,219342,0,2018_boxofficemojo_rankings.csv,2018,1.0,0.0
12217,Show Me Love,219331,169331,50000,1999_boxofficemojo_rankings.csv,1999,0.7720340489944422,0.2279659510055578
12218,Club Life,219229,4444,214785,2015_boxofficemojo_rankings.csv,2015,0.020271040783837905,0.9797289592161621
12219,The House I Live In,219159,210752,8407,2012_boxofficemojo_rankings.csv,2012,0.9616397227583626,0.03836027724163735
12220,The Secrets We Keep,219001,207928,11073,2020_boxofficemojo_rankings.csv,2020,0.9494385870384153,0.05056141296158465
12221,Harry Potter and the Prisoner of Azkaban 2018 Re-release,218774,218774,0,2018_boxofficemojo_rankings.csv,2018,1.0,0.0
12222,Jack & Sarah,218626,218626,0,1996_boxofficemojo_rankings.csv,1996,1.0,0.0
12223,California Typewriter,218563,218563,0,2017_boxofficemojo_rankings.csv,2017,1.0,0.0
12224,Ghosts of Cité Soleil,218444,48752,169692,2007_boxofficemojo_rankings.csv,2007,0.22317848052590136,0.7768215194740986
12225,Dark Money,217932,217932,0,2018_boxofficemojo_rankings.csv,2018,1.0,0.0
12226,Sister My Sister,217881,217881,0,1995_boxofficemojo_rankings.csv,1995,1.0,0.0
12227,Getting Grace,217812,217812,0,2018_boxofficemojo_rankings.csv,2018,1.0,0.0
12228,Beautiful Creatures,217679,55835,161844,2001_boxofficemojo_rankings.csv,2001,0.25650154585421653,0.7434984541457834
12229,Jane's Journey,217615,27253,190362,2010_boxofficemojo_rankings.csv,2010,0.12523493325368196,0.874765066746318
12230,Complete Unknown,217473,191761,25712,2016_boxofficemojo_rankings.csv,2016,0.881769231122944,0.118230768877056
12231,Zero Patience,217300,217300,0,1994_boxofficemojo_rankings.csv,1994,1.0,0.0
12232,Ratcatcher,217244,217244,0,2000_boxofficemojo_rankings.csv,2000,1.0,0.0
12233,Two Men Went to War,217151,150208,66943,2003_boxofficemojo_rankings.csv,2003,0.6917214288674701,0.3082785711325299
12234,The Death of Mr. Lazarescu,216922,80301,136621,2006_boxofficemojo_rankings.csv,2006,0.370183752685297,0.629816247314703
12235,A Chorus of Disapproval,216373,216373,0,1989_boxofficemojo_rankings.csv,1989,1.0,0.0
12236,Chris & Don. A Love Story,216110,216110,0,2008_boxofficemojo_rankings.csv,2008,1.0,0.0
12237,Beijing Bicycle,215854,66131,149723,2001_boxofficemojo_rankings.csv,2001,0.306369119868059,0.6936308801319411
12238,Terminal Bliss,215500,215500,0,1992_boxofficemojo_rankings.csv,1992,1.0,0.0
12239,The Karate Kid 2019 Re-release,215447,215447,0,2019_boxofficemojo_rankings.csv,2019,1.0,0.0
12240,How the Garcia Girls Spent Their Summer,215303,215303,0,2008_boxofficemojo_rankings.csv,2008,1.0,0.0
12241,The Treasure of the Sierra Madre,215295,215295,0,2018_boxofficemojo_rankings.csv,2018,1.0,0.0
12242,The Designated Mourner,215292,215292,0,1997_boxofficemojo_rankings.csv,1997,1.0,0.0
12243,Call + Response,215185,215185,0,2008_boxofficemojo_rankings.csv,2008,1.0,0.0
12244,The Tribe,215034,150564,64470,2015_boxofficemojo_rankings.csv,2015,0.7001869471804458,0.2998130528195541
12245,Risk,214669,200219,14450,2017_boxofficemojo_rankings.csv,2017,0.9326870670660412,0.06731293293395879
12246,"Niagara, Niagara",214661,214661,0,1998_boxofficemojo_rankings.csv,1998,1.0,0.0
12247,Hamlet 2019 Re-release,214578,214578,0,2019_boxofficemojo_rankings.csv,2019,1.0,0.0
12248,Hote Hote Pyar Hogaya,214574,214574,0,1999_boxofficemojo_rankings.csv,1999,1.0,0.0
12249,The Pervert's Guide to Ideology,214313,67966,146347,2013_boxofficemojo_rankings.csv,2013,0.31713428490105594,0.6828657150989441
12250,Ingrid Bergman: In Her Own Words,214014,138148,75866,2015_boxofficemojo_rankings.csv,2015,0.6455091722971394,0.35449082770286056
12251,The Year My Voice Broke,213901,213901,0,1988_boxofficemojo_rankings.csv,1988,1.0,0.0
12252,Marjorie Prime,213858,180608,33250,2017_boxofficemojo_rankings.csv,2017,0.844523001243816,0.155476998756184
12253,The Château,213598,202272,11326,2002_boxofficemojo_rankings.csv,2002,0.9469751589434358,0.0530248410565642
12254,Thaandavam,213476,213476,0,2012_boxofficemojo_rankings.csv,2012,1.0,0.0
12255,The Wound,213043,30678,182365,2017_boxofficemojo_rankings.csv,2017,0.14399909877348704,0.856000901226513
12256,The Delicate Art of Parking,213008,213008,0,2004_boxofficemojo_rankings.csv,2004,1.0,0.0
12257,The Afflicted,212940,212940,0,2011_boxofficemojo_rankings.csv,2011,1.0,0.0
12258,Once in a Lifetime: The Extraordinary Story of the New York Cosmos,212780,144601,68179,2006_boxofficemojo_rankings.csv,2006,0.6795798477300499,0.3204201522699502
12259,Chocolate City,212662,212662,0,2015_boxofficemojo_rankings.csv,2015,1.0,0.0
12260,Young & Wild,212624,5514,207110,2012_boxofficemojo_rankings.csv,2012,0.025933102566032058,0.9740668974339679
12261,Bopha!,212483,212483,0,1993_boxofficemojo_rankings.csv,1993,1.0,0.0
12262,Big Sonia,212471,212471,0,2017_boxofficemojo_rankings.csv,2017,1.0,0.0
12263,Fatima,212228,50105,162123,2016_boxofficemojo_rankings.csv,2016,0.23609043104585634,0.7639095689541436
12264,Donnie Darko 2016 Re-release,212034,207971,4063,2016_boxofficemojo_rankings.csv,2016,0.9808379788147183,0.019162021185281607
12265,Beatrice,211821,211821,0,1988_boxofficemojo_rankings.csv,1988,1.0,0.0
12266,Tesla,211083,92344,118739,2020_boxofficemojo_rankings.csv,2020,0.4374772009114898,0.5625227990885102
12267,Somewhere Between,210975,210975,0,2012_boxofficemojo_rankings.csv,2012,1.0,0.0
12268,Stranded: I've Come from a Plane That Crashed on the Mountains,210754,89473,121281,2008_boxofficemojo_rankings.csv,2008,0.4245376125720034,0.5754623874279966
12269,La soga,210625,210625,0,2010_boxofficemojo_rankings.csv,2010,1.0,0.0
12270,A Glimpse Inside the Mind of Charles Swan III,210565,45350,165215,2013_boxofficemojo_rankings.csv,2013,0.2153729252249899,0.7846270747750101
12271,Matador,210318,206952,3366,1988_boxofficemojo_rankings.csv,1988,0.9839956637092403,0.016004336290759705
12272,Straight to Hell,210200,210200,0,1987_boxofficemojo_rankings.csv,1987,1.0,0.0
12273,Tigers Are Not Afraid 2019 Re-release,210138,175559,34579,2019_boxofficemojo_rankings.csv,2019,0.8354462305722906,0.1645537694277094
12274,Beware of Mr. Baker,210123,116476,93647,2012_boxofficemojo_rankings.csv,2012,0.5543229441803135,0.4456770558196866
12275,"Faith, Hope & Love",210091,210091,0,2019_boxofficemojo_rankings.csv,2019,1.0,0.0
12276,Pierrepoint: The Last Hangman 2007 Re-release,209950,23192,186758,2007_boxofficemojo_rankings.csv,2007,0.11046439628482972,0.8895356037151703
12277,Man of the Year,209935,209935,0,1996_boxofficemojo_rankings.csv,1996,1.0,0.0
12278,House,209765,209765,0,2010_boxofficemojo_rankings.csv,2010,1.0,0.0
12279,The Death of Louis XIV,209715,43635,166080,2016_boxofficemojo_rankings.csv,2016,0.2080680924111294,0.7919319075888707
12280,Believe in Me,209654,209654,0,2007_boxofficemojo_rankings.csv,2007,1.0,0.0
12281,Rob the Mob,209613,208693,920,2014_boxofficemojo_rankings.csv,2014,0.99561095924394,0.004389040756059977
12282,SEED: The Untold Story,209580,207825,1755,2016_boxofficemojo_rankings.csv,2016,0.9916261093615804,0.008373890638419696
12283,The Journals of Knud Rasmussen,209478,209478,0,2006_boxofficemojo_rankings.csv,2006,1.0,0.0
12284,Sleepwalking,208995,170392,38603,2008_boxofficemojo_rankings.csv,2008,0.8152922318715758,0.18470776812842413
12285,Kathy Griffin: A Hell of a Story,208907,208907,0,2019_boxofficemojo_rankings.csv,2019,1.0,0.0
12286,Casablanca 2013 Re-release,208608,208608,0,2013_boxofficemojo_rankings.csv,2013,1.0,0.0
12287,Hatchet,208550,175281,33269,2007_boxofficemojo_rankings.csv,2007,0.8404747063054423,0.15952529369455767
12288,Boys Life 3,208538,208538,0,2000_boxofficemojo_rankings.csv,2000,1.0,0.0
12289,A Man Named Pearl,208392,208392,0,2007_boxofficemojo_rankings.csv,2007,1.0,0.0
12290,Agent Mr. Chan,208351,208351,0,2018_boxofficemojo_rankings.csv,2018,1.0,0.0
12291,The Right Kind of Wrong,208105,2098,206007,2014_boxofficemojo_rankings.csv,2014,0.010081449268398164,0.9899185507316018
12292,The Dating Project,208100,208100,0,2018_boxofficemojo_rankings.csv,2018,1.0,0.0
12293,Batman 2019 Re-release,207901,159419,48482,2019_boxofficemojo_rankings.csv,2019,0.766802468482595,0.2331975315174049
12294,Under the Electric Sky,207584,207584,0,2014_boxofficemojo_rankings.csv,2014,1.0,0.0
12295,Heading Home: The Tale of Team Israel,207533,207533,0,2018_boxofficemojo_rankings.csv,2018,1.0,0.0
12296,Sweetgrass,207473,207473,0,2010_boxofficemojo_rankings.csv,2010,1.0,0.0
12297,Advanced Style,207231,87879,119352,2014_boxofficemojo_rankings.csv,2014,0.4240630021570132,0.5759369978429868
12298,Tamara,206871,206871,0,2006_boxofficemojo_rankings.csv,2006,1.0,0.0
12299,Revelation,206755,206755,0,1999_boxofficemojo_rankings.csv,1999,1.0,0.0
12300,Ek Thi Daayan,206279,112135,94144,2013_boxofficemojo_rankings.csv,2013,0.5436084138472651,0.4563915861527349
12301,I Married a Strange Person!,206272,206272,0,1998_boxofficemojo_rankings.csv,1998,1.0,0.0
12302,Onegin,206128,206128,0,1999_boxofficemojo_rankings.csv,1999,1.0,0.0
12303,The Bridge,205724,179780,25944,2006_boxofficemojo_rankings.csv,2006,0.8738892885613735,0.1261107114386265
12304,Man Bites Dog,205569,205569,0,1993_boxofficemojo_rankings.csv,1993,1.0,0.0
12305,The Desert Bride,205350,30110,175240,2017_boxofficemojo_rankings.csv,2017,0.14662770878987094,0.853372291210129
12306,Ayn Rand: A Sense of Life,205246,205246,0,1998_boxofficemojo_rankings.csv,1998,1.0,0.0
12307,Frankenhooker,205068,205068,0,1990_boxofficemojo_rankings.csv,1990,1.0,0.0
12308,The Tic Code,205003,205003,0,2000_boxofficemojo_rankings.csv,2000,1.0,0.0
12309,The Princess Academy,205000,205000,0,1987_boxofficemojo_rankings.csv,1987,1.0,0.0
12310,The Untold Story of Emmett Louis Till,204956,204956,0,2005_boxofficemojo_rankings.csv,2005,1.0,0.0
12311,Sicilian Ghost Story,204892,15285,189607,2017_boxofficemojo_rankings.csv,2017,0.07460027721921793,0.9253997227807821
12312,The Iron Orchard,204881,204881,0,2019_boxofficemojo_rankings.csv,2019,1.0,0.0
12313,Working Woman,204727,64048,140679,2019_boxofficemojo_rankings.csv,2019,0.3128458874501165,0.6871541125498835
12314,Hesburgh,204709,204709,0,2019_boxofficemojo_rankings.csv,2019,1.0,0.0
12315,Don't Call Me Son,204583,11678,192905,2016_boxofficemojo_rankings.csv,2016,0.05708196673232869,0.9429180332676713
12316,Pop Aye,204464,77976,126488,2017_boxofficemojo_rankings.csv,2017,0.3813678691603412,0.6186321308396588
12317,Touchback,204232,204232,0,2012_boxofficemojo_rankings.csv,2012,1.0,0.0
12318,I Have Never Forgotten You: The Life & Legacy of Simon Wiesenthal,204167,29976,174191,2007_boxofficemojo_rankings.csv,2007,0.14682098478206565,0.8531790152179344
12319,Postmen in the Mountains,203975,203975,0,2003_boxofficemojo_rankings.csv,2003,1.0,0.0
12320,The Home Teachers,203917,203917,0,2004_boxofficemojo_rankings.csv,2004,1.0,0.0
12321,Bulandi,203548,203548,0,2000_boxofficemojo_rankings.csv,2000,1.0,0.0
12322,States of Grace,203144,203144,0,2005_boxofficemojo_rankings.csv,2005,1.0,0.0
12323,Forrest Gump 2019 Re-release,203088,203088,0,2019_boxofficemojo_rankings.csv,2019,1.0,0.0
12324,Charlie's Country,202966,42937,160029,2014_boxofficemojo_rankings.csv,2014,0.2115477469132761,0.7884522530867238
12325,Keep the Change,202788,202788,0,2018_boxofficemojo_rankings.csv,2018,1.0,0.0
12326,"Filth to Ashes, Flesh to Dust",202531,202531,0,2011_boxofficemojo_rankings.csv,2011,1.0,0.0
12327,The Girl in the Picture,202428,202428,0,1986_boxofficemojo_rankings.csv,1986,1.0,0.0
12328,The Bolshoi Ballet: Live From Moscow - Coppélia,202217,202217,0,2018_boxofficemojo_rankings.csv,2018,1.0,0.0
12329,Glastonbury,202041,8419,193622,2006_boxofficemojo_rankings.csv,2006,0.04166976009819789,0.9583302399018021
12330,"Hieronymus Bosch, Touched by the Devil",201907,172533,29374,2016_boxofficemojo_rankings.csv,2016,0.8545171787010851,0.14548282129891485
12331,The Bad Batch,201890,180851,21039,2017_boxofficemojo_rankings.csv,2017,0.8957897865174105,0.10421021348258953
12332,Blink of an Eye,201874,201874,0,2019_boxofficemojo_rankings.csv,2019,1.0,0.0
12333,Lightning in a Bottle,201711,201711,0,2004_boxofficemojo_rankings.csv,2004,1.0,0.0
12334,Milarepa,201634,151114,50520,2007_boxofficemojo_rankings.csv,2007,0.7494470178640507,0.2505529821359493
12335,The Rachel Papers,201468,201468,0,1989_boxofficemojo_rankings.csv,1989,1.0,0.0
12336,The Vertical Ray of the Sun,201247,110134,91113,2001_boxofficemojo_rankings.csv,2001,0.5472578473219477,0.45274215267805235
12337,The Snow Walker,201149,201149,0,2004_boxofficemojo_rankings.csv,2004,1.0,0.0
12338,Independent Lens: Imelda,200992,200992,0,2004_boxofficemojo_rankings.csv,2004,1.0,0.0
12339,Kikujiro,200920,200920,0,2000_boxofficemojo_rankings.csv,2000,1.0,0.0
12340,Zombi Child,200909,25878,175031,2019_boxofficemojo_rankings.csv,2019,0.12880458316949464,0.8711954168305054
12341,Eat the Rich,200723,200723,0,1988_boxofficemojo_rankings.csv,1988,1.0,0.0
12342,Champions,200498,200498,0,1984_boxofficemojo_rankings.csv,1984,1.0,0.0
12343,Legendary,200393,200393,0,2010_boxofficemojo_rankings.csv,2010,1.0,0.0
12344,Masculin Féminin,200380,200380,0,2005_boxofficemojo_rankings.csv,2005,1.0,0.0
12345,Gemini,200340,200340,0,2018_boxofficemojo_rankings.csv,2018,1.0,0.0
12346,White Girl,200242,200242,0,2016_boxofficemojo_rankings.csv,2016,1.0,0.0
12347,No Place on Earth,200238,200238,0,2013_boxofficemojo_rankings.csv,2013,1.0,0.0
12348,9/11,200229,170000,30229,2017_boxofficemojo_rankings.csv,2017,0.8490278630967543,0.1509721369032458
12349,Or (My Treasure),200175,29194,170981,2004_boxofficemojo_rankings.csv,2004,0.14584238791057824,0.8541576120894218
12350,Sleep with Me,200151,200151,0,1994_boxofficemojo_rankings.csv,1994,1.0,0.0
12351,Listen Up Philip,200126,200126,0,2014_boxofficemojo_rankings.csv,2014,1.0,0.0
12352,Cutie and the Boxer,200036,200036,0,2013_boxofficemojo_rankings.csv,2013,1.0,0.0
12353,What Would Jesus Buy?,200010,200010,0,2007_boxofficemojo_rankings.csv,2007,1.0,0.0
12354,Rebel Without a Cause 2018 Re-release,199963,199963,0,2018_boxofficemojo_rankings.csv,2018,1.0,0.0
12355,The Fallen Idol 2016 Re-release,199619,199619,0,2016_boxofficemojo_rankings.csv,2016,1.0,0.0
12356,October Baby,199442,199442,0,2011_boxofficemojo_rankings.csv,2011,1.0,0.0
12357,Come on My Brother,199227,199227,0,2000_boxofficemojo_rankings.csv,2000,1.0,0.0
12358,The New Kids,199108,199108,0,1985_boxofficemojo_rankings.csv,1985,1.0,0.0
12359,Five Days One Summer,199078,199078,0,1982_boxofficemojo_rankings.csv,1982,1.0,0.0
12360,Latin Boys Go to Hell,199033,199033,0,1997_boxofficemojo_rankings.csv,1997,1.0,0.0
12361,Friendsgiving Day #2,198869,198869,0,2019_boxofficemojo_rankings.csv,2019,1.0,0.0
12362,Little Joe,198674,23862,174812,2019_boxofficemojo_rankings.csv,2019,0.1201063048008295,0.8798936951991705
12363,The Warrior Queen of Jhansi,198544,177289,21255,2019_boxofficemojo_rankings.csv,2019,0.8929456442904343,0.10705435570956563
12364,Ex Libris: New York Public Library,198239,158192,40047,2017_boxofficemojo_rankings.csv,2017,0.7979862690994204,0.2020137309005796
12365,A Summer's Tale,198126,198126,0,2014_boxofficemojo_rankings.csv,2014,1.0,0.0
12366,Whores' Glory,197932,31420,166512,2011_boxofficemojo_rankings.csv,2011,0.1587413859305216,0.8412586140694784
12367,Pusher,197857,0,197857,2012_boxofficemojo_rankings.csv,2012,0.0,1.0
12368,Rocket Singh: Salesman of the Year,197650,0,197650,2009_boxofficemojo_rankings.csv,2009,0.0,1.0
12369,Getting Away with Murder,197322,197322,0,1996_boxofficemojo_rankings.csv,1996,1.0,0.0
12370,Haven,197312,142483,54829,2006_boxofficemojo_rankings.csv,2006,0.722120296788842,0.27787970321115796
12371,Madeline's Madeline,197309,185576,11733,2018_boxofficemojo_rankings.csv,2018,0.9405348970396687,0.05946510296033126
12372,Sky Blue,197221,74663,122558,2004_boxofficemojo_rankings.csv,2004,0.3785753038469534,0.6214246961530466
12373,Have It All -The Movie,197142,197142,0,2018_boxofficemojo_rankings.csv,2018,1.0,0.0
12374,Japón,196702,21900,174802,2003_boxofficemojo_rankings.csv,2003,0.111335929477077,0.888664070522923
12375,Máncora,196069,29697,166372,2009_boxofficemojo_rankings.csv,2009,0.15146198532149396,0.848538014678506
12376,Mom,195701,0,195701,2017_boxofficemojo_rankings.csv,2017,0.0,1.0
12377,Boom for Real: The Late Teenage Years of Jean-Michel Basquiat,195517,166616,28901,2018_boxofficemojo_rankings.csv,2018,0.8521816517233796,0.14781834827662044
12378,La traviata,195494,195494,0,2008_boxofficemojo_rankings.csv,2008,1.0,0.0
12379,One Day You'll Understand,195366,145642,49724,2008_boxofficemojo_rankings.csv,2008,0.7454828373411955,0.2545171626588045
12380,The Princess and the Pea,195358,0,195358,2005_boxofficemojo_rankings.csv,2005,0.0,1.0
12381,The Puffy Chair,195254,194523,731,2006_boxofficemojo_rankings.csv,2006,0.9962561586446372,0.0037438413553627582
12382,Infinity,195170,195170,0,1996_boxofficemojo_rankings.csv,1996,1.0,0.0
12383,The Divine Order,195081,76277,118804,2017_boxofficemojo_rankings.csv,2017,0.3910016864789498,0.6089983135210503
12384,Free Angela and All Political Prisoners,195005,194102,903,2013_boxofficemojo_rankings.csv,2013,0.9953693495038589,0.004630650496141125
12385,Herb & Dorothy,194721,194721,0,2009_boxofficemojo_rankings.csv,2009,1.0,0.0
12386,Family,194601,194601,0,2019_boxofficemojo_rankings.csv,2019,1.0,0.0
12387,I Want Someone to Eat Cheese With,194568,194568,0,2007_boxofficemojo_rankings.csv,2007,1.0,0.0
12388,In the Pit,194258,10433,183825,2006_boxofficemojo_rankings.csv,2006,0.05370692584089201,0.946293074159108
12389,Nowhere,194201,194201,0,1997_boxofficemojo_rankings.csv,1997,1.0,0.0
12390,A Screaming Man,193981,9862,184119,2010_boxofficemojo_rankings.csv,2010,0.0508400307246586,0.9491599692753414
12391,Alice's House,193531,61822,131709,2007_boxofficemojo_rankings.csv,2007,0.3194423632389643,0.6805576367610356
12392,Drama/Mex,193508,8628,184880,2007_boxofficemojo_rankings.csv,2007,0.04458730388407715,0.9554126961159228
12393,Alila,193385,50961,142424,2003_boxofficemojo_rankings.csv,2003,0.2635209556066913,0.7364790443933087
12394,Mondo New York,193209,193209,0,1988_boxofficemojo_rankings.csv,1988,1.0,0.0
12395,Van Gogh,193205,193205,0,1992_boxofficemojo_rankings.csv,1992,1.0,0.0
12396,Fay Grim,193067,126714,66353,2007_boxofficemojo_rankings.csv,2007,0.6563213806605996,0.3436786193394003
12397,Mr. Klein,193028,193028,0,2019_boxofficemojo_rankings.csv,2019,1.0,0.0
12398,Client 9: The Rise and Fall of Eliot Spitzer,192870,189416,3454,2010_boxofficemojo_rankings.csv,2010,0.982091564266086,0.017908435733914034
12399,The Return of Swamp Thing,192816,192816,0,1989_boxofficemojo_rankings.csv,1989,1.0,0.0
12400,Beverly Hills Brats,192561,192561,0,1989_boxofficemojo_rankings.csv,1989,1.0,0.0
12401,November,192186,192186,0,2005_boxofficemojo_rankings.csv,2005,1.0,0.0
12402,Claire's Camera,191980,83418,108562,2018_boxofficemojo_rankings.csv,2018,0.4345140118762371,0.5654859881237629
12403,The Princess of Nebraska,191887,0,191887,2008_boxofficemojo_rankings.csv,2008,0.0,1.0
12404,Harry Potter and the Deathly Hallows: Part 2 2018 Re-release,191886,181938,9948,2018_boxofficemojo_rankings.csv,2018,0.9481567180513429,0.05184328194865701
12405,Past Life,191678,180099,11579,2017_boxofficemojo_rankings.csv,2017,0.9395913980738531,0.06040860192614698
12406,Diamond Men,191221,191221,0,2001_boxofficemojo_rankings.csv,2001,1.0,0.0
12407,Chalo Dilli,191185,94300,96885,2011_boxofficemojo_rankings.csv,2011,0.4932395323900934,0.5067604676099067
12408,The Indian Runner,191125,191125,0,1991_boxofficemojo_rankings.csv,1991,1.0,0.0
12409,For Queen & Country,191051,191051,0,1989_boxofficemojo_rankings.csv,1989,1.0,0.0
12410,The Romantics,191019,106524,84495,2010_boxofficemojo_rankings.csv,2010,0.5576618032761139,0.4423381967238861
12411,A Pure Formality,190749,190749,0,1995_boxofficemojo_rankings.csv,1995,1.0,0.0
12412,Digimon Adventure tri. Part 1: Reunion Domestic Release,190581,190581,0,2016_boxofficemojo_rankings.csv,2016,1.0,0.0
12413,One Week,190441,190441,0,2001_boxofficemojo_rankings.csv,2001,1.0,0.0
12414,Code Black,190229,190229,0,2014_boxofficemojo_rankings.csv,2014,1.0,0.0
12415,The Doors: Break On Thru - A Celebration Of Ray Manzarek,190160,190160,0,2020_boxofficemojo_rankings.csv,2020,1.0,0.0
12416,The Divine Plan,190031,190031,0,2019_boxofficemojo_rankings.csv,2019,1.0,0.0
12417,Java Heat,189739,1061,188678,2013_boxofficemojo_rankings.csv,2013,0.0055918920200907565,0.9944081079799092
12418,Munna Michael,189105,99629,89476,2017_boxofficemojo_rankings.csv,2017,0.5268448745405991,0.47315512545940086
12419,Nick Saban: Gamechanger,189000,189000,0,2010_boxofficemojo_rankings.csv,2010,1.0,0.0
12420,Miles from Home,188964,188964,0,1988_boxofficemojo_rankings.csv,1988,1.0,0.0
12421,Harry Potter and the Goblet of Fire 2018 Re-release,188716,188716,0,2018_boxofficemojo_rankings.csv,2018,1.0,0.0
12422,Days of Being Wild,188630,146310,42320,2004_boxofficemojo_rankings.csv,2004,0.7756454434607433,0.22435455653925673
12423,Lost Boys of Sudan,188467,188467,0,2003_boxofficemojo_rankings.csv,2003,1.0,0.0
12424,Leap Year,188242,12979,175263,2010_boxofficemojo_rankings.csv,2010,0.06894848121035688,0.9310515187896431
12425,Repo! The Genetic Opera,188126,146750,41376,2008_boxofficemojo_rankings.csv,2008,0.7800622986721665,0.21993770132783347
12426,The Bolshoi Ballet: Live From Moscow - Don Quixote,187946,187946,0,2018_boxofficemojo_rankings.csv,2018,1.0,0.0
12427,Undead,187847,41196,146651,2003_boxofficemojo_rankings.csv,2003,0.21930613744164135,0.7806938625583587
12428,Bustin' Down the Door,187827,109427,78400,2008_boxofficemojo_rankings.csv,2008,0.5825946216465151,0.41740537835348485
12429,Music Within,187581,154087,33494,2007_boxofficemojo_rankings.csv,2007,0.8214424701862129,0.1785575298137871
12430,Chapter 27,187488,56215,131273,2008_boxofficemojo_rankings.csv,2008,0.29983252261478066,0.7001674773852193
12431,Rocket Gibraltar,187349,187349,0,1988_boxofficemojo_rankings.csv,1988,1.0,0.0
12432,Owaranai hito: Miyazaki Hayao,187320,187320,0,2018_boxofficemojo_rankings.csv,2018,1.0,0.0
12433,Calle 54,187308,187308,0,2000_boxofficemojo_rankings.csv,2000,1.0,0.0
12434,The Last Days on Mars,187191,24084,163107,2013_boxofficemojo_rankings.csv,2013,0.12866003173229482,0.8713399682677052
12435,Stoned,187160,38922,148238,2005_boxofficemojo_rankings.csv,2005,0.20796110279974353,0.7920388972002564
12436,The Big Tease,187152,187152,0,2000_boxofficemojo_rankings.csv,2000,1.0,0.0
12437,In the Fog,186838,11894,174944,2013_boxofficemojo_rankings.csv,2013,0.06365942688318223,0.9363405731168177
12438,Good for Nothing,186119,0,186119,2012_boxofficemojo_rankings.csv,2012,0.0,1.0
12439,Twiceland,186078,52874,133204,2018_boxofficemojo_rankings.csv,2018,0.28414965767043926,0.7158503423295607
12440,Salt of This Sea 2010 Re-release,186045,11662,174383,2010_boxofficemojo_rankings.csv,2010,0.06268375930554436,0.9373162406944556
12441,In the Basement,186036,3643,182393,2014_boxofficemojo_rankings.csv,2014,0.019582231396073877,0.9804177686039262
12442,Crude,185881,170295,15586,2009_boxofficemojo_rankings.csv,2009,0.9161506555269231,0.08384934447307686
12443,Britt-Marie Was Here,185794,36549,149245,2019_boxofficemojo_rankings.csv,2019,0.19671787032950472,0.8032821296704953
12444,Buñuel in the Labyrinth of the Turtles,185675,36205,149470,2019_boxofficemojo_rankings.csv,2019,0.19499124814864682,0.8050087518513531
12445,The Duke of Burgundy,185147,64521,120626,2015_boxofficemojo_rankings.csv,2015,0.3484852576601295,0.6515147423398705
12446,Cobra Kai Premiere Event feat. The Karate Kid,185082,185082,0,2018_boxofficemojo_rankings.csv,2018,1.0,0.0
12447,The Sugar Curtain,185058,582,184476,2007_boxofficemojo_rankings.csv,2007,0.0031449599584994973,0.9968550400415005
12448,The Ballad of the Sad Cafe,184890,184890,0,1991_boxofficemojo_rankings.csv,1991,1.0,0.0
12449,Amigo,184705,184705,0,2011_boxofficemojo_rankings.csv,2011,1.0,0.0
12450,To Dust,184495,184495,0,2019_boxofficemojo_rankings.csv,2019,1.0,0.0
12451,Vatel,184301,51080,133221,2000_boxofficemojo_rankings.csv,2000,0.27715530572270364,0.7228446942772964
12452,Score,184025,101382,82643,2017_boxofficemojo_rankings.csv,2017,0.5509142779513653,0.4490857220486347
12453,Good Morning Babylon,183700,183700,0,1987_boxofficemojo_rankings.csv,1987,1.0,0.0
12454,The River and the Wall,183602,183602,0,2019_boxofficemojo_rankings.csv,2019,1.0,0.0
12455,The Hidden Fortress,183579,183579,0,2001_boxofficemojo_rankings.csv,2001,1.0,0.0
12456,Youssou Ndour: I Bring What I Love,183503,172225,11278,2009_boxofficemojo_rankings.csv,2009,0.9385405143240165,0.0614594856759835
12457,"The Man Nobody Knew: In Search of My Father, CIA Spymaster William Colby",183342,183342,0,2011_boxofficemojo_rankings.csv,2011,1.0,0.0
12458,Lambert & Stamp,183320,183320,0,2015_boxofficemojo_rankings.csv,2015,1.0,0.0
12459,Burnt Money,183132,183132,0,2001_boxofficemojo_rankings.csv,2001,1.0,0.0
12460,Hellbent,183066,183066,0,2005_boxofficemojo_rankings.csv,2005,1.0,0.0
12461,Americanizing Shelley,182831,128024,54807,2007_boxofficemojo_rankings.csv,2007,0.7002313612024219,0.2997686387975781
12462,Whose Streets?,182799,182799,0,2017_boxofficemojo_rankings.csv,2017,1.0,0.0
12463,The Masked Saint,182695,182695,0,2016_boxofficemojo_rankings.csv,2016,1.0,0.0
12464,I Am Not A Witch,182462,50868,131594,2017_boxofficemojo_rankings.csv,2017,0.2787868158849514,0.7212131841150486
12465,Shock and Awe,182415,77980,104435,2018_boxofficemojo_rankings.csv,2018,0.42748677466217144,0.5725132253378286
12466,Beyond Silence,181881,181881,0,1998_boxofficemojo_rankings.csv,1998,1.0,0.0
12467,The Baxter,181872,181872,0,2005_boxofficemojo_rankings.csv,2005,1.0,0.0
12468,Fida,181865,98297,83568,2004_boxofficemojo_rankings.csv,2004,0.5404943227119017,0.4595056772880983
12469,Fulltime Killer,181662,23124,158538,2001_boxofficemojo_rankings.csv,2001,0.12729134326386365,0.8727086567361363
12470,Giant Little Ones,181507,181507,0,2019_boxofficemojo_rankings.csv,2019,1.0,0.0
12471,Bolshoi Ballet: Raymonda domestic,181361,181361,0,2019_boxofficemojo_rankings.csv,2019,1.0,0.0
12472,Raymonda: Bolshoi Ballet,181361,181361,0,2019_boxofficemojo_rankings.csv,2019,1.0,0.0
12473,Rafiki,181316,137968,43348,2019_boxofficemojo_rankings.csv,2019,0.7609256767190982,0.23907432328090186
12474,"Dancing/The Song of Wolfgang the Intrepid, the Glorious Destroyer of Dragons/A Smaller World/The Green Beret/Weeds/The Tale of Nippoless Nippleby/Office Space/The Boss/Unsavory Avery/Rrring/Pre-Hysterical Daze",181273,181273,0,1992_boxofficemojo_rankings.csv,1992,1.0,0.0
12475,Chairman of the Board,181233,181233,0,1998_boxofficemojo_rankings.csv,1998,1.0,0.0
12476,Winnebago Man,181039,181039,0,2010_boxofficemojo_rankings.csv,2010,1.0,0.0
12477,1001 Grams,181030,10983,170047,2014_boxofficemojo_rankings.csv,2014,0.06066950229243772,0.9393304977075623
12478,"Not Quite Hollywood: The Wild, Untold Story of Ozploitation!",180957,21152,159805,2008_boxofficemojo_rankings.csv,2008,0.11688964781688467,0.8831103521831153
12479,An Honest Liar,180590,180590,0,2015_boxofficemojo_rankings.csv,2015,1.0,0.0
12480,Fukrey,180331,125279,55052,2013_boxofficemojo_rankings.csv,2013,0.694716937187727,0.30528306281227297
12481,Go for It!,180237,180237,0,2011_boxofficemojo_rankings.csv,2011,1.0,0.0
12482,Lost Woods,180117,180117,0,2012_boxofficemojo_rankings.csv,2012,1.0,0.0
12483,Chop Suey,179914,179914,0,2001_boxofficemojo_rankings.csv,2001,1.0,0.0
12484,Lila & Eve,179807,38263,141544,2015_boxofficemojo_rankings.csv,2015,0.21280039153091926,0.7871996084690808
12485,Cherish,179751,179751,0,2002_boxofficemojo_rankings.csv,2002,1.0,0.0
12486,Constantine's Sword,179507,179507,0,2008_boxofficemojo_rankings.csv,2008,1.0,0.0
12487,The Efficiency Expert,179469,179469,0,1992_boxofficemojo_rankings.csv,1992,1.0,0.0
12488,The Inner Life of Martin Frost,179443,5114,174329,2007_boxofficemojo_rankings.csv,2007,0.02849930061356531,0.9715006993864347
12489,Smiley Face,179381,9397,169984,2007_boxofficemojo_rankings.csv,2007,0.05238570417156778,0.9476142958284323
12490,Protocols of Zion,178875,178875,0,2005_boxofficemojo_rankings.csv,2005,1.0,0.0
12491,Breakfast of Champions,178278,178278,0,1999_boxofficemojo_rankings.csv,1999,1.0,0.0
12492,Offender,178158,0,178158,2012_boxofficemojo_rankings.csv,2012,0.0,1.0
12493,Walking on Water,178119,102140,75979,2019_boxofficemojo_rankings.csv,2019,0.5734368596275524,0.42656314037244764
12494,Sugar Town,178095,178095,0,1999_boxofficemojo_rankings.csv,1999,1.0,0.0
12495,Lagaan: Once Upon a Time in India 2002 Re-release,178072,73276,104796,2002_boxofficemojo_rankings.csv,2002,0.41149647333662787,0.5885035266633721
12496,Modest Heroes,178027,178027,0,2019_boxofficemojo_rankings.csv,2019,1.0,0.0
12497,Giant 1996 Re-release,177909,177909,0,1996_boxofficemojo_rankings.csv,1996,1.0,0.0
12498,Seven Hours to Judgment,177820,177820,0,1988_boxofficemojo_rankings.csv,1988,1.0,0.0
12499,Zaytoun,177753,42330,135423,2013_boxofficemojo_rankings.csv,2013,0.2381394406845454,0.7618605593154546
12500,Monumental: In Search of America's National Treasure,177729,177729,0,2012_boxofficemojo_rankings.csv,2012,1.0,0.0
12501,Awesome; I Fuckin' Shot That!,177683,162538,15145,2006_boxofficemojo_rankings.csv,2006,0.914763933522059,0.08523606647794105
12502,Nostalgia for the Light,177634,163962,13672,2010_boxofficemojo_rankings.csv,2010,0.9230327527387775,0.07696724726122252
12503,Chicago 10,177490,177490,0,2008_boxofficemojo_rankings.csv,2008,1.0,0.0
12504,Bush's Brain,177485,177485,0,2004_boxofficemojo_rankings.csv,2004,1.0,0.0
12505,Tarkovsky At 70,177345,177345,0,2002_boxofficemojo_rankings.csv,2002,1.0,0.0
12506,People Places Things,177338,67046,110292,2015_boxofficemojo_rankings.csv,2015,0.3780689981842583,0.6219310018157417
12507,Anita: Speaking Truth to Power,176979,176979,0,2014_boxofficemojo_rankings.csv,2014,1.0,0.0
12508,Bye Bye Germany,176933,73730,103203,2017_boxofficemojo_rankings.csv,2017,0.4167114105339309,0.5832885894660691
12509,Casino Jack and the United States of Money,176865,176865,0,2010_boxofficemojo_rankings.csv,2010,1.0,0.0
12510,Touch the Sound: A Sound Journey with Evelyn Glennie,176801,176801,0,2005_boxofficemojo_rankings.csv,2005,1.0,0.0
12511,Anchor Baby,176784,15790,160994,2010_boxofficemojo_rankings.csv,2010,0.08931803783147796,0.910681962168522
12512,Vigilante Diaries,176777,1991,174786,2016_boxofficemojo_rankings.csv,2016,0.01126277739751212,0.9887372226024879
12513,An Unreasonable Man,176647,176647,0,2007_boxofficemojo_rankings.csv,2007,1.0,0.0
12514,The Sea,176401,75994,100407,2003_boxofficemojo_rankings.csv,2003,0.430802546470825,0.5691974535291751
12515,"Iyengar: The Man, Yoga, and the Student's Journey",176387,176387,0,2019_boxofficemojo_rankings.csv,2019,1.0,0.0
12516,Better Watch Out,176288,20369,155919,2017_boxofficemojo_rankings.csv,2017,0.1155438827373389,0.884456117262661
12517,Girl on a Bicycle,176272,91401,84871,2013_boxofficemojo_rankings.csv,2013,0.5185225106653354,0.4814774893346646
12518,The Bolshoi Ballet: Live From Moscow - The Flames of Paris,175922,175922,0,2018_boxofficemojo_rankings.csv,2018,1.0,0.0
12519,Afternoon Delight,175755,174496,1259,2013_boxofficemojo_rankings.csv,2013,0.9928366191573497,0.00716338084265028
12520,The Business of Fancydancing,175710,175710,0,2002_boxofficemojo_rankings.csv,2002,1.0,0.0
12521,Butter,175706,105018,70688,2012_boxofficemojo_rankings.csv,2012,0.5976915984656187,0.4023084015343813
12522,A.C.O.D.,175705,175705,0,2013_boxofficemojo_rankings.csv,2013,1.0,0.0
12523,Black Rock,175682,0,175682,2013_boxofficemojo_rankings.csv,2013,0.0,1.0
12524,Romper Stomper,175340,175340,0,1993_boxofficemojo_rankings.csv,1993,1.0,0.0
12525,Champion,175232,175232,0,2017_boxofficemojo_rankings.csv,2017,1.0,0.0
12526,Cleopatra's Second Husband,175058,175058,0,2000_boxofficemojo_rankings.csv,2000,1.0,0.0
12527,Lonesome Jim,174815,154187,20628,2006_boxofficemojo_rankings.csv,2006,0.8820009724565969,0.11799902754340302
12528,My Best Friend Is a Vampire,174380,174380,0,1988_boxofficemojo_rankings.csv,1988,1.0,0.0
12529,Marooned in Iraq,174357,141243,33114,2003_boxofficemojo_rankings.csv,2003,0.8100793200158296,0.18992067998417042
12530,Stateside,174318,174318,0,2004_boxofficemojo_rankings.csv,2004,1.0,0.0
12531,Always at The Carlyle,174251,174251,0,2018_boxofficemojo_rankings.csv,2018,1.0,0.0
12532,SOMM,174197,174197,0,2013_boxofficemojo_rankings.csv,2013,1.0,0.0
12533,Grand Illusion,174065,174065,0,2012_boxofficemojo_rankings.csv,2012,1.0,0.0
12534,American Women,174011,164927,9084,2000_boxofficemojo_rankings.csv,2000,0.9477964036756297,0.0522035963243703
12535,Passport to Love,173828,173828,0,2009_boxofficemojo_rankings.csv,2009,1.0,0.0
12536,Mercy Streets,173599,173599,0,2000_boxofficemojo_rankings.csv,2000,1.0,0.0
12537,The Fallen Idol,173566,141502,32064,2006_boxofficemojo_rankings.csv,2006,0.8152633580309507,0.18473664196904924
12538,Baptists at Our Barbecue,173306,173306,0,2004_boxofficemojo_rankings.csv,2004,1.0,0.0
12539,Neon Bull,173219,26734,146485,2016_boxofficemojo_rankings.csv,2016,0.15433641806037443,0.8456635819396255
12540,Cirkus Columbia,173083,3457,169626,2011_boxofficemojo_rankings.csv,2011,0.019973076500869526,0.9800269234991305
12541,My Name Is Bruce,173066,173066,0,2008_boxofficemojo_rankings.csv,2008,1.0,0.0
12542,Them That Follow,172952,159218,13734,2019_boxofficemojo_rankings.csv,2019,0.9205906841204496,0.0794093158795504
12543,Bellflower,172935,168226,4709,2011_boxofficemojo_rankings.csv,2011,0.9727701159395149,0.027229884060485154
12544,Rodin 2017 Re-release,172619,44261,128358,2017_boxofficemojo_rankings.csv,2017,0.256408622457551,0.743591377542449
12545,Forty Shades of Blue,172569,75828,96741,2005_boxofficemojo_rankings.csv,2005,0.43940684595726925,0.5605931540427307
12546,Afternoon of a Faun: Tanaquil Le Clercq,172450,172450,0,2014_boxofficemojo_rankings.csv,2014,1.0,0.0
12547,All Things Must Pass,172394,172394,0,2015_boxofficemojo_rankings.csv,2015,1.0,0.0
12548,The Great New Wonderful,172055,150142,21913,2006_boxofficemojo_rankings.csv,2006,0.8726395629304583,0.12736043706954173
12549,Escape from Tomorrow,171962,171962,0,2013_boxofficemojo_rankings.csv,2013,1.0,0.0
12550,Little Woods,171912,150010,21902,2019_boxofficemojo_rankings.csv,2019,0.8725976080785518,0.12740239192144817
12551,Copperhead,171740,171740,0,2013_boxofficemojo_rankings.csv,2013,1.0,0.0
12552,Abuse of Weakness,171660,31611,140049,2014_boxofficemojo_rankings.csv,2014,0.1841488989863684,0.8158511010136316
12553,United Passions,171511,607,170904,2014_boxofficemojo_rankings.csv,2014,0.003539131600888573,0.9964608683991114
12554,North Station,171400,171400,0,2002_boxofficemojo_rankings.csv,2002,1.0,0.0
12555,Hollywood Dreams,171255,171255,0,2007_boxofficemojo_rankings.csv,2007,1.0,0.0
12556,The Bolshoi Ballet: Live From Moscow - La Sylphide,171177,171177,0,2018_boxofficemojo_rankings.csv,2018,1.0,0.0
12557,Palau the Movie,171155,134696,36459,2019_boxofficemojo_rankings.csv,2019,0.786982559668137,0.21301744033186293
12558,Underground,171082,171082,0,1997_boxofficemojo_rankings.csv,1997,1.0,0.0
12559,Cheerful Weather for the Wedding,170922,2651,168271,2012_boxofficemojo_rankings.csv,2012,0.015509998712863177,0.9844900012871368
12560,Uninvited Guest,170832,170832,0,2000_boxofficemojo_rankings.csv,2000,1.0,0.0
12561,London Kills Me,170667,170667,0,1992_boxofficemojo_rankings.csv,1992,1.0,0.0
12562,Apparition Hill,170457,170457,0,2016_boxofficemojo_rankings.csv,2016,1.0,0.0
12563,Owl and the Sparrow,170324,47071,123253,2008_boxofficemojo_rankings.csv,2008,0.27636152274488623,0.7236384772551138
12564,The Human Centipede II (Full Sequence),170323,141877,28446,2011_boxofficemojo_rankings.csv,2011,0.8329879112040065,0.1670120887959935
12565,Amusement,170255,0,170255,2008_boxofficemojo_rankings.csv,2008,0.0,1.0
12566,The House That Jack Built,170113,170113,0,2018_boxofficemojo_rankings.csv,2018,1.0,0.0
12567,Pass the Ammo,169785,169785,0,1988_boxofficemojo_rankings.csv,1988,1.0,0.0
12568,Lady Beware,169600,169600,0,1987_boxofficemojo_rankings.csv,1987,1.0,0.0
12569,My New Gun,169600,169600,0,1992_boxofficemojo_rankings.csv,1992,1.0,0.0
12570,Knockout,169503,169503,0,2000_boxofficemojo_rankings.csv,2000,1.0,0.0
12571,The Fits,169236,166425,2811,2016_boxofficemojo_rankings.csv,2016,0.9833900588527263,0.01660994114727363
12572,The Experts,169203,169203,0,1989_boxofficemojo_rankings.csv,1989,1.0,0.0
12573,Viva Riva!,168982,61759,107223,2011_boxofficemojo_rankings.csv,2011,0.3654767963451729,0.6345232036548272
12574,Free the Mind,168916,157201,11715,2013_boxofficemojo_rankings.csv,2013,0.930646001562907,0.06935399843709299
12575,Grizzly Falls,168874,168874,0,2000_boxofficemojo_rankings.csv,2000,1.0,0.0
12576,Girls of the Sun,168771,19712,149059,2018_boxofficemojo_rankings.csv,2018,0.1167973170746159,0.8832026829253841
12577,Valley of Bones,168738,168738,0,2017_boxofficemojo_rankings.csv,2017,1.0,0.0
12578,Hangman's Curse,168406,168406,0,2003_boxofficemojo_rankings.csv,2003,1.0,0.0
12579,Shotgun Stories,168237,46026,122211,2007_boxofficemojo_rankings.csv,2007,0.27357834483496496,0.726421655165035
12580,Be Natural: The Untold Story of Alice Guy-Blaché,168169,115804,52365,2019_boxofficemojo_rankings.csv,2019,0.68861680809186,0.31138319190814
12581,I Am Cuba,168100,168100,0,1995_boxofficemojo_rankings.csv,1995,1.0,0.0
12582,De Palma,168045,165237,2808,2016_boxofficemojo_rankings.csv,2016,0.9832901901276444,0.016709809872355617
12583,Twentynine Palms,167999,54523,113476,2003_boxofficemojo_rankings.csv,2003,0.32454359847380043,0.6754564015261996
12584,The Clovehitch Killer,167994,8208,159786,2018_boxofficemojo_rankings.csv,2018,0.04885888781742205,0.9511411121825779
12585,The Bolshoi Ballet: Live From Moscow - The Lady of the Camellias,167991,167991,0,2018_boxofficemojo_rankings.csv,2018,1.0,0.0
12586,Perrier's Bounty,167938,828,167110,2010_boxofficemojo_rankings.csv,2010,0.004930390977622694,0.9950696090223773
12587,Beauty and the Dogs,167723,8915,158808,2017_boxofficemojo_rankings.csv,2017,0.05315311555362115,0.9468468844463789
12588,Genius Within: The Inner Life of Glenn Gould,167508,167508,0,2010_boxofficemojo_rankings.csv,2010,1.0,0.0
12589,Ziggy Stardust and the Spiders from Mars,167239,162547,4692,2002_boxofficemojo_rankings.csv,2002,0.9719443431257063,0.028055656874293674
12590,On_Line,167102,167102,0,2003_boxofficemojo_rankings.csv,2003,1.0,0.0
12591,Is Genesis History? 2018 Re-release,166763,166763,0,2018_boxofficemojo_rankings.csv,2018,1.0,0.0
12592,Our Brand Is Crisis,166750,166750,0,2006_boxofficemojo_rankings.csv,2006,1.0,0.0
12593,Night Visitor,166635,166635,0,1989_boxofficemojo_rankings.csv,1989,1.0,0.0
12594,Holly,166620,166620,0,2007_boxofficemojo_rankings.csv,2007,1.0,0.0
12595,We'll Meet Again,166484,91968,74516,2004_boxofficemojo_rankings.csv,2004,0.5524134451358689,0.44758655486413107
12596,The Hi-Lo Country,166082,166082,0,1998_boxofficemojo_rankings.csv,1998,1.0,0.0
12597,The Day After,166022,24746,141276,2017_boxofficemojo_rankings.csv,2017,0.1490525352061775,0.8509474647938225
12598,Far From the Tree,166018,166018,0,2018_boxofficemojo_rankings.csv,2018,1.0,0.0
12599,Fool for Love,165987,165987,0,2010_boxofficemojo_rankings.csv,2010,1.0,0.0
12600,The Film Critic,165891,7358,158533,2014_boxofficemojo_rankings.csv,2014,0.04435442549625959,0.9556455745037404
12601,Gigantic,165888,102704,63184,2009_boxofficemojo_rankings.csv,2009,0.619116512345679,0.380883487654321
12602,La strada di Levi,165869,22026,143843,2007_boxofficemojo_rankings.csv,2007,0.1327915403119329,0.867208459688067
12603,Hotel de Love,165845,165845,0,1997_boxofficemojo_rankings.csv,1997,1.0,0.0
12604,Bright Ones,165627,165627,0,2019_boxofficemojo_rankings.csv,2019,1.0,0.0
12605,2001: A Space Odyssey 2019 Re-release,165494,135370,30124,2019_boxofficemojo_rankings.csv,2019,0.8179752740280615,0.18202472597193856
12606,Solomon & Gaenor,165485,165485,0,2000_boxofficemojo_rankings.csv,2000,1.0,0.0
12607,Maybe Baby,165046,20501,144545,2001_boxofficemojo_rankings.csv,2001,0.12421385553118525,0.8757861444688148
12608,Uncle Nino,165000,165000,0,2005_boxofficemojo_rankings.csv,2005,1.0,0.0
12609,Fallen Angels,164913,163145,1768,1998_boxofficemojo_rankings.csv,1998,0.9892791956971252,0.010720804302874849
12610,Christmas Eve,164839,91302,73537,2015_boxofficemojo_rankings.csv,2015,0.5538859129210927,0.4461140870789073
12611,Nas: Time Is Illmatic,164540,164540,0,2014_boxofficemojo_rankings.csv,2014,1.0,0.0
12612,The Chambermaid,164531,86422,78109,2019_boxofficemojo_rankings.csv,2019,0.525262716448572,0.474737283551428
12613,Red Betsy,164520,164520,0,2003_boxofficemojo_rankings.csv,2003,1.0,0.0
12614,Hybrid,164386,164386,0,2002_boxofficemojo_rankings.csv,2002,1.0,0.0
12615,Saint Judy,164336,78935,85401,2019_boxofficemojo_rankings.csv,2019,0.48032689124720085,0.5196731087527992
12616,Eastern Boys,164290,16831,147459,2014_boxofficemojo_rankings.csv,2014,0.10244689268975592,0.8975531073102441
12617,Lost & Found,164026,125173,38853,2018_boxofficemojo_rankings.csv,2018,0.7631290161315889,0.2368709838684111
12618,The Loss of Sexual Innocence,164022,164022,0,1999_boxofficemojo_rankings.csv,1999,1.0,0.0
12619,Canadian Bacon,163971,163971,0,1995_boxofficemojo_rankings.csv,1995,1.0,0.0
12620,Cruel Peter,163925,0,163925,2020_boxofficemojo_rankings.csv,2020,0.0,1.0
12621,Keep on Keepin' On,163745,163745,0,2014_boxofficemojo_rankings.csv,2014,1.0,0.0
12622,Narco Cultura,163690,145088,18602,2013_boxofficemojo_rankings.csv,2013,0.88635836031523,0.11364163968477
12623,Halston,163446,151991,11455,2019_boxofficemojo_rankings.csv,2019,0.9299156908091969,0.07008430919080308
12624,My Life's in Turnaround,163383,163383,0,1994_boxofficemojo_rankings.csv,1994,1.0,0.0
12625,Stolen Summer,163348,134736,28612,2002_boxofficemojo_rankings.csv,2002,0.8248402184293655,0.17515978157063447
12626,"Police, Adjective",162974,53206,109768,2009_boxofficemojo_rankings.csv,2009,0.3264692527642446,0.6735307472357553
12627,The Fassbinder Series,162885,162885,0,2003_boxofficemojo_rankings.csv,2003,1.0,0.0
12628,Face,162717,108151,54566,2004_boxofficemojo_rankings.csv,2004,0.6646570425954265,0.3353429574045736
12629,Walking Out,162445,101947,60498,2017_boxofficemojo_rankings.csv,2017,0.6275785650527871,0.3724214349472129
12630,The Bay Boy,162364,162364,0,1985_boxofficemojo_rankings.csv,1985,1.0,0.0
12631,The Turin Horse,162088,56391,105697,2011_boxofficemojo_rankings.csv,2011,0.34790360791668723,0.6520963920833127
12632,Road to Nowhere,161619,40294,121325,2011_boxofficemojo_rankings.csv,2011,0.24931474640976617,0.7506852535902339
12633,Vanaja,161590,161590,0,2007_boxofficemojo_rankings.csv,2007,1.0,0.0
12634,The Samuel Project,161565,161565,0,2018_boxofficemojo_rankings.csv,2018,1.0,0.0
12635,Mughal-E-Azam,161434,161434,0,2005_boxofficemojo_rankings.csv,2005,1.0,0.0
12636,Come Early Morning,161408,119452,41956,2006_boxofficemojo_rankings.csv,2006,0.7400624504361618,0.25993754956383824
12637,The Blue Iguana,161398,161398,0,1988_boxofficemojo_rankings.csv,1988,1.0,0.0
12638,Lu Over the Wall,161253,109857,51396,2018_boxofficemojo_rankings.csv,2018,0.6812710461200722,0.31872895387992783
12639,Tharlo,161229,17091,144138,2016_boxofficemojo_rankings.csv,2016,0.10600450291200715,0.8939954970879929
12640,Spring Fever,161110,10824,150286,2010_boxofficemojo_rankings.csv,2010,0.06718391161318354,0.9328160883868165
12641,Bulgarian Lovers,161027,60712,100315,2003_boxofficemojo_rankings.csv,2003,0.3770299390785396,0.6229700609214603
12642,The Beast of War,161004,161004,0,1988_boxofficemojo_rankings.csv,1988,1.0,0.0
12643,"Diana Ross: Her Life, Love and Legacy",160968,160968,0,2019_boxofficemojo_rankings.csv,2019,1.0,0.0
12644,Gigantic (A Tale of Two Johns),160621,160621,0,2003_boxofficemojo_rankings.csv,2003,1.0,0.0
12645,Broken Sky,160445,29185,131260,2006_boxofficemojo_rankings.csv,2006,0.18190033968026426,0.8180996603197357
12646,National Theatre Live: The Curious Incident of the Dog in the Night-Time 2018 Re-release,160381,160381,0,2018_boxofficemojo_rankings.csv,2018,1.0,0.0
12647,Cocaine Cowboys,160347,150056,10291,2006_boxofficemojo_rankings.csv,2006,0.9358204394220035,0.06417956057799647
12648,Washington Heights,160291,160291,0,2003_boxofficemojo_rankings.csv,2003,1.0,0.0
12649,Danny Deckchair 2004 Re-release,160276,160276,0,2004_boxofficemojo_rankings.csv,2004,1.0,0.0
12650,Beauty and the Beast 2016 Re-release,160215,160215,0,2016_boxofficemojo_rankings.csv,2016,1.0,0.0
12651,Punks,160083,160083,0,2001_boxofficemojo_rankings.csv,2001,1.0,0.0
12652,Taffin,159969,159969,0,1988_boxofficemojo_rankings.csv,1988,1.0,0.0
12653,Sinbad: The Fifth Voyage,159862,159862,0,2014_boxofficemojo_rankings.csv,2014,1.0,0.0
12654,The Eclipse,159852,133411,26441,2010_boxofficemojo_rankings.csv,2010,0.8345907464404574,0.16540925355954259
12655,Murder 3,159798,0,159798,2013_boxofficemojo_rankings.csv,2013,0.0,1.0
12656,The Model,159743,0,159743,2016_boxofficemojo_rankings.csv,2016,0.0,1.0
12657,Gor,159731,159731,0,1988_boxofficemojo_rankings.csv,1988,1.0,0.0
12658,Eames: The Architect & The Painter,159715,153088,6627,2011_boxofficemojo_rankings.csv,2011,0.9585073412015152,0.0414926587984848
12659,Mountain Patrol 2006 Re-release,159460,143383,16077,2006_boxofficemojo_rankings.csv,2006,0.8991784773610937,0.10082152263890631
12660,When Will I Be Loved,159429,159429,0,2004_boxofficemojo_rankings.csv,2004,1.0,0.0
12661,Km. 0 - Kilometer Zero,159338,159338,0,2003_boxofficemojo_rankings.csv,2003,1.0,0.0
12662,The Body,159317,68196,91121,2019_boxofficemojo_rankings.csv,2019,0.42805224803379427,0.5719477519662057
12663,The Witness,159305,159305,0,2016_boxofficemojo_rankings.csv,2016,1.0,0.0
12664,Girls Rock!,159294,159294,0,2008_boxofficemojo_rankings.csv,2008,1.0,0.0
12665,We Are What We Are,159047,81381,77666,2013_boxofficemojo_rankings.csv,2013,0.5116789376725119,0.4883210623274881
12666,Teza,158999,30070,128929,2009_boxofficemojo_rankings.csv,2009,0.1891206862936245,0.8108793137063756
12667,Mast,158928,158928,0,1999_boxofficemojo_rankings.csv,1999,1.0,0.0
12668,Until Forever,158872,35839,123033,2016_boxofficemojo_rankings.csv,2016,0.2255841180321265,0.7744158819678735
12669,The Last Resort,158646,158646,0,2018_boxofficemojo_rankings.csv,2018,1.0,0.0
12670,The Big Picture 2012 Re-release,158411,158411,0,2012_boxofficemojo_rankings.csv,2012,1.0,0.0
12671,Dev,158357,84728,73629,2004_boxofficemojo_rankings.csv,2004,0.535044235493221,0.464955764506779
12672,Bright Angel,158243,158243,0,1991_boxofficemojo_rankings.csv,1991,1.0,0.0
12673,Mother of George,157937,157937,0,2013_boxofficemojo_rankings.csv,2013,1.0,0.0
12674,The Look of Silence,157857,109089,48768,2015_boxofficemojo_rankings.csv,2015,0.6910621638571619,0.30893783614283815
12675,Altiplano,157796,2961,154835,2009_boxofficemojo_rankings.csv,2009,0.018764734213795025,0.981235265786205
12676,Crazy Horse,157782,157782,0,2012_boxofficemojo_rankings.csv,2012,1.0,0.0
12677,Hell and Back,157768,157768,0,2015_boxofficemojo_rankings.csv,2015,1.0,0.0
12678,Till Human Voices Wake Us,157720,120601,37119,2002_boxofficemojo_rankings.csv,2002,0.7646525488206949,0.23534745117930508
12679,House of Fools,157613,57862,99751,2003_boxofficemojo_rankings.csv,2003,0.3671143877725822,0.6328856122274178
12680,Chasing Madoff,157612,157612,0,2011_boxofficemojo_rankings.csv,2011,1.0,0.0
12681,Eva Hesse,157481,157481,0,2016_boxofficemojo_rankings.csv,2016,1.0,0.0
12682,2005 Academy Award Nominated Short Films,157415,157415,0,2006_boxofficemojo_rankings.csv,2006,1.0,0.0
12683,Eden Log,157350,0,157350,2007_boxofficemojo_rankings.csv,2007,0.0,1.0
12684,Suntan,157267,6643,150624,2016_boxofficemojo_rankings.csv,2016,0.042240266553059444,0.9577597334469405
12685,Derrida,157200,157200,0,2002_boxofficemojo_rankings.csv,2002,1.0,0.0
12686,LUV,156996,156996,0,2013_boxofficemojo_rankings.csv,2013,1.0,0.0
12687,One Day in September,156818,156818,0,2000_boxofficemojo_rankings.csv,2000,1.0,0.0
12688,Marina Abramovic: The Artist Is Present,156695,86637,70058,2012_boxofficemojo_rankings.csv,2012,0.5529021347203166,0.4470978652796835
12689,The Horse Boy,156612,156612,0,2009_boxofficemojo_rankings.csv,2009,1.0,0.0
12690,The Booksellers,156502,25694,130808,2020_boxofficemojo_rankings.csv,2020,0.1641768156317491,0.8358231843682509
12691,Jodi No. 1,156415,82834,73581,2001_boxofficemojo_rankings.csv,2001,0.5295783652462999,0.4704216347537001
12692,Hatchet II,156190,52604,103586,2010_boxofficemojo_rankings.csv,2010,0.3367949292528331,0.663205070747167
12693,Distant Thunder,156188,156188,0,1988_boxofficemojo_rankings.csv,1988,1.0,0.0
12694,Deadtime,156072,156072,0,2012_boxofficemojo_rankings.csv,2012,1.0,0.0
12695,Pépé le Moko,155895,155895,0,2002_boxofficemojo_rankings.csv,2002,1.0,0.0
12696,Queen & Country,155881,41297,114584,2015_boxofficemojo_rankings.csv,2015,0.26492645030504036,0.7350735496949596
12697,Il ne faut jurer... de rien! 2006 Re-release,155878,23442,132436,2006_boxofficemojo_rankings.csv,2006,0.15038684099103145,0.8496131590089685
12698,Matando Cabos 2005 Re-release,155874,155874,0,2005_boxofficemojo_rankings.csv,2005,1.0,0.0
12699,El Topo,155820,80302,75518,2006_boxofficemojo_rankings.csv,2006,0.5153510460788089,0.4846489539211911
12700,Money,155732,155732,0,2019_boxofficemojo_rankings.csv,2019,1.0,0.0
12701,Dans l'oeil du chat,155714,155714,0,2004_boxofficemojo_rankings.csv,2004,1.0,0.0
12702,Naqoyqatsi,155640,133058,22582,2002_boxofficemojo_rankings.csv,2002,0.8549087638139296,0.14509123618607042
12703,Duck Season 2005 Re-release,155410,147551,7859,2005_boxofficemojo_rankings.csv,2005,0.9494305385753813,0.05056946142461875
12704,The Forgiveness of Blood,155383,126700,28683,2012_boxofficemojo_rankings.csv,2012,0.8154045165816081,0.18459548341839196
12705,The Gleaners & I,155320,155320,0,2001_boxofficemojo_rankings.csv,2001,1.0,0.0
12706,Small Faces,155239,155239,0,1996_boxofficemojo_rankings.csv,1996,1.0,0.0
12707,Western,155215,41072,114143,2018_boxofficemojo_rankings.csv,2018,0.2646136004896434,0.7353863995103566
12708,The Boy and the World 2015 Re-release,155215,129480,25735,2015_boxofficemojo_rankings.csv,2015,0.8341977257352704,0.16580227426472957
12709,Eating Out,155212,155212,0,2005_boxofficemojo_rankings.csv,2005,1.0,0.0
12710,Service,155156,64536,90620,2008_boxofficemojo_rankings.csv,2008,0.4159426641573642,0.5840573358426357
12711,Magic Trip: Ken Kesey's Search for a Kool Place,155005,154521,484,2011_boxofficemojo_rankings.csv,2011,0.9968775200799974,0.0031224799200025807
12712,Pantaleón y las visitadoras,154976,43214,111762,2002_boxofficemojo_rankings.csv,2002,0.2788431757175305,0.7211568242824695
12713,Hansel & Gretel,154642,154642,0,2002_boxofficemojo_rankings.csv,2002,1.0,0.0
12714,The Exterminating Angels,154210,23308,130902,2007_boxofficemojo_rankings.csv,2007,0.15114454315543738,0.8488554568445627
12715,Bad Reputation,154190,148568,5622,2018_boxofficemojo_rankings.csv,2018,0.963538491471561,0.03646150852843894
12716,Eating Animals,153993,149614,4379,2018_boxofficemojo_rankings.csv,2018,0.9715636425032307,0.028436357496769333
12717,Suddenly,153985,44806,109179,2003_boxofficemojo_rankings.csv,2003,0.29097639380459134,0.7090236061954086
12718,Citizen Koch,153908,153908,0,2014_boxofficemojo_rankings.csv,2014,1.0,0.0
12719,The Tag Along: Devil Fish,153895,20726,133169,2018_boxofficemojo_rankings.csv,2018,0.13467624029370676,0.8653237597062933
12720,The Revolution Will Not Be Televised,153859,153859,0,2003_boxofficemojo_rankings.csv,2003,1.0,0.0
12721,The Terrorist,153629,153629,0,2000_boxofficemojo_rankings.csv,2000,1.0,0.0
12722,Contempt 2008 Re-release,153619,153619,0,2008_boxofficemojo_rankings.csv,2008,1.0,0.0
12723,Love Story 50th Anniversary,153504,153504,0,2020_boxofficemojo_rankings.csv,2020,1.0,0.0
12724,Harmonium,153283,17191,136092,2017_boxofficemojo_rankings.csv,2017,0.11215203251502123,0.8878479674849787
12725,Brothers at War,153148,153148,0,2009_boxofficemojo_rankings.csv,2009,1.0,0.0
12726,The Mostly Unfabulous Social Life of Ethan Green,153122,153122,0,2006_boxofficemojo_rankings.csv,2006,1.0,0.0
12727,Backstreet Boys: Show 'Em What You're Made Of,153068,153068,0,2015_boxofficemojo_rankings.csv,2015,1.0,0.0
12728,Stalingrad,152972,152972,0,1995_boxofficemojo_rankings.csv,1995,1.0,0.0
12729,Quai des Orfèvres,152961,152961,0,2002_boxofficemojo_rankings.csv,2002,1.0,0.0
12730,In the Shadow of Women,152802,50291,102511,2015_boxofficemojo_rankings.csv,2015,0.329125273229408,0.670874726770592
12731,Deceptive Practice: The Mysteries and Mentors of Ricky Jay,152791,152791,0,2013_boxofficemojo_rankings.csv,2013,1.0,0.0
12732,Ladybird Ladybird,152457,152457,0,1994_boxofficemojo_rankings.csv,1994,1.0,0.0
12733,Finding Fela,152346,120980,31366,2014_boxofficemojo_rankings.csv,2014,0.7941133997610702,0.2058866002389298
12734,Pushing Hands,152322,152322,0,1995_boxofficemojo_rankings.csv,1995,1.0,0.0
12735,The Call Up,152294,0,152294,2016_boxofficemojo_rankings.csv,2016,0.0,1.0
12736,Snake & Mongoose,152200,152200,0,2013_boxofficemojo_rankings.csv,2013,1.0,0.0
12737,Irresistible,152192,0,152192,2020_boxofficemojo_rankings.csv,2020,0.0,1.0
12738,One Week and a Day,152178,41614,110564,2016_boxofficemojo_rankings.csv,2016,0.2734560843223068,0.7265439156776933
12739,"Buttons, A New Musical Film",151983,151983,0,2018_boxofficemojo_rankings.csv,2018,1.0,0.0
12740,Born to Be Blue,151926,151926,0,2016_boxofficemojo_rankings.csv,2016,1.0,0.0
12741,The Boys & Girl from County Clare,151869,142872,8997,2004_boxofficemojo_rankings.csv,2004,0.9407581534085298,0.05924184659147028
12742,Lupin the 3rd: Castle of Cagliostro 2017 Re-release,151802,142425,9377,2017_boxofficemojo_rankings.csv,2017,0.9382287453393235,0.06177125466067641
12743,ShowBusiness: The Road to Broadway,151792,151792,0,2007_boxofficemojo_rankings.csv,2007,1.0,0.0
12744,Go Tigers!,151779,151779,0,2001_boxofficemojo_rankings.csv,2001,1.0,0.0
12745,Dandelion,151755,0,151755,2005_boxofficemojo_rankings.csv,2005,0.0,1.0
12746,Generation Found,151751,151751,0,2016_boxofficemojo_rankings.csv,2016,1.0,0.0
12747,Garçon stupide,151702,151702,0,2005_boxofficemojo_rankings.csv,2005,1.0,0.0
12748,Red Riding: The Year of Our Lord 1974,151644,151644,0,2010_boxofficemojo_rankings.csv,2010,1.0,0.0
12749,Before You Know It,151507,151507,0,2019_boxofficemojo_rankings.csv,2019,1.0,0.0
12750,We Summon the Darkness,151479,60794,90685,2020_boxofficemojo_rankings.csv,2020,0.40133615880749146,0.5986638411925085
12751,Stuck,151449,67505,83944,2008_boxofficemojo_rankings.csv,2008,0.4457276046721999,0.5542723953278001
12752,Jay Myself,151331,151331,0,2019_boxofficemojo_rankings.csv,2019,1.0,0.0
12753,Revenge of the Electric Car,151272,150886,386,2011_boxofficemojo_rankings.csv,2011,0.9974483050399281,0.0025516949600719236
12754,The Cremaster Cycle 2010 Re-release,151239,151239,0,2010_boxofficemojo_rankings.csv,2010,1.0,0.0
12755,Vampire Hunter D: Bloodlust,151086,151086,0,2001_boxofficemojo_rankings.csv,2001,1.0,0.0
12756,Paperback Romance,151068,151068,0,1997_boxofficemojo_rankings.csv,1997,1.0,0.0
12757,All the Best: Fun Begins,150902,120713,30189,2009_boxofficemojo_rankings.csv,2009,0.7999430093703198,0.2000569906296802
12758,Glory 2019 Re-release,150801,150801,0,2019_boxofficemojo_rankings.csv,2019,1.0,0.0
12759,Tasting Menu,150718,18686,132032,2013_boxofficemojo_rankings.csv,2013,0.12397988296023037,0.8760201170397697
12760,Red King,150657,150657,0,1999_boxofficemojo_rankings.csv,1999,1.0,0.0
12761,My Brother,150487,65797,84690,2007_boxofficemojo_rankings.csv,2007,0.437227135898782,0.5627728641012181
12762,Stoked: The Rise and Fall of Gator,150268,150268,0,2003_boxofficemojo_rankings.csv,2003,1.0,0.0
12763,Kicks,150191,150191,0,2016_boxofficemojo_rankings.csv,2016,1.0,0.0
12764,Godzilla 2014 Re-release,150191,150191,0,2014_boxofficemojo_rankings.csv,2014,1.0,0.0
12765,Nobody Else But You,150173,43040,107133,2011_boxofficemojo_rankings.csv,2011,0.28660278478821094,0.7133972152117891
12766,Invincible,150143,81954,68189,2002_boxofficemojo_rankings.csv,2002,0.5458396328833179,0.4541603671166821
12767,Razorback,150140,150140,0,1984_boxofficemojo_rankings.csv,1984,1.0,0.0
12768,Only the Brave,150000,150000,0,2010_boxofficemojo_rankings.csv,2010,1.0,0.0
12769,Yellow Rose,150000,150000,0,2020_boxofficemojo_rankings.csv,2020,1.0,0.0
12770,The Day I Became a Woman,149971,149971,0,2001_boxofficemojo_rankings.csv,2001,1.0,0.0
12771,Becket,149327,149327,0,2007_boxofficemojo_rankings.csv,2007,1.0,0.0
12772,Piercing,149211,15856,133355,2019_boxofficemojo_rankings.csv,2019,0.10626562384810771,0.8937343761518923
12773,Michael Moore in TrumpLand,149090,149090,0,2016_boxofficemojo_rankings.csv,2016,1.0,0.0
12774,Gun Hill Road,148994,148994,0,2011_boxofficemojo_rankings.csv,2011,1.0,0.0
12775,Roosters,148919,148919,0,1995_boxofficemojo_rankings.csv,1995,1.0,0.0
12776,Agnes Browne,148853,148853,0,1999_boxofficemojo_rankings.csv,1999,1.0,0.0
12777,Heartbreakers,148750,148750,0,1984_boxofficemojo_rankings.csv,1984,1.0,0.0
12778,From Afar,148630,30169,118461,2016_boxofficemojo_rankings.csv,2016,0.2029805557424477,0.7970194442575523
12779,Trial by Fire,148504,148504,0,2019_boxofficemojo_rankings.csv,2019,1.0,0.0
12780,War and Peace,148503,148503,0,2019_boxofficemojo_rankings.csv,2019,1.0,0.0
12781,Bartleby,148479,148479,0,2002_boxofficemojo_rankings.csv,2002,1.0,0.0
12782,Tokyo Godfathers,148355,129560,18795,2003_boxofficemojo_rankings.csv,2003,0.8733106400188736,0.12668935998112635
12783,Jonestown: The Life and Death of Peoples Temple,148292,148292,0,2006_boxofficemojo_rankings.csv,2006,1.0,0.0
12784,Harry Potter and the Deathly Hallows: Part 1 2018 Re-release,148263,148263,0,2010_boxofficemojo_rankings.csv,2010,1.0,0.0
12785,Denise Calls Up,148121,148121,0,1996_boxofficemojo_rankings.csv,1996,1.0,0.0
12786,Girls Will Be Girls,148047,148047,0,2003_boxofficemojo_rankings.csv,2003,1.0,0.0
12787,Restless Creature: Wendy Whelan,147780,147780,0,2017_boxofficemojo_rankings.csv,2017,1.0,0.0
12788,The Proposition,147773,147773,0,1998_boxofficemojo_rankings.csv,1998,1.0,0.0
12789,Roadside Prophets,147724,147724,0,1992_boxofficemojo_rankings.csv,1992,1.0,0.0
12790,Under the Boardwalk,147542,147542,0,1989_boxofficemojo_rankings.csv,1989,1.0,0.0
12791,Night of the Living Dead 2018 Re-release,147423,147423,0,2018_boxofficemojo_rankings.csv,2018,1.0,0.0
12792,The Strange Case of Angelica,147173,50135,97038,2010_boxofficemojo_rankings.csv,2010,0.3406535166097042,0.6593464833902958
12793,Driven,147172,0,147172,2019_boxofficemojo_rankings.csv,2019,0.0,1.0
12794,La scorta,147107,147107,0,1994_boxofficemojo_rankings.csv,1994,1.0,0.0
12795,The Doctor and the Devils,147070,147070,0,1985_boxofficemojo_rankings.csv,1985,1.0,0.0
12796,Songs My Brothers Taught Me,146937,34793,112144,2015_boxofficemojo_rankings.csv,2015,0.23678855563949175,0.7632114443605083
12797,Postal,146741,0,146741,2007_boxofficemojo_rankings.csv,2007,0.0,1.0
12798,Ayurveda: Art of Being,146713,32267,114446,2001_boxofficemojo_rankings.csv,2001,0.21993279395827228,0.7800672060417277
12799,American Promise,146702,146702,0,2013_boxofficemojo_rankings.csv,2013,1.0,0.0
12800,Watermark,146572,84464,62108,2014_boxofficemojo_rankings.csv,2014,0.576262860573643,0.423737139426357
12801,Dirty Deeds,146490,146490,0,2005_boxofficemojo_rankings.csv,2005,1.0,0.0
12802,Touched with Fire,146487,146487,0,2016_boxofficemojo_rankings.csv,2016,1.0,0.0
12803,5 Broken Cameras,146475,109983,36492,2012_boxofficemojo_rankings.csv,2012,0.7508653353814644,0.2491346646185356
12804,Biggie and Tupac,146419,94874,51545,2002_boxofficemojo_rankings.csv,2002,0.6479623546124479,0.35203764538755217
12805,Hannah,146325,11700,134625,2018_boxofficemojo_rankings.csv,2018,0.07995899538698104,0.920041004613019
12806,Starlet,146222,88212,58010,2012_boxofficemojo_rankings.csv,2012,0.6032744730615092,0.3967255269384908
12807,Company Man,146193,146193,0,2001_boxofficemojo_rankings.csv,2001,1.0,0.0
12808,Stop Making Sense 1999 Re-release,146154,146154,0,1999_boxofficemojo_rankings.csv,1999,1.0,0.0
12809,Deadly Renovations,146146,146146,0,2012_boxofficemojo_rankings.csv,2012,1.0,0.0
12810,Six-String Samurai,146125,146125,0,1998_boxofficemojo_rankings.csv,1998,1.0,0.0
12811,The Visitors II: The Corridors of Time,146072,146072,0,1998_boxofficemojo_rankings.csv,1998,1.0,0.0
12812,The Punk Singer,146000,122742,23258,2013_boxofficemojo_rankings.csv,2013,0.8406986301369863,0.1593013698630137
12813,Citizen K,145941,120411,25530,2019_boxofficemojo_rankings.csv,2019,0.8250662939132938,0.17493370608670628
12814,Framing John DeLorean,145625,145625,0,2019_boxofficemojo_rankings.csv,2019,1.0,0.0
12815,Daytime Drinking,145587,4970,140617,2009_boxofficemojo_rankings.csv,2009,0.03413766339027523,0.9658623366097248
12816,The Last Dalai Lama?,145524,145524,0,2017_boxofficemojo_rankings.csv,2017,1.0,0.0
12817,A Soap,145135,4164,140971,2006_boxofficemojo_rankings.csv,2006,0.028690529507010714,0.9713094704929893
12818,Deterrence,145071,145071,0,2000_boxofficemojo_rankings.csv,2000,1.0,0.0
12819,Krisha,144822,144822,0,2016_boxofficemojo_rankings.csv,2016,1.0,0.0
12820,Mr. Smith Goes to Washington 2018 Re-release,144738,144738,0,2018_boxofficemojo_rankings.csv,2018,1.0,0.0
12821,Sky Kids,144680,144680,0,2008_boxofficemojo_rankings.csv,2008,1.0,0.0
12822,Wendy,144564,143518,1046,2020_boxofficemojo_rankings.csv,2020,0.992764450347251,0.0072355496527489556
12823,Irving Berlin's Holiday Inn The Broadway Musical,144550,144550,0,2017_boxofficemojo_rankings.csv,2017,1.0,0.0
12824,Last Year at Marienbad,144492,144492,0,2008_boxofficemojo_rankings.csv,2008,1.0,0.0
12825,The Kingdom,144487,83381,61106,1994_boxofficemojo_rankings.csv,1994,0.577083059375584,0.42291694062441604
12826,The Price of Everything,144446,87400,57046,2018_boxofficemojo_rankings.csv,2018,0.6050704069340792,0.39492959306592085
12827,Yellow Day 2015 Re-release,144163,144163,0,2015_boxofficemojo_rankings.csv,2015,1.0,0.0
12828,From Beneath,144123,144123,0,2012_boxofficemojo_rankings.csv,2012,1.0,0.0
12829,Cold Weather,144056,141358,2698,2011_boxofficemojo_rankings.csv,2011,0.9812711723218748,0.018728827678125174
12830,Dahmer,144008,144008,0,2002_boxofficemojo_rankings.csv,2002,1.0,0.0
12831,Thunder Soul,143986,143986,0,2011_boxofficemojo_rankings.csv,2011,1.0,0.0
12832,Cop Car,143658,134552,9106,2015_boxofficemojo_rankings.csv,2015,0.9366133455846525,0.06338665441534756
12833,Undertow,143597,143597,0,2004_boxofficemojo_rankings.csv,2004,1.0,0.0
12834,Dirty Girl,143485,55125,88360,2011_boxofficemojo_rankings.csv,2011,0.38418650033104507,0.6158134996689549
12835,10th & Wolf,143451,54702,88749,2006_boxofficemojo_rankings.csv,2006,0.38132881611142483,0.6186711838885752
12836,The Escape Artist,143369,143369,0,1982_boxofficemojo_rankings.csv,1982,1.0,0.0
12837,X,143355,143355,0,2000_boxofficemojo_rankings.csv,2000,1.0,0.0
12838,Doctor Who: Logopolis,143248,143248,0,2019_boxofficemojo_rankings.csv,2019,1.0,0.0
12839,Alpeis,143234,16057,127177,2012_boxofficemojo_rankings.csv,2012,0.1121032715695994,0.8878967284304006
12840,Survival of the Dead,143191,101740,41451,2010_boxofficemojo_rankings.csv,2010,0.7105195158913619,0.28948048410863814
12841,Kids for Cash,143178,143178,0,2014_boxofficemojo_rankings.csv,2014,1.0,0.0
12842,The Lost Skeleton of Cadavra,143121,143121,0,2004_boxofficemojo_rankings.csv,2004,1.0,0.0
12843,Clash,143121,18215,124906,2016_boxofficemojo_rankings.csv,2016,0.12726993243479293,0.8727300675652071
12844,Disguising,143108,0,143108,2018_boxofficemojo_rankings.csv,2018,0.0,1.0
12845,Summer Palace,143027,63045,79982,2007_boxofficemojo_rankings.csv,2007,0.4407908996203514,0.5592091003796485
12846,Shelter,142666,142666,0,2008_boxofficemojo_rankings.csv,2008,1.0,0.0
12847,Flow: For Love of Water,142569,142569,0,2008_boxofficemojo_rankings.csv,2008,1.0,0.0
12848,Waco: The Rules of Engagement,142193,142193,0,1997_boxofficemojo_rankings.csv,1997,1.0,0.0
12849,Not Forgotten,142055,53744,88311,2009_boxofficemojo_rankings.csv,2009,0.3783323360670163,0.6216676639329837
12850,Dragon 2012 Re-release,142029,11137,130892,2012_boxofficemojo_rankings.csv,2012,0.0784135634271874,0.9215864365728126
12851,John Dies at the End,141951,141951,0,2013_boxofficemojo_rankings.csv,2013,1.0,0.0
12852,Citadel,141886,13377,128509,2012_boxofficemojo_rankings.csv,2012,0.09427991486122662,0.9057200851387733
12853,Texas Chainsaw Massacre: The Next Generation 1997 Re-release,141626,141626,0,1997_boxofficemojo_rankings.csv,1997,1.0,0.0
12854,In Between Days,141616,23465,118151,2006_boxofficemojo_rankings.csv,2006,0.16569455428765112,0.8343054457123489
12855,May in the Summer,141605,22004,119601,2014_boxofficemojo_rankings.csv,2014,0.15538999329119735,0.8446100067088027
12856,Simple Men,141554,141554,0,1992_boxofficemojo_rankings.csv,1992,1.0,0.0
12857,Silsila Hai Pyar Ka,141528,141528,0,1999_boxofficemojo_rankings.csv,1999,1.0,0.0
12858,Best F(r)iends Volume Two,141524,141524,0,2018_boxofficemojo_rankings.csv,2018,1.0,0.0
12859,Music from the Inside Out,141504,141504,0,2005_boxofficemojo_rankings.csv,2005,1.0,0.0
12860,The Silencing,141479,100746,40733,2020_boxofficemojo_rankings.csv,2020,0.7120915471554082,0.28790845284459177
12861,Witness in the War Zone,141211,141211,0,1987_boxofficemojo_rankings.csv,1987,1.0,0.0
12862,Branagh Theatre Live: The Winter's Tale,141143,141143,0,2019_boxofficemojo_rankings.csv,2019,1.0,0.0
12863,Zu Warriors,141084,0,141084,2003_boxofficemojo_rankings.csv,2003,0.0,1.0
12864,Let's Get Harry,140980,140980,0,1986_boxofficemojo_rankings.csv,1986,1.0,0.0
12865,Metropolis Giorgio Moroder Presents,140907,27362,113545,2011_boxofficemojo_rankings.csv,2011,0.19418481693599324,0.8058151830640068
12866,Canelo vs. Kovalev,140820,140820,0,2019_boxofficemojo_rankings.csv,2019,1.0,0.0
12867,Opal Dream,140666,14443,126223,2006_boxofficemojo_rankings.csv,2006,0.10267584206560221,0.8973241579343978
12868,The Cordillera of Dreams,140465,20943,119522,2019_boxofficemojo_rankings.csv,2019,0.14909763998149006,0.8509023600185099
12869,Incitement,140306,140306,0,2020_boxofficemojo_rankings.csv,2020,1.0,0.0
12870,Under the Skin,140254,140254,0,1998_boxofficemojo_rankings.csv,1998,1.0,0.0
12871,Gore Vidal: The United States of Amnesia,140164,140164,0,2014_boxofficemojo_rankings.csv,2014,1.0,0.0
12872,Beautiful Boy,140123,77247,62876,2011_boxofficemojo_rankings.csv,2011,0.5512799469037917,0.4487200530962083
12873,Baghead,140106,140106,0,2008_boxofficemojo_rankings.csv,2008,1.0,0.0
12874,The Weathered Underground,140091,140091,0,2010_boxofficemojo_rankings.csv,2010,1.0,0.0
12875,Liv & Ingmar,140041,10347,129694,2012_boxofficemojo_rankings.csv,2012,0.07388550495926192,0.9261144950407381
12876,Troublesome Creek: A Midwestern,140000,140000,0,1997_boxofficemojo_rankings.csv,1997,1.0,0.0
12877,The Wizard of Oz 2002 Re-release,139905,139905,0,2002_boxofficemojo_rankings.csv,2002,1.0,0.0
12878,Hanna's War,139796,139796,0,1988_boxofficemojo_rankings.csv,1988,1.0,0.0
12879,Coherence,139745,102617,37128,2014_boxofficemojo_rankings.csv,2014,0.7343160757093277,0.2656839242906723
12880,Tigerland,139692,139692,0,2000_boxofficemojo_rankings.csv,2000,1.0,0.0
12881,Hunky Dory,139653,20296,119357,2012_boxofficemojo_rankings.csv,2012,0.14533164343050275,0.8546683565694972
12882,Support the Girls,139550,129124,10426,2018_boxofficemojo_rankings.csv,2018,0.9252884270870656,0.07471157291293443
12883,Flowers,139421,61568,77853,2014_boxofficemojo_rankings.csv,2014,0.44159775069752766,0.5584022493024724
12884,Wilder vs. Ortiz,139207,139207,0,2019_boxofficemojo_rankings.csv,2019,1.0,0.0
12885,Rock on 2,139173,98868,40305,2016_boxofficemojo_rankings.csv,2016,0.710396413097368,0.289603586902632
12886,Men of Respect,139155,139155,0,1991_boxofficemojo_rankings.csv,1991,1.0,0.0
12887,Kamikaze Girls 2005 Re-release,139139,34424,104715,2005_boxofficemojo_rankings.csv,2005,0.24740726899000282,0.7525927310099972
12888,The Salon,139084,139084,0,2007_boxofficemojo_rankings.csv,2007,1.0,0.0
12889,The Polar Express 2014 IMAX Release,139055,139055,0,2014_boxofficemojo_rankings.csv,2014,1.0,0.0
12890,Grease,138981,102000,36981,2014_boxofficemojo_rankings.csv,2014,0.7339132687201848,0.26608673127981525
12891,What the Bleep!?: Down the Rabbit Hole,138913,138913,0,2006_boxofficemojo_rankings.csv,2006,1.0,0.0
12892,Who Will Write Our History,138868,138039,829,2019_boxofficemojo_rankings.csv,2019,0.9940303021574445,0.0059696978425555205
12893,Head Full of Honey,138844,12350,126494,2018_boxofficemojo_rankings.csv,2018,0.0889487482354297,0.9110512517645704
12894,The List,138814,138814,0,2007_boxofficemojo_rankings.csv,2007,1.0,0.0
12895,Good Ol' Freda,138811,138811,0,2013_boxofficemojo_rankings.csv,2013,1.0,0.0
12896,Lies and Alibis,138704,0,138704,2006_boxofficemojo_rankings.csv,2006,0.0,1.0
12897,Zero Motivation,138609,116044,22565,2014_boxofficemojo_rankings.csv,2014,0.8372039333665202,0.16279606663347979
12898,Intervista,138608,138608,0,1992_boxofficemojo_rankings.csv,1992,1.0,0.0
12899,The Brawler,138515,75929,62586,2018_boxofficemojo_rankings.csv,2018,0.548164458722882,0.451835541277118
12900,Beauty and the Beast 2002 Re-release,138503,138503,0,2002_boxofficemojo_rankings.csv,2002,1.0,0.0
12901,Fear and Trembling 2004 Re-release,138436,126684,11752,2004_boxofficemojo_rankings.csv,2004,0.915108786731775,0.08489121326822503
12902,Histoires d'hiver,138411,138411,0,1999_boxofficemojo_rankings.csv,1999,1.0,0.0
12903,Psycho-Pass: The Movie,138366,138366,0,2016_boxofficemojo_rankings.csv,2016,1.0,0.0
12904,Brooklyn Lobster,138267,138267,0,2005_boxofficemojo_rankings.csv,2005,1.0,0.0
12905,Most Wanted,138000,138000,0,2020_boxofficemojo_rankings.csv,2020,1.0,0.0
12906,War Dance,137977,115210,22767,2007_boxofficemojo_rankings.csv,2007,0.8349942381701299,0.1650057618298702
12907,Lynryd Skynyrd: Last of the Street Survivors Farewell Tour,137888,137888,0,2019_boxofficemojo_rankings.csv,2019,1.0,0.0
12908,Love Ranch,137885,137885,0,2010_boxofficemojo_rankings.csv,2010,1.0,0.0
12909,Super Sucker,137628,137628,0,2003_boxofficemojo_rankings.csv,2003,1.0,0.0
12910,The Hottest State,137341,31216,106125,2007_boxofficemojo_rankings.csv,2007,0.22728828245025157,0.7727117175497484
12911,Time of Favor,137340,137340,0,2002_boxofficemojo_rankings.csv,2002,1.0,0.0
12912,Beneath Us,137260,137260,0,2020_boxofficemojo_rankings.csv,2020,1.0,0.0
12913,Endurance,137124,137124,0,1999_boxofficemojo_rankings.csv,1999,1.0,0.0
12914,Is the Man Who Is Tall Happy?,137042,137042,0,2013_boxofficemojo_rankings.csv,2013,1.0,0.0
12915,Slaughter Creek,136815,136815,0,2012_boxofficemojo_rankings.csv,2012,1.0,0.0
12916,Road,136700,136700,0,2002_boxofficemojo_rankings.csv,2002,1.0,0.0
12917,The in Crowd,136567,136567,0,1988_boxofficemojo_rankings.csv,1988,1.0,0.0
12918,Stewardess School,136158,136158,0,1986_boxofficemojo_rankings.csv,1986,1.0,0.0
12919,Bedrooms and Hallways,136049,136049,0,1999_boxofficemojo_rankings.csv,1999,1.0,0.0
12920,Close My Eyes,135893,135893,0,1991_boxofficemojo_rankings.csv,1991,1.0,0.0
12921,Swiri,135892,98452,37440,2001_boxofficemojo_rankings.csv,2001,0.7244870926912548,0.27551290730874517
12922,Made in Abyss: Journey's Dawn,135821,134047,1774,2019_boxofficemojo_rankings.csv,2019,0.9869386913658418,0.013061308634158194
12923,I Will Follow,135809,135809,0,2011_boxofficemojo_rankings.csv,2011,1.0,0.0
12924,Mantra: Sounds Into Silence,135684,115013,20671,2018_boxofficemojo_rankings.csv,2018,0.8476533710680699,0.15234662893193007
12925,Sonchiriya,135413,86765,48648,2019_boxofficemojo_rankings.csv,2019,0.6407435032087022,0.35925649679129773
12926,La Sapienza,135392,135392,0,2015_boxofficemojo_rankings.csv,2015,1.0,0.0
12927,The Kind Words,135382,135382,0,2016_boxofficemojo_rankings.csv,2016,1.0,0.0
12928,The Ninth Day,135311,72888,62423,2005_boxofficemojo_rankings.csv,2005,0.5386701746347303,0.4613298253652696
12929,The Cherry Orchard,135280,135280,0,2002_boxofficemojo_rankings.csv,2002,1.0,0.0
12930,The Other Dream Team,135228,135228,0,2012_boxofficemojo_rankings.csv,2012,1.0,0.0
12931,The Other Story,135191,135191,0,2019_boxofficemojo_rankings.csv,2019,1.0,0.0
12932,The Bolshoi Ballet: Live From Moscow - A Hero of Our Time,135168,104837,30331,2017_boxofficemojo_rankings.csv,2017,0.7756051728219697,0.2243948271780303
12933,No Place to Hide,135004,135004,0,1993_boxofficemojo_rankings.csv,1993,1.0,0.0
12934,My Neighbor Totoro 2015 Re-release,134877,0,134877,2015_boxofficemojo_rankings.csv,2015,0.0,1.0
12935,Another Day of Life,134801,3190,131611,2018_boxofficemojo_rankings.csv,2018,0.023664512874533573,0.9763354871254665
12936,Led Zeppelin: Celebration Day,134753,0,134753,2012_boxofficemojo_rankings.csv,2012,0.0,1.0
12937,Concert for George,134600,134600,0,2003_boxofficemojo_rankings.csv,2003,1.0,0.0
12938,Attenberg,134503,24036,110467,2010_boxofficemojo_rankings.csv,2010,0.17870233377694178,0.8212976662230582
12939,The Devil Came on Horseback,134495,132782,1713,2007_boxofficemojo_rankings.csv,2007,0.9872634670433845,0.012736532956615488
12940,A Perfect Candidate,134485,134485,0,1996_boxofficemojo_rankings.csv,1996,1.0,0.0
12941,The Saint of Fort Washington,134454,134454,0,1993_boxofficemojo_rankings.csv,1993,1.0,0.0
12942,The Times of Bill Cunningham,134288,134288,0,2020_boxofficemojo_rankings.csv,2020,1.0,0.0
12943,Ism,134165,134165,0,2016_boxofficemojo_rankings.csv,2016,1.0,0.0
12944,Redwood Highway,134049,134049,0,2014_boxofficemojo_rankings.csv,2014,1.0,0.0
12945,Lunacy,133982,48324,85658,2005_boxofficemojo_rankings.csv,2005,0.36067531459449775,0.6393246854055022
12946,The Great Museum,133905,18020,115885,2014_boxofficemojo_rankings.csv,2014,0.13457301818453382,0.8654269818154662
12947,Pure Country 2: The Gift,133771,133771,0,2010_boxofficemojo_rankings.csv,2010,1.0,0.0
12948,Liebestraum,133645,133645,0,1991_boxofficemojo_rankings.csv,1991,1.0,0.0
12949,Don't Think I've Forgotten: Cambodia's Lost Rock and Roll,133443,133443,0,2015_boxofficemojo_rankings.csv,2015,1.0,0.0
12950,Under the Shadow,133324,31900,101424,2016_boxofficemojo_rankings.csv,2016,0.23926674867240708,0.760733251327593
12951,The Jewish Cardinal,133232,133232,0,2014_boxofficemojo_rankings.csv,2014,1.0,0.0
12952,A Shot at Glory,133122,133122,0,2002_boxofficemojo_rankings.csv,2002,1.0,0.0
12953,"Hare Krishna! The Mantra, the Movement and the Swami Who Started It",133006,133006,0,2017_boxofficemojo_rankings.csv,2017,1.0,0.0
12954,Crying Ladies,132920,132920,0,2004_boxofficemojo_rankings.csv,2004,1.0,0.0
12955,Tonight You're Mine,132787,6255,126532,2011_boxofficemojo_rankings.csv,2011,0.04710551484708594,0.9528944851529141
12956,Hukkle,132745,53715,79030,2003_boxofficemojo_rankings.csv,2003,0.40464800934121814,0.5953519906587819
12957,Stolen,132596,132596,0,2006_boxofficemojo_rankings.csv,2006,1.0,0.0
12958,Harry Potter and the Order of the Phoenix 2018 Re-release,132522,132522,0,2007_boxofficemojo_rankings.csv,2007,1.0,0.0
12959,1+1=11,132498,132498,0,2003_boxofficemojo_rankings.csv,2003,1.0,0.0
12960,Dawson City: Frozen Time,132369,132369,0,2016_boxofficemojo_rankings.csv,2016,1.0,0.0
12961,Sonny,132221,30005,102216,2002_boxofficemojo_rankings.csv,2002,0.22693066910702536,0.7730693308929747
12962,Kumaré,132160,132160,0,2012_boxofficemojo_rankings.csv,2012,1.0,0.0
12963,My Brother the Devil,132056,44906,87150,2012_boxofficemojo_rankings.csv,2012,0.34005270491306716,0.6599472950869328
12964,How to Survive a Plague,132055,132055,0,2012_boxofficemojo_rankings.csv,2012,1.0,0.0
12965,A Ballerina's Tale,131995,131995,0,2015_boxofficemojo_rankings.csv,2015,1.0,0.0
12966,Mugamoodi,131965,101000,30965,2012_boxofficemojo_rankings.csv,2012,0.7653544500435722,0.23464554995642783
12967,Hounddog,131961,131961,0,2008_boxofficemojo_rankings.csv,2008,1.0,0.0
12968,Touchez Pas au Grisbi,131548,131548,0,2003_boxofficemojo_rankings.csv,2003,1.0,0.0
12969,Ballerina,131460,114507,16953,2008_boxofficemojo_rankings.csv,2008,0.8710406207211319,0.1289593792788681
12970,Robot Stories,131451,131451,0,2004_boxofficemojo_rankings.csv,2004,1.0,0.0
12971,Proud American,131357,131357,0,2008_boxofficemojo_rankings.csv,2008,1.0,0.0
12972,Unknown White Male,131256,126836,4420,2006_boxofficemojo_rankings.csv,2006,0.9663253489364295,0.03367465106357043
12973,28 Hotel Rooms,131208,18869,112339,2012_boxofficemojo_rankings.csv,2012,0.1438098286689836,0.8561901713310164
12974,Rudy 2018 Re-release,131200,131200,0,2018_boxofficemojo_rankings.csv,2018,1.0,0.0
12975,Son frère,131195,22834,108361,2003_boxofficemojo_rankings.csv,2003,0.1740462670071268,0.8259537329928732
12976,The Wind,130974,28252,102722,2019_boxofficemojo_rankings.csv,2019,0.21570693420068104,0.7842930657993189
12977,Mister America,130897,130897,0,2019_boxofficemojo_rankings.csv,2019,1.0,0.0
12978,The Nines,130880,63165,67715,2007_boxofficemojo_rankings.csv,2007,0.4826176650366748,0.5173823349633252
12979,The Image Book,130802,94153,36649,2018_boxofficemojo_rankings.csv,2018,0.7198131527040871,0.2801868472959129
12980,Matroni et moi,130572,130572,0,1999_boxofficemojo_rankings.csv,1999,1.0,0.0
12981,The Earrings of Madame De...,130561,130561,0,2007_boxofficemojo_rankings.csv,2007,1.0,0.0
12982,Until the Light Takes Us,130441,130441,0,2009_boxofficemojo_rankings.csv,2009,1.0,0.0
12983,Karla,130416,0,130416,2006_boxofficemojo_rankings.csv,2006,0.0,1.0
12984,October,130335,32127,98208,2010_boxofficemojo_rankings.csv,2010,0.24649556911036943,0.7535044308896306
12985,Five Seasons: The Gardens of Piet Oudolf,130319,119223,11096,2018_boxofficemojo_rankings.csv,2018,0.9148550863649967,0.08514491363500334
12986,Requiem for the American Dream,130152,130152,0,2016_boxofficemojo_rankings.csv,2016,1.0,0.0
12987,4 Little Girls,130146,130146,0,1997_boxofficemojo_rankings.csv,1997,1.0,0.0
12988,Harry Potter and the Half-Blood Prince 2018 Re-release,130081,130081,0,2018_boxofficemojo_rankings.csv,2018,1.0,0.0
12989,Be Here to Love Me: A Film About Townes Van Zandt,129988,129988,0,2005_boxofficemojo_rankings.csv,2005,1.0,0.0
12990,Section 375,129916,0,129916,2019_boxofficemojo_rankings.csv,2019,0.0,1.0
12991,The Fairy,129818,38399,91419,2011_boxofficemojo_rankings.csv,2011,0.2957910305196506,0.7042089694803494
12992,Martians Go Home,129778,129778,0,1990_boxofficemojo_rankings.csv,1990,1.0,0.0
12993,Great Performances at the Met: Puccini: Madama Butterfly,129730,129730,0,2018_boxofficemojo_rankings.csv,2018,1.0,0.0
12994,Game 6,129664,129664,0,2006_boxofficemojo_rankings.csv,2006,1.0,0.0
12995,Great Performances at the Met: Tchaikovsky: Eugene Onegin 2018 Re-release,129498,129498,0,2018_boxofficemojo_rankings.csv,2018,1.0,0.0
12996,Great Performances at the Met: Verdi: Il Trovatore,129393,129393,0,2018_boxofficemojo_rankings.csv,2018,1.0,0.0
12997,Whatever the Heart Says,129319,129319,0,2005_boxofficemojo_rankings.csv,2005,1.0,0.0
12998,Crackers,129268,129268,0,1984_boxofficemojo_rankings.csv,1984,1.0,0.0
12999,Maryam,129265,129265,0,2002_boxofficemojo_rankings.csv,2002,1.0,0.0
13000,Repo Man,129000,129000,0,1984_boxofficemojo_rankings.csv,1984,1.0,0.0
13001,I Called Him Morgan,128986,128986,0,2017_boxofficemojo_rankings.csv,2017,1.0,0.0
13002,The Golden Era 2014 Re-release,128926,102931,25995,2014_boxofficemojo_rankings.csv,2014,0.7983727099266246,0.20162729007337543
13003,Yossi,128668,117047,11621,2012_boxofficemojo_rankings.csv,2012,0.9096822830851494,0.09031771691485062
13004,Love After Love,128602,121098,7504,2018_boxofficemojo_rankings.csv,2018,0.9416494300244164,0.058350569975583584
13005,The Adventurer: The Curse of the Midas Box,128471,6399,122072,2014_boxofficemojo_rankings.csv,2014,0.04980890629013552,0.9501910937098644
13006,Where Hands Touch,128269,67743,60526,2018_boxofficemojo_rankings.csv,2018,0.5281322844958641,0.47186771550413587
13007,Stonewall Uprising,128203,128203,0,2010_boxofficemojo_rankings.csv,2010,1.0,0.0
13008,Love Comes Lately,127958,78079,49879,2008_boxofficemojo_rankings.csv,2008,0.6101924068835086,0.3898075931164913
13009,Twin Town,127923,127923,0,1997_boxofficemojo_rankings.csv,1997,1.0,0.0
13010,Computer Chess,127852,102041,25811,2013_boxofficemojo_rankings.csv,2013,0.7981181365954385,0.20188186340456152
13011,Steve Jobs: The Lost Interview,127541,105710,21831,2011_boxofficemojo_rankings.csv,2011,0.8288315130036615,0.17116848699633844
13012,American Chai,127518,127518,0,2002_boxofficemojo_rankings.csv,2002,1.0,0.0
13013,Petit Con,127426,127426,0,1985_boxofficemojo_rankings.csv,1985,1.0,0.0
13014,The Wendell Baker Story 2007 Re-release,127414,127414,0,2007_boxofficemojo_rankings.csv,2007,1.0,0.0
13015,Benda Bilili!,127362,13420,113942,2010_boxofficemojo_rankings.csv,2010,0.10536894835194172,0.8946310516480583
13016,Sleepless in Seattle 2018 Re-release,127281,127281,0,2018_boxofficemojo_rankings.csv,2018,1.0,0.0
13017,A Band Called Death,127257,127257,0,2013_boxofficemojo_rankings.csv,2013,1.0,0.0
13018,Friends and Family,127212,127212,0,2003_boxofficemojo_rankings.csv,2003,1.0,0.0
13019,Burma VJ: Reporting from a Closed Country,127063,51672,75391,2009_boxofficemojo_rankings.csv,2009,0.40666441056798597,0.593335589432014
13020,O Fantasma,126783,126783,0,2002_boxofficemojo_rankings.csv,2002,1.0,0.0
13021,Chimes at Midnight,126724,126724,0,2016_boxofficemojo_rankings.csv,2016,1.0,0.0
13022,Silent Night,126594,14567,112027,2012_boxofficemojo_rankings.csv,2012,0.11506864464350601,0.884931355356494
13023,Police Academy: Mission to Moscow,126247,126247,0,1994_boxofficemojo_rankings.csv,1994,1.0,0.0
13024,Escape Fire: The Fight to Rescue American Healthcare,126238,126238,0,2012_boxofficemojo_rankings.csv,2012,1.0,0.0
13025,The Arbor,126182,21620,104562,2010_boxofficemojo_rankings.csv,2010,0.17133981074955223,0.8286601892504478
13026,Baran,125900,125900,0,2001_boxofficemojo_rankings.csv,2001,1.0,0.0
13027,The Great Buster,125807,118344,7463,2018_boxofficemojo_rankings.csv,2018,0.9406789765275382,0.059321023472461785
13028,Europa Report,125687,125687,0,2013_boxofficemojo_rankings.csv,2013,1.0,0.0
13029,Rosie,125679,6839,118840,2019_boxofficemojo_rankings.csv,2019,0.05441641006055108,0.9455835899394489
13030,Paris Is Burning 2019 Re-release,125677,125677,0,2019_boxofficemojo_rankings.csv,2019,1.0,0.0
13031,Only,125603,0,125603,2020_boxofficemojo_rankings.csv,2020,0.0,1.0
13032,Green Card Fever,125596,125596,0,2003_boxofficemojo_rankings.csv,2003,1.0,0.0
13033,Gaby: A True Story,125400,125400,0,1987_boxofficemojo_rankings.csv,1987,1.0,0.0
13034,The Night Flier,125397,125397,0,1998_boxofficemojo_rankings.csv,1998,1.0,0.0
13035,This Changes Everything,125348,64988,60360,2019_boxofficemojo_rankings.csv,2019,0.5184606056738041,0.48153939432619586
13036,The B-Side: Elsa Dorfman's Portrait Photography,125227,125227,0,2017_boxofficemojo_rankings.csv,2017,1.0,0.0
13037,Manda Bala (Send a Bullet),125025,122905,2120,2007_boxofficemojo_rankings.csv,2007,0.9830433913217357,0.016956608678264345
13038,Spinning Plates,124856,112449,12407,2013_boxofficemojo_rankings.csv,2013,0.9006295252130454,0.09937047478695457
13039,Mary Magdalene 2019 Re-release,124741,124741,0,2019_boxofficemojo_rankings.csv,2019,1.0,0.0
13040,Every Secret Thing,124733,103536,21197,2015_boxofficemojo_rankings.csv,2015,0.8300610103180394,0.16993898968196067
13041,Hymn: Sarah Brightman in Concert,124707,113274,11433,2018_boxofficemojo_rankings.csv,2018,0.9083211046693449,0.09167889533065506
13042,Oleanna,124693,124693,0,1994_boxofficemojo_rankings.csv,1994,1.0,0.0
13043,Ran 2010 Re-release,124673,124673,0,2010_boxofficemojo_rankings.csv,2010,1.0,0.0
13044,A Tuba to Cuba,124592,121772,2820,2019_boxofficemojo_rankings.csv,2019,0.9773661230255554,0.022633876974444588
13045,'85: The Greatest Team in Football History,124573,124573,0,2018_boxofficemojo_rankings.csv,2018,1.0,0.0
13046,Final: The Rapture,124561,124561,0,2013_boxofficemojo_rankings.csv,2013,1.0,0.0
13047,Vidal Sassoon: The Movie,124532,85974,38558,2011_boxofficemojo_rankings.csv,2011,0.6903767706292359,0.30962322937076414
13048,Singin' in the Rain 2002 Re-release,124382,120420,3962,2002_boxofficemojo_rankings.csv,2002,0.9681465163769677,0.031853483623032273
13049,Shirley,124318,0,124318,2020_boxofficemojo_rankings.csv,2020,0.0,1.0
13050,The First Saturday in May,124294,124294,0,2008_boxofficemojo_rankings.csv,2008,1.0,0.0
13051,Post Tenebras Lux,124279,39185,85094,2012_boxofficemojo_rankings.csv,2012,0.31529864257034573,0.6847013574296542
13052,The Square,124244,124244,0,2013_boxofficemojo_rankings.csv,2013,1.0,0.0
13053,"Rita, Sue and Bob Too",124167,124167,0,1987_boxofficemojo_rankings.csv,1987,1.0,0.0
13054,Treeless Mountain,124023,60336,63687,2009_boxofficemojo_rankings.csv,2009,0.48649040903703344,0.5135095909629666
13055,Marguerite & Julien,123918,0,123918,2015_boxofficemojo_rankings.csv,2015,0.0,1.0
13056,Knights of Badassdom,123854,123854,0,2014_boxofficemojo_rankings.csv,2014,1.0,0.0
13057,The Beyond,123843,123843,0,1998_boxofficemojo_rankings.csv,1998,1.0,0.0
13058,Wings of Desire 2018 Re-release,123830,123830,0,2018_boxofficemojo_rankings.csv,2018,1.0,0.0
13059,The Magic of Belle Isle,123821,102388,21433,2012_boxofficemojo_rankings.csv,2012,0.8269033524200257,0.1730966475799743
13060,Were the World Mine,123789,123789,0,2008_boxofficemojo_rankings.csv,2008,1.0,0.0
13061,Haseena Maan Jaayegi,123719,123719,0,1999_boxofficemojo_rankings.csv,1999,1.0,0.0
13062,Puncture,123700,68945,54755,2011_boxofficemojo_rankings.csv,2011,0.5573565076798707,0.44264349232012934
13063,Appropriate Behavior,123699,46912,76787,2015_boxofficemojo_rankings.csv,2015,0.37924316283882653,0.6207568371611735
13064,"War Eagle, Arkansas",123670,123670,0,2009_boxofficemojo_rankings.csv,2009,1.0,0.0
13065,Eureka,123572,123572,0,1984_boxofficemojo_rankings.csv,1984,1.0,0.0
13066,There Goes My Baby,123509,123509,0,1994_boxofficemojo_rankings.csv,1994,1.0,0.0
13067,Sigur Rós: Inni,123482,123482,0,2011_boxofficemojo_rankings.csv,2011,1.0,0.0
13068,Open Doors,123470,123470,0,1991_boxofficemojo_rankings.csv,1991,1.0,0.0
13069,Downtown 81 2019 Re-release,123387,123387,0,2019_boxofficemojo_rankings.csv,2019,1.0,0.0
13070,Momma's Man,123385,100435,22950,2008_boxofficemojo_rankings.csv,2008,0.8139968391619727,0.18600316083802731
13071,Roseanna's Grave,123330,123330,0,1997_boxofficemojo_rankings.csv,1997,1.0,0.0
13072,Flannel Pajamas,123301,123301,0,2006_boxofficemojo_rankings.csv,2006,1.0,0.0
13073,Easy Rider 2019 Re-release,123276,123276,0,2019_boxofficemojo_rankings.csv,2019,1.0,0.0
13074,Sour Grapes,123104,123104,0,1998_boxofficemojo_rankings.csv,1998,1.0,0.0
13075,The Last Mountain,122961,122961,0,2011_boxofficemojo_rankings.csv,2011,1.0,0.0
13076,Ashby,122919,4631,118288,2015_boxofficemojo_rankings.csv,2015,0.03767521701282959,0.9623247829871704
13077,Secret Ballot,122875,114909,7966,2002_boxofficemojo_rankings.csv,2002,0.9351698880976602,0.06483011190233978
13078,Blood Fest,122833,82774,40059,2018_boxofficemojo_rankings.csv,2018,0.6738742845977872,0.32612571540221275
13079,"14 Days, 12 Nights",122806,122530,276,2020_boxofficemojo_rankings.csv,2020,0.9977525528068661,0.002247447193133886
13080,Do I Sound Gay?,122595,119388,3207,2015_boxofficemojo_rankings.csv,2015,0.9738406949712468,0.026159305028753212
13081,Street Dreams,122575,122575,0,2009_boxofficemojo_rankings.csv,2009,1.0,0.0
13082,Film socialisme 2010 Re-release,122264,42925,79339,2010_boxofficemojo_rankings.csv,2010,0.3510845383759733,0.6489154616240267
13083,Tragedy Girls,122211,61899,60312,2017_boxofficemojo_rankings.csv,2017,0.506492868890689,0.49350713110931094
13084,Dancing at the Blue Iguana,122121,67913,54208,2001_boxofficemojo_rankings.csv,2001,0.5561123803440849,0.44388761965591506
13085,Before I Forget,122071,27611,94460,2007_boxofficemojo_rankings.csv,2007,0.22618803810896937,0.7738119618910306
13086,"Truth or Consequences, N.M.",122046,109261,12785,1997_boxofficemojo_rankings.csv,1997,0.8952444160398538,0.10475558396014617
13087,Howard Zinn: You Can't Be Neutral on a Moving Train,122011,122011,0,2004_boxofficemojo_rankings.csv,2004,1.0,0.0
13088,The Ones Below,121827,12488,109339,2016_boxofficemojo_rankings.csv,2016,0.10250601262445927,0.8974939873755408
13089,Tremors,121813,23911,97902,2019_boxofficemojo_rankings.csv,2019,0.19629267812138276,0.8037073218786173
13090,Yu-Gi-Oh!: The Movie - Pyramid of Light 2018 Re-release,121688,121688,0,2018_boxofficemojo_rankings.csv,2018,1.0,0.0
13091,For the Moment,121548,121548,0,1996_boxofficemojo_rankings.csv,1996,1.0,0.0
13092,Fidel,121304,121304,0,2002_boxofficemojo_rankings.csv,2002,1.0,0.0
13093,Mutual Appreciation,121292,103509,17783,2006_boxofficemojo_rankings.csv,2006,0.8533868680539525,0.14661313194604755
13094,All the Queen's Men,121258,23662,97596,2001_boxofficemojo_rankings.csv,2001,0.19513764040310744,0.8048623595968926
13095,Letters to Elena,121254,8511,112743,2012_boxofficemojo_rankings.csv,2012,0.07019149883715177,0.9298085011628482
13096,Afflicted,121179,121179,0,2014_boxofficemojo_rankings.csv,2014,1.0,0.0
13097,In Jackson Heights,121094,121094,0,2015_boxofficemojo_rankings.csv,2015,1.0,0.0
13098,Michael,121034,15715,105319,2011_boxofficemojo_rankings.csv,2011,0.12983954921757523,0.8701604507824248
13099,The Girl Without Hands,121020,21787,99233,2016_boxofficemojo_rankings.csv,2016,0.1800280945298298,0.8199719054701702
13100,Miss Sharon Jones!,120880,120880,0,2016_boxofficemojo_rankings.csv,2016,1.0,0.0
13101,Better Living Through Chemistry,120823,75143,45680,2014_boxofficemojo_rankings.csv,2014,0.6219262888688412,0.3780737111311588
13102,Jocks,120808,120808,0,1986_boxofficemojo_rankings.csv,1986,1.0,0.0
13103,I Am a Sex Addict,120790,115694,5096,2006_boxofficemojo_rankings.csv,2006,0.9578110770759168,0.04218892292408312
13104,David & Layla,120750,120750,0,2007_boxofficemojo_rankings.csv,2007,1.0,0.0
13105,Hockney 2016 Re-release,120745,120745,0,2016_boxofficemojo_rankings.csv,2016,1.0,0.0
13106,Examined Life,120712,120712,0,2009_boxofficemojo_rankings.csv,2009,1.0,0.0
13107,Cowgirls 'n Angels,120680,120680,0,2012_boxofficemojo_rankings.csv,2012,1.0,0.0
13108,Lagerfeld Confidential,120643,67500,53143,2007_boxofficemojo_rankings.csv,2007,0.5595020017738286,0.4404979982261714
13109,Sons of Provo,120488,120488,0,2005_boxofficemojo_rankings.csv,2005,1.0,0.0
13110,Spark: A Burning Man Story,120459,120459,0,2013_boxofficemojo_rankings.csv,2013,1.0,0.0
13111,I Vitelloni 2003 Re-release,120343,116428,3915,2003_boxofficemojo_rankings.csv,2003,0.9674679873361973,0.03253201266380263
13112,Foodfight!,120141,0,120141,2012_boxofficemojo_rankings.csv,2012,0.0,1.0
13113,Blank City,119929,116037,3892,2011_boxofficemojo_rankings.csv,2011,0.9675474655838038,0.03245253441619625
13114,Avant qu'on explose,119894,119894,0,2019_boxofficemojo_rankings.csv,2019,1.0,0.0
13115,The Pearl Button,119753,42166,77587,2015_boxofficemojo_rankings.csv,2015,0.35210808915016745,0.6478919108498326
13116,Mongolian Ping Pong,119732,71223,48509,2006_boxofficemojo_rankings.csv,2006,0.5948535061637658,0.40514649383623424
13117,Amy's Orgasm,119664,119664,0,2002_boxofficemojo_rankings.csv,2002,1.0,0.0
13118,The Komediant,119506,119506,0,2002_boxofficemojo_rankings.csv,2002,1.0,0.0
13119,Digging for Fire,119364,119364,0,2015_boxofficemojo_rankings.csv,2015,1.0,0.0
13120,Valley of the Heart's Delight,119290,119290,0,2010_boxofficemojo_rankings.csv,2010,1.0,0.0
13121,Celine: Through the Eyes of the World,119274,0,119274,2010_boxofficemojo_rankings.csv,2010,0.0,1.0
13122,The Trial,119267,119267,0,1993_boxofficemojo_rankings.csv,1993,1.0,0.0
13123,Jimmy Carter Man from Plains,119263,108807,10456,2007_boxofficemojo_rankings.csv,2007,0.9123282157919891,0.08767178420801086
13124,Fellini: I'm a Born Liar,119217,106686,12531,2003_boxofficemojo_rankings.csv,2003,0.89488915171494,0.10511084828506001
13125,12 and Holding,119195,96464,22731,2006_boxofficemojo_rankings.csv,2006,0.8092956919333865,0.19070430806661354
13126,Remember the Goal,119100,119100,0,2016_boxofficemojo_rankings.csv,2016,1.0,0.0
13127,Home Movie,119052,119052,0,2002_boxofficemojo_rankings.csv,2002,1.0,0.0
13128,Until Forever 2016 Re-release,118795,105358,13437,2016_boxofficemojo_rankings.csv,2016,0.8868891788374932,0.11311082116250684
13129,Neither Heaven Nor Earth,118663,12810,105853,2015_boxofficemojo_rankings.csv,2015,0.10795277382166303,0.892047226178337
13130,Gentlemen Broncos,118492,113682,4810,2009_boxofficemojo_rankings.csv,2009,0.9594065422138204,0.040593457786179656
13131,Music from Another Room,118475,118475,0,1998_boxofficemojo_rankings.csv,1998,1.0,0.0
13132,The Levelling,118451,3040,115411,2017_boxofficemojo_rankings.csv,2017,0.025664620813669787,0.9743353791863302
13133,See What I'm Saying: The Deaf Entertainers Documentary,118206,118206,0,2010_boxofficemojo_rankings.csv,2010,1.0,0.0
13134,Consuming Passions,118206,118206,0,1988_boxofficemojo_rankings.csv,1988,1.0,0.0
13135,Styx 2018 Re-release,118188,70794,47394,2018_boxofficemojo_rankings.csv,2018,0.5989948218093207,0.40100517819067927
13136,Come to Daddy,117947,96713,21234,2020_boxofficemojo_rankings.csv,2020,0.8199699865193689,0.18003001348063113
13137,Victor,117755,117755,0,2016_boxofficemojo_rankings.csv,2016,1.0,0.0
13138,The Decoy Bride,117754,759,116995,2011_boxofficemojo_rankings.csv,2011,0.006445640912410619,0.9935543590875894
13139,Freakonomics,117678,101270,16408,2010_boxofficemojo_rankings.csv,2010,0.8605686704396743,0.13943132956032564
13140,Running Free,117608,117608,0,2000_boxofficemojo_rankings.csv,2000,1.0,0.0
13141,Spring Forward,117471,117471,0,2000_boxofficemojo_rankings.csv,2000,1.0,0.0
13142,Bisbee '17,117470,117470,0,2018_boxofficemojo_rankings.csv,2018,1.0,0.0
13143,The Big Picture,117463,117463,0,1989_boxofficemojo_rankings.csv,1989,1.0,0.0
13144,George Takei's Allegiance 2018 Re-release,117162,117162,0,2018_boxofficemojo_rankings.csv,2018,1.0,0.0
13145,Jauja 2014 Re-release,117117,60231,56886,2014_boxofficemojo_rankings.csv,2014,0.5142805912036681,0.48571940879633185
13146,Sir! No Sir!,116944,116944,0,2006_boxofficemojo_rankings.csv,2006,1.0,0.0
13147,"Love, Sex and Eating the Bones",116869,116869,0,2004_boxofficemojo_rankings.csv,2004,1.0,0.0
13148,Skin,116863,0,116863,2019_boxofficemojo_rankings.csv,2019,0.0,1.0
13149,Gummo,116799,116799,0,1997_boxofficemojo_rankings.csv,1997,1.0,0.0
13150,Gimme the Loot,116783,104442,12341,2013_boxofficemojo_rankings.csv,2013,0.8943253726997936,0.10567462730020637
13151,A Case of You,116559,4187,112372,2013_boxofficemojo_rankings.csv,2013,0.035921722046345625,0.9640782779536544
13152,The Undefeated,116381,116381,0,2011_boxofficemojo_rankings.csv,2011,1.0,0.0
13153,Touching Home,116353,116353,0,2010_boxofficemojo_rankings.csv,2010,1.0,0.0
13154,No Impact Man: The Documentary,116349,100028,16321,2009_boxofficemojo_rankings.csv,2009,0.8597237621294553,0.14027623787054466
13155,The Art of Flight,116134,0,116134,2012_boxofficemojo_rankings.csv,2012,0.0,1.0
13156,Sputnik,116062,18853,97209,2020_boxofficemojo_rankings.csv,2020,0.1624390412021161,0.8375609587978838
13157,The Grand,115879,115879,0,2008_boxofficemojo_rankings.csv,2008,1.0,0.0
13158,Bank Robber,115842,115842,0,1993_boxofficemojo_rankings.csv,1993,1.0,0.0
13159,Mob Psycho 100,115766,115766,0,2019_boxofficemojo_rankings.csv,2019,1.0,0.0
13160,I Am Divine,115739,81497,34242,2013_boxofficemojo_rankings.csv,2013,0.7041446703358418,0.2958553296641582
13161,Headshot,115511,1373,114138,2011_boxofficemojo_rankings.csv,2011,0.011886313857554691,0.9881136861424453
13162,Loggerheads,115314,115314,0,2005_boxofficemojo_rankings.csv,2005,1.0,0.0
13163,Unconditional Love,115202,115202,0,1999_boxofficemojo_rankings.csv,1999,1.0,0.0
13164,Shakes the Clown,115103,115103,0,1992_boxofficemojo_rankings.csv,1992,1.0,0.0
13165,Caged No More,114959,114959,0,2016_boxofficemojo_rankings.csv,2016,1.0,0.0
13166,Sound and Fury,114882,114882,0,2000_boxofficemojo_rankings.csv,2000,1.0,0.0
13167,Berlin,114860,33231,81629,2008_boxofficemojo_rankings.csv,2008,0.28931742991467874,0.7106825700853212
13168,Nostalgia,114603,114603,0,2018_boxofficemojo_rankings.csv,2018,1.0,0.0
13169,Guncrazy,114516,114516,0,1993_boxofficemojo_rankings.csv,1993,1.0,0.0
13170,Taboo,114425,114425,0,2000_boxofficemojo_rankings.csv,2000,1.0,0.0
13171,Sympathy for the Devil,114301,51150,63151,2019_boxofficemojo_rankings.csv,2019,0.44750264652102784,0.5524973534789722
13172,John McEnroe: In the Realm of Perfection,114289,90964,23325,2018_boxofficemojo_rankings.csv,2018,0.795912117526621,0.2040878824733789
13173,Kippur,114283,114283,0,2000_boxofficemojo_rankings.csv,2000,1.0,0.0
13174,After Innocence,114264,114264,0,2005_boxofficemojo_rankings.csv,2005,1.0,0.0
13175,Akira 2001 Re-release,114009,114009,0,2001_boxofficemojo_rankings.csv,2001,1.0,0.0
13176,Ain't in It for My Health: A Film About Levon Helm,113966,113966,0,2013_boxofficemojo_rankings.csv,2013,1.0,0.0
13177,Bodied,113956,113956,0,2018_boxofficemojo_rankings.csv,2018,1.0,0.0
13178,The Woman Who Loves Giraffes,113858,113858,0,2019_boxofficemojo_rankings.csv,2019,1.0,0.0
13179,35 and Ticking,113794,113794,0,2011_boxofficemojo_rankings.csv,2011,1.0,0.0
13180,Oh My God,113792,38244,75548,2008_boxofficemojo_rankings.csv,2008,0.3360868953880765,0.6639131046119235
13181,Winter Passing,113783,107492,6291,2006_boxofficemojo_rankings.csv,2006,0.9447105455120712,0.055289454487928776
13182,Seaside,113724,15290,98434,2002_boxofficemojo_rankings.csv,2002,0.13444831346065914,0.8655516865393409
13183,Games People Play: New York,113622,113622,0,2004_boxofficemojo_rankings.csv,2004,1.0,0.0
13184,The Goonies 2015 Re-release,113538,113538,0,2015_boxofficemojo_rankings.csv,2015,1.0,0.0
13185,"We Love You, Sally Carmichael!",113435,113435,0,2017_boxofficemojo_rankings.csv,2017,1.0,0.0
13186,Darfur Now,113398,109107,4291,2007_boxofficemojo_rankings.csv,2007,0.9621598264519656,0.03784017354803436
13187,Abacus: Small Enough to Jail,113278,113278,0,2017_boxofficemojo_rankings.csv,2017,1.0,0.0
13188,God the Father,113276,113276,0,2014_boxofficemojo_rankings.csv,2014,1.0,0.0
13189,Absurdistan,113269,39683,73586,2008_boxofficemojo_rankings.csv,2008,0.3503429888142387,0.6496570111857614
13190,Burn 2012 Re-release,113173,113173,0,2012_boxofficemojo_rankings.csv,2012,1.0,0.0
13191,Road Hard,113169,113169,0,2015_boxofficemojo_rankings.csv,2015,1.0,0.0
13192,Police Story,113164,113164,0,2019_boxofficemojo_rankings.csv,2019,1.0,0.0
13193,Food of Love,113164,43922,69242,2002_boxofficemojo_rankings.csv,2002,0.38812696617298786,0.6118730338270121
13194,Going All the Way,113069,113069,0,1997_boxofficemojo_rankings.csv,1997,1.0,0.0
13195,Afghan Star,112909,102115,10794,2009_boxofficemojo_rankings.csv,2009,0.9044008892116661,0.09559911078833397
13196,Thicker Than Water,112891,112891,0,1999_boxofficemojo_rankings.csv,1999,1.0,0.0
13197,Filmworker,112828,102609,10219,2018_boxofficemojo_rankings.csv,2018,0.9094285106533839,0.09057148934661609
13198,Monster Beach Party,112791,112791,0,2009_boxofficemojo_rankings.csv,2009,1.0,0.0
13199,Follow Me: The Yoni Netanyahu Story,112679,112679,0,2012_boxofficemojo_rankings.csv,2012,1.0,0.0
13200,A Boy. A Girl. A Dream.,112552,112552,0,2018_boxofficemojo_rankings.csv,2018,1.0,0.0
13201,Arizona Dream,112547,112547,0,1995_boxofficemojo_rankings.csv,1995,1.0,0.0
13202,Perfect Blue,112536,112536,0,1999_boxofficemojo_rankings.csv,1999,1.0,0.0
13203,The Recall,112357,22943,89414,2017_boxofficemojo_rankings.csv,2017,0.20419733527951084,0.7958026647204891
13204,Killing Kasztner,112313,112313,0,2009_boxofficemojo_rankings.csv,2009,1.0,0.0
13205,"Hale County This Morning, This Evening",112282,112282,0,2018_boxofficemojo_rankings.csv,2018,1.0,0.0
13206,The Dawn Wall,112191,112191,0,2018_boxofficemojo_rankings.csv,2018,1.0,0.0
13207,Penton: The John Penton Story,112159,112159,0,2014_boxofficemojo_rankings.csv,2014,1.0,0.0
13208,How Viktor 'The Garlic' Took Alexey 'The Stud' to the Nursing Home,112071,12954,99117,2017_boxofficemojo_rankings.csv,2017,0.11558744010493348,0.8844125598950665
13209,Marwencol,112036,112036,0,2010_boxofficemojo_rankings.csv,2010,1.0,0.0
13210,A Chance in the World,112007,112007,0,2018_boxofficemojo_rankings.csv,2018,1.0,0.0
13211,Even Money,111974,64458,47516,2007_boxofficemojo_rankings.csv,2007,0.5756514905245861,0.4243485094754139
13212,Una noche,111903,100887,11016,2013_boxofficemojo_rankings.csv,2013,0.9015575989919842,0.09844240100801586
13213,The Producers,111866,111866,0,2002_boxofficemojo_rankings.csv,2002,1.0,0.0
13214,Hometown Legend,111806,111806,0,2002_boxofficemojo_rankings.csv,2002,1.0,0.0
13215,Torrents of Spring,111747,111747,0,1990_boxofficemojo_rankings.csv,1990,1.0,0.0
13216,Saint John of Las Vegas,111731,102645,9086,2010_boxofficemojo_rankings.csv,2010,0.9186796860316295,0.08132031396837046
13217,Arranged,111731,23571,88160,2007_boxofficemojo_rankings.csv,2007,0.21096204276342287,0.7890379572365771
13218,1915,111682,111682,0,2015_boxofficemojo_rankings.csv,2015,1.0,0.0
13219,Medicine for Melancholy,111551,111551,0,2009_boxofficemojo_rankings.csv,2009,1.0,0.0
13220,Thomas in Love,111523,44256,67267,2001_boxofficemojo_rankings.csv,2001,0.3968329402903437,0.6031670597096563
13221,Let's Bring Our Heroes Home,111423,111423,0,2004_boxofficemojo_rankings.csv,2004,1.0,0.0
13222,Rich Hill,111376,111376,0,2014_boxofficemojo_rankings.csv,2014,1.0,0.0
13223,Love the Hard Way,111350,44391,66959,2003_boxofficemojo_rankings.csv,2003,0.39866187696452626,0.6013381230354737
13224,Elevator to the Gallows 2016 Re-release,111267,111267,0,2016_boxofficemojo_rankings.csv,2016,1.0,0.0
13225,"Wild Horse, Wild Ride",111205,111205,0,2012_boxofficemojo_rankings.csv,2012,1.0,0.0
13226,A Paris Education,111197,21598,89599,2018_boxofficemojo_rankings.csv,2018,0.19423185877316834,0.8057681412268317
13227,Strangerland,111107,17472,93635,2015_boxofficemojo_rankings.csv,2015,0.15725381839128047,0.8427461816087195
13228,The Obama Effect,110904,110904,0,2012_boxofficemojo_rankings.csv,2012,1.0,0.0
13229,Puccini for Beginners,110864,89464,21400,2007_boxofficemojo_rankings.csv,2007,0.8069707028431231,0.1930292971568769
13230,The Overnighters,110763,110763,0,2014_boxofficemojo_rankings.csv,2014,1.0,0.0
13231,Duran Duran: Unstaged,110746,110746,0,2014_boxofficemojo_rankings.csv,2014,1.0,0.0
13232,Word Wars,110617,110617,0,2004_boxofficemojo_rankings.csv,2004,1.0,0.0
13233,In the Face of Evil: Reagan's War in Word and Deed,110577,110577,0,2004_boxofficemojo_rankings.csv,2004,1.0,0.0
13234,The Perfect Family,110313,110313,0,2012_boxofficemojo_rankings.csv,2012,1.0,0.0
13235,The Trouble with Terkel,110289,110289,0,2017_boxofficemojo_rankings.csv,2017,1.0,0.0
13236,Roar,110048,110048,0,2015_boxofficemojo_rankings.csv,2015,1.0,0.0
13237,Diva,110014,110014,0,2007_boxofficemojo_rankings.csv,2007,1.0,0.0
13238,Best Worst Movie,109895,109895,0,2010_boxofficemojo_rankings.csv,2010,1.0,0.0
13239,The Fifth Element 2017 Re-release,109786,0,109786,2017_boxofficemojo_rankings.csv,2017,0.0,1.0
13240,Babylon,109749,109749,0,2019_boxofficemojo_rankings.csv,2019,1.0,0.0
13241,Zero Days,109649,109649,0,2016_boxofficemojo_rankings.csv,2016,1.0,0.0
13242,Anohana the Movie: The Flower We Saw That Day (Ano hi mita hana no namae wo bokutachi wa mada shiran,109630,109630,0,2014_boxofficemojo_rankings.csv,2014,1.0,0.0
13243,The 24 Hour Woman,109535,109535,0,1999_boxofficemojo_rankings.csv,1999,1.0,0.0
13244,Cameraperson,109464,102033,7431,2016_boxofficemojo_rankings.csv,2016,0.9321146678360008,0.06788533216399913
13245,Wedding Party 2,109459,11140,98319,2017_boxofficemojo_rankings.csv,2017,0.10177326670260098,0.898226733297399
13246,Blood Done Sign My Name,109383,109383,0,2010_boxofficemojo_rankings.csv,2010,1.0,0.0
13247,Trumbo,109057,109057,0,2008_boxofficemojo_rankings.csv,2008,1.0,0.0
13248,The Lure,108846,101657,7189,2017_boxofficemojo_rankings.csv,2017,0.9339525568234018,0.06604744317659814
13249,Adult Beginners,108808,108808,0,2015_boxofficemojo_rankings.csv,2015,1.0,0.0
13250,Sworn Virgin,108681,4636,104045,2015_boxofficemojo_rankings.csv,2015,0.042656950156881146,0.9573430498431188
13251,Monsieur N. 2004 Re-release,108631,37757,70874,2004_boxofficemojo_rankings.csv,2004,0.34757113531128314,0.6524288646887169
13252,Red Sorghum,108371,0,108371,2018_boxofficemojo_rankings.csv,2018,0.0,1.0
13253,Violet & Daisy,108139,17186,90953,2013_boxofficemojo_rankings.csv,2013,0.15892508715634507,0.8410749128436549
13254,Slayground,108128,108128,0,1984_boxofficemojo_rankings.csv,1984,1.0,0.0
13255,Bettie Page Reveals All,108118,108118,0,2013_boxofficemojo_rankings.csv,2013,1.0,0.0
13256,Downtown 81,108058,108058,0,2001_boxofficemojo_rankings.csv,2001,1.0,0.0
13257,"Love, Cecil",107940,106057,1883,2017_boxofficemojo_rankings.csv,2017,0.9825551232166018,0.017444876783398185
13258,Mad Dog Time,107874,107874,0,1996_boxofficemojo_rankings.csv,1996,1.0,0.0
13259,Crush,107792,107792,0,1993_boxofficemojo_rankings.csv,1993,1.0,0.0
13260,Kidnapping of Michel Houellebecq,107641,11546,96095,2014_boxofficemojo_rankings.csv,2014,0.10726396075844706,0.892736039241553
13261,Bonjour Monsieur Shlomi,107585,107585,0,2004_boxofficemojo_rankings.csv,2004,1.0,0.0
13262,Sleep Dealer,107559,80136,27423,2008_boxofficemojo_rankings.csv,2008,0.7450422558781692,0.2549577441218308
13263,Revenge of the Green Dragons,107412,0,107412,2014_boxofficemojo_rankings.csv,2014,0.0,1.0
13264,"No Date, No Signature",107368,36444,70924,2018_boxofficemojo_rankings.csv,2018,0.3394307428656583,0.6605692571343417
13265,Cockneys vs Zombies,107348,0,107348,2012_boxofficemojo_rankings.csv,2012,0.0,1.0
13266,Marebito,107259,13983,93276,2005_boxofficemojo_rankings.csv,2005,0.1303666825161525,0.8696333174838475
13267,Eternity and a Day,107178,107178,0,1999_boxofficemojo_rankings.csv,1999,1.0,0.0
13268,A Slipping-Down Life,107099,107099,0,2004_boxofficemojo_rankings.csv,2004,1.0,0.0
13269,National Theatre Live: Julius Caesar,107057,107057,0,2018_boxofficemojo_rankings.csv,2018,1.0,0.0
13270,Carlos Castaneda: Enigma of a Sorcerer,107040,107040,0,2004_boxofficemojo_rankings.csv,2004,1.0,0.0
13271,Jeruzalem,107024,11287,95737,2016_boxofficemojo_rankings.csv,2016,0.10546232620720586,0.8945376737927941
13272,Best Worst Thing That Ever Could Have Happened...,106986,106986,0,2016_boxofficemojo_rankings.csv,2016,1.0,0.0
13273,The Tales of Hoffmann,106860,91930,14930,2015_boxofficemojo_rankings.csv,2015,0.8602844843720756,0.1397155156279244
13274,Ed's Next Move,106791,106791,0,1996_boxofficemojo_rankings.csv,1996,1.0,0.0
13275,Ivory Tower,106771,106771,0,2014_boxofficemojo_rankings.csv,2014,1.0,0.0
13276,Vita Activa: The Spirit of Hannah Arendt,106768,82143,24625,2016_boxofficemojo_rankings.csv,2016,0.7693597332534092,0.23064026674659074
13277,Kurt Cobain About a Son,106724,87016,19708,2007_boxofficemojo_rankings.csv,2007,0.8153367564933848,0.1846632435066152
13278,The Secret Agent,106606,106606,0,1996_boxofficemojo_rankings.csv,1996,1.0,0.0
13279,The Alphabet Killer,106596,29784,76812,2008_boxofficemojo_rankings.csv,2008,0.2794101091973432,0.7205898908026568
13280,The Way We Get By,106542,106542,0,2009_boxofficemojo_rankings.csv,2009,1.0,0.0
13281,Dekalog 2016 Re-release,106494,106494,0,2016_boxofficemojo_rankings.csv,2016,1.0,0.0
13282,Wrong,106425,46021,60404,2012_boxofficemojo_rankings.csv,2012,0.4324265914963589,0.567573408503641
13283,Lawn Dogs,106404,106404,0,1998_boxofficemojo_rankings.csv,1998,1.0,0.0
13284,The Charmer,106379,26167,80212,2018_boxofficemojo_rankings.csv,2018,0.24597899961458558,0.7540210003854144
13285,Six Dance Lessons in Six Weeks,106323,106323,0,2014_boxofficemojo_rankings.csv,2014,1.0,0.0
13286,The Bachelors,106212,0,106212,2017_boxofficemojo_rankings.csv,2017,0.0,1.0
13287,Almost Peaceful 2004 Re-release,106184,106184,0,2004_boxofficemojo_rankings.csv,2004,1.0,0.0
13288,The Skeptic,106128,6671,99457,2009_boxofficemojo_rankings.csv,2009,0.06285805819387909,0.9371419418061209
13289,Shattered Image,106116,106116,0,1998_boxofficemojo_rankings.csv,1998,1.0,0.0
13290,The Brink,106057,106057,0,2019_boxofficemojo_rankings.csv,2019,1.0,0.0
13291,Big Star: Nothing Can Hurt Me,105998,105998,0,2013_boxofficemojo_rankings.csv,2013,1.0,0.0
13292,The Million Dollar Hotel,105983,59989,45994,2000_boxofficemojo_rankings.csv,2000,0.566024739816763,0.43397526018323695
13293,A Jihad for Love,105651,105651,0,2008_boxofficemojo_rankings.csv,2008,1.0,0.0
13294,King Corn,105422,105422,0,2007_boxofficemojo_rankings.csv,2007,1.0,0.0
13295,Tortilla Heaven,105401,105401,0,2007_boxofficemojo_rankings.csv,2007,1.0,0.0
13296,Never Heard,105271,105271,0,2018_boxofficemojo_rankings.csv,2018,1.0,0.0
13297,Captain Sabertooth 2006 Re-release,105152,105152,0,2006_boxofficemojo_rankings.csv,2006,1.0,0.0
13298,Guerrilla: The Taking of Patty Hearst,105054,105054,0,2004_boxofficemojo_rankings.csv,2004,1.0,0.0
13299,Cold Case Hammarskjöld,104965,104965,0,2019_boxofficemojo_rankings.csv,2019,1.0,0.0
13300,The Girl,104883,104883,0,2001_boxofficemojo_rankings.csv,2001,1.0,0.0
13301,Another Gay Sequel: Gays Gone Wild!,104828,104828,0,2008_boxofficemojo_rankings.csv,2008,1.0,0.0
13302,A Ciambra,104808,41934,62874,2017_boxofficemojo_rankings.csv,2017,0.4001030455690405,0.5998969544309595
13303,Dictator,104734,104734,0,2016_boxofficemojo_rankings.csv,2016,1.0,0.0
13304,Mr. Untouchable,104678,104678,0,2007_boxofficemojo_rankings.csv,2007,1.0,0.0
13305,Band Baaja Baaraat,104532,43820,60712,2010_boxofficemojo_rankings.csv,2010,0.4192017755328512,0.5807982244671488
13306,Alien Trespass,104526,104526,0,2009_boxofficemojo_rankings.csv,2009,1.0,0.0
13307,Results,104507,104507,0,2015_boxofficemojo_rankings.csv,2015,1.0,0.0
13308,Big Bad Love,104294,104294,0,2002_boxofficemojo_rankings.csv,2002,1.0,0.0
13309,Human Traffic,104257,104257,0,2000_boxofficemojo_rankings.csv,2000,1.0,0.0
13310,Little Men,104255,104255,0,1998_boxofficemojo_rankings.csv,1998,1.0,0.0
13311,XX/XY,104130,104130,0,2003_boxofficemojo_rankings.csv,2003,1.0,0.0
13312,2 or 3 Things I Know About Her,104038,104038,0,2006_boxofficemojo_rankings.csv,2006,1.0,0.0
13313,Demon,104038,104038,0,2016_boxofficemojo_rankings.csv,2016,1.0,0.0
13314,Lola,103951,103951,0,2001_boxofficemojo_rankings.csv,2001,1.0,0.0
13315,World Traveler,103863,103863,0,2002_boxofficemojo_rankings.csv,2002,1.0,0.0
13316,The Investigator,103739,103739,0,2013_boxofficemojo_rankings.csv,2013,1.0,0.0
13317,The Real Dirt on Farmer John,103714,65429,38285,2006_boxofficemojo_rankings.csv,2006,0.6308598646277263,0.36914013537227375
13318,30 Years to Life,103540,103540,0,2002_boxofficemojo_rankings.csv,2002,1.0,0.0
13319,Stevie,103401,103401,0,2003_boxofficemojo_rankings.csv,2003,1.0,0.0
13320,Frankie Starlight,103365,103365,0,1995_boxofficemojo_rankings.csv,1995,1.0,0.0
13321,Rolling,103318,103318,0,2009_boxofficemojo_rankings.csv,2009,1.0,0.0
13322,Stevie Nicks: In Your Dreams,103028,103028,0,2013_boxofficemojo_rankings.csv,2013,1.0,0.0
13323,Al Franken: God Spoke,102990,102990,0,2006_boxofficemojo_rankings.csv,2006,1.0,0.0
13324,Lucky Grandma,102972,102000,972,2020_boxofficemojo_rankings.csv,2020,0.9905605407295187,0.009439459270481296
13325,Puerto Ricans in Paris,102890,102890,0,2016_boxofficemojo_rankings.csv,2016,1.0,0.0
13326,Brake,102819,4876,97943,2012_boxofficemojo_rankings.csv,2012,0.047423141637246036,0.952576858362754
13327,Islander,102737,102737,0,2007_boxofficemojo_rankings.csv,2007,1.0,0.0
13328,Mini's First Time,102676,49034,53642,2006_boxofficemojo_rankings.csv,2006,0.4775604815146675,0.5224395184853325
13329,Pure,102471,102471,0,2005_boxofficemojo_rankings.csv,2005,1.0,0.0
13330,Sweet Nothing,102350,102350,0,1996_boxofficemojo_rankings.csv,1996,1.0,0.0
13331,The Gracefield Incident,102256,0,102256,2017_boxofficemojo_rankings.csv,2017,0.0,1.0
13332,Tanna,102225,46654,55571,2016_boxofficemojo_rankings.csv,2016,0.45638542430912205,0.543614575690878
13333,Return with Honor: A Missionary Homecoming,102171,102171,0,2007_boxofficemojo_rankings.csv,2007,1.0,0.0
13334,Civic Duty,102070,95953,6117,2007_boxofficemojo_rankings.csv,2007,0.9400705398256098,0.059929460174390124
13335,Andrei Rublev 2018 Re-release,102021,102021,0,2018_boxofficemojo_rankings.csv,2018,1.0,0.0
13336,Becoming Traviata,102015,62652,39363,2013_boxofficemojo_rankings.csv,2013,0.6141449786796059,0.38585502132039406
13337,Tower,101987,101987,0,2016_boxofficemojo_rankings.csv,2016,1.0,0.0
13338,In the Family,101934,101934,0,2011_boxofficemojo_rankings.csv,2011,1.0,0.0
13339,Québec sur ordonnance,101896,101896,0,2007_boxofficemojo_rankings.csv,2007,1.0,0.0
13340,Hotel by the River,101879,28354,73525,2019_boxofficemojo_rankings.csv,2019,0.2783105448620422,0.7216894551379578
13341,Cracks,101860,29683,72177,2009_boxofficemojo_rankings.csv,2009,0.29140977812684077,0.7085902218731592
13342,The Kitchen Toto,101807,101807,0,1988_boxofficemojo_rankings.csv,1988,1.0,0.0
13343,Kill Me Three Times,101807,24296,77511,2015_boxofficemojo_rankings.csv,2015,0.23864763719587062,0.7613523628041294
13344,Magnus,101739,8944,92795,2016_boxofficemojo_rankings.csv,2016,0.08791122381780832,0.9120887761821916
13345,Those Who Remained,101737,0,101737,2019_boxofficemojo_rankings.csv,2019,0.0,1.0
13346,Rubber,101729,100370,1359,2011_boxofficemojo_rankings.csv,2011,0.9866409774990416,0.01335902250095843
13347,Kickboxer: Retaliation,101690,4537,97153,2018_boxofficemojo_rankings.csv,2018,0.044615989772839024,0.955384010227161
13348,A Lego Brickumentary,101531,101531,0,2015_boxofficemojo_rankings.csv,2015,1.0,0.0
13349,Blazing Saddles 2013 Re-release,101481,101481,0,2013_boxofficemojo_rankings.csv,2013,1.0,0.0
13350,Man from Reno,101438,101438,0,2015_boxofficemojo_rankings.csv,2015,1.0,0.0
13351,James White,101368,101368,0,2015_boxofficemojo_rankings.csv,2015,1.0,0.0
13352,Emerald Cowboy,101358,101358,0,2003_boxofficemojo_rankings.csv,2003,1.0,0.0
13353,QT8: The First Eight,101346,51896,49450,2019_boxofficemojo_rankings.csv,2019,0.5120675705010558,0.4879324294989442
13354,Korengal,101310,101310,0,2014_boxofficemojo_rankings.csv,2014,1.0,0.0
13355,The House of the Devil,101215,101215,0,2009_boxofficemojo_rankings.csv,2009,1.0,0.0
13356,Feed the Fish,101170,101170,0,2010_boxofficemojo_rankings.csv,2010,1.0,0.0
13357,Beyond Sight: The Derek Rabelo Story,101074,101074,0,2014_boxofficemojo_rankings.csv,2014,1.0,0.0
13358,Totally F***ed Up,101071,101071,0,1994_boxofficemojo_rankings.csv,1994,1.0,0.0
13359,First Cow,101068,101068,0,2020_boxofficemojo_rankings.csv,2020,1.0,0.0
13360,Dum,101000,101000,0,2003_boxofficemojo_rankings.csv,2003,1.0,0.0
13361,Khauff,100975,100975,0,2000_boxofficemojo_rankings.csv,2000,1.0,0.0
13362,Miss Juneteenth,100947,92349,8598,2020_boxofficemojo_rankings.csv,2020,0.9148265921721299,0.08517340782787007
13363,The Adventures of Sebastian Cole,100841,100841,0,1999_boxofficemojo_rankings.csv,1999,1.0,0.0
13364,The Good Guy,100688,100688,0,2010_boxofficemojo_rankings.csv,2010,1.0,0.0
13365,A Woman Is a Woman,100665,100665,0,2003_boxofficemojo_rankings.csv,2003,1.0,0.0
13366,Self Medicated,100610,100610,0,2007_boxofficemojo_rankings.csv,2007,1.0,0.0
13367,Desert Blue,100590,100590,0,1999_boxofficemojo_rankings.csv,1999,1.0,0.0
13368,Sade,100544,100544,0,2002_boxofficemojo_rankings.csv,2002,1.0,0.0
13369,The Man Who Fell to Earth,100468,100072,396,2011_boxofficemojo_rankings.csv,2011,0.996058446470518,0.003941553529482024
13370,Roman Polanski: Wanted and Desired,100458,59192,41266,2008_boxofficemojo_rankings.csv,2008,0.5892213661430648,0.41077863385693525
13371,The United States of Autism,100403,100403,0,2013_boxofficemojo_rankings.csv,2013,1.0,0.0
13372,One Track Heart: The Story of Krishna Das,100401,100401,0,2013_boxofficemojo_rankings.csv,2013,1.0,0.0
13373,All About Nina,100335,100335,0,2018_boxofficemojo_rankings.csv,2018,1.0,0.0
13374,Race for Glory,100326,100326,0,1989_boxofficemojo_rankings.csv,1989,1.0,0.0
13375,8: The Mormon Proposition,100280,100280,0,2010_boxofficemojo_rankings.csv,2010,1.0,0.0
13376,Rejoice and Shout,100237,100237,0,2011_boxofficemojo_rankings.csv,2011,1.0,0.0
13377,Bhutto,100202,100202,0,2010_boxofficemojo_rankings.csv,2010,1.0,0.0
13378,Being Cyrus,100184,100184,0,2006_boxofficemojo_rankings.csv,2006,1.0,0.0
13379,The Telephone,99978,99978,0,1988_boxofficemojo_rankings.csv,1988,1.0,0.0
13380,Fighter,99938,99938,0,2001_boxofficemojo_rankings.csv,2001,1.0,0.0
13381,Yves Saint Laurent: His Life and Times,99819,99819,0,2004_boxofficemojo_rankings.csv,2004,1.0,0.0
13382,A Place in the World,99707,99707,0,1994_boxofficemojo_rankings.csv,1994,1.0,0.0
13383,White Lion,99635,0,99635,2010_boxofficemojo_rankings.csv,2010,0.0,1.0
13384,The Roads Not Taken,99546,3518,96028,2020_boxofficemojo_rankings.csv,2020,0.035340445623129005,0.964659554376871
13385,Papi Chulo,99546,84703,14843,2019_boxofficemojo_rankings.csv,2019,0.8508930544672815,0.14910694553271855
13386,Heavy Water,99503,55446,44057,2019_boxofficemojo_rankings.csv,2019,0.5572294302684341,0.44277056973156587
13387,Meow Wolf: Origin Story,99488,99488,0,2018_boxofficemojo_rankings.csv,2018,1.0,0.0
13388,The Stars Fell on Henrietta,99318,99318,0,1995_boxofficemojo_rankings.csv,1995,1.0,0.0
13389,Kings of the Evening,99270,99270,0,2010_boxofficemojo_rankings.csv,2010,1.0,0.0
13390,Cold Heaven,99219,99219,0,1992_boxofficemojo_rankings.csv,1992,1.0,0.0
13391,Carnage,99049,60158,38891,2002_boxofficemojo_rankings.csv,2002,0.6073559551333179,0.39264404486668214
13392,"I Love You, Don't Touch Me!",98973,98973,0,1998_boxofficemojo_rankings.csv,1998,1.0,0.0
13393,Cemetery of Splendor,98932,51950,46982,2015_boxofficemojo_rankings.csv,2015,0.5251081550964298,0.4748918449035701
13394,8½ 1999 Re-release,98760,98760,0,1999_boxofficemojo_rankings.csv,1999,1.0,0.0
13395,Absolute Wilson,98730,66217,32513,2006_boxofficemojo_rankings.csv,2006,0.6706877342246531,0.3293122657753469
13396,Handcart,98666,98666,0,2002_boxofficemojo_rankings.csv,2002,1.0,0.0
13397,Under Our Skin,98548,98548,0,2009_boxofficemojo_rankings.csv,2009,1.0,0.0
13398,High Strung Free Dance 2019 Re-release,98481,83891,14590,2019_boxofficemojo_rankings.csv,2019,0.8518495953534184,0.14815040464658158
13399,Aida's Secrets,98468,98468,0,2017_boxofficemojo_rankings.csv,2017,1.0,0.0
13400,Reign of Judges: Title of Liberty - Concept Short,98408,93224,5184,2018_boxofficemojo_rankings.csv,2018,0.9473213559873181,0.052678644012681894
13401,The Very Thought of You,98378,98378,0,1999_boxofficemojo_rankings.csv,1999,1.0,0.0
13402,Purple Noon,98311,0,98311,2008_boxofficemojo_rankings.csv,2008,0.0,1.0
13403,Blind,98280,12522,85758,2017_boxofficemojo_rankings.csv,2017,0.1274114774114774,0.8725885225885226
13404,Charlie Says,98240,40685,57555,2019_boxofficemojo_rankings.csv,2019,0.41413884364820847,0.5858611563517915
13405,Amsterdamned,98003,98003,0,1988_boxofficemojo_rankings.csv,1988,1.0,0.0
13406,The Red Balloon / White Mane,97959,69139,28820,2007_boxofficemojo_rankings.csv,2007,0.7057952816994865,0.2942047183005135
13407,National Theatre Live: Macbeth,97857,97857,0,2018_boxofficemojo_rankings.csv,2018,1.0,0.0
13408,Brother of Sleep,97848,97848,0,1996_boxofficemojo_rankings.csv,1996,1.0,0.0
13409,Red Doors,97848,97848,0,2006_boxofficemojo_rankings.csv,2006,1.0,0.0
13410,"Tim Timmerman, Hope of America",97727,97727,0,2017_boxofficemojo_rankings.csv,2017,1.0,0.0
13411,The Here After,97699,0,97699,2015_boxofficemojo_rankings.csv,2015,0.0,1.0
13412,On Guard,97552,97552,0,2002_boxofficemojo_rankings.csv,2002,1.0,0.0
13413,The Last Winter,97522,33190,64332,2007_boxofficemojo_rankings.csv,2007,0.3403334632185558,0.6596665367814442
13414,D.E.B.S.,97446,97446,0,2005_boxofficemojo_rankings.csv,2005,1.0,0.0
13415,Aileen: Life and Death of a Serial Killer,97362,97362,0,2004_boxofficemojo_rankings.csv,2004,1.0,0.0
13416,Everybody's Famous!,97353,81734,15619,2001_boxofficemojo_rankings.csv,2001,0.8395632389345988,0.16043676106540117
13417,In Bloom,97236,56092,41144,2013_boxofficemojo_rankings.csv,2013,0.5768645357686454,0.4231354642313546
13418,Difret,97205,49667,47538,2015_boxofficemojo_rankings.csv,2015,0.5109510827632323,0.48904891723676763
13419,Prassthanam,97204,19984,77220,2019_boxofficemojo_rankings.csv,2019,0.20558824739722645,0.7944117526027735
13420,A Field in England,97195,32846,64349,2013_boxofficemojo_rankings.csv,2013,0.3379391944030043,0.6620608055969958
13421,Little Monsters,97111,0,97111,2019_boxofficemojo_rankings.csv,2019,0.0,1.0
13422,Kisses 2010 Re-release,96933,81680,15253,2010_boxofficemojo_rankings.csv,2010,0.8426438880463826,0.15735611195361746
13423,A Little Help,96868,96868,0,2011_boxofficemojo_rankings.csv,2011,1.0,0.0
13424,Leviathan,96778,76202,20576,2013_boxofficemojo_rankings.csv,2013,0.7873896960052904,0.21261030399470954
13425,Singin' in the Rain 2013 Re-release,96763,96763,0,2013_boxofficemojo_rankings.csv,2013,1.0,0.0
13426,Hardflip,96734,96734,0,2012_boxofficemojo_rankings.csv,2012,1.0,0.0
13427,Sunshine Superman,96715,88097,8618,2015_boxofficemojo_rankings.csv,2015,0.9108928294473453,0.08910717055265471
13428,Godspeed: The Race Across America,96690,96690,0,2018_boxofficemojo_rankings.csv,2018,1.0,0.0
13429,Kabluey,96663,83506,13157,2008_boxofficemojo_rankings.csv,2008,0.8638879405770564,0.13611205942294363
13430,Paragraph 175,96630,96630,0,2000_boxofficemojo_rankings.csv,2000,1.0,0.0
13431,A Poem Is a Naked Person,96592,96592,0,2015_boxofficemojo_rankings.csv,2015,1.0,0.0
13432,Dina,96524,90503,6021,2017_boxofficemojo_rankings.csv,2017,0.9376217313828685,0.06237826861713149
13433,Louise Bourgeois,96443,95865,578,2008_boxofficemojo_rankings.csv,2008,0.9940068226828283,0.005993177317171801
13434,Hiroshima Mon Amour 2014 Re-release,96439,96439,0,2014_boxofficemojo_rankings.csv,2014,1.0,0.0
13435,Greetings from the Shore,96314,96314,0,2008_boxofficemojo_rankings.csv,2008,1.0,0.0
13436,Autumn Spring 2003 Re-release,96269,96269,0,2003_boxofficemojo_rankings.csv,2003,1.0,0.0
13437,My Reincarnation,96115,92822,3293,2011_boxofficemojo_rankings.csv,2011,0.9657389585392498,0.034261041460750145
13438,The Holy Mountain,95858,61001,34857,2007_boxofficemojo_rankings.csv,2007,0.6363683782261261,0.36363162177387387
13439,Signs of Life,95836,95836,0,1989_boxofficemojo_rankings.csv,1989,1.0,0.0
13440,A Bigger Splash 2019 Re-release,95826,95826,0,2019_boxofficemojo_rankings.csv,2019,1.0,0.0
13441,Saand Ki Aankh,95724,0,95724,2019_boxofficemojo_rankings.csv,2019,0.0,1.0
13442,Ardor,95549,18565,76984,2014_boxofficemojo_rankings.csv,2014,0.19429821348208773,0.8057017865179122
13443,The Lovers & the Despot,95521,55511,40010,2016_boxofficemojo_rankings.csv,2016,0.5811392259293768,0.4188607740706232
13444,Kehtaa Hai Dil Baar Baar,95415,95415,0,2002_boxofficemojo_rankings.csv,2002,1.0,0.0
13445,Classe Tous Risques,95413,95413,0,2005_boxofficemojo_rankings.csv,2005,1.0,0.0
13446,Code Unknown,95242,95242,0,2001_boxofficemojo_rankings.csv,2001,1.0,0.0
13447,The Final Wish,95215,25183,70032,2019_boxofficemojo_rankings.csv,2019,0.26448563776715855,0.7355143622328415
13448,Made in U.S.A,95209,95209,0,2009_boxofficemojo_rankings.csv,2009,1.0,0.0
13449,The Night Eats the World,95208,0,95208,2018_boxofficemojo_rankings.csv,2018,0.0,1.0
13450,Queen of Earth,95183,91218,3965,2015_boxofficemojo_rankings.csv,2015,0.958343401657859,0.04165659834214093
13451,The Pool,95102,95102,0,2008_boxofficemojo_rankings.csv,2008,1.0,0.0
13452,Almost You,95000,95000,0,1985_boxofficemojo_rankings.csv,1985,1.0,0.0
13453,Saala Khadoos,94787,76931,17856,2016_boxofficemojo_rankings.csv,2016,0.8116197368837499,0.1883802631162501
13454,Bicycle Thieves 2008 Re-release,94685,36818,57867,2008_boxofficemojo_rankings.csv,2008,0.38884723028990864,0.6111527697100914
13455,The Hebrew Hammer,94615,82157,12458,2003_boxofficemojo_rankings.csv,2003,0.8683295460550653,0.13167045394493473
13456,Jin-Roh: The Wolf Brigade,94591,94591,0,2001_boxofficemojo_rankings.csv,2001,1.0,0.0
13457,The Fight Within,94326,94326,0,2016_boxofficemojo_rankings.csv,2016,1.0,0.0
13458,Keep Watching,94178,94178,0,2017_boxofficemojo_rankings.csv,2017,1.0,0.0
13459,Escaflowne: The Movie,94060,94060,0,2002_boxofficemojo_rankings.csv,2002,1.0,0.0
13460,Blue Caprice,93995,93995,0,2013_boxofficemojo_rankings.csv,2013,1.0,0.0
13461,Let the Corpses Tan,93409,93409,0,2018_boxofficemojo_rankings.csv,2018,1.0,0.0
13462,Flavors,93370,93370,0,2004_boxofficemojo_rankings.csv,2004,1.0,0.0
13463,First Lady,93298,93298,0,2020_boxofficemojo_rankings.csv,2020,1.0,0.0
13464,The Inner Circle,93292,93292,0,1991_boxofficemojo_rankings.csv,1991,1.0,0.0
13465,Will You Still Love Me Tomorrow?,93046,6694,86352,2013_boxofficemojo_rankings.csv,2013,0.07194290995851514,0.9280570900414848
13466,Celsius 41.11: The Temperature at Which the Brain... Begins to Die,93000,93000,0,2004_boxofficemojo_rankings.csv,2004,1.0,0.0
13467,Un air de famille,92806,92806,0,1998_boxofficemojo_rankings.csv,1998,1.0,0.0
13468,Vamps,92748,3361,89387,2012_boxofficemojo_rankings.csv,2012,0.03623797817742701,0.963762021822573
13469,Haiku Tunnel,92723,92723,0,2001_boxofficemojo_rankings.csv,2001,1.0,0.0
13470,A Man Called Sarge,92706,92706,0,1990_boxofficemojo_rankings.csv,1990,1.0,0.0
13471,The First Time,92654,22836,69818,2012_boxofficemojo_rankings.csv,2012,0.24646534418373733,0.7535346558162627
13472,In Custody,92612,92612,0,1994_boxofficemojo_rankings.csv,1994,1.0,0.0
13473,American: The Bill Hicks Story,92234,92234,0,2011_boxofficemojo_rankings.csv,2011,1.0,0.0
13474,Somersault 2006 Re-release,92214,92214,0,2006_boxofficemojo_rankings.csv,2006,1.0,0.0
13475,Into the Forest,92166,9995,82171,2016_boxofficemojo_rankings.csv,2016,0.10844563070980621,0.8915543692901938
13476,The Brandon Teena Story,92113,92113,0,1998_boxofficemojo_rankings.csv,1998,1.0,0.0
13477,Beowulf & Grendel,92076,68820,23256,2006_boxofficemojo_rankings.csv,2006,0.7474260393587906,0.25257396064120946
13478,Nancy,92000,80115,11885,2018_boxofficemojo_rankings.csv,2018,0.8708152173913043,0.12918478260869565
13479,My Führer 2009 Re-release,91995,2465,89530,2009_boxofficemojo_rankings.csv,2009,0.02679493450731018,0.9732050654926898
13480,Martha & Ethel,91874,91874,0,1995_boxofficemojo_rankings.csv,1995,1.0,0.0
13481,The Young Girls of Rochefort,91837,91837,0,1998_boxofficemojo_rankings.csv,1998,1.0,0.0
13482,TwentyFourSeven,91805,91805,0,1998_boxofficemojo_rankings.csv,1998,1.0,0.0
13483,Fandango,91666,91666,0,1985_boxofficemojo_rankings.csv,1985,1.0,0.0
13484,Generation War,91595,91595,0,2014_boxofficemojo_rankings.csv,2014,1.0,0.0
13485,A Show of Force,91578,91578,0,1990_boxofficemojo_rankings.csv,1990,1.0,0.0
13486,Legends from the Sky,91462,91462,0,2015_boxofficemojo_rankings.csv,2015,1.0,0.0
13487,Other People,91441,91441,0,2016_boxofficemojo_rankings.csv,2016,1.0,0.0
13488,Evil Bong 3: The Wrath of Bong,91260,91260,0,2011_boxofficemojo_rankings.csv,2011,1.0,0.0
13489,Morris from America,91151,91151,0,2016_boxofficemojo_rankings.csv,2016,1.0,0.0
13490,A Kind of Murder,91149,2915,88234,2016_boxofficemojo_rankings.csv,2016,0.03198060318818638,0.9680193968118136
13491,Mapplethorpe,91002,91002,0,2019_boxofficemojo_rankings.csv,2019,1.0,0.0
13492,BANDSTAND: The Broadway Musical on Screen 2018 Re-release,91000,91000,0,2018_boxofficemojo_rankings.csv,2018,1.0,0.0
13493,Because of Grácia,90878,90878,0,2017_boxofficemojo_rankings.csv,2017,1.0,0.0
13494,Ek Khiladi Ek Haseena,90869,90869,0,2005_boxofficemojo_rankings.csv,2005,1.0,0.0
13495,Porto,90849,15126,75723,2017_boxofficemojo_rankings.csv,2017,0.16649605389162236,0.8335039461083776
13496,Heroic Antics,90785,63649,27136,2014_boxofficemojo_rankings.csv,2014,0.7010959960345872,0.2989040039654128
13497,Beasts of No Nation,90777,90777,0,2015_boxofficemojo_rankings.csv,2015,1.0,0.0
13498,Yuri!!! On Ice,90751,81878,8873,2018_boxofficemojo_rankings.csv,2018,0.902226972705535,0.09777302729446508
13499,Loopers: The Caddie's Long Walk,90679,90679,0,2019_boxofficemojo_rankings.csv,2019,1.0,0.0
13500,Moonwalkers,90646,0,90646,2016_boxofficemojo_rankings.csv,2016,0.0,1.0
13501,The Good Neighbor,90573,0,90573,2016_boxofficemojo_rankings.csv,2016,0.0,1.0
13502,Fireworks Wednesday 2016 Re-release,90519,90519,0,2016_boxofficemojo_rankings.csv,2016,1.0,0.0
13503,Minding the Gap,90328,11998,78330,2018_boxofficemojo_rankings.csv,2018,0.1328270303781773,0.8671729696218227
13504,The Unforeseen,90287,90287,0,2008_boxofficemojo_rankings.csv,2008,1.0,0.0
13505,Adrift in Manhattan,90272,2099,88173,2007_boxofficemojo_rankings.csv,2007,0.023251949663239985,0.97674805033676
13506,Dark Horse,90136,90136,0,2015_boxofficemojo_rankings.csv,2015,1.0,0.0
13507,King's Faith,90106,90106,0,2013_boxofficemojo_rankings.csv,2013,1.0,0.0
13508,Johnny Suede,90091,90091,0,1992_boxofficemojo_rankings.csv,1992,1.0,0.0
13509,Pray the Devil Back to Hell,90066,90066,0,2008_boxofficemojo_rankings.csv,2008,1.0,0.0
13510,Stripper,90000,90000,0,1986_boxofficemojo_rankings.csv,1986,1.0,0.0
13511,Raining Stones,89995,89388,607,1994_boxofficemojo_rankings.csv,1994,0.9932551808433802,0.006744819156619813
13512,Running for Grace,89988,89988,0,2018_boxofficemojo_rankings.csv,2018,1.0,0.0
13513,Pump,89787,89787,0,2014_boxofficemojo_rankings.csv,2014,1.0,0.0
13514,Eulogy,89781,75076,14705,2004_boxofficemojo_rankings.csv,2004,0.8362125616778606,0.16378743832213943
13515,Imaginary Crimes,89611,89611,0,1994_boxofficemojo_rankings.csv,1994,1.0,0.0
13516,Twenty Bucks,89558,89558,0,1993_boxofficemojo_rankings.csv,1993,1.0,0.0
13517,The Principle,89543,89543,0,2014_boxofficemojo_rankings.csv,2014,1.0,0.0
13518,Throw Down Your Heart,89521,89521,0,2009_boxofficemojo_rankings.csv,2009,1.0,0.0
13519,Oy Vey! My Son Is Gay!!,89507,89507,0,2010_boxofficemojo_rankings.csv,2010,1.0,0.0
13520,Mystery Team,89442,89442,0,2009_boxofficemojo_rankings.csv,2009,1.0,0.0
13521,Somebody Up There Likes Me,89435,89435,0,2013_boxofficemojo_rankings.csv,2013,1.0,0.0
13522,Cat on a Hot Tin Roof,89332,89332,0,2018_boxofficemojo_rankings.csv,2018,1.0,0.0
13523,Salvation Boulevard,89182,28468,60714,2011_boxofficemojo_rankings.csv,2011,0.31921239712049515,0.6807876028795048
13524,Home Movies,89134,89134,0,1980_boxofficemojo_rankings.csv,1980,1.0,0.0
13525,Night of the Living Dead,89029,89029,0,2017_boxofficemojo_rankings.csv,2017,1.0,0.0
13526,This Is Not a Film,88758,77016,11742,2012_boxofficemojo_rankings.csv,2012,0.8677076995876428,0.1322923004123572
13527,Let Him Have It,88686,88686,0,1991_boxofficemojo_rankings.csv,1991,1.0,0.0
13528,Diamonds,88428,88428,0,1999_boxofficemojo_rankings.csv,1999,1.0,0.0
13529,Anthony Kaun Hai?,88420,55418,33002,2006_boxofficemojo_rankings.csv,2006,0.6267586518887129,0.37324134811128706
13530,The Lumber Baron,88336,88336,0,2019_boxofficemojo_rankings.csv,2019,1.0,0.0
13531,Crazy on the Outside,88335,88335,0,2010_boxofficemojo_rankings.csv,2010,1.0,0.0
13532,Jewtopia,88327,46437,41890,2013_boxofficemojo_rankings.csv,2013,0.5257395813284726,0.4742604186715274
13533,Pete Seeger: The Power of Song,88312,88312,0,2007_boxofficemojo_rankings.csv,2007,1.0,0.0
13534,Money for Nothing: Inside the Federal Reserve,88045,88045,0,2013_boxofficemojo_rankings.csv,2013,1.0,0.0
13535,Jim Allison: Breakthrough,87984,87984,0,2019_boxofficemojo_rankings.csv,2019,1.0,0.0
13536,Little Chenier,87939,87939,0,2008_boxofficemojo_rankings.csv,2008,1.0,0.0
13537,Seeing Other People,87923,87923,0,2004_boxofficemojo_rankings.csv,2004,1.0,0.0
13538,Hyena Road,87768,1430,86338,2015_boxofficemojo_rankings.csv,2015,0.01629295415185489,0.9837070458481451
13539,The Cartel,87763,87763,0,2010_boxofficemojo_rankings.csv,2010,1.0,0.0
13540,Ocean Waves,87738,87738,0,2016_boxofficemojo_rankings.csv,2016,1.0,0.0
13541,Glory,87728,18415,69313,2017_boxofficemojo_rankings.csv,2017,0.2099101769104505,0.7900898230895496
13542,Exporting Raymond,87727,87727,0,2011_boxofficemojo_rankings.csv,2011,1.0,0.0
13543,Author: The JT LeRoy Story,87686,85999,1687,2016_boxofficemojo_rankings.csv,2016,0.9807608968364391,0.019239103163560888
13544,Goldstone 2018 Re-release,87639,87639,0,2018_boxofficemojo_rankings.csv,2018,1.0,0.0
13545,Woman on the Beach 2008 Re-release,87635,23686,63949,2008_boxofficemojo_rankings.csv,2008,0.27028013921378446,0.7297198607862155
13546,Butterfly Kiss,87626,87626,0,1996_boxofficemojo_rankings.csv,1996,1.0,0.0
13547,Frisk,87433,87433,0,1996_boxofficemojo_rankings.csv,1996,1.0,0.0
13548,Kairo 2005 Re-release,87420,51420,36000,2005_boxofficemojo_rankings.csv,2005,0.5881949210706932,0.4118050789293068
13549,Borstal Boy,87400,87400,0,2002_boxofficemojo_rankings.csv,2002,1.0,0.0
13550,America: Freedom to Fascism,87400,87400,0,2006_boxofficemojo_rankings.csv,2006,1.0,0.0
13551,First Morning,87264,87264,0,2005_boxofficemojo_rankings.csv,2005,1.0,0.0
13552,To Fall in Love,87000,87000,0,2000_boxofficemojo_rankings.csv,2000,1.0,0.0
13553,It's All True,86980,86980,0,1993_boxofficemojo_rankings.csv,1993,1.0,0.0
13554,The Zodiac,86872,45148,41724,2006_boxofficemojo_rankings.csv,2006,0.5197071553550051,0.48029284464499494
13555,War Photographer,86863,61040,25823,2002_boxofficemojo_rankings.csv,2002,0.7027157708115078,0.29728422918849223
13556,ECCO,86858,86858,0,2019_boxofficemojo_rankings.csv,2019,1.0,0.0
13557,Singularity,86822,4176,82646,2017_boxofficemojo_rankings.csv,2017,0.04809840823754348,0.9519015917624565
13558,Vault,86741,29491,57250,2019_boxofficemojo_rankings.csv,2019,0.3399891631408446,0.6600108368591554
13559,Gueros,86736,60114,26622,2015_boxofficemojo_rankings.csv,2015,0.6930686220254566,0.30693137797454345
13560,School Life,86616,37381,49235,2017_boxofficemojo_rankings.csv,2017,0.4315715341276439,0.5684284658723562
13561,Beuys,86451,65410,21041,2018_boxofficemojo_rankings.csv,2018,0.7566135730066743,0.2433864269933257
13562,"My Love, Don't Cross That River 2016 Re-release",86446,86446,0,2016_boxofficemojo_rankings.csv,2016,1.0,0.0
13563,The Ride,86307,86307,0,1997_boxofficemojo_rankings.csv,1997,1.0,0.0
13564,National Theater Live: Cyrano de Bergerac,86300,86300,0,2019_boxofficemojo_rankings.csv,2019,1.0,0.0
13565,Prey for Rock & Roll,86277,58040,28237,2003_boxofficemojo_rankings.csv,2003,0.6727169465790419,0.3272830534209581
13566,Crazy Wisdom: The Life & Times of Chogyam Trungpa Rinpoche,86202,86202,0,2011_boxofficemojo_rankings.csv,2011,1.0,0.0
13567,Second Best,86115,86115,0,1994_boxofficemojo_rankings.csv,1994,1.0,0.0
13568,Rapt 2011 Re-release,86028,45759,40269,2011_boxofficemojo_rankings.csv,2011,0.5319082159296973,0.4680917840703027
13569,Mudbound,85955,0,85955,2017_boxofficemojo_rankings.csv,2017,0.0,1.0
13570,Bay of Angels,85840,85840,0,2001_boxofficemojo_rankings.csv,2001,1.0,0.0
13571,Tab Hunter Confidential,85812,85812,0,2015_boxofficemojo_rankings.csv,2015,1.0,0.0
13572,Color of the Cross,85802,85802,0,2006_boxofficemojo_rankings.csv,2006,1.0,0.0
13573,Where's the Party Yaar?,85739,85739,0,2003_boxofficemojo_rankings.csv,2003,1.0,0.0
13574,An Almost Perfect Affair,85493,85493,0,1979_boxofficemojo_rankings.csv,1979,1.0,0.0
13575,Jackals,85410,0,85410,2017_boxofficemojo_rankings.csv,2017,0.0,1.0
13576,Julien Donkey-Boy,85400,85400,0,1999_boxofficemojo_rankings.csv,1999,1.0,0.0
13577,Chicago Joe and the Showgirl,85395,85395,0,1990_boxofficemojo_rankings.csv,1990,1.0,0.0
13578,Mind Games,85085,85085,0,1989_boxofficemojo_rankings.csv,1989,1.0,0.0
13579,Deal,85076,61626,23450,2008_boxofficemojo_rankings.csv,2008,0.72436409798298,0.2756359020170201
13580,The Good Old Naughty Days,85006,60862,24144,2002_boxofficemojo_rankings.csv,2002,0.7159729901418723,0.2840270098581277
13581,Skid Row Marathon,84997,84997,0,2019_boxofficemojo_rankings.csv,2019,1.0,0.0
13582,Three... Extremes 2005 Re-release,84976,77532,7444,2005_boxofficemojo_rankings.csv,2005,0.9123987949538693,0.08760120504613067
13583,Waking Sleeping Beauty,84918,80741,4177,2010_boxofficemojo_rankings.csv,2010,0.9508113709696413,0.0491886290303587
13584,Wilder Napalm,84859,84859,0,1993_boxofficemojo_rankings.csv,1993,1.0,0.0
13585,Ran 2016 Re-release,84789,66097,18692,2016_boxofficemojo_rankings.csv,2016,0.779546875184281,0.22045312481571902
13586,Decoys,84733,84733,0,2004_boxofficemojo_rankings.csv,2004,1.0,0.0
13587,Live Nude Girls Unite!,84706,84706,0,2000_boxofficemojo_rankings.csv,2000,1.0,0.0
13588,51 Birch Street,84689,84689,0,2006_boxofficemojo_rankings.csv,2006,1.0,0.0
13589,Wretches & Jabberers,84610,84610,0,2011_boxofficemojo_rankings.csv,2011,1.0,0.0
13590,Visitors,84577,84577,0,2014_boxofficemojo_rankings.csv,2014,1.0,0.0
13591,The Pickle,84471,84471,0,1993_boxofficemojo_rankings.csv,1993,1.0,0.0
13592,Mozart and the Whale,84447,36006,48441,2006_boxofficemojo_rankings.csv,2006,0.4263739386834346,0.5736260613165655
13593,Woodstock,84440,84440,0,2019_boxofficemojo_rankings.csv,2019,1.0,0.0
13594,Brothers of the Head,84425,45082,39343,2006_boxofficemojo_rankings.csv,2006,0.5339887474089429,0.46601125259105713
13595,Heaven Knows What,84417,80734,3683,2015_boxofficemojo_rankings.csv,2015,0.9563713470035656,0.04362865299643437
13596,The Diabolical,84259,0,84259,2015_boxofficemojo_rankings.csv,2015,0.0,1.0
13597,Chapter & Verse,84147,84147,0,2017_boxofficemojo_rankings.csv,2017,1.0,0.0
13598,"Me & You, Us, Forever",84093,84093,0,2008_boxofficemojo_rankings.csv,2008,1.0,0.0
13599,Los Sures,83992,83992,0,2016_boxofficemojo_rankings.csv,2016,1.0,0.0
13600,The Disappearance of My Mother,83930,24951,58979,2019_boxofficemojo_rankings.csv,2019,0.29728345049445964,0.7027165495055403
13601,Why Me?,83882,83882,0,1990_boxofficemojo_rankings.csv,1990,1.0,0.0
13602,16 Days of Glory,83857,83857,0,1986_boxofficemojo_rankings.csv,1986,1.0,0.0
13603,"Nico, 1988",83558,73304,10254,2018_boxofficemojo_rankings.csv,2018,0.8772828454486704,0.12271715455132962
13604,Fools of Fortune,83490,83490,0,1990_boxofficemojo_rankings.csv,1990,1.0,0.0
13605,The Real Blonde,83488,83488,0,1998_boxofficemojo_rankings.csv,1998,1.0,0.0
13606,Young Ahmed Domestic,83470,21291,62179,2020_boxofficemojo_rankings.csv,2020,0.25507367916616747,0.7449263208338325
13607,He Was a Quiet Man,83440,2431,81009,2007_boxofficemojo_rankings.csv,2007,0.02913470757430489,0.9708652924256951
13608,Barely Legal,83439,26511,56928,2005_boxofficemojo_rankings.csv,2005,0.3177291194765038,0.6822708805234962
13609,Save Me,83397,83397,0,2008_boxofficemojo_rankings.csv,2008,1.0,0.0
13610,ABCD,83372,83372,0,2001_boxofficemojo_rankings.csv,2001,1.0,0.0
13611,The Treatment,83354,83354,0,2007_boxofficemojo_rankings.csv,2007,1.0,0.0
13612,Z,83305,83305,0,2009_boxofficemojo_rankings.csv,2009,1.0,0.0
13613,Maria Stuarda at La Scala,83214,83214,0,2008_boxofficemojo_rankings.csv,2008,1.0,0.0
13614,The Look,83137,19988,63149,2011_boxofficemojo_rankings.csv,2011,0.2404224352574666,0.7595775647425335
13615,The Kindness of Strangers,83042,2705,80337,2019_boxofficemojo_rankings.csv,2019,0.032573878278461504,0.9674261217215385
13616,Hateship Loveship,83008,54030,28978,2014_boxofficemojo_rankings.csv,2014,0.6509011179645335,0.34909888203546646
13617,Le Doulos,82772,82772,0,2007_boxofficemojo_rankings.csv,2007,1.0,0.0
13618,Alien Abduction,82725,12897,69828,2014_boxofficemojo_rankings.csv,2014,0.15590208522212148,0.8440979147778785
13619,Doctor Who: The Woman Who Fell to Earth,82698,82698,0,2018_boxofficemojo_rankings.csv,2018,1.0,0.0
13620,Hanussen,82635,82635,0,1989_boxofficemojo_rankings.csv,1989,1.0,0.0
13621,12 O'Clock Boys,82614,82614,0,2014_boxofficemojo_rankings.csv,2014,1.0,0.0
13622,Praying with Lior,82553,82553,0,2008_boxofficemojo_rankings.csv,2008,1.0,0.0
13623,Funny Ha Ha,82528,77070,5458,2005_boxofficemojo_rankings.csv,2005,0.9338648701046918,0.06613512989530826
13624,V/H/S Viral,82409,2756,79653,2014_boxofficemojo_rankings.csv,2014,0.033442949192442575,0.9665570508075574
13625,The Treasure,82392,50203,32189,2016_boxofficemojo_rankings.csv,2016,0.6093188659093116,0.39068113409068844
13626,Better Living Through Circuitry,82378,82378,0,2000_boxofficemojo_rankings.csv,2000,1.0,0.0
13627,Humboldt County,82357,82357,0,2008_boxofficemojo_rankings.csv,2008,1.0,0.0
13628,Water & Power,82312,82312,0,2014_boxofficemojo_rankings.csv,2014,1.0,0.0
13629,Prey,82258,0,82258,2019_boxofficemojo_rankings.csv,2019,0.0,1.0
13630,Careful What You Wish For,82230,0,82230,2015_boxofficemojo_rankings.csv,2015,0.0,1.0
13631,On the Basis of Sex 2020 Re-release,82150,82150,0,2020_boxofficemojo_rankings.csv,2020,1.0,0.0
13632,Killer: A Journal of Murder,82029,82029,0,1996_boxofficemojo_rankings.csv,1996,1.0,0.0
13633,The Whale,81881,81881,0,2011_boxofficemojo_rankings.csv,2011,1.0,0.0
13634,Naked Tango,81777,81777,0,1991_boxofficemojo_rankings.csv,1991,1.0,0.0
13635,Best Man in Grass Creek,81760,81760,0,2001_boxofficemojo_rankings.csv,2001,1.0,0.0
13636,King Cobra,81757,81757,0,2016_boxofficemojo_rankings.csv,2016,1.0,0.0
13637,Inkubus,81600,81600,0,2011_boxofficemojo_rankings.csv,2011,1.0,0.0
13638,'R Xmas,81476,850,80626,2001_boxofficemojo_rankings.csv,2001,0.010432520005891305,0.9895674799941087
13639,Anything But Love,81451,81451,0,2003_boxofficemojo_rankings.csv,2003,1.0,0.0
13640,A State of Mind,81450,41468,39982,2005_boxofficemojo_rankings.csv,2005,0.509122160834868,0.490877839165132
13641,Hating Breitbart,81432,81432,0,2012_boxofficemojo_rankings.csv,2012,1.0,0.0
13642,The Girl in the Book,81379,8245,73134,2015_boxofficemojo_rankings.csv,2015,0.10131606434092333,0.8986839356590767
13643,Vaastav: The Reality,81367,81367,0,1999_boxofficemojo_rankings.csv,1999,1.0,0.0
13644,The Future of Food,81280,81280,0,2005_boxofficemojo_rankings.csv,2005,1.0,0.0
13645,Patti Smith: Dream of Life,81113,30918,50195,2008_boxofficemojo_rankings.csv,2008,0.3811719453108626,0.6188280546891374
13646,Yomeddine,81030,11308,69722,2018_boxofficemojo_rankings.csv,2018,0.139553251882019,0.8604467481179809
13647,The Island President,80996,76398,4598,2012_boxofficemojo_rankings.csv,2012,0.9432317645315818,0.05676823546841819
13648,Burning Bush,80943,16731,64212,2013_boxofficemojo_rankings.csv,2013,0.2067010118231348,0.7932989881768652
13649,Woman Walks Ahead,80912,57528,23384,2018_boxofficemojo_rankings.csv,2018,0.7109946608661262,0.28900533913387383
13650,Brother to Brother,80906,80906,0,2004_boxofficemojo_rankings.csv,2004,1.0,0.0
13651,The Big Blue 2000 Director's Cut,80882,80882,0,2000_boxofficemojo_rankings.csv,2000,1.0,0.0
13652,Taur Mittran Di,80879,69510,11369,2012_boxofficemojo_rankings.csv,2012,0.8594319909988996,0.14056800900110042
13653,Chrystal,80858,80858,0,2005_boxofficemojo_rankings.csv,2005,1.0,0.0
13654,Slappy and the Stinkers,80837,80837,0,1998_boxofficemojo_rankings.csv,1998,1.0,0.0
13655,Kind Hearts and Coronets 2019 Re-release,80795,35948,44847,2019_boxofficemojo_rankings.csv,2019,0.444928522804629,0.555071477195371
13656,Nasty Baby,80772,79800,972,2015_boxofficemojo_rankings.csv,2015,0.98796612687565,0.012033873124350022
13657,Trace Amounts,80735,80735,0,2015_boxofficemojo_rankings.csv,2015,1.0,0.0
13658,Batman Returns 2019 Re-release,80699,70642,10057,2019_boxofficemojo_rankings.csv,2019,0.8753763987162171,0.12462360128378294
13659,Ms. Purple,80657,80657,0,2019_boxofficemojo_rankings.csv,2019,1.0,0.0
13660,Enemies of the People,80654,73171,7483,2010_boxofficemojo_rankings.csv,2010,0.9072209685818434,0.09277903141815658
13661,Winnie Mandela,80634,80634,0,2013_boxofficemojo_rankings.csv,2013,1.0,0.0
13662,Always Kabhi Kabhi,80546,21381,59165,2011_boxofficemojo_rankings.csv,2011,0.26545079830159163,0.7345492016984083
13663,Il trittico dell'amore,80374,80374,0,2008_boxofficemojo_rankings.csv,2008,1.0,0.0
13664,Ginger Snaps 2: Unleashed,80372,80372,0,2004_boxofficemojo_rankings.csv,2004,1.0,0.0
13665,Free Radicals,80371,1443,78928,2003_boxofficemojo_rankings.csv,2003,0.017954237224869666,0.9820457627751303
13666,Songs from the Second Floor,80334,80334,0,2001_boxofficemojo_rankings.csv,2001,1.0,0.0
13667,The Mysteries of Pittsburgh,80283,80283,0,2009_boxofficemojo_rankings.csv,2009,1.0,0.0
13668,Armstrong,80169,19740,60429,2019_boxofficemojo_rankings.csv,2019,0.24622983946413202,0.753770160535868
13669,For the Love of Spock,80141,80141,0,2016_boxofficemojo_rankings.csv,2016,1.0,0.0
13670,Mannat,80119,53589,26530,2006_boxofficemojo_rankings.csv,2006,0.6688675595052359,0.33113244049476404
13671,Inhale,80112,4115,75997,2010_boxofficemojo_rankings.csv,2010,0.051365588176552825,0.9486344118234472
13672,Ramaiya Vastavaiya,80108,80108,0,2013_boxofficemojo_rankings.csv,2013,1.0,0.0
13673,Jack Paradise (Les nuits de Montréal),79974,79974,0,2004_boxofficemojo_rankings.csv,2004,1.0,0.0
13674,Searching for the Wrong-Eyed Jesus,79916,79916,0,2005_boxofficemojo_rankings.csv,2005,1.0,0.0
13675,En el séptimo día,79887,79887,0,2018_boxofficemojo_rankings.csv,2018,1.0,0.0
13676,Seventh Heaven,79808,79808,0,1998_boxofficemojo_rankings.csv,1998,1.0,0.0
13677,Air Guitar Nation,79770,71471,8299,2007_boxofficemojo_rankings.csv,2007,0.8959633947599348,0.1040366052400652
13678,Made-Up,79766,79766,0,2003_boxofficemojo_rankings.csv,2003,1.0,0.0
13679,"Sobibór, October 14, 1943, 4 p.m.",79728,41040,38688,2001_boxofficemojo_rankings.csv,2001,0.5147501505117399,0.4852498494882601
13680,Ripe,79727,79727,0,1997_boxofficemojo_rankings.csv,1997,1.0,0.0
13681,Ballast,79710,77556,2154,2008_boxofficemojo_rankings.csv,2008,0.9729770417764396,0.027022958223560406
13682,Aurangzeb,79665,0,79665,2013_boxofficemojo_rankings.csv,2013,0.0,1.0
13683,Harvest of Empire,79627,79627,0,2012_boxofficemojo_rankings.csv,2012,1.0,0.0
13684,Camp X-Ray,79624,13302,66322,2014_boxofficemojo_rankings.csv,2014,0.16706018285943935,0.8329398171405606
13685,End of the Century,79607,66309,13298,2019_boxofficemojo_rankings.csv,2019,0.832954388433178,0.16704561156682202
13686,Suits on the Loose,79470,79470,0,2006_boxofficemojo_rankings.csv,2006,1.0,0.0
13687,Cover,79436,79436,0,2008_boxofficemojo_rankings.csv,2008,1.0,0.0
13688,Jayne Mansfield's Car,79178,14836,64342,2013_boxofficemojo_rankings.csv,2013,0.18737528101240244,0.8126247189875976
13689,Concussion,78957,42606,36351,2013_boxofficemojo_rankings.csv,2013,0.5396101675595577,0.4603898324404423
13690,Fort McCoy,78948,78948,0,2014_boxofficemojo_rankings.csv,2014,1.0,0.0
13691,Radiant City,78944,78944,0,2007_boxofficemojo_rankings.csv,2007,1.0,0.0
13692,Me and Him,78814,78814,0,1989_boxofficemojo_rankings.csv,1989,1.0,0.0
13693,Christ Stopped at Eboli,78736,78736,0,2019_boxofficemojo_rankings.csv,2019,1.0,0.0
13694,The Boxcar Children - Surprise Island,78676,78676,0,2018_boxofficemojo_rankings.csv,2018,1.0,0.0
13695,Blackbird,78400,78400,0,2015_boxofficemojo_rankings.csv,2015,1.0,0.0
13696,Bugs Bunny's 3rd Movie: 1001 Rabbit Tales,78350,78350,0,1982_boxofficemojo_rankings.csv,1982,1.0,0.0
13697,Harold and Lillian: A Hollywood Love Story,78301,78301,0,2017_boxofficemojo_rankings.csv,2017,1.0,0.0
13698,Colliding Dreams,78288,78288,0,2016_boxofficemojo_rankings.csv,2016,1.0,0.0
13699,Anesthesia,78270,32163,46107,2016_boxofficemojo_rankings.csv,2016,0.41092372556535073,0.5890762744346493
13700,To Want to Fly,78144,78144,0,1993_boxofficemojo_rankings.csv,1993,1.0,0.0
13701,Un traductor,78075,13509,64566,2018_boxofficemojo_rankings.csv,2018,0.17302593659942364,0.8269740634005763
13702,The Neon Bible,78072,78072,0,1996_boxofficemojo_rankings.csv,1996,1.0,0.0
13703,Hardbodies 2,78068,78068,0,1986_boxofficemojo_rankings.csv,1986,1.0,0.0
13704,Jodi Breakers,78024,52618,25406,2012_boxofficemojo_rankings.csv,2012,0.6743822413616323,0.32561775863836767
13705,Genealogies of a Crime,77998,77998,0,1998_boxofficemojo_rankings.csv,1998,1.0,0.0
13706,Homegrown,77910,77910,0,1998_boxofficemojo_rankings.csv,1998,1.0,0.0
13707,Ping Pong Playa,77907,77907,0,2008_boxofficemojo_rankings.csv,2008,1.0,0.0
13708,Bright Leaves,77888,77888,0,2004_boxofficemojo_rankings.csv,2004,1.0,0.0
13709,Heaven,77886,77886,0,1987_boxofficemojo_rankings.csv,1987,1.0,0.0
13710,Baraka 2002 Re-release,77873,77873,0,2002_boxofficemojo_rankings.csv,2002,1.0,0.0
13711,Table No. 21,77621,46720,30901,2013_boxofficemojo_rankings.csv,2013,0.6018989706393888,0.39810102936061115
13712,Chevalier,77590,25696,51894,2015_boxofficemojo_rankings.csv,2015,0.3311766980280964,0.6688233019719036
13713,The Princess Blade,77567,77567,0,2003_boxofficemojo_rankings.csv,2003,1.0,0.0
13714,Circo,77466,77466,0,2011_boxofficemojo_rankings.csv,2011,1.0,0.0
13715,The Art of the Steal,77450,64065,13385,2014_boxofficemojo_rankings.csv,2014,0.8271788250484183,0.17282117495158167
13716,Finding Amanda,77410,57297,20113,2008_boxofficemojo_rankings.csv,2008,0.7401756878956207,0.2598243121043793
13717,Breaking Upwards,77389,77389,0,2010_boxofficemojo_rankings.csv,2010,1.0,0.0
13718,The Sun 2009 Re-release,77303,77303,0,2009_boxofficemojo_rankings.csv,2009,1.0,0.0
13719,To Catch a Dollar: Muhammad Yunus Banks on America,77142,77142,0,2011_boxofficemojo_rankings.csv,2011,1.0,0.0
13720,Parchi,77110,69431,7679,2018_boxofficemojo_rankings.csv,2018,0.9004149915704838,0.09958500842951627
13721,The Missing Picture,76933,52164,24769,2014_boxofficemojo_rankings.csv,2014,0.6780445322553391,0.32195546774466094
13722,Fast Color,76916,76916,0,2019_boxofficemojo_rankings.csv,2019,1.0,0.0
13723,How the West Was Won 2003 Re-release,76729,76729,0,2003_boxofficemojo_rankings.csv,2003,1.0,0.0
13724,Eisenstein in Guanajuato 2015 Re-release,76713,34282,42431,2015_boxofficemojo_rankings.csv,2015,0.4468864468864469,0.5531135531135531
13725,Mademoiselle C,76621,48668,27953,2013_boxofficemojo_rankings.csv,2013,0.6351783453622375,0.3648216546377625
13726,Speaking Parts,76609,76609,0,1990_boxofficemojo_rankings.csv,1990,1.0,0.0
13727,Blue Moon,76544,76544,0,2000_boxofficemojo_rankings.csv,2000,1.0,0.0
13728,The New Rijksmuseum - The Film,76460,40578,35882,2015_boxofficemojo_rankings.csv,2015,0.5307088673816375,0.4692911326183625
13729,Steal This Movie,76424,76424,0,2000_boxofficemojo_rankings.csv,2000,1.0,0.0
13730,After Midnight,76325,76325,0,1989_boxofficemojo_rankings.csv,1989,1.0,0.0
13731,Swimming Upstream 2004 Re-release,76287,54965,21322,2004_boxofficemojo_rankings.csv,2004,0.7205028379671503,0.27949716203284963
13732,Night Catches Us,76185,76185,0,2010_boxofficemojo_rankings.csv,2010,1.0,0.0
13733,America the Beautiful,76173,76173,0,2008_boxofficemojo_rankings.csv,2008,1.0,0.0
13734,Don't Blink,76134,76134,0,2016_boxofficemojo_rankings.csv,2016,1.0,0.0
13735,93Queen,76056,76056,0,2018_boxofficemojo_rankings.csv,2018,1.0,0.0
13736,Office Killer,76054,76054,0,1997_boxofficemojo_rankings.csv,1997,1.0,0.0
13737,Greener Grass,76045,51456,24589,2019_boxofficemojo_rankings.csv,2019,0.6766519823788546,0.3233480176211454
13738,Whitey: United States of America v. James J. Bulger,75881,75881,0,2014_boxofficemojo_rankings.csv,2014,1.0,0.0
13739,Wish You Were Here 2013 Re-release,75870,46347,29523,2013_boxofficemojo_rankings.csv,2013,0.6108738631870304,0.38912613681296954
13740,"Bert Rigby, You're a Fool",75868,75868,0,1989_boxofficemojo_rankings.csv,1989,1.0,0.0
13741,Into the White 2013 Re-release,75747,704,75043,2013_boxofficemojo_rankings.csv,2013,0.009294097456004858,0.9907059025439952
13742,Touch Me Not,75507,13782,61725,2018_boxofficemojo_rankings.csv,2018,0.18252612340577695,0.8174738765942231
13743,The Riot Act,75506,75506,0,2018_boxofficemojo_rankings.csv,2018,1.0,0.0
13744,Swim Little Fish Swim,75504,3877,71627,2014_boxofficemojo_rankings.csv,2014,0.05134827293918203,0.948651727060818
13745,Hum To Mohabbat Karega,75446,75446,0,2000_boxofficemojo_rankings.csv,2000,1.0,0.0
13746,Tears of the Black Tiger 2007 Re-release,75234,75234,0,2007_boxofficemojo_rankings.csv,2007,1.0,0.0
13747,Restaurant,75232,75232,0,2000_boxofficemojo_rankings.csv,2000,1.0,0.0
13748,An Everlasting Piece,75228,75228,0,2000_boxofficemojo_rankings.csv,2000,1.0,0.0
13749,Widespread Panic: The Earth Will Swallow You,75204,75204,0,2002_boxofficemojo_rankings.csv,2002,1.0,0.0
13750,Ghost Town,75000,75000,0,1988_boxofficemojo_rankings.csv,1988,1.0,0.0
13751,Bill Nye: Science Guy,74909,74909,0,2017_boxofficemojo_rankings.csv,2017,1.0,0.0
13752,Where Is Kyra?,74821,59717,15104,2018_boxofficemojo_rankings.csv,2018,0.7981315406102565,0.20186845938974352
13753,August Evening,74759,74759,0,2008_boxofficemojo_rankings.csv,2008,1.0,0.0
13754,The Ornithologist,74714,50511,24203,2016_boxofficemojo_rankings.csv,2016,0.6760580346387558,0.3239419653612442
13755,Above and Beyond: NASA's Journey to Tomorrow,74711,74711,0,2018_boxofficemojo_rankings.csv,2018,1.0,0.0
13756,Batkid Begins: The Wish Heard Around the World,74709,74709,0,2015_boxofficemojo_rankings.csv,2015,1.0,0.0
13757,The Monster,74700,12544,62156,2016_boxofficemojo_rankings.csv,2016,0.16792503346720214,0.8320749665327979
13758,The War Within,74655,74655,0,2005_boxofficemojo_rankings.csv,2005,1.0,0.0
13759,We Come as Friends,74633,50921,23712,2014_boxofficemojo_rankings.csv,2014,0.6822853161470127,0.3177146838529873
13760,The Nomi Song,74631,74631,0,2005_boxofficemojo_rankings.csv,2005,1.0,0.0
13761,Hadewijch,74586,5006,69580,2010_boxofficemojo_rankings.csv,2010,0.0671171533531762,0.9328828466468237
13762,Stations of the Cross,74509,1505,73004,2014_boxofficemojo_rankings.csv,2014,0.02019890214604947,0.9798010978539505
13763,Made in Bangladesh,74432,5322,69110,2019_boxofficemojo_rankings.csv,2019,0.07150150472914875,0.9284984952708513
13764,Shoot Down,74421,74421,0,2008_boxofficemojo_rankings.csv,2008,1.0,0.0
13765,Reset,74341,5454,68887,2016_boxofficemojo_rankings.csv,2016,0.07336463055379938,0.9266353694462006
13766,Set Me Free,74052,74052,0,2000_boxofficemojo_rankings.csv,2000,1.0,0.0
13767,Virtual Sexuality,74007,74007,0,1999_boxofficemojo_rankings.csv,1999,1.0,0.0
13768,The Boy Downstairs,73988,13638,60350,2018_boxofficemojo_rankings.csv,2018,0.1843271881926799,0.8156728118073201
13769,"The Beans of Egypt, Maine",73956,73956,0,1994_boxofficemojo_rankings.csv,1994,1.0,0.0
13770,The Keeping Room,73922,27166,46756,2015_boxofficemojo_rankings.csv,2015,0.3674954681962068,0.6325045318037932
13771,After Auschwitz,73885,73885,0,2018_boxofficemojo_rankings.csv,2018,1.0,0.0
13772,Love N' Dancing,73848,47812,26036,2009_boxofficemojo_rankings.csv,2009,0.6474379807171488,0.35256201928285125
13773,Captive Hearts,73757,73757,0,1987_boxofficemojo_rankings.csv,1987,1.0,0.0
13774,War Pigs,73701,0,73701,2015_boxofficemojo_rankings.csv,2015,0.0,1.0
13775,Wait for Your Laugh,73585,73585,0,2017_boxofficemojo_rankings.csv,2017,1.0,0.0
13776,Prodigal Sons,73544,73544,0,2010_boxofficemojo_rankings.csv,2010,1.0,0.0
13777,On the Ice,73492,73492,0,2012_boxofficemojo_rankings.csv,2012,1.0,0.0
13778,A Four Letter Word,73445,72568,877,2008_boxofficemojo_rankings.csv,2008,0.9880590918374293,0.01194090816257063
13779,Primal Rage: The Legend of Konga,73383,21497,51886,2018_boxofficemojo_rankings.csv,2018,0.2929425071201777,0.7070574928798223
13780,Father and Son,73351,39291,34060,2004_boxofficemojo_rankings.csv,2004,0.5356573189186241,0.46434268108137583
13781,Vengeance: A Love Story,73270,4526,68744,2017_boxofficemojo_rankings.csv,2017,0.06177152995769073,0.9382284700423092
13782,Te Ata,73236,73236,0,2017_boxofficemojo_rankings.csv,2017,1.0,0.0
13783,The Theory of Flight,73233,73233,0,1998_boxofficemojo_rankings.csv,1998,1.0,0.0
13784,When the Whales Came,73131,73131,0,1989_boxofficemojo_rankings.csv,1989,1.0,0.0
13785,Antonio Lopez 1970: Sex Fashion & Disco,73122,43169,29953,2018_boxofficemojo_rankings.csv,2018,0.5903695194332759,0.40963048056672413
13786,Buster's Mal Heart,73121,73121,0,2017_boxofficemojo_rankings.csv,2017,1.0,0.0
13787,Headshot,73010,0,73010,2017_boxofficemojo_rankings.csv,2017,0.0,1.0
13788,5B,72968,72968,0,2019_boxofficemojo_rankings.csv,2019,1.0,0.0
13789,Come Away Home,72810,72810,0,2005_boxofficemojo_rankings.csv,2005,1.0,0.0
13790,Do Not Resist,72791,72791,0,2016_boxofficemojo_rankings.csv,2016,1.0,0.0
13791,The Seagull's Laughter,72527,72527,0,2004_boxofficemojo_rankings.csv,2004,1.0,0.0
13792,Stiff Upper Lips,72482,72482,0,1999_boxofficemojo_rankings.csv,1999,1.0,0.0
13793,Unconscious,72275,68501,3774,2006_boxofficemojo_rankings.csv,2006,0.9477827741265998,0.052217225873400205
13794,Eye of the Dolphin,72260,72210,50,2007_boxofficemojo_rankings.csv,2007,0.999308054248547,0.0006919457514530861
13795,Dorian Blues,72234,72234,0,2005_boxofficemojo_rankings.csv,2005,1.0,0.0
13796,Loving Jezebel,72190,72190,0,2000_boxofficemojo_rankings.csv,2000,1.0,0.0
13797,The Green Wave,72152,0,72152,2011_boxofficemojo_rankings.csv,2011,0.0,1.0
13798,Partisan,72151,0,72151,2015_boxofficemojo_rankings.csv,2015,0.0,1.0
13799,After Tiller,72125,72125,0,2013_boxofficemojo_rankings.csv,2013,1.0,0.0
13800,Hollywood Buddha,72115,72115,0,2004_boxofficemojo_rankings.csv,2004,1.0,0.0
13801,Veil of Tears,72078,72078,0,2014_boxofficemojo_rankings.csv,2014,1.0,0.0
13802,Naked in Ashes,72073,72073,0,2005_boxofficemojo_rankings.csv,2005,1.0,0.0
13803,The Invisible War,71968,71968,0,2012_boxofficemojo_rankings.csv,2012,1.0,0.0
13804,The Chambermaid Lynn,71918,315,71603,2015_boxofficemojo_rankings.csv,2015,0.004379988320031147,0.9956200116799688
13805,Raiders!: The Story of the Greatest Fan Film Ever Made,71916,71916,0,2016_boxofficemojo_rankings.csv,2016,1.0,0.0
13806,Come and See 2020 Re-release,71909,71909,0,2020_boxofficemojo_rankings.csv,2020,1.0,0.0
13807,An Oversimplification of Her Beauty,71906,71906,0,2013_boxofficemojo_rankings.csv,2013,1.0,0.0
13808,Umberto D.,71816,71816,0,2002_boxofficemojo_rankings.csv,2002,1.0,0.0
13809,As I Lay Dying,71759,16697,55062,2013_boxofficemojo_rankings.csv,2013,0.23268161484970526,0.7673183851502947
13810,New Suit,71743,71743,0,2003_boxofficemojo_rankings.csv,2003,1.0,0.0
13811,Runaway Slave,71737,71737,0,2012_boxofficemojo_rankings.csv,2012,1.0,0.0
13812,Flamenco Flamenco 2014 Re-release,71732,71732,0,2014_boxofficemojo_rankings.csv,2014,1.0,0.0
13813,"Je t'aime, je t'aime 2014 Re-release",71717,71717,0,2014_boxofficemojo_rankings.csv,2014,1.0,0.0
13814,Body of War,71716,71716,0,2008_boxofficemojo_rankings.csv,2008,1.0,0.0
13815,The Dummy,71646,71646,0,2003_boxofficemojo_rankings.csv,2003,1.0,0.0
13816,Herman U.S.A.,71509,71509,0,2001_boxofficemojo_rankings.csv,2001,1.0,0.0
13817,The Congressman,71451,71451,0,2016_boxofficemojo_rankings.csv,2016,1.0,0.0
13818,A Troll in Central Park,71368,71368,0,1994_boxofficemojo_rankings.csv,1994,1.0,0.0
13819,The Search for One-eye Jimmy,71314,71314,0,1996_boxofficemojo_rankings.csv,1996,1.0,0.0
13820,The Sicilian Girl 2010 Re-release,71239,71239,0,2010_boxofficemojo_rankings.csv,2010,1.0,0.0
13821,Freedom on My Mind,71176,71176,0,1994_boxofficemojo_rankings.csv,1994,1.0,0.0
13822,My Journey Through French Cinema,71174,52214,18960,2016_boxofficemojo_rankings.csv,2016,0.7336105881361171,0.2663894118638829
13823,Plump Fiction,71145,71145,0,1998_boxofficemojo_rankings.csv,1998,1.0,0.0
13824,Free Trip to Egypt 2019 Re-release,71087,71087,0,2019_boxofficemojo_rankings.csv,2019,1.0,0.0
13825,Boricua's Bond,71046,71046,0,2000_boxofficemojo_rankings.csv,2000,1.0,0.0
13826,Rosencrantz and Guildenstern Are Undead,71007,71007,0,2010_boxofficemojo_rankings.csv,2010,1.0,0.0
13827,Freaks of Nature,70958,70958,0,2015_boxofficemojo_rankings.csv,2015,1.0,0.0
13828,Norman Lear: Just Another Version of You,70950,70950,0,2016_boxofficemojo_rankings.csv,2016,1.0,0.0
13829,It Runs in the Family,70936,70936,0,1994_boxofficemojo_rankings.csv,1994,1.0,0.0
13830,Todo el poder,70920,70920,0,2003_boxofficemojo_rankings.csv,2003,1.0,0.0
13831,The Better Angels,70918,70918,0,2014_boxofficemojo_rankings.csv,2014,1.0,0.0
13832,Happy Together,70912,70912,0,1990_boxofficemojo_rankings.csv,1990,1.0,0.0
13833,4:44 Last Day on Earth,70851,17801,53050,2012_boxofficemojo_rankings.csv,2012,0.2512455716927072,0.7487544283072928
13834,Miss Lovely,70845,0,70845,2014_boxofficemojo_rankings.csv,2014,0.0,1.0
13835,Big Man Japan 2008 Re-release,70681,40796,29885,2008_boxofficemojo_rankings.csv,2008,0.5771848162872625,0.4228151837127375
13836,How to Build a Girl,70632,70632,0,2020_boxofficemojo_rankings.csv,2020,1.0,0.0
13837,Seasons of Gray,70605,70605,0,2013_boxofficemojo_rankings.csv,2013,1.0,0.0
13838,Fireflies in the Garden 2011 Re-release,70600,70600,0,2011_boxofficemojo_rankings.csv,2011,1.0,0.0
13839,Snipes,70569,70569,0,2002_boxofficemojo_rankings.csv,2002,1.0,0.0
13840,Go for Sisters,70495,70495,0,2013_boxofficemojo_rankings.csv,2013,1.0,0.0
13841,The Secret Adventures of Tom Thumb,70441,70441,0,1994_boxofficemojo_rankings.csv,1994,1.0,0.0
13842,The Fog 2018 Re-release,70421,70421,0,2018_boxofficemojo_rankings.csv,2018,1.0,0.0
13843,Uproar,70257,70257,0,1999_boxofficemojo_rankings.csv,1999,1.0,0.0
13844,Over Your Cities Grass Will Grow,70256,51301,18955,2010_boxofficemojo_rankings.csv,2010,0.7302009792757914,0.2697990207242086
13845,Crips and Bloods: Made in America,70219,70219,0,2009_boxofficemojo_rankings.csv,2009,1.0,0.0
13846,Cavite,70071,70071,0,2006_boxofficemojo_rankings.csv,2006,1.0,0.0
13847,Manifesto,70060,70060,0,1989_boxofficemojo_rankings.csv,1989,1.0,0.0
13848,Wastelander,70045,70045,0,2018_boxofficemojo_rankings.csv,2018,1.0,0.0
13849,The Business of Being Born,69991,69991,0,2008_boxofficemojo_rankings.csv,2008,1.0,0.0
13850,Nick Mason's Saucerful of Secrets: Live at the Roundhouse,69967,32444,37523,2020_boxofficemojo_rankings.csv,2020,0.4637043177497963,0.5362956822502036
13851,Manic,69958,69958,0,2003_boxofficemojo_rankings.csv,2003,1.0,0.0
13852,The Mirror,69915,69915,0,1998_boxofficemojo_rankings.csv,1998,1.0,0.0
13853,Take Out,69816,69816,0,2008_boxofficemojo_rankings.csv,2008,1.0,0.0
13854,Turn It Around: The Story of East Bay Punk,69787,69787,0,2017_boxofficemojo_rankings.csv,2017,1.0,0.0
13855,Zoo,69770,69770,0,2007_boxofficemojo_rankings.csv,2007,1.0,0.0
13856,Mga munting tinig,69739,69739,0,2003_boxofficemojo_rankings.csv,2003,1.0,0.0
13857,Assassination of a High School President,69564,0,69564,2010_boxofficemojo_rankings.csv,2010,0.0,1.0
13858,Dopamine,69544,69544,0,2003_boxofficemojo_rankings.csv,2003,1.0,0.0
13859,Chef Flynn,69542,68407,1135,2018_boxofficemojo_rankings.csv,2018,0.9836789278421674,0.016321072157832676
13860,Back to the Jurassic,69423,4351,65072,2015_boxofficemojo_rankings.csv,2015,0.0626737536551287,0.9373262463448713
13861,"Late August, Early September",69400,69400,0,1999_boxofficemojo_rankings.csv,1999,1.0,0.0
13862,An Inconsistent Truth,69394,69394,0,2012_boxofficemojo_rankings.csv,2012,1.0,0.0
13863,Dark Matter,69379,30591,38788,2008_boxofficemojo_rankings.csv,2008,0.44092592859510804,0.559074071404892
13864,Wild Geese II,69342,69342,0,1985_boxofficemojo_rankings.csv,1985,1.0,0.0
13865,BBC2 Play of the Week: Langrishe Go Down,69338,69338,0,2002_boxofficemojo_rankings.csv,2002,1.0,0.0
13866,Siddharth,69310,60537,8773,2014_boxofficemojo_rankings.csv,2014,0.8734237483768575,0.1265762516231424
13867,Rocky Handsome,69289,0,69289,2016_boxofficemojo_rankings.csv,2016,0.0,1.0
13868,Girls Can't Swim,69250,69250,0,2002_boxofficemojo_rankings.csv,2002,1.0,0.0
13869,White on Rice,69171,69171,0,2009_boxofficemojo_rankings.csv,2009,1.0,0.0
13870,Behind the Mask: The Rise of Leslie Vernon,69136,69136,0,2007_boxofficemojo_rankings.csv,2007,1.0,0.0
13871,Bajatey Raho,69085,55397,13688,2013_boxofficemojo_rankings.csv,2013,0.8018672649634508,0.19813273503654918
13872,August,69081,69081,0,1996_boxofficemojo_rankings.csv,1996,1.0,0.0
13873,The White Sheik 2019 re-release,68940,50850,18090,2019_boxofficemojo_rankings.csv,2019,0.737597911227154,0.26240208877284593
13874,The Pinochet Case,68934,35701,33233,2001_boxofficemojo_rankings.csv,2001,0.5179011808396438,0.4820988191603563
13875,My Entire High School Sinking Into the Sea,68883,68883,0,2017_boxofficemojo_rankings.csv,2017,1.0,0.0
13876,Klown 2012 Re-release,68795,68795,0,2012_boxofficemojo_rankings.csv,2012,1.0,0.0
13877,Under the Sun of Satan,68765,68765,0,1989_boxofficemojo_rankings.csv,1989,1.0,0.0
13878,Strange Powers: Stephin Merritt and the Magnetic Fields,68719,68719,0,2010_boxofficemojo_rankings.csv,2010,1.0,0.0
13879,Bundy,68716,6073,62643,2002_boxofficemojo_rankings.csv,2002,0.08837825251760871,0.9116217474823913
13880,Noma: My Perfect Storm,68622,21130,47492,2015_boxofficemojo_rankings.csv,2015,0.30791874326017893,0.692081256739821
13881,Take Me to the River,68598,68598,0,2014_boxofficemojo_rankings.csv,2014,1.0,0.0
13882,Mastizaade,68583,43403,25180,2016_boxofficemojo_rankings.csv,2016,0.6328536226178499,0.3671463773821501
13883,Wildflower,68577,18062,50515,2016_boxofficemojo_rankings.csv,2016,0.2633827668168628,0.7366172331831372
13884,Cowboys and Angels,68568,33941,34627,2004_boxofficemojo_rankings.csv,2004,0.49499766654999416,0.5050023334500058
13885,Outside In,68492,68492,0,2018_boxofficemojo_rankings.csv,2018,1.0,0.0
13886,Alive and Kicking,68485,68485,0,2017_boxofficemojo_rankings.csv,2017,1.0,0.0
13887,Last Year at Marienbad 2019 Re-release,68402,63425,4977,2019_boxofficemojo_rankings.csv,2019,0.9272389696207713,0.07276103037922868
13888,Budrus,68353,68353,0,2010_boxofficemojo_rankings.csv,2010,1.0,0.0
13889,2012: Time for Change,68339,68339,0,2010_boxofficemojo_rankings.csv,2010,1.0,0.0
13890,The Eyes of Orson Welles,68328,10253,58075,2018_boxofficemojo_rankings.csv,2018,0.15005561409670998,0.84994438590329
13891,10x10,68260,2263,65997,2018_boxofficemojo_rankings.csv,2018,0.033152651626135364,0.9668473483738647
13892,Shake Hands with the Devil: The Journey of Roméo Dallaire,68249,68249,0,2005_boxofficemojo_rankings.csv,2005,1.0,0.0
13893,Maidentrip,68243,68243,0,2013_boxofficemojo_rankings.csv,2013,1.0,0.0
13894,Le Amiche,68167,68167,0,2010_boxofficemojo_rankings.csv,2010,1.0,0.0
13895,¡He matado a mi marido!,68017,45777,22240,2019_boxofficemojo_rankings.csv,2019,0.6730229207404032,0.32697707925959685
13896,Brenda Starr,67878,67878,0,1992_boxofficemojo_rankings.csv,1992,1.0,0.0
13897,I Am Big Bird: The Caroll Spinney Story,67845,67845,0,2015_boxofficemojo_rankings.csv,2015,1.0,0.0
13898,The Messenger,67816,67816,0,2015_boxofficemojo_rankings.csv,2015,1.0,0.0
13899,Summer in the Forest,67743,45542,22201,2017_boxofficemojo_rankings.csv,2017,0.6722761023279158,0.3277238976720842
13900,Sanam Teri Kasam,67736,22121,45615,2016_boxofficemojo_rankings.csv,2016,0.32657670957836304,0.673423290421637
13901,Happy Valley,67665,67665,0,2008_boxofficemojo_rankings.csv,2008,1.0,0.0
13902,What Alice Found,67436,67436,0,2003_boxofficemojo_rankings.csv,2003,1.0,0.0
13903,Beyond the Gates,67433,67433,0,2004_boxofficemojo_rankings.csv,2004,1.0,0.0
13904,The Greasy Strangler,67427,45878,21549,2016_boxofficemojo_rankings.csv,2016,0.6804099248075697,0.3195900751924303
13905,Ping Pong,67421,67421,0,1987_boxofficemojo_rankings.csv,1987,1.0,0.0
13906,For No Good Reason,67421,67421,0,2014_boxofficemojo_rankings.csv,2014,1.0,0.0
13907,Making the Five Heartbeats,67415,67415,0,2018_boxofficemojo_rankings.csv,2018,1.0,0.0
13908,Being Frank,67343,67343,0,2019_boxofficemojo_rankings.csv,2019,1.0,0.0
13909,The Doctor from India,67136,67136,0,2018_boxofficemojo_rankings.csv,2018,1.0,0.0
13910,Close to Home,67110,20931,46179,2006_boxofficemojo_rankings.csv,2006,0.31189092534644614,0.6881090746535539
13911,The Sun Behind the Clouds: Tibet's Struggle for Freedom,67095,67095,0,2010_boxofficemojo_rankings.csv,2010,1.0,0.0
13912,The Autobiography of Nicolae Ceausescu,67093,34023,33070,2010_boxofficemojo_rankings.csv,2010,0.5071020821844305,0.4928979178155694
13913,Turbo Kid,67069,67069,0,2015_boxofficemojo_rankings.csv,2015,1.0,0.0
13914,Side by Side,67054,58825,8229,2012_boxofficemojo_rankings.csv,2012,0.8772780147343932,0.12272198526560682
13915,Allah Made Me Funny: Live in Concert,66903,66903,0,2008_boxofficemojo_rankings.csv,2008,1.0,0.0
13916,"3100, Run and Become",66789,65524,1265,2018_boxofficemojo_rankings.csv,2018,0.9810597553489347,0.018940244651065294
13917,Pandora's Promise,66680,66680,0,2013_boxofficemojo_rankings.csv,2013,1.0,0.0
13918,Max Rose,66680,66680,0,2016_boxofficemojo_rankings.csv,2016,1.0,0.0
13919,Diggers,66517,66517,0,2007_boxofficemojo_rankings.csv,2007,1.0,0.0
13920,Vodka Lemon,66361,66361,0,2004_boxofficemojo_rankings.csv,2004,1.0,0.0
13921,The Town Is Quiet,66303,66303,0,2001_boxofficemojo_rankings.csv,2001,1.0,0.0
13922,Dance Me Outside,66229,66229,0,1995_boxofficemojo_rankings.csv,1995,1.0,0.0
13923,Just a Little Harmless Sex,66194,66194,0,1999_boxofficemojo_rankings.csv,1999,1.0,0.0
13924,King Georges,66175,66175,0,2016_boxofficemojo_rankings.csv,2016,1.0,0.0
13925,Dancing Across Borders,66166,66166,0,2010_boxofficemojo_rankings.csv,2010,1.0,0.0
13926,Out in the Dark,66017,26966,39051,2013_boxofficemojo_rankings.csv,2013,0.4084705454655619,0.5915294545344381
13927,The Talent Given Us,65827,65827,0,2005_boxofficemojo_rankings.csv,2005,1.0,0.0
13928,Shadey,65817,65817,0,1987_boxofficemojo_rankings.csv,1987,1.0,0.0
13929,Titanic Town,65793,65793,0,2000_boxofficemojo_rankings.csv,2000,1.0,0.0
13930,Among Giants,65748,65748,0,1999_boxofficemojo_rankings.csv,1999,1.0,0.0
13931,D-Day,65536,0,65536,2013_boxofficemojo_rankings.csv,2013,0.0,1.0
13932,Architects of Denial,65424,65424,0,2017_boxofficemojo_rankings.csv,2017,1.0,0.0
13933,Blind Shaft,65383,33272,32111,2003_boxofficemojo_rankings.csv,2003,0.5088784546441736,0.4911215453558264
13934,Mail Order Wife,65369,62387,2982,2005_boxofficemojo_rankings.csv,2005,0.9543820465358197,0.045617953464180266
13935,Sing Your Song,65310,47718,17592,2012_boxofficemojo_rankings.csv,2012,0.730638493339458,0.26936150666054204
13936,Mad About Mambo,65283,65283,0,2000_boxofficemojo_rankings.csv,2000,1.0,0.0
13937,Spooky House,65238,65238,0,2002_boxofficemojo_rankings.csv,2002,1.0,0.0
13938,You've Been Trumped,65220,29273,35947,2012_boxofficemojo_rankings.csv,2012,0.44883471327813557,0.5511652867218645
13939,Madame Butterfly,65196,65196,0,1996_boxofficemojo_rankings.csv,1996,1.0,0.0
13940,One 2004 Re-release,65172,65172,0,2004_boxofficemojo_rankings.csv,2004,1.0,0.0
13941,An Adolescent 2005 Re-release,65171,65171,0,2005_boxofficemojo_rankings.csv,2005,1.0,0.0
13942,Through a Lens Darkly: Black Photographers and the Emergence of a People,65169,65169,0,2014_boxofficemojo_rankings.csv,2014,1.0,0.0
13943,The Lesson,65142,9045,56097,2015_boxofficemojo_rankings.csv,2015,0.13885051119093672,0.8611494888090633
13944,Gaudi Afternoon,65115,5858,59257,2002_boxofficemojo_rankings.csv,2002,0.08996391000537511,0.9100360899946249
13945,Aberdeen,65090,65090,0,2001_boxofficemojo_rankings.csv,2001,1.0,0.0
13946,Racing Dreams,65082,65082,0,2010_boxofficemojo_rankings.csv,2010,1.0,0.0
13947,The Wild Child,65051,65051,0,2008_boxofficemojo_rankings.csv,2008,1.0,0.0
13948,Last Resort,65041,37283,27758,2001_boxofficemojo_rankings.csv,2001,0.5732230439261389,0.4267769560738611
13949,Expired,65003,29796,35207,2008_boxofficemojo_rankings.csv,2008,0.4583788440533514,0.5416211559466486
13950,Nice Girls Don't Explode,65000,65000,0,1987_boxofficemojo_rankings.csv,1987,1.0,0.0
13951,Toys in the Attic 2012 Re-release,64918,64918,0,2012_boxofficemojo_rankings.csv,2012,1.0,0.0
13952,Manolo: the Boy Who Made Shoes for Lizards,64889,60056,4833,2017_boxofficemojo_rankings.csv,2017,0.9255189631524604,0.07448103684753965
13953,Searching for Ingmar Bergman,64742,36686,28056,2018_boxofficemojo_rankings.csv,2018,0.5666491612863366,0.4333508387136635
13954,Bloodline,64698,64698,0,2008_boxofficemojo_rankings.csv,2008,1.0,0.0
13955,The Jesus Rolls,64648,18169,46479,2019_boxofficemojo_rankings.csv,2019,0.2810450439302067,0.7189549560697933
13956,Monsieur Verdoux,64636,64636,0,2008_boxofficemojo_rankings.csv,2008,1.0,0.0
13957,"Monrovia, Indiana",64596,63944,652,2018_boxofficemojo_rankings.csv,2018,0.9899064957582513,0.010093504241748714
13958,Battle of the Brides,64572,64572,0,2011_boxofficemojo_rankings.csv,2011,1.0,0.0
13959,Let the Fire Burn,64489,64489,0,2013_boxofficemojo_rankings.csv,2013,1.0,0.0
13960,Syndromes and a Century,64453,16675,47778,2007_boxofficemojo_rankings.csv,2007,0.25871565326672147,0.7412843467332785
13961,Trilogy: The Weeping Meadow,64424,24966,39458,2005_boxofficemojo_rankings.csv,2005,0.38752638768160935,0.6124736123183907
13962,Badmaa$h Company,64398,0,64398,2010_boxofficemojo_rankings.csv,2010,0.0,1.0
13963,Just a Kiss,64389,64389,0,2002_boxofficemojo_rankings.csv,2002,1.0,0.0
13964,D' Lucky Ones!,64352,64352,0,2006_boxofficemojo_rankings.csv,2006,1.0,0.0
13965,Rock School,64310,64310,0,2005_boxofficemojo_rankings.csv,2005,1.0,0.0
13966,Cohen and Tate,64227,64227,0,1989_boxofficemojo_rankings.csv,1989,1.0,0.0
13967,Losing Chase,64161,64161,0,1996_boxofficemojo_rankings.csv,1996,1.0,0.0
13968,Paulette 2015 Re-release,64125,29494,34631,2015_boxofficemojo_rankings.csv,2015,0.4599454191033138,0.5400545808966861
13969,Beautiful Losers,64064,56386,7678,2008_boxofficemojo_rankings.csv,2008,0.8801510989010989,0.1198489010989011
13970,Girl Asleep,64056,60289,3767,2016_boxofficemojo_rankings.csv,2016,0.9411920819283127,0.058807918071687275
13971,Making Waves: The Art of Cinematic Sound,63998,53144,10854,2019_boxofficemojo_rankings.csv,2019,0.8304009500296884,0.16959904997031158
13972,Jealousy,63946,63946,0,2014_boxofficemojo_rankings.csv,2014,1.0,0.0
13973,Only the Strong Survive,63778,57581,6197,2003_boxofficemojo_rankings.csv,2003,0.9028348333281069,0.09716516667189314
13974,Her Majesty,63652,63652,0,2004_boxofficemojo_rankings.csv,2004,1.0,0.0
13975,The Details,63595,63595,0,2012_boxofficemojo_rankings.csv,2012,1.0,0.0
13976,A Plumm Summer,63521,63521,0,2008_boxofficemojo_rankings.csv,2008,1.0,0.0
13977,S.F.W.,63513,63513,0,1995_boxofficemojo_rankings.csv,1995,1.0,0.0
13978,A Liar's Autobiography: The Untrue Story of Monty Python's Graham Chapman,63469,5102,58367,2012_boxofficemojo_rankings.csv,2012,0.08038570010556334,0.9196142998944367
13979,All About Eve 2000 Re-release,63463,63463,0,2000_boxofficemojo_rankings.csv,2000,1.0,0.0
13980,Movie Madness,63405,63405,0,1982_boxofficemojo_rankings.csv,1982,1.0,0.0
13981,I Smile Back,63373,58738,4635,2015_boxofficemojo_rankings.csv,2015,0.9268615972101684,0.07313840278983164
13982,Nijinsky: The Diaries of Vaslav Nijinsky,63364,55968,7396,2002_boxofficemojo_rankings.csv,2002,0.8832775708604255,0.11672242913957452
13983,Trapped,63241,63241,0,2016_boxofficemojo_rankings.csv,2016,1.0,0.0
13984,Delta of Venus,63174,63174,0,1995_boxofficemojo_rankings.csv,1995,1.0,0.0
13985,Skills Like This,63163,63163,0,2009_boxofficemojo_rankings.csv,2009,1.0,0.0
13986,The Last of the Unjust,63136,40563,22573,2013_boxofficemojo_rankings.csv,2013,0.6424702230106437,0.3575297769893563
13987,No Tears for the Dead,63063,63063,0,2014_boxofficemojo_rankings.csv,2014,1.0,0.0
13988,Creative Control,63014,63014,0,2016_boxofficemojo_rankings.csv,2016,1.0,0.0
13989,"Love, Antosha",62900,50168,12732,2019_boxofficemojo_rankings.csv,2019,0.7975834658187599,0.20241653418124006
13990,The Mudge Boy,62852,62852,0,2004_boxofficemojo_rankings.csv,2004,1.0,0.0
13991,Mala Noche,62743,25386,37357,2007_boxofficemojo_rankings.csv,2007,0.40460290390959947,0.5953970960904005
13992,The Gardener,62734,62734,0,2018_boxofficemojo_rankings.csv,2018,1.0,0.0
13993,The Swan,62716,2367,60349,2018_boxofficemojo_rankings.csv,2018,0.0377415651508387,0.9622584348491613
13994,Cool It,62713,62713,0,2010_boxofficemojo_rankings.csv,2010,1.0,0.0
13995,No Such Thing,62703,62703,0,2002_boxofficemojo_rankings.csv,2002,1.0,0.0
13996,Survival Quest,62683,62683,0,1989_boxofficemojo_rankings.csv,1989,1.0,0.0
13997,A Year Without Love,62676,24381,38295,2005_boxofficemojo_rankings.csv,2005,0.38900057438253877,0.6109994256174612
13998,Drunk Stoned Brilliant Dead,62660,62660,0,2015_boxofficemojo_rankings.csv,2015,1.0,0.0
13999,The Order of Myths,62645,62645,0,2008_boxofficemojo_rankings.csv,2008,1.0,0.0
14000,The Providence Effect,62500,62500,0,2009_boxofficemojo_rankings.csv,2009,1.0,0.0
14001,The Tiger Hunter,62398,62398,0,2017_boxofficemojo_rankings.csv,2017,1.0,0.0
14002,Vajra Sky Over Tibet,62356,62356,0,2006_boxofficemojo_rankings.csv,2006,1.0,0.0
14003,Mifune: The Last Samurai,62279,62279,0,2016_boxofficemojo_rankings.csv,2016,1.0,0.0
14004,Maya Lin: A Strong Clear Vision,62186,62186,0,1995_boxofficemojo_rankings.csv,1995,1.0,0.0
14005,Public Speaking,62173,62173,0,2011_boxofficemojo_rankings.csv,2011,1.0,0.0
14006,Poster Boy,62062,62062,0,2006_boxofficemojo_rankings.csv,2006,1.0,0.0
14007,Proteus,62031,62031,0,2004_boxofficemojo_rankings.csv,2004,1.0,0.0
14008,Trigun: Badlands Rumble 2011 Re-release,62027,62027,0,2011_boxofficemojo_rankings.csv,2011,1.0,0.0
14009,Kites The Remix,61997,41783,20214,2010_boxofficemojo_rankings.csv,2010,0.6739519654176815,0.3260480345823185
14010,Love Is All There Is,61875,61875,0,1996_boxofficemojo_rankings.csv,1996,1.0,0.0
14011,"I, Me aur Main",61863,0,61863,2013_boxofficemojo_rankings.csv,2013,0.0,1.0
14012,Dark Star: HR Gigers Welt,61845,61845,0,2015_boxofficemojo_rankings.csv,2015,1.0,0.0
14013,King Lear,61821,61821,0,1988_boxofficemojo_rankings.csv,1988,1.0,0.0
14014,In a Valley of Violence,61797,61797,0,2016_boxofficemojo_rankings.csv,2016,1.0,0.0
14015,If a Tree Falls: A Story of the Earth Liberation Front,61794,61794,0,2011_boxofficemojo_rankings.csv,2011,1.0,0.0
14016,Love at Stake,61789,61789,0,1988_boxofficemojo_rankings.csv,1988,1.0,0.0
14017,River Runs Red,61789,9893,51896,2018_boxofficemojo_rankings.csv,2018,0.1601094045865769,0.8398905954134231
14018,Amour Fou,61693,13702,47991,2014_boxofficemojo_rankings.csv,2014,0.22209975199779552,0.7779002480022045
14019,Quill: The Life of a Guide Dog 2012 Re-release,61674,15674,46000,2012_boxofficemojo_rankings.csv,2012,0.2541427505918215,0.7458572494081784
14020,Vivere,61658,3625,58033,2007_boxofficemojo_rankings.csv,2007,0.05879204644977132,0.9412079535502287
14021,Backwards,61465,61465,0,2012_boxofficemojo_rankings.csv,2012,1.0,0.0
14022,Donald Cried,61406,61406,0,2017_boxofficemojo_rankings.csv,2017,1.0,0.0
14023,Silent Tongue,61274,61274,0,1994_boxofficemojo_rankings.csv,1994,1.0,0.0
14024,Here and Now,61271,13892,47379,2018_boxofficemojo_rankings.csv,2018,0.22673042711886537,0.7732695728811346
14025,Never Goin' Back,61271,61271,0,2018_boxofficemojo_rankings.csv,2018,1.0,0.0
14026,The Seasons In Quincy: Four Portraits of John Berger,61267,28456,32811,2016_boxofficemojo_rankings.csv,2016,0.46445884407592997,0.53554115592407
14027,The Outcasts,61250,1455,59795,2017_boxofficemojo_rankings.csv,2017,0.023755102040816326,0.9762448979591837
14028,The Untamed,61249,27593,33656,2017_boxofficemojo_rankings.csv,2017,0.45050531437247954,0.5494946856275205
14029,Judy Berlin,61236,61236,0,2000_boxofficemojo_rankings.csv,2000,1.0,0.0
14030,Apocalypse Now 1987 Re-release,61211,61211,0,1987_boxofficemojo_rankings.csv,1987,1.0,0.0
14031,The Elephant King,61122,22251,38871,2008_boxofficemojo_rankings.csv,2008,0.36404240698930007,0.6359575930106999
14032,The Mountain,61035,61035,0,2019_boxofficemojo_rankings.csv,2019,1.0,0.0
14033,The Bodyguard 2012 Re-release,61020,61020,0,2012_boxofficemojo_rankings.csv,2012,1.0,0.0
14034,The Sacrifice 2017 Re-release,61018,61018,0,2017_boxofficemojo_rankings.csv,2017,1.0,0.0
14035,Independent Lens: Don't Stop Believin': Everyman's Journey,61018,61018,0,2013_boxofficemojo_rankings.csv,2013,1.0,0.0
14036,Love U... Mr. Kalakaar!,60956,48557,12399,2011_boxofficemojo_rankings.csv,2011,0.7965909836603452,0.20340901633965483
14037,Brighton Rock,60950,49466,11484,2009_boxofficemojo_rankings.csv,2009,0.811583264971288,0.18841673502871206
14038,Chelsea Walls,60902,60902,0,2002_boxofficemojo_rankings.csv,2002,1.0,0.0
14039,The Wicker Man 2013 Re-release,60891,60891,0,2013_boxofficemojo_rankings.csv,2013,1.0,0.0
14040,It's Pat: The Movie,60822,60822,0,1994_boxofficemojo_rankings.csv,1994,1.0,0.0
14041,It's a Disaster,60818,60818,0,2013_boxofficemojo_rankings.csv,2013,1.0,0.0
14042,You I Love,60815,60815,0,2004_boxofficemojo_rankings.csv,2004,1.0,0.0
14043,A Kid Like Jake,60784,58403,2381,2018_boxofficemojo_rankings.csv,2018,0.9608285075019742,0.039171492498025796
14044,Apprentice,60752,2578,58174,2016_boxofficemojo_rankings.csv,2016,0.042434816960758494,0.9575651830392415
14045,Aurora Borealis,60729,60729,0,2006_boxofficemojo_rankings.csv,2006,1.0,0.0
14046,Pyaar Ke Side Effects,60714,30230,30484,2006_boxofficemojo_rankings.csv,2006,0.4979082254504727,0.5020917745495272
14047,Rachel River,60698,60698,0,1989_boxofficemojo_rankings.csv,1989,1.0,0.0
14048,How to Live Forever,60630,60630,0,2011_boxofficemojo_rankings.csv,2011,1.0,0.0
14049,Viper Club,60607,60607,0,2018_boxofficemojo_rankings.csv,2018,1.0,0.0
14050,The Long Way Home,60509,60509,0,1997_boxofficemojo_rankings.csv,1997,1.0,0.0
14051,Too Late,60438,60438,0,2016_boxofficemojo_rankings.csv,2016,1.0,0.0
14052,The Slammin' Salmon,60421,41587,18834,2009_boxofficemojo_rankings.csv,2009,0.6882871849191506,0.31171281508084936
14053,Limelight,60335,60335,0,2011_boxofficemojo_rankings.csv,2011,1.0,0.0
14054,Boogie Man: The Lee Atwater Story,60332,60332,0,2008_boxofficemojo_rankings.csv,2008,1.0,0.0
14055,Crime After Crime,60291,60291,0,2011_boxofficemojo_rankings.csv,2011,1.0,0.0
14056,Joe the King,60279,60279,0,1999_boxofficemojo_rankings.csv,1999,1.0,0.0
14057,Edvard Munch,60244,43539,16705,2005_boxofficemojo_rankings.csv,2005,0.7227109753668415,0.27728902463315847
14058,Ikiru,60239,60239,0,2002_boxofficemojo_rankings.csv,2002,1.0,0.0
14059,Wetlands 2014 Re-release,60230,59478,752,2014_boxofficemojo_rankings.csv,2014,0.9875145276440312,0.012485472355968787
14060,Presenting Princess Shaw,60197,60197,0,2016_boxofficemojo_rankings.csv,2016,1.0,0.0
14061,Just One Drop,60078,60078,0,2017_boxofficemojo_rankings.csv,2017,1.0,0.0
14062,Heaven,60065,60065,0,2020_boxofficemojo_rankings.csv,2020,1.0,0.0
14063,Gregory Crewdson: Brief Encounters,60064,60064,0,2012_boxofficemojo_rankings.csv,2012,1.0,0.0
14064,Decoding Annie Parker,60048,48390,11658,2014_boxofficemojo_rankings.csv,2014,0.8058553157474021,0.19414468425259793
14065,Down and Out with the Dolls,60000,60000,0,2003_boxofficemojo_rankings.csv,2003,1.0,0.0
14066,The Force,59912,59912,0,2017_boxofficemojo_rankings.csv,2017,1.0,0.0
14067,The Alarmist,59864,59864,0,1998_boxofficemojo_rankings.csv,1998,1.0,0.0
14068,John Fogerty: 50 Year Trip - Live at Red Rocks,59795,59795,0,2019_boxofficemojo_rankings.csv,2019,1.0,0.0
14069,Frontera,59696,59696,0,2014_boxofficemojo_rankings.csv,2014,1.0,0.0
14070,Cheap Thrills,59424,59424,0,2014_boxofficemojo_rankings.csv,2014,1.0,0.0
14071,The Extraordinary Voyage,59424,52986,6438,2012_boxofficemojo_rankings.csv,2012,0.8916599353796446,0.1083400646203554
14072,Ten Little Indians,59405,59405,0,1989_boxofficemojo_rankings.csv,1989,1.0,0.0
14073,Sweet Dreams,59403,59403,0,2013_boxofficemojo_rankings.csv,2013,1.0,0.0
14074,Bomb City,59329,59329,0,2018_boxofficemojo_rankings.csv,2018,1.0,0.0
14075,Bang! The Bert Berns Story,59299,59299,0,2017_boxofficemojo_rankings.csv,2017,1.0,0.0
14076,Saint Frances,59257,44330,14927,2020_boxofficemojo_rankings.csv,2020,0.7480972712084648,0.2519027287915352
14077,Crossing the Line,59227,59227,0,1991_boxofficemojo_rankings.csv,1991,1.0,0.0
14078,Phobia,59167,59167,0,1980_boxofficemojo_rankings.csv,1980,1.0,0.0
14079,The Young Unknowns,59166,59166,0,2003_boxofficemojo_rankings.csv,2003,1.0,0.0
14080,Digimon Adventure tri. Part 4: Loss,59114,59114,0,2018_boxofficemojo_rankings.csv,2018,1.0,0.0
14081,The Trials of Muhammad Ali,59081,59081,0,2013_boxofficemojo_rankings.csv,2013,1.0,0.0
14082,Screen Door Jesus,59000,59000,0,2005_boxofficemojo_rankings.csv,2005,1.0,0.0
14083,My Brothers' Crossing,58963,58963,0,2020_boxofficemojo_rankings.csv,2020,1.0,0.0
14084,Shiloh 2: Shiloh Season,58946,58946,0,1999_boxofficemojo_rankings.csv,1999,1.0,0.0
14085,The One I Wrote for You,58872,58872,0,2014_boxofficemojo_rankings.csv,2014,1.0,0.0
14086,Sonatine,58834,58834,0,1998_boxofficemojo_rankings.csv,1998,1.0,0.0
14087,Maxed Out,58829,58829,0,2007_boxofficemojo_rankings.csv,2007,1.0,0.0
14088,What We Do Is Secret,58776,58776,0,2008_boxofficemojo_rankings.csv,2008,1.0,0.0
14089,Sagrada: The Mystery of Creation 2014 Re-release,58755,58755,0,2014_boxofficemojo_rankings.csv,2014,1.0,0.0
14090,The Conformist 2014 Re-release,58657,58657,0,2014_boxofficemojo_rankings.csv,2014,1.0,0.0
14091,Horn from the Heart: The Paul Butterfield Story,58597,58597,0,2018_boxofficemojo_rankings.csv,2018,1.0,0.0
14092,Putty Hill,58585,49918,8667,2011_boxofficemojo_rankings.csv,2011,0.852061107792097,0.14793889220790304
14093,Eyes Without a Face,58565,58565,0,2003_boxofficemojo_rankings.csv,2003,1.0,0.0
14094,Home Delivery,58499,58499,0,2005_boxofficemojo_rankings.csv,2005,1.0,0.0
14095,The Making of '...And God Spoke',58484,58484,0,1994_boxofficemojo_rankings.csv,1994,1.0,0.0
14096,Four Seasons Lodge,58334,58334,0,2009_boxofficemojo_rankings.csv,2009,1.0,0.0
14097,Gozu,58202,58202,0,2004_boxofficemojo_rankings.csv,2004,1.0,0.0
14098,Orlando 2010 Re-release,58198,58198,0,2010_boxofficemojo_rankings.csv,2010,1.0,0.0
14099,Cynthia,58177,58177,0,2018_boxofficemojo_rankings.csv,2018,1.0,0.0
14100,Faust,58132,58132,0,2013_boxofficemojo_rankings.csv,2013,1.0,0.0
14101,Betty,58099,58099,0,1993_boxofficemojo_rankings.csv,1993,1.0,0.0
14102,In Search of Greatness,58090,58090,0,2018_boxofficemojo_rankings.csv,2018,1.0,0.0
14103,Voices of Iraq,57999,57999,0,2004_boxofficemojo_rankings.csv,2004,1.0,0.0
14104,The Boom,57962,57962,0,2017_boxofficemojo_rankings.csv,2017,1.0,0.0
14105,The End of Poverty?,57805,57805,0,2009_boxofficemojo_rankings.csv,2009,1.0,0.0
14106,Springtime in a Small Town,57751,43017,14734,2003_boxofficemojo_rankings.csv,2003,0.7448702186975117,0.25512978130248826
14107,Rififi 2015 Re-release,57749,57749,0,2015_boxofficemojo_rankings.csv,2015,1.0,0.0
14108,Command and Control,57635,57635,0,2016_boxofficemojo_rankings.csv,2016,1.0,0.0
14109,Battleship Potemkin,57620,51198,6422,2011_boxofficemojo_rankings.csv,2011,0.888545643873655,0.11145435612634502
14110,Playback,57587,264,57323,2012_boxofficemojo_rankings.csv,2012,0.00458436799972216,0.9954156320002778
14111,Sold,57527,57527,0,2016_boxofficemojo_rankings.csv,2016,1.0,0.0
14112,Pandora's Box,57472,53485,3987,2006_boxofficemojo_rankings.csv,2006,0.930627087973274,0.06937291202672606
14113,Court,57416,22898,34518,2015_boxofficemojo_rankings.csv,2015,0.39880869444057404,0.6011913055594259
14114,Ramen Heads,57345,57345,0,2018_boxofficemojo_rankings.csv,2018,1.0,0.0
14115,Keys to Tulsa,57252,57252,0,1997_boxofficemojo_rankings.csv,1997,1.0,0.0
14116,Run & Jump,57189,20061,37128,2014_boxofficemojo_rankings.csv,2014,0.3507842417248072,0.6492157582751927
14117,Mickey and the Bear,57188,57188,0,2019_boxofficemojo_rankings.csv,2019,1.0,0.0
14118,Kuch Khatti Kuch Meethi,57188,57188,0,2001_boxofficemojo_rankings.csv,2001,1.0,0.0
14119,Gumby: The Movie,57100,57100,0,1995_boxofficemojo_rankings.csv,1995,1.0,0.0
14120,Così ridevano,57009,57009,0,2001_boxofficemojo_rankings.csv,2001,1.0,0.0
14121,The Big Chill 1998 Re-release,56948,56948,0,1998_boxofficemojo_rankings.csv,1998,1.0,0.0
14122,Wall,56866,14541,42325,2004_boxofficemojo_rankings.csv,2004,0.2557063974958675,0.7442936025041326
14123,My Joy,56857,6298,50559,2011_boxofficemojo_rankings.csv,2011,0.11076912253548375,0.8892308774645162
14124,The Battle of Algiers 2016 Re-release,56853,56853,0,2016_boxofficemojo_rankings.csv,2016,1.0,0.0
14125,Electric Shadows,56809,7129,49680,2005_boxofficemojo_rankings.csv,2005,0.12549067929377386,0.8745093207062261
14126,Eleven Men Out 2007 Re-release,56733,1000,55733,2007_boxofficemojo_rankings.csv,2007,0.017626425537165317,0.9823735744628347
14127,Harvard Man,56653,56653,0,2002_boxofficemojo_rankings.csv,2002,1.0,0.0
14128,Farmageddon,56573,56573,0,2011_boxofficemojo_rankings.csv,2011,1.0,0.0
14129,The Two of Us,56558,56558,0,2005_boxofficemojo_rankings.csv,2005,1.0,0.0
14130,Muran,56493,30116,26377,2011_boxofficemojo_rankings.csv,2011,0.5330925955428106,0.46690740445718937
14131,Beyond the Black Rainbow,56491,56491,0,2012_boxofficemojo_rankings.csv,2012,1.0,0.0
14132,Big Men,56286,56286,0,2014_boxofficemojo_rankings.csv,2014,1.0,0.0
14133,Saving Brinton,56218,56218,0,2017_boxofficemojo_rankings.csv,2017,1.0,0.0
14134,Divan,56214,56214,0,2004_boxofficemojo_rankings.csv,2004,1.0,0.0
14135,Wedding Doll,56196,56196,0,2016_boxofficemojo_rankings.csv,2016,1.0,0.0
14136,Notebook,56166,0,56166,2019_boxofficemojo_rankings.csv,2019,0.0,1.0
14137,False Confessions,56165,29245,26920,2017_boxofficemojo_rankings.csv,2017,0.5206979435591561,0.47930205644084395
14138,Kart Racer,56146,56146,0,2003_boxofficemojo_rankings.csv,2003,1.0,0.0
14139,Évolution,55985,24770,31215,2016_boxofficemojo_rankings.csv,2016,0.4424399392694472,0.5575600607305529
14140,"God Said, 'Ha!'",55970,55970,0,1999_boxofficemojo_rankings.csv,1999,1.0,0.0
14141,Man Push Cart,55903,36608,19295,2006_boxofficemojo_rankings.csv,2006,0.6548485769994454,0.3451514230005545
14142,Unknown Pleasures,55901,11254,44647,2003_boxofficemojo_rankings.csv,2003,0.20132019105203844,0.7986798089479615
14143,Vitalina Varela,55862,14941,40921,2019_boxofficemojo_rankings.csv,2019,0.2674626758798468,0.7325373241201533
14144,Terms and Conditions May Apply,55824,55824,0,2013_boxofficemojo_rankings.csv,2013,1.0,0.0
14145,Hellion,55708,55708,0,2014_boxofficemojo_rankings.csv,2014,1.0,0.0
14146,XX,55668,30911,24757,2017_boxofficemojo_rankings.csv,2017,0.5552741251706546,0.4447258748293454
14147,Recorder: The Marion Stokes Project,55632,55632,0,2019_boxofficemojo_rankings.csv,2019,1.0,0.0
14148,Holidays,55621,0,55621,2016_boxofficemojo_rankings.csv,2016,0.0,1.0
14149,As Good as Dead,55618,1981,53637,2010_boxofficemojo_rankings.csv,2010,0.03561796540688266,0.9643820345931173
14150,Wings of Honneamise,55572,55572,0,1995_boxofficemojo_rankings.csv,1995,1.0,0.0
14151,Finding Joe,55518,55518,0,2011_boxofficemojo_rankings.csv,2011,1.0,0.0
14152,The Boys: The Sherman Brothers' Story,55513,55513,0,2009_boxofficemojo_rankings.csv,2009,1.0,0.0
14153,Entertainment,55506,55506,0,2015_boxofficemojo_rankings.csv,2015,1.0,0.0
14154,The Other Side of the Street,55459,55459,0,2005_boxofficemojo_rankings.csv,2005,1.0,0.0
14155,Naam Shabana,55429,0,55429,2017_boxofficemojo_rankings.csv,2017,0.0,1.0
14156,That Man: Peter Berlin,55398,55398,0,2006_boxofficemojo_rankings.csv,2006,1.0,0.0
14157,Into Eternity,55366,55366,0,2011_boxofficemojo_rankings.csv,2011,1.0,0.0
14158,Dracula: Pages from a Virgin's Diary,55365,55365,0,2003_boxofficemojo_rankings.csv,2003,1.0,0.0
14159,C.O.G.,55301,55301,0,2013_boxofficemojo_rankings.csv,2013,1.0,0.0
14160,Natural Selection,55282,55282,0,2012_boxofficemojo_rankings.csv,2012,1.0,0.0
14161,The Tracker 2004 Re-release,55188,55188,0,2004_boxofficemojo_rankings.csv,2004,1.0,0.0
14162,Mamma Mia! 2018 Re-release,55168,39601,15567,2018_boxofficemojo_rankings.csv,2018,0.7178255510440835,0.2821744489559165
14163,Shadow of China,55166,55166,0,1991_boxofficemojo_rankings.csv,1991,1.0,0.0
14164,American Dream: Detroit,55092,55092,0,2018_boxofficemojo_rankings.csv,2018,1.0,0.0
14165,The Lovely Month of May,55038,55038,0,2013_boxofficemojo_rankings.csv,2013,1.0,0.0
14166,Twenty Two 2017 Re-release,55001,46796,8205,2017_boxofficemojo_rankings.csv,2017,0.8508208941655606,0.14917910583443938
14167,Zombeavers,54985,14947,40038,2014_boxofficemojo_rankings.csv,2014,0.27183777393834685,0.7281622260616532
14168,Ciao America,54965,54965,0,2002_boxofficemojo_rankings.csv,2002,1.0,0.0
14169,The Amateurs 2007 Re-release,54945,16334,38611,2007_boxofficemojo_rankings.csv,2007,0.2972790972790973,0.7027209027209027
14170,DAZN Boxing: Canelo Alvarez vs. Rocky Fielding,54916,54916,0,2018_boxofficemojo_rankings.csv,2018,1.0,0.0
14171,Extreme Movie,54822,0,54822,2008_boxofficemojo_rankings.csv,2008,0.0,1.0
14172,Snowmen,54805,54805,0,2011_boxofficemojo_rankings.csv,2011,1.0,0.0
14173,Once in the Life,54780,54780,0,2000_boxofficemojo_rankings.csv,2000,1.0,0.0
14174,Orphans,54754,54754,0,2000_boxofficemojo_rankings.csv,2000,1.0,0.0
14175,Six Ways to Sunday,54751,54751,0,1999_boxofficemojo_rankings.csv,1999,1.0,0.0
14176,The Nature of Existence,54645,54645,0,2010_boxofficemojo_rankings.csv,2010,1.0,0.0
14177,In a Dream,54640,54640,0,2009_boxofficemojo_rankings.csv,2009,1.0,0.0
14178,What Our Fathers Did: A Nazi Legacy,54603,40119,14484,2015_boxofficemojo_rankings.csv,2015,0.734739849458821,0.2652601505411791
14179,Grand Champion,54579,54579,0,2004_boxofficemojo_rankings.csv,2004,1.0,0.0
14180,The Lottery,54543,54543,0,2010_boxofficemojo_rankings.csv,2010,1.0,0.0
14181,The Harimaya Bridge,54473,54473,0,2010_boxofficemojo_rankings.csv,2010,1.0,0.0
14182,The Grandfather,54468,54468,0,1999_boxofficemojo_rankings.csv,1999,1.0,0.0
14183,A Simple Wedding,54415,54415,0,2020_boxofficemojo_rankings.csv,2020,1.0,0.0
14184,Schizo,54357,54357,0,2005_boxofficemojo_rankings.csv,2005,1.0,0.0
14185,Digimon Adventure tri. Part 6: Future,54324,54324,0,2018_boxofficemojo_rankings.csv,2018,1.0,0.0
14186,Harlan: In the Shadow of Jew Suess,54305,54305,0,2010_boxofficemojo_rankings.csv,2010,1.0,0.0
14187,The Search for General Tso,54275,54275,0,2015_boxofficemojo_rankings.csv,2015,1.0,0.0
14188,Wagner & Me 2012 Re-release,54215,37745,16470,2012_boxofficemojo_rankings.csv,2012,0.6962095361062437,0.30379046389375636
14189,Return of the Living Dead III,54207,54207,0,1993_boxofficemojo_rankings.csv,1993,1.0,0.0
14190,Line of Duty,54204,54204,0,2013_boxofficemojo_rankings.csv,2013,1.0,0.0
14191,Give Me Your Hand,54147,3601,50546,2009_boxofficemojo_rankings.csv,2009,0.06650414612074537,0.9334958538792546
14192,Jungle,54125,54125,0,2000_boxofficemojo_rankings.csv,2000,1.0,0.0
14193,Last Passenger,54110,14806,39304,2014_boxofficemojo_rankings.csv,2014,0.2736277952319349,0.7263722047680651
14194,Broken Hill,54058,54058,0,2009_boxofficemojo_rankings.csv,2009,1.0,0.0
14195,Low Down,54051,54051,0,2014_boxofficemojo_rankings.csv,2014,1.0,0.0
14196,Kal Kissne Dekha,54048,24625,29423,2009_boxofficemojo_rankings.csv,2009,0.4556135287152161,0.5443864712847839
14197,A Beautiful Soul,54008,54008,0,2012_boxofficemojo_rankings.csv,2012,1.0,0.0
14198,L.A. Twister,54000,54000,0,2004_boxofficemojo_rankings.csv,2004,1.0,0.0
14199,Surviving Progress,53953,53953,0,2012_boxofficemojo_rankings.csv,2012,1.0,0.0
14200,The Assassin's Code,53940,11218,42722,2018_boxofficemojo_rankings.csv,2018,0.20797182054134222,0.7920281794586578
14201,Afraid of the Dark,53932,53932,0,1992_boxofficemojo_rankings.csv,1992,1.0,0.0
14202,The Last Man on the Moon,53881,52482,1399,2016_boxofficemojo_rankings.csv,2016,0.9740353742506634,0.0259646257493365
14203,The Summer of Sangaile,53843,4480,49363,2015_boxofficemojo_rankings.csv,2015,0.0832048734283008,0.9167951265716991
14204,At Middleton,53837,53837,0,2014_boxofficemojo_rankings.csv,2014,1.0,0.0
14205,Easy,53825,21589,32236,2004_boxofficemojo_rankings.csv,2004,0.40109614491407336,0.5989038550859266
14206,Ballot Measure 9,53819,53819,0,1995_boxofficemojo_rankings.csv,1995,1.0,0.0
14207,Rising from Ashes,53804,38602,15202,2013_boxofficemojo_rankings.csv,2013,0.7174559512303917,0.2825440487696082
14208,The Heir Apparent: Largo Winch 2011 Re-release,53793,10352,43441,2011_boxofficemojo_rankings.csv,2011,0.1924413957206328,0.8075586042793672
14209,Down by Love,53780,675,53105,2016_boxofficemojo_rankings.csv,2016,0.012551134250650799,0.9874488657493492
14210,Bart Got a Room,53760,53760,0,2009_boxofficemojo_rankings.csv,2009,1.0,0.0
14211,The Legend of Hallowaiian,53738,451,53287,2018_boxofficemojo_rankings.csv,2018,0.00839257136476981,0.9916074286352302
14212,The Other F Word,53714,53714,0,2011_boxofficemojo_rankings.csv,2011,1.0,0.0
14213,Leonie 2013 Re-release,53692,53692,0,2013_boxofficemojo_rankings.csv,2013,1.0,0.0
14214,Intimate Relations,53662,53662,0,1997_boxofficemojo_rankings.csv,1997,1.0,0.0
14215,Kalamazoo?,53609,53609,0,2006_boxofficemojo_rankings.csv,2006,1.0,0.0
14216,Under the Domim Tree,53532,53532,0,1996_boxofficemojo_rankings.csv,1996,1.0,0.0
14217,Grass,53503,8084,45419,2018_boxofficemojo_rankings.csv,2018,0.15109433115900042,0.8489056688409996
14218,Plagues and Pleasures on the Salton Sea,53471,53471,0,2006_boxofficemojo_rankings.csv,2006,1.0,0.0
14219,God of Vampires,53345,53345,0,2010_boxofficemojo_rankings.csv,2010,1.0,0.0
14220,High Lonesome: The Story of Bluegrass Music,53319,53319,0,1994_boxofficemojo_rankings.csv,1994,1.0,0.0
14221,Ugly Me 2008 Re-release,53250,53250,0,2008_boxofficemojo_rankings.csv,2008,1.0,0.0
14222,Finishing the Game,53219,52868,351,2007_boxofficemojo_rankings.csv,2007,0.9934046111351209,0.006595388864879085
14223,Boys Life 4: Four Play,53169,53169,0,2003_boxofficemojo_rankings.csv,2003,1.0,0.0
14224,The Killing of John Lennon,53117,6975,46142,2007_boxofficemojo_rankings.csv,2007,0.13131389197432083,0.8686861080256791
14225,The Great Silence,53074,53074,0,2018_boxofficemojo_rankings.csv,2018,1.0,0.0
14226,Waiting for Happiness,53048,7406,45642,2003_boxofficemojo_rankings.csv,2003,0.1396094103453476,0.8603905896546524
14227,Love Thy Nature,52947,41149,11798,2015_boxofficemojo_rankings.csv,2015,0.7771733998149093,0.22282660018509076
14228,Ping Pong Summer,52909,52909,0,2014_boxofficemojo_rankings.csv,2014,1.0,0.0
14229,Mia and the Migoo 2010 Re-release,52873,17000,35873,2010_boxofficemojo_rankings.csv,2010,0.3215251640723999,0.6784748359276
14230,An Alan Smithee Film: Burn Hollywood Burn,52850,45779,7071,1998_boxofficemojo_rankings.csv,1998,0.8662062440870388,0.13379375591296122
14231,Billy the Kid,52823,52823,0,2007_boxofficemojo_rankings.csv,2007,1.0,0.0
14232,To Be Takei,52823,52823,0,2014_boxofficemojo_rankings.csv,2014,1.0,0.0
14233,Southie,52819,52819,0,1999_boxofficemojo_rankings.csv,1999,1.0,0.0
14234,Occupy Unmasked,52768,52768,0,2012_boxofficemojo_rankings.csv,2012,1.0,0.0
14235,!Women Art Revolution,52681,52681,0,2011_boxofficemojo_rankings.csv,2011,1.0,0.0
14236,Reggie's Prayer,52665,52665,0,1997_boxofficemojo_rankings.csv,1997,1.0,0.0
14237,Close to You,52654,52654,0,2006_boxofficemojo_rankings.csv,2006,1.0,0.0
14238,Prisoners of the Sun,52654,52654,0,1991_boxofficemojo_rankings.csv,1991,1.0,0.0
14239,Pierrot le Fou,52640,52640,0,2007_boxofficemojo_rankings.csv,2007,1.0,0.0
14240,A Brother's Kiss,52632,52632,0,1997_boxofficemojo_rankings.csv,1997,1.0,0.0
14241,La forza del destino,52577,52577,0,2008_boxofficemojo_rankings.csv,2008,1.0,0.0
14242,Salvation Army,52511,3929,48582,2014_boxofficemojo_rankings.csv,2014,0.07482241816000457,0.9251775818399954
14243,Cropsey,52476,52476,0,2010_boxofficemojo_rankings.csv,2010,1.0,0.0
14244,Visual Acoustics,52467,52467,0,2009_boxofficemojo_rankings.csv,2009,1.0,0.0
14245,Hush!,52462,21278,31184,2002_boxofficemojo_rankings.csv,2002,0.4055888071365941,0.5944111928634059
14246,Going Attractions: The Definitive Story of the American Drive-in Movie,52458,52458,0,2013_boxofficemojo_rankings.csv,2013,1.0,0.0
14247,Lost in Love,52453,52453,0,2009_boxofficemojo_rankings.csv,2009,1.0,0.0
14248,The Only Thrill,52436,52436,0,1998_boxofficemojo_rankings.csv,1998,1.0,0.0
14249,A Tale of Winter,52431,23268,29163,2014_boxofficemojo_rankings.csv,2014,0.4437832579962236,0.5562167420037764
14250,Trucker,52429,52429,0,2009_boxofficemojo_rankings.csv,2009,1.0,0.0
14251,Breath Made Visible: Anna Halprin,52387,52387,0,2010_boxofficemojo_rankings.csv,2010,1.0,0.0
14252,Birdboy: The Forgotten Children,52366,38786,13580,2017_boxofficemojo_rankings.csv,2017,0.7406714280258183,0.25932857197418174
14253,The Spirit of '76,52310,52310,0,1990_boxofficemojo_rankings.csv,1990,1.0,0.0
14254,Here and There,52307,27156,25151,2010_boxofficemojo_rankings.csv,2010,0.5191656948400788,0.48083430515992126
14255,The Human Experience,52296,52296,0,2010_boxofficemojo_rankings.csv,2010,1.0,0.0
14256,Breaking the Rules,52285,52285,0,1992_boxofficemojo_rankings.csv,1992,1.0,0.0
14257,In My Skin,52231,31046,21185,2002_boxofficemojo_rankings.csv,2002,0.5943979628955984,0.4056020371044016
14258,Nunzio,52195,52195,0,1978_boxofficemojo_rankings.csv,1978,1.0,0.0
14259,Dare Not Walk Alone,52166,52166,0,2008_boxofficemojo_rankings.csv,2008,1.0,0.0
14260,Follow Me Home,52155,52155,0,1997_boxofficemojo_rankings.csv,1997,1.0,0.0
14261,"Surfer, Dude",52132,52132,0,2008_boxofficemojo_rankings.csv,2008,1.0,0.0
14262,Screamers,52034,52034,0,2006_boxofficemojo_rankings.csv,2006,1.0,0.0
14263,Henri-Georges Clouzot's Inferno,52003,25489,26514,2010_boxofficemojo_rankings.csv,2010,0.4901447993384997,0.5098552006615003
14264,Herod's Law,52000,52000,0,2003_boxofficemojo_rankings.csv,2003,1.0,0.0
14265,Will It Snow for Christmas?,51950,51950,0,1997_boxofficemojo_rankings.csv,1997,1.0,0.0
14266,Julian Po,51942,51942,0,1997_boxofficemojo_rankings.csv,1997,1.0,0.0
14267,Hiding and Seeking: Faith and Tolerance After the Holocaust,51936,51936,0,2004_boxofficemojo_rankings.csv,2004,1.0,0.0
14268,American Dharma,51891,51891,0,2019_boxofficemojo_rankings.csv,2019,1.0,0.0
14269,Quay,51858,51858,0,2015_boxofficemojo_rankings.csv,2015,1.0,0.0
14270,The Snowman Trek,51743,51743,0,2018_boxofficemojo_rankings.csv,2018,1.0,0.0
14271,The Strange Case of Dr. Jekyll and Mr. Hyde,51721,24216,27505,2006_boxofficemojo_rankings.csv,2006,0.4682044044005336,0.5317955955994663
14272,Wanda 2018 Re-release,51713,51713,0,2018_boxofficemojo_rankings.csv,2018,1.0,0.0
14273,Midnight Family,51712,42310,9402,2019_boxofficemojo_rankings.csv,2019,0.8181853341584159,0.18181466584158415
14274,"This World, Then the Fireworks",51618,51618,0,1997_boxofficemojo_rankings.csv,1997,1.0,0.0
14275,Moonlight,51570,51570,0,2006_boxofficemojo_rankings.csv,2006,1.0,0.0
14276,The Fire and the Rain,51549,51549,0,2002_boxofficemojo_rankings.csv,2002,1.0,0.0
14277,The Motel,51540,51540,0,2006_boxofficemojo_rankings.csv,2006,1.0,0.0
14278,The Willow Tree,51499,25752,25747,2007_boxofficemojo_rankings.csv,2007,0.5000485446319346,0.4999514553680654
14279,Tickling Giants,51499,51499,0,2017_boxofficemojo_rankings.csv,2017,1.0,0.0
14280,The Yes Men Are Revolting,51331,50190,1141,2015_boxofficemojo_rankings.csv,2015,0.9777717168962226,0.022228283103777443
14281,Venus and Serena,51271,51271,0,2013_boxofficemojo_rankings.csv,2013,1.0,0.0
14282,Fall,51266,51266,0,1997_boxofficemojo_rankings.csv,1997,1.0,0.0
14283,Maggie's Stiletto Sisters,51264,51264,0,1996_boxofficemojo_rankings.csv,1996,1.0,0.0
14284,Amu,51251,51251,0,2007_boxofficemojo_rankings.csv,2007,1.0,0.0
14285,God's Sandbox,51246,51246,0,2005_boxofficemojo_rankings.csv,2005,1.0,0.0
14286,God Loves Uganda,51229,51229,0,2013_boxofficemojo_rankings.csv,2013,1.0,0.0
14287,Miss Fisher & the Crypt of Tears Special Screenings,51158,51032,126,2020_boxofficemojo_rankings.csv,2020,0.9975370421048516,0.002462957895148364
14288,A Matter of Taste,51148,10720,40428,2001_boxofficemojo_rankings.csv,2001,0.2095878626730273,0.7904121373269727
14289,An Invisible Sign,51138,1279,49859,2011_boxofficemojo_rankings.csv,2011,0.02501075521138879,0.9749892447886112
14290,Da wan,51059,820,50239,2002_boxofficemojo_rankings.csv,2002,0.01605985232769933,0.9839401476723006
14291,Wasabi Tuna 2005 Re-release,51036,51036,0,2005_boxofficemojo_rankings.csv,2005,1.0,0.0
14292,The Unknowns,51035,51035,0,2016_boxofficemojo_rankings.csv,2016,1.0,0.0
14293,The Good Doctor,51017,5206,45811,2012_boxofficemojo_rankings.csv,2012,0.10204441656702667,0.8979555834329733
14294,Gunnin' for That #1 Spot,50950,50804,146,2008_boxofficemojo_rankings.csv,2008,0.9971344455348381,0.0028655544651619235
14295,The Ogre,50935,50935,0,1998_boxofficemojo_rankings.csv,1998,1.0,0.0
14296,Johns,50789,50789,0,1997_boxofficemojo_rankings.csv,1997,1.0,0.0
14297,Only You,50785,50785,0,1999_boxofficemojo_rankings.csv,1999,1.0,0.0
14298,As I Open My Eyes,50721,30989,19732,2016_boxofficemojo_rankings.csv,2016,0.6109698152638946,0.38903018473610534
14299,Long Night's Journey Into Day,50715,50715,0,2000_boxofficemojo_rankings.csv,2000,1.0,0.0
14300,House of Cardin,50659,0,50659,2020_boxofficemojo_rankings.csv,2020,0.0,1.0
14301,Asambhav,50611,19504,31107,2004_boxofficemojo_rankings.csv,2004,0.38537076920037144,0.6146292307996285
14302,The Line King: The Al Hirschfeld Story,50605,50605,0,1996_boxofficemojo_rankings.csv,1996,1.0,0.0
14303,Keep Quiet,50451,50451,0,2017_boxofficemojo_rankings.csv,2017,1.0,0.0
14304,American Casino,50437,50437,0,2009_boxofficemojo_rankings.csv,2009,1.0,0.0
14305,Clinton Road,50400,50400,0,2019_boxofficemojo_rankings.csv,2019,1.0,0.0
14306,Wake in Fright 2012 Re-release,50394,50394,0,2012_boxofficemojo_rankings.csv,2012,1.0,0.0
14307,Hollywood Vice Squad,50379,50379,0,1986_boxofficemojo_rankings.csv,1986,1.0,0.0
14308,Spontaneous Combustion,50367,50367,0,1990_boxofficemojo_rankings.csv,1990,1.0,0.0
14309,Midnight Traveler,50336,41265,9071,2019_boxofficemojo_rankings.csv,2019,0.8197910044500953,0.18020899554990463
14310,The Fitzgerald Family Christmas,50292,50292,0,2012_boxofficemojo_rankings.csv,2012,1.0,0.0
14311,The Royal Wedding: Prince Harry and Meghan Markle,50264,50264,0,2018_boxofficemojo_rankings.csv,2018,1.0,0.0
14312,The Warrior 2005 Re-release,50257,50257,0,2005_boxofficemojo_rankings.csv,2005,1.0,0.0
14313,The Retrieval,50257,50257,0,2014_boxofficemojo_rankings.csv,2014,1.0,0.0
14314,Carnets d'ado: You'll Get Over It,50256,50256,0,2004_boxofficemojo_rankings.csv,2004,1.0,0.0
14315,In Order of Disappearance 2016 Re-release,50251,50251,0,2016_boxofficemojo_rankings.csv,2016,1.0,0.0
14316,"Tristan und Isolde, Azione in tre atti",50172,50172,0,2008_boxofficemojo_rankings.csv,2008,1.0,0.0
14317,Royal Kill,50090,50090,0,2009_boxofficemojo_rankings.csv,2009,1.0,0.0
14318,A Family Affair,50075,50075,0,2003_boxofficemojo_rankings.csv,2003,1.0,0.0
14319,Le combat dans l'île,50039,50039,0,2009_boxofficemojo_rankings.csv,2009,1.0,0.0
14320,Quest,50022,47807,2215,2017_boxofficemojo_rankings.csv,2017,0.955719483427292,0.04428051657270801
14321,The Discoverers,50020,50020,0,2014_boxofficemojo_rankings.csv,2014,1.0,0.0
14322,Frank & Jesse,50004,50004,0,1994_boxofficemojo_rankings.csv,1994,1.0,0.0
14323,Hamsun,50000,50000,0,1997_boxofficemojo_rankings.csv,1997,1.0,0.0
14324,Bigger,49997,46382,3615,2018_boxofficemojo_rankings.csv,2018,0.9276956617397044,0.07230433826029561
14325,AKA,49988,49988,0,2003_boxofficemojo_rankings.csv,2003,1.0,0.0
14326,Afterschool,49971,3911,46060,2008_boxofficemojo_rankings.csv,2008,0.07826539392847852,0.9217346060715215
14327,Spring,49970,49970,0,2015_boxofficemojo_rankings.csv,2015,1.0,0.0
14328,On the Outs,49940,49940,0,2005_boxofficemojo_rankings.csv,2005,1.0,0.0
14329,Transformation: The Life and Legacy of Werner Erhard,49919,49919,0,2007_boxofficemojo_rankings.csv,2007,1.0,0.0
14330,How to Kill Your Neighbor's Dog,49894,49894,0,2002_boxofficemojo_rankings.csv,2002,1.0,0.0
14331,Fakers,49880,49880,0,2007_boxofficemojo_rankings.csv,2007,1.0,0.0
14332,Free Trip to Egypt,49693,49693,0,2019_boxofficemojo_rankings.csv,2019,1.0,0.0
14333,The Fantasticks,49666,49666,0,2000_boxofficemojo_rankings.csv,2000,1.0,0.0
14334,Curdled,49620,49620,0,1996_boxofficemojo_rankings.csv,1996,1.0,0.0
14335,NOW: In the Wings on a World Stage,49591,49591,0,2014_boxofficemojo_rankings.csv,2014,1.0,0.0
14336,A Call to Spy,49586,49586,0,2020_boxofficemojo_rankings.csv,2020,1.0,0.0
14337,Picnic at Hanging Rock,49582,49582,0,1998_boxofficemojo_rankings.csv,1998,1.0,0.0
14338,Ciao,49494,49494,0,2008_boxofficemojo_rankings.csv,2008,1.0,0.0
14339,Red Herring,49480,49480,0,2015_boxofficemojo_rankings.csv,2015,1.0,0.0
14340,GasLand,49428,30846,18582,2010_boxofficemojo_rankings.csv,2010,0.6240592376790484,0.3759407623209517
14341,Yurîka,49388,49388,0,2001_boxofficemojo_rankings.csv,2001,1.0,0.0
14342,Jumanji/Jumanji: Welcome to the Jungle 2018 NCM Fathom Event,49381,49381,0,2018_boxofficemojo_rankings.csv,2018,1.0,0.0
14343,Shirin in Love,49254,49254,0,2014_boxofficemojo_rankings.csv,2014,1.0,0.0
14344,Confusion of Genders 2003 Re-release,49237,49237,0,2003_boxofficemojo_rankings.csv,2003,1.0,0.0
14345,Journey to the End of the Night,49172,0,49172,2007_boxofficemojo_rankings.csv,2007,0.0,1.0
14346,The Amati Girls,49136,49136,0,2001_boxofficemojo_rankings.csv,2001,1.0,0.0
14347,Bonsai,49128,21267,27861,2012_boxofficemojo_rankings.csv,2012,0.4328895945285784,0.5671104054714216
14348,La Rondine,49088,49088,0,2008_boxofficemojo_rankings.csv,2008,1.0,0.0
14349,Assisted Living,49048,49048,0,2005_boxofficemojo_rankings.csv,2005,1.0,0.0
14350,Hal,49045,48698,347,2018_boxofficemojo_rankings.csv,2018,0.9929248649199715,0.007075135080028545
14351,Raging Bull 25th Anniversary,49034,49034,0,2005_boxofficemojo_rankings.csv,2005,1.0,0.0
14352,The Way I See It,49030,49030,0,2020_boxofficemojo_rankings.csv,2020,1.0,0.0
14353,Orgasm Inc.,49001,49001,0,2011_boxofficemojo_rankings.csv,2011,1.0,0.0
14354,Chocolate: Deep Dark Secrets,49000,49000,0,2005_boxofficemojo_rankings.csv,2005,1.0,0.0
14355,Box Elder,48996,48996,0,2008_boxofficemojo_rankings.csv,2008,1.0,0.0
14356,Lucky Them,48995,48995,0,2014_boxofficemojo_rankings.csv,2014,1.0,0.0
14357,Alice Neel,48969,48969,0,2007_boxofficemojo_rankings.csv,2007,1.0,0.0
14358,The Internet's Own Boy: The Story of Aaron Swartz,48911,48911,0,2014_boxofficemojo_rankings.csv,2014,1.0,0.0
14359,Bolivar Is Me,48911,48911,0,2002_boxofficemojo_rankings.csv,2002,1.0,0.0
14360,The Situation,48896,48896,0,2007_boxofficemojo_rankings.csv,2007,1.0,0.0
14361,The Seven Five,48869,48869,0,2015_boxofficemojo_rankings.csv,2015,1.0,0.0
14362,The Bounty Killer,48815,48815,0,2019_boxofficemojo_rankings.csv,2019,1.0,0.0
14363,A Thousand Clouds of Peace,48782,48782,0,2004_boxofficemojo_rankings.csv,2004,1.0,0.0
14364,The Citizen,48767,24296,24471,2013_boxofficemojo_rankings.csv,2013,0.49820575389095084,0.5017942461090491
14365,A Birder's Guide to Everything,48713,48713,0,2014_boxofficemojo_rankings.csv,2014,1.0,0.0
14366,American Mustang,48700,48700,0,2014_boxofficemojo_rankings.csv,2014,1.0,0.0
14367,Tales from Earthsea 2010 Re-release,48658,48658,0,2010_boxofficemojo_rankings.csv,2010,1.0,0.0
14368,The China Hustle,48650,48650,0,2018_boxofficemojo_rankings.csv,2018,1.0,0.0
14369,Shakespeare Behind Bars,48594,48594,0,2006_boxofficemojo_rankings.csv,2006,1.0,0.0
14370,Sisters in Law,48526,33312,15214,2006_boxofficemojo_rankings.csv,2006,0.6864773523471953,0.3135226476528047
14371,Person to Person,48499,48499,0,2017_boxofficemojo_rankings.csv,2017,1.0,0.0
14372,The Cats of Mirikitani,48483,38925,9558,2007_boxofficemojo_rankings.csv,2007,0.8028587339892334,0.19714126601076665
14373,Following,48482,48482,0,1999_boxofficemojo_rankings.csv,1999,1.0,0.0
14374,Be with Me,48443,1365,47078,2006_boxofficemojo_rankings.csv,2006,0.028177445657783375,0.9718225543422166
14375,Alleluia,48426,6334,42092,2014_boxofficemojo_rankings.csv,2014,0.13079750547226696,0.869202494527733
14376,Boogie Woogie,48411,2618,45793,2010_boxofficemojo_rankings.csv,2010,0.05407861849579641,0.9459213815042036
14377,"Lebanon, Pa.",48381,48381,0,2011_boxofficemojo_rankings.csv,2011,1.0,0.0
14378,Waydowntown,48333,48333,0,2000_boxofficemojo_rankings.csv,2000,1.0,0.0
14379,Dry Season,48251,3303,44948,2007_boxofficemojo_rankings.csv,2007,0.06845453980228389,0.9315454601977161
14380,Ceremony,48174,22270,25904,2011_boxofficemojo_rankings.csv,2011,0.4622825590567526,0.5377174409432474
14381,The Forbidden Room,48082,34404,13678,2015_boxofficemojo_rankings.csv,2015,0.7155276402811863,0.2844723597188137
14382,Interview with the Assassin,48058,48058,0,2002_boxofficemojo_rankings.csv,2002,1.0,0.0
14383,Life Happens,48041,30905,17136,2012_boxofficemojo_rankings.csv,2012,0.6433046772548449,0.3566953227451552
14384,A Cop,48040,48040,0,2013_boxofficemojo_rankings.csv,2013,1.0,0.0
14385,Blackball 2005 Re-release,48000,48000,0,2005_boxofficemojo_rankings.csv,2005,1.0,0.0
14386,Two Weeks,47986,47986,0,2006_boxofficemojo_rankings.csv,2006,1.0,0.0
14387,Saving Banksy,47965,47965,0,2017_boxofficemojo_rankings.csv,2017,1.0,0.0
14388,The Queen,47818,47818,0,2019_boxofficemojo_rankings.csv,2019,1.0,0.0
14389,Alphaville,47696,47696,0,2014_boxofficemojo_rankings.csv,2014,1.0,0.0
14390,So B. It,47627,47627,0,2017_boxofficemojo_rankings.csv,2017,1.0,0.0
14391,Laila's Birthday,47622,13689,33933,2009_boxofficemojo_rankings.csv,2009,0.28745117802696235,0.7125488219730377
14392,GMO OMG,47558,47558,0,2013_boxofficemojo_rankings.csv,2013,1.0,0.0
14393,350 Days - Legends. Champions. Survivors,47526,47526,0,2018_boxofficemojo_rankings.csv,2018,1.0,0.0
14394,Entre les Bras,47439,47439,0,2012_boxofficemojo_rankings.csv,2012,1.0,0.0
14395,Twist,47370,47370,0,2004_boxofficemojo_rankings.csv,2004,1.0,0.0
14396,Alabama Moon,47305,47305,0,2011_boxofficemojo_rankings.csv,2011,1.0,0.0
14397,Daughters of the Dust 2016 Re-release,47287,40986,6301,2016_boxofficemojo_rankings.csv,2016,0.8667498466809059,0.13325015331909404
14398,The Raft,47269,39678,7591,2019_boxofficemojo_rankings.csv,2019,0.8394084918233937,0.16059150817660622
14399,Every Man for Himself,47262,47262,0,2010_boxofficemojo_rankings.csv,2010,1.0,0.0
14400,Tibet: A Buddhist Trilogy,47243,47243,0,2006_boxofficemojo_rankings.csv,2006,1.0,0.0
14401,International Khiladi,47238,47238,0,1999_boxofficemojo_rankings.csv,1999,1.0,0.0
14402,Never Been Thawed,47219,47219,0,2005_boxofficemojo_rankings.csv,2005,1.0,0.0
14403,Went the Day Well?,47214,47214,0,2011_boxofficemojo_rankings.csv,2011,1.0,0.0
14404,The Goebbels Experiment,47211,47211,0,2005_boxofficemojo_rankings.csv,2005,1.0,0.0
14405,"Fear, Anxiety & Depression",47148,47148,0,1989_boxofficemojo_rankings.csv,1989,1.0,0.0
14406,VHYes,47037,47037,0,2020_boxofficemojo_rankings.csv,2020,1.0,0.0
14407,Ivans xtc.,47027,47027,0,2002_boxofficemojo_rankings.csv,2002,1.0,0.0
14408,Diary of a Country Priest,47000,47000,0,2011_boxofficemojo_rankings.csv,2011,1.0,0.0
14409,Collapse,46964,46964,0,2009_boxofficemojo_rankings.csv,2009,1.0,0.0
14410,A Master Builder,46874,46874,0,2014_boxofficemojo_rankings.csv,2014,1.0,0.0
14411,Enter the Fat Dragon,46855,46855,0,2020_boxofficemojo_rankings.csv,2020,1.0,0.0
14412,78/52: Hitchcock's Shower Scene,46838,37664,9174,2017_boxofficemojo_rankings.csv,2017,0.8041333959605449,0.19586660403945513
14413,"Connected: An Autoblogography About Love, Death & Technology",46782,46782,0,2011_boxofficemojo_rankings.csv,2011,1.0,0.0
14414,Tropical Malady,46750,46750,0,2005_boxofficemojo_rankings.csv,2005,1.0,0.0
14415,On the Ropes,46737,46737,0,1999_boxofficemojo_rankings.csv,1999,1.0,0.0
14416,The Woodmans,46623,46623,0,2011_boxofficemojo_rankings.csv,2011,1.0,0.0
14417,Casi divas 2009 Re-release,46612,46612,0,2009_boxofficemojo_rankings.csv,2009,1.0,0.0
14418,Beeswax,46590,46590,0,2009_boxofficemojo_rankings.csv,2009,1.0,0.0
14419,White Dog,46509,46509,0,1982_boxofficemojo_rankings.csv,1982,1.0,0.0
14420,Ca$h,46488,46488,0,2010_boxofficemojo_rankings.csv,2010,1.0,0.0
14421,Shanghai 2015 Re-release,46425,46425,0,2015_boxofficemojo_rankings.csv,2015,1.0,0.0
14422,Etoiles: Dancers of the Paris Opera Ballet,46412,46412,0,2002_boxofficemojo_rankings.csv,2002,1.0,0.0
14423,Patience,46410,15941,30469,2012_boxofficemojo_rankings.csv,2012,0.34348200818789054,0.6565179918121095
14424,Mediterranea,46392,22076,24316,2015_boxofficemojo_rankings.csv,2015,0.4758579065356096,0.5241420934643904
14425,William S. Burroughs: A Man Within,46380,46380,0,2010_boxofficemojo_rankings.csv,2010,1.0,0.0
14426,New Best Friend,46375,46375,0,2002_boxofficemojo_rankings.csv,2002,1.0,0.0
14427,The Last Time I Committed Suicide,46362,46362,0,1997_boxofficemojo_rankings.csv,1997,1.0,0.0
14428,The Tunnel 2005 Re-release,46296,46296,0,2005_boxofficemojo_rankings.csv,2005,1.0,0.0
14429,The Hip Hop Project,46208,46208,0,2007_boxofficemojo_rankings.csv,2007,1.0,0.0
14430,Greedy Lying Bastards,46121,45000,1121,2012_boxofficemojo_rankings.csv,2012,0.9756943691593851,0.024305630840614906
14431,Ballplayer: Pelotero,46109,46109,0,2012_boxofficemojo_rankings.csv,2012,1.0,0.0
14432,William Kunstler: Disturbing the Universe,46078,46078,0,2009_boxofficemojo_rankings.csv,2009,1.0,0.0
14433,Breakfast with Scot,46060,46060,0,2008_boxofficemojo_rankings.csv,2008,1.0,0.0
14434,Panique,46041,46041,0,2017_boxofficemojo_rankings.csv,2017,1.0,0.0
14435,Every Day,46029,46029,0,2011_boxofficemojo_rankings.csv,2011,1.0,0.0
14436,Monk with a Camera,45938,45938,0,2014_boxofficemojo_rankings.csv,2014,1.0,0.0
14437,Maurice 2017 Re-release,45926,45926,0,2017_boxofficemojo_rankings.csv,2017,1.0,0.0
14438,Ellie Parker,45726,34410,11316,2005_boxofficemojo_rankings.csv,2005,0.7525259152342212,0.24747408476577876
14439,Safe Men,45724,45724,0,1998_boxofficemojo_rankings.csv,1998,1.0,0.0
14440,High on the Hog,45696,45696,0,2019_boxofficemojo_rankings.csv,2019,1.0,0.0
14441,Phoenix,45661,45661,0,1998_boxofficemojo_rankings.csv,1998,1.0,0.0
14442,Eddie: The Sleepwalking Cannibal,45604,1632,43972,2012_boxofficemojo_rankings.csv,2012,0.035786334532058595,0.9642136654679414
14443,Our Time,45579,14777,30802,2019_boxofficemojo_rankings.csv,2019,0.3242063230873867,0.6757936769126133
14444,3 Weeks in Yerevan,45536,45536,0,2016_boxofficemojo_rankings.csv,2016,1.0,0.0
14445,An Eye for Beauty,45513,9395,36118,2015_boxofficemojo_rankings.csv,2015,0.20642453804407532,0.7935754619559247
14446,Straight-Jacket,45497,45497,0,2004_boxofficemojo_rankings.csv,2004,1.0,0.0
14447,Feed,45488,45488,0,1992_boxofficemojo_rankings.csv,1992,1.0,0.0
14448,The Low Life,45436,45436,0,1996_boxofficemojo_rankings.csv,1996,1.0,0.0
14449,Mercury,45429,0,45429,2018_boxofficemojo_rankings.csv,2018,0.0,1.0
14450,Randy and the Mob,45410,45410,0,2007_boxofficemojo_rankings.csv,2007,1.0,0.0
14451,Au Hasard Balthazar,45406,45406,0,2003_boxofficemojo_rankings.csv,2003,1.0,0.0
14452,Return to the Hiding Place,45405,45405,0,2014_boxofficemojo_rankings.csv,2014,1.0,0.0
14453,Dhadkan,45380,45380,0,2000_boxofficemojo_rankings.csv,2000,1.0,0.0
14454,Sympathy for Mr. Vengeance 2005 Re-release,45289,45289,0,2005_boxofficemojo_rankings.csv,2005,1.0,0.0
14455,Ai Weiwei: The Fake Case,45255,45255,0,2014_boxofficemojo_rankings.csv,2014,1.0,0.0
14456,There's No Place Like Utopia,45254,45254,0,2014_boxofficemojo_rankings.csv,2014,1.0,0.0
14457,Karobaar: The Business of Love,45200,45200,0,2000_boxofficemojo_rankings.csv,2000,1.0,0.0
14458,CornerStore,45176,45176,0,2011_boxofficemojo_rankings.csv,2011,1.0,0.0
14459,American Made Movie,45175,45175,0,2013_boxofficemojo_rankings.csv,2013,1.0,0.0
14460,The Proposal,45149,45149,0,2019_boxofficemojo_rankings.csv,2019,1.0,0.0
14461,Bailey's Billion$,45000,45000,0,2005_boxofficemojo_rankings.csv,2005,1.0,0.0
14462,Undoing,44999,44999,0,2008_boxofficemojo_rankings.csv,2008,1.0,0.0
14463,Bed & Breakfast,44947,44947,0,1992_boxofficemojo_rankings.csv,1992,1.0,0.0
14464,The Farthest,44921,14773,30148,2017_boxofficemojo_rankings.csv,2017,0.32886623182921126,0.6711337681707887
14465,Celebration,44898,22557,22341,2019_boxofficemojo_rankings.csv,2019,0.5024054523586797,0.49759454764132033
14466,The Pruitt-Igoe Myth,44883,44883,0,2012_boxofficemojo_rankings.csv,2012,1.0,0.0
14467,What Doesn't Kill You,44872,0,44872,2008_boxofficemojo_rankings.csv,2008,0.0,1.0
14468,The Babysitters,44852,44852,0,2008_boxofficemojo_rankings.csv,2008,1.0,0.0
14469,Red Cherry,44846,44846,0,1997_boxofficemojo_rankings.csv,1997,1.0,0.0
14470,River of Fundament,44840,44840,0,2015_boxofficemojo_rankings.csv,2015,1.0,0.0
14471,Union Square,44830,44830,0,2012_boxofficemojo_rankings.csv,2012,1.0,0.0
14472,Pressure Cooker,44803,44803,0,2009_boxofficemojo_rankings.csv,2009,1.0,0.0
14473,The War at Home,44722,44722,0,1996_boxofficemojo_rankings.csv,1996,1.0,0.0
14474,That Summer,44659,34556,10103,2018_boxofficemojo_rankings.csv,2018,0.7737746031035178,0.22622539689648224
14475,The Dog,44581,44581,0,2014_boxofficemojo_rankings.csv,2014,1.0,0.0
14476,The Bride Wore Black,44566,44566,0,2011_boxofficemojo_rankings.csv,2011,1.0,0.0
14477,Bandwagon,44544,44544,0,1997_boxofficemojo_rankings.csv,1997,1.0,0.0
14478,Moving the Mountain,44536,44536,0,1995_boxofficemojo_rankings.csv,1995,1.0,0.0
14479,What Is Democracy?,44536,44536,0,2019_boxofficemojo_rankings.csv,2019,1.0,0.0
14480,"Léon Morin, Priest 2017 Re-release",44511,44511,0,2017_boxofficemojo_rankings.csv,2017,1.0,0.0
14481,Defendor,44462,44462,0,2010_boxofficemojo_rankings.csv,2010,1.0,0.0
14482,William Eggleston in the Real World,44435,44435,0,2005_boxofficemojo_rankings.csv,2005,1.0,0.0
14483,Maze 2019 Re-release,44381,44381,0,2019_boxofficemojo_rankings.csv,2019,1.0,0.0
14484,Such a Long Journey,44364,44364,0,2000_boxofficemojo_rankings.csv,2000,1.0,0.0
14485,Get Bruce,44337,44337,0,1999_boxofficemojo_rankings.csv,1999,1.0,0.0
14486,What You Gonna Do When the World's on Fire?,44290,4672,39618,2019_boxofficemojo_rankings.csv,2019,0.10548656581621134,0.8945134341837887
14487,Lana's Rain,44287,44287,0,2004_boxofficemojo_rankings.csv,2004,1.0,0.0
14488,Texas Chainsaw Massacre: The Next Generation,44272,44272,0,1995_boxofficemojo_rankings.csv,1995,1.0,0.0
14489,Carmine Street Guitars,44253,44253,0,2019_boxofficemojo_rankings.csv,2019,1.0,0.0
14490,Slut in a Good Way,44240,40513,3727,2019_boxofficemojo_rankings.csv,2019,0.915754972875226,0.08424502712477396
14491,Loaded,44231,44231,0,1996_boxofficemojo_rankings.csv,1996,1.0,0.0
14492,Nuts!,44230,44230,0,2016_boxofficemojo_rankings.csv,2016,1.0,0.0
14493,Danny Says,44213,44213,0,2016_boxofficemojo_rankings.csv,2016,1.0,0.0
14494,Regret to Inform,44204,44204,0,1999_boxofficemojo_rankings.csv,1999,1.0,0.0
14495,Life of a King,44161,6547,37614,2014_boxofficemojo_rankings.csv,2014,0.14825298340164397,0.851747016598356
14496,"Paris, France",44159,44159,0,1994_boxofficemojo_rankings.csv,1994,1.0,0.0
14497,Hermia & Helena,44156,43152,1004,2017_boxofficemojo_rankings.csv,2017,0.9772624331914123,0.022737566808587736
14498,Apaharan,44133,44133,0,2005_boxofficemojo_rankings.csv,2005,1.0,0.0
14499,Submission,44069,39985,4084,2018_boxofficemojo_rankings.csv,2018,0.9073271460663959,0.09267285393360412
14500,Wedding Bell Blues,44052,44052,0,1997_boxofficemojo_rankings.csv,1997,1.0,0.0
14501,Liyana,44045,44045,0,2018_boxofficemojo_rankings.csv,2018,1.0,0.0
14502,Garry Winogrand: All Things are Photographable,44002,44002,0,2018_boxofficemojo_rankings.csv,2018,1.0,0.0
14503,Digging to China,43961,43961,0,1998_boxofficemojo_rankings.csv,1998,1.0,0.0
14504,Granito,43942,43942,0,2011_boxofficemojo_rankings.csv,2011,1.0,0.0
14505,Miss Julie,43941,43941,0,1999_boxofficemojo_rankings.csv,1999,1.0,0.0
14506,The Circle,43918,43918,0,2001_boxofficemojo_rankings.csv,2001,1.0,0.0
14507,All Roads Lead Home,43907,43907,0,2008_boxofficemojo_rankings.csv,2008,1.0,0.0
14508,Summer 2011 Re-release,43839,43839,0,2011_boxofficemojo_rankings.csv,2011,1.0,0.0
14509,Altered,43836,0,43836,2007_boxofficemojo_rankings.csv,2007,0.0,1.0
14510,Animal Factory,43805,43805,0,2000_boxofficemojo_rankings.csv,2000,1.0,0.0
14511,Hitler's Hollywood,43766,43766,0,2018_boxofficemojo_rankings.csv,2018,1.0,0.0
14512,Contempt 2013 Re-release,43763,43763,0,2013_boxofficemojo_rankings.csv,2013,1.0,0.0
14513,Bad Blood 2013 Re-release,43758,35176,8582,2013_boxofficemojo_rankings.csv,2013,0.8038758626993922,0.19612413730060788
14514,The Land,43756,43756,0,2016_boxofficemojo_rankings.csv,2016,1.0,0.0
14515,Bereavement,43712,43712,0,2011_boxofficemojo_rankings.csv,2011,1.0,0.0
14516,Woodshock,43682,42603,1079,2017_boxofficemojo_rankings.csv,2017,0.9752987500572318,0.024701249942768188
14517,Bloodhounds of Broadway,43671,43671,0,1989_boxofficemojo_rankings.csv,1989,1.0,0.0
14518,A Grin Without A Cat,43616,43616,0,2002_boxofficemojo_rankings.csv,2002,1.0,0.0
14519,The Golden Boys,43600,43600,0,2009_boxofficemojo_rankings.csv,2009,1.0,0.0
14520,"February 15, 1839",43595,43595,0,2001_boxofficemojo_rankings.csv,2001,1.0,0.0
14521,Love Etc.,43593,43593,0,2011_boxofficemojo_rankings.csv,2011,1.0,0.0
14522,"OC87: The Obsessive Compulsive, Major Depression, Bipolar, Asperger's Movie",43583,43583,0,2012_boxofficemojo_rankings.csv,2012,1.0,0.0
14523,The Graduate 45th Anniversary Reunion,43466,43466,0,2012_boxofficemojo_rankings.csv,2012,1.0,0.0
14524,If You Build It,43393,43393,0,2014_boxofficemojo_rankings.csv,2014,1.0,0.0
14525,The Empire of Corpses,43320,0,43320,2016_boxofficemojo_rankings.csv,2016,0.0,1.0
14526,Next Goal Wins,43089,43089,0,2014_boxofficemojo_rankings.csv,2014,1.0,0.0
14527,3 Backyards,43073,43073,0,2011_boxofficemojo_rankings.csv,2011,1.0,0.0
14528,Spree,43062,28771,14291,2020_boxofficemojo_rankings.csv,2020,0.6681296734940319,0.33187032650596815
14529,"First Love, Last Rites",42953,42953,0,1998_boxofficemojo_rankings.csv,1998,1.0,0.0
14530,Jenny's Wedding,42927,4704,38223,2015_boxofficemojo_rankings.csv,2015,0.10958138234677475,0.8904186176532253
14531,Hammett,42914,42914,0,1982_boxofficemojo_rankings.csv,1982,1.0,0.0
14532,Hadh Kar Di Aapne,42914,42914,0,2000_boxofficemojo_rankings.csv,2000,1.0,0.0
14533,Tell Them Who You Are,42908,39075,3833,2005_boxofficemojo_rankings.csv,2005,0.9106693390509928,0.08933066094900718
14534,Andre Gregory: Before and After Dinner,42892,42892,0,2013_boxofficemojo_rankings.csv,2013,1.0,0.0
14535,Tekkonkinkreet,42840,6000,36840,2007_boxofficemojo_rankings.csv,2007,0.1400560224089636,0.8599439775910365
14536,First We Take Brooklyn,42812,42812,0,2018_boxofficemojo_rankings.csv,2018,1.0,0.0
14537,White Palms,42630,0,42630,2007_boxofficemojo_rankings.csv,2007,0.0,1.0
14538,La petite Lili 2004 Re-release,42628,34634,7994,2004_boxofficemojo_rankings.csv,2004,0.812470676550624,0.187529323449376
14539,Moving McAllister,42538,42538,0,2007_boxofficemojo_rankings.csv,2007,1.0,0.0
14540,Interior. Leather Bar.,42534,42534,0,2014_boxofficemojo_rankings.csv,2014,1.0,0.0
14541,Bolivia,42451,33098,9353,2002_boxofficemojo_rankings.csv,2002,0.7796753904501661,0.22032460954983393
14542,Last Call at the Oasis,42423,42423,0,2012_boxofficemojo_rankings.csv,2012,1.0,0.0
14543,Fixing the Future,42393,42393,0,2012_boxofficemojo_rankings.csv,2012,1.0,0.0
14544,Secret Lives: Hidden Children and Their Rescuers During WWII,42390,42390,0,2003_boxofficemojo_rankings.csv,2003,1.0,0.0
14545,Closet Monster,42360,42166,194,2016_boxofficemojo_rankings.csv,2016,0.9954202077431539,0.004579792256846081
14546,The Tracey Fragments,42318,32645,9673,2008_boxofficemojo_rankings.csv,2008,0.7714211446665722,0.22857885533342787
14547,The Oath,42273,42273,0,2010_boxofficemojo_rankings.csv,2010,1.0,0.0
14548,Girlhood,42213,37977,4236,2002_boxofficemojo_rankings.csv,2002,0.8996517660436358,0.10034823395636415
14549,Death of a Dynasty,42108,42108,0,2005_boxofficemojo_rankings.csv,2005,1.0,0.0
14550,Mandela,42056,42056,0,1997_boxofficemojo_rankings.csv,1997,1.0,0.0
14551,Down for Life,41914,41914,0,2011_boxofficemojo_rankings.csv,2011,1.0,0.0
14552,In Pursuit of Silence,41913,29834,12079,2016_boxofficemojo_rankings.csv,2016,0.7118077923317347,0.2881922076682652
14553,Golden Exits,41888,41888,0,2018_boxofficemojo_rankings.csv,2018,1.0,0.0
14554,The Nightmare,41853,28281,13572,2015_boxofficemojo_rankings.csv,2015,0.675722170453731,0.3242778295462691
14555,Azumi 2006 Re-release,41803,41803,0,2006_boxofficemojo_rankings.csv,2006,1.0,0.0
14556,On the Bowery,41802,41802,0,2010_boxofficemojo_rankings.csv,2010,1.0,0.0
14557,Blackboards,41772,23520,18252,2002_boxofficemojo_rankings.csv,2002,0.5630565929330652,0.4369434070669348
14558,The Road Within,41760,0,41760,2015_boxofficemojo_rankings.csv,2015,0.0,1.0
14559,Thomas Kinkade's Christmas Cottage,41724,0,41724,2008_boxofficemojo_rankings.csv,2008,0.0,1.0
14560,We Live in Public,41711,41711,0,2009_boxofficemojo_rankings.csv,2009,1.0,0.0
14561,Adored: Diary of a Porn Star,41703,41703,0,2004_boxofficemojo_rankings.csv,2004,1.0,0.0
14562,Union,41656,41656,0,2019_boxofficemojo_rankings.csv,2019,1.0,0.0
14563,For Better or Worse,41628,41628,0,1995_boxofficemojo_rankings.csv,1995,1.0,0.0
14564,Kalakalappu,41624,30949,10675,2012_boxofficemojo_rankings.csv,2012,0.7435373822794542,0.25646261772054585
14565,Death of a Superhero,41575,607,40968,2012_boxofficemojo_rankings.csv,2012,0.014600120264582081,0.9853998797354179
14566,The Settlers,41562,41562,0,2017_boxofficemojo_rankings.csv,2017,1.0,0.0
14567,Jonathan,41558,0,41558,2018_boxofficemojo_rankings.csv,2018,0.0,1.0
14568,Holla II,41537,41537,0,2013_boxofficemojo_rankings.csv,2013,1.0,0.0
14569,Animal Behavior,41526,41526,0,1989_boxofficemojo_rankings.csv,1989,1.0,0.0
14570,My Mother's Smile 2005 Re-release,41432,41432,0,2005_boxofficemojo_rankings.csv,2005,1.0,0.0
14571,Brother Minister: The Assassination of Malcolm X,41430,41430,0,1995_boxofficemojo_rankings.csv,1995,1.0,0.0
14572,Dahek: A Burning Passion,41284,41284,0,1999_boxofficemojo_rankings.csv,1999,1.0,0.0
14573,The Betrayal,41271,41271,0,2008_boxofficemojo_rankings.csv,2008,1.0,0.0
14574,Censored Voices,41260,41260,0,2015_boxofficemojo_rankings.csv,2015,1.0,0.0
14575,Happy New Year,41232,41232,0,1987_boxofficemojo_rankings.csv,1987,1.0,0.0
14576,Steve McQueen: The Man & Le Mans,41203,6843,34360,2015_boxofficemojo_rankings.csv,2015,0.16608013979564595,0.833919860204354
14577,Vlad,41176,0,41176,2004_boxofficemojo_rankings.csv,2004,0.0,1.0
14578,Colma: The Musical,41131,41131,0,2007_boxofficemojo_rankings.csv,2007,1.0,0.0
14579,The Comedy,41113,41113,0,2012_boxofficemojo_rankings.csv,2012,1.0,0.0
14580,Karl Marx City,41072,41072,0,2017_boxofficemojo_rankings.csv,2017,1.0,0.0
14581,Blue Iguana,41050,0,41050,2018_boxofficemojo_rankings.csv,2018,0.0,1.0
14582,The Myth of the American Sleepover,41045,41045,0,2011_boxofficemojo_rankings.csv,2011,1.0,0.0
14583,Canvas,41010,35630,5380,2007_boxofficemojo_rankings.csv,2007,0.8688124847598147,0.13118751524018532
14584,Fat Kid Rules the World,41000,41000,0,2012_boxofficemojo_rankings.csv,2012,1.0,0.0
14585,Why Don't You Just Die!,40995,0,40995,2019_boxofficemojo_rankings.csv,2019,0.0,1.0
14586,Hell and Back Again,40949,40634,315,2011_boxofficemojo_rankings.csv,2011,0.9923075044567633,0.007692495543236709
14587,I Can't Think Straight,40945,39576,1369,2008_boxofficemojo_rankings.csv,2008,0.9665649041396996,0.033435095860300405
14588,Tom Dowd & the Language of Music,40919,40919,0,2004_boxofficemojo_rankings.csv,2004,1.0,0.0
14589,Moving Midway,40864,40864,0,2008_boxofficemojo_rankings.csv,2008,1.0,0.0
14590,Simon Magus,40861,40861,0,2001_boxofficemojo_rankings.csv,2001,1.0,0.0
14591,The Intruder,40853,40853,0,2005_boxofficemojo_rankings.csv,2005,1.0,0.0
14592,Hate Crime,40758,40758,0,2005_boxofficemojo_rankings.csv,2005,1.0,0.0
14593,Found Memories,40729,10575,30154,2012_boxofficemojo_rankings.csv,2012,0.25964300621179015,0.7403569937882098
14594,Shikari,40712,40712,0,2000_boxofficemojo_rankings.csv,2000,1.0,0.0
14595,Language of a Broken Heart,40645,40645,0,2013_boxofficemojo_rankings.csv,2013,1.0,0.0
14596,Mercedes Sosa: The Voice of Latin America,40643,2648,37995,2013_boxofficemojo_rankings.csv,2013,0.06515267081662279,0.9348473291833772
14597,Life and Nothing More,40581,24358,16223,2017_boxofficemojo_rankings.csv,2017,0.6002316354944432,0.3997683645055568
14598,Tying the Knot,40576,40576,0,2004_boxofficemojo_rankings.csv,2004,1.0,0.0
14599,My Flesh and Blood,40573,40573,0,2003_boxofficemojo_rankings.csv,2003,1.0,0.0
14600,The FP,40557,40557,0,2012_boxofficemojo_rankings.csv,2012,1.0,0.0
14601,Backstage,40507,12663,27844,2006_boxofficemojo_rankings.csv,2006,0.31261263485323526,0.6873873651467648
14602,The Dhamma Brothers,40492,40492,0,2008_boxofficemojo_rankings.csv,2008,1.0,0.0
14603,Sex Is Comedy 2004 Re-release,40470,40470,0,2004_boxofficemojo_rankings.csv,2004,1.0,0.0
14604,CBGB,40400,40400,0,2013_boxofficemojo_rankings.csv,2013,1.0,0.0
14605,Pulse,40397,40397,0,1988_boxofficemojo_rankings.csv,1988,1.0,0.0
14606,Terkel in Trouble 2010 Re-release,40385,40385,0,2010_boxofficemojo_rankings.csv,2010,1.0,0.0
14607,Belle de Jour 2017 Re-release,40382,26331,14051,2017_boxofficemojo_rankings.csv,2017,0.6520479421524441,0.34795205784755584
14608,Nothing Personal,40374,40374,0,1997_boxofficemojo_rankings.csv,1997,1.0,0.0
14609,Committed,40361,40361,0,2000_boxofficemojo_rankings.csv,2000,1.0,0.0
14610,Bliss 2009 Re-release,40349,40349,0,2009_boxofficemojo_rankings.csv,2009,1.0,0.0
14611,Zizek!,40331,20177,20154,2005_boxofficemojo_rankings.csv,2005,0.5002851404626714,0.4997148595373286
14612,Of Mind and Music,40322,15073,25249,2016_boxofficemojo_rankings.csv,2016,0.37381578294727447,0.6261842170527255
14613,Paan Singh Tomar,40311,40311,0,2012_boxofficemojo_rankings.csv,2012,1.0,0.0
14614,The Red Baron 2010 Re-release,40239,37189,3050,2010_boxofficemojo_rankings.csv,2010,0.9242028877457193,0.07579711225428068
14615,Khosla's Nest,40194,26472,13722,2006_boxofficemojo_rankings.csv,2006,0.6586057620540379,0.3413942379459621
14616,Yiddish Theater: A Love Story,40182,40182,0,2007_boxofficemojo_rankings.csv,2007,1.0,0.0
14617,Teenage,40169,40169,0,2014_boxofficemojo_rankings.csv,2014,1.0,0.0
14618,The Locusts,40158,40158,0,1997_boxofficemojo_rankings.csv,1997,1.0,0.0
14619,On Her Shoulders,40145,28288,11857,2018_boxofficemojo_rankings.csv,2018,0.7046456594843692,0.29535434051563086
14620,Aniara,40124,40124,0,2019_boxofficemojo_rankings.csv,2019,1.0,0.0
14621,Margaret Cho: Assassin,40123,40123,0,2005_boxofficemojo_rankings.csv,2005,1.0,0.0
14622,Addiction Incorporated,40106,40106,0,2011_boxofficemojo_rankings.csv,2011,1.0,0.0
14623,Humor Me,40099,40099,0,2018_boxofficemojo_rankings.csv,2018,1.0,0.0
14624,Unrest,40081,40081,0,2017_boxofficemojo_rankings.csv,2017,1.0,0.0
14625,Ghost River 2004 Re-release,40029,40029,0,2004_boxofficemojo_rankings.csv,2004,1.0,0.0
14626,Louder Than a Bomb,40000,40000,0,2011_boxofficemojo_rankings.csv,2011,1.0,0.0
14627,Rape of the Soul,39975,39975,0,2006_boxofficemojo_rankings.csv,2006,1.0,0.0
14628,Good Luck,39962,39962,0,1997_boxofficemojo_rankings.csv,1997,1.0,0.0
14629,Is That a Gun in Your Pocket?,39928,39928,0,2016_boxofficemojo_rankings.csv,2016,1.0,0.0
14630,Good Dick,39924,27595,12329,2008_boxofficemojo_rankings.csv,2008,0.6911882576896102,0.3088117423103897
14631,Justice,39895,39895,0,2004_boxofficemojo_rankings.csv,2004,1.0,0.0
14632,Loins of Punjab Presents,39891,39891,0,2008_boxofficemojo_rankings.csv,2008,1.0,0.0
14633,The Short Game,39819,39819,0,2013_boxofficemojo_rankings.csv,2013,1.0,0.0
14634,Plot for Peace,39811,7051,32760,2013_boxofficemojo_rankings.csv,2013,0.17711185350782446,0.8228881464921756
14635,Freeze Frame,39663,1100,38563,2004_boxofficemojo_rankings.csv,2004,0.027733656052240124,0.9722663439477599
14636,Port of Shadows,39623,27389,12234,2012_boxofficemojo_rankings.csv,2012,0.6912399364005755,0.3087600635994246
14637,An Elephant Sitting Still,39599,32556,7043,2018_boxofficemojo_rankings.csv,2018,0.8221419732821535,0.17785802671784642
14638,Loro,39520,35613,3907,2019_boxofficemojo_rankings.csv,2019,0.9011386639676113,0.09886133603238867
14639,The Homeless Billionaire,39493,39493,0,2016_boxofficemojo_rankings.csv,2016,1.0,0.0
14640,Refusenik,39456,39456,0,2008_boxofficemojo_rankings.csv,2008,1.0,0.0
14641,Juvenile Delinquents,39455,34292,5163,2020_boxofficemojo_rankings.csv,2020,0.869142060575339,0.130857939424661
14642,Mac,39437,39437,0,1993_boxofficemojo_rankings.csv,1993,1.0,0.0
14643,B. Monkey,39371,39371,0,1999_boxofficemojo_rankings.csv,1999,1.0,0.0
14644,Power Trip,39359,39359,0,2003_boxofficemojo_rankings.csv,2003,1.0,0.0
14645,Prophet's Prey,39347,39347,0,2015_boxofficemojo_rankings.csv,2015,1.0,0.0
14646,Child of God,39324,39324,0,2014_boxofficemojo_rankings.csv,2014,1.0,0.0
14647,"3 1/2 Minutes, 10 Bullets",39263,30407,8856,2015_boxofficemojo_rankings.csv,2015,0.7744441331533505,0.22555586684664952
14648,La Notte,39236,39236,0,2016_boxofficemojo_rankings.csv,2016,1.0,0.0
14649,Where Soldiers Come From,39201,39201,0,2011_boxofficemojo_rankings.csv,2011,1.0,0.0
14650,Sea of Dreams 2007 Re-release,39200,39200,0,2007_boxofficemojo_rankings.csv,2007,1.0,0.0
14651,How to Make Money Selling Drugs,39192,39192,0,2013_boxofficemojo_rankings.csv,2013,1.0,0.0
14652,I Do Not Care If We Go Down in History as Barbarians,39171,11307,27864,2018_boxofficemojo_rankings.csv,2018,0.2886574251359424,0.7113425748640576
14653,The Expedition to the End of the World,39115,39115,0,2014_boxofficemojo_rankings.csv,2014,1.0,0.0
14654,Century of Cinema: A Personal Journey with Martin Scorsese Through American Movies,39075,39075,0,1998_boxofficemojo_rankings.csv,1998,1.0,0.0
14655,Zilla and Zoe,39003,39003,0,2019_boxofficemojo_rankings.csv,2019,1.0,0.0
14656,Torment,39003,39003,0,1994_boxofficemojo_rankings.csv,1994,1.0,0.0
14657,The Girl with the Red Hair,39001,39001,0,1983_boxofficemojo_rankings.csv,1983,1.0,0.0
14658,The Bra,38992,0,38992,2019_boxofficemojo_rankings.csv,2019,0.0,1.0
14659,I Used to Be Darker,38974,22214,16760,2013_boxofficemojo_rankings.csv,2013,0.5699697234053471,0.43003027659465287
14660,The Life of Reilly,38960,38960,0,2007_boxofficemojo_rankings.csv,2007,1.0,0.0
14661,Herb & Dorothy 50X50,38933,38933,0,2013_boxofficemojo_rankings.csv,2013,1.0,0.0
14662,Shed of the Dead,38901,38901,0,2019_boxofficemojo_rankings.csv,2019,1.0,0.0
14663,The Son of Joseph,38774,30588,8186,2016_boxofficemojo_rankings.csv,2016,0.7888791458193635,0.2111208541806365
14664,Tsahal,38773,38773,0,1995_boxofficemojo_rankings.csv,1995,1.0,0.0
14665,Restored Me,38745,38745,0,2016_boxofficemojo_rankings.csv,2016,1.0,0.0
14666,Whiteboyz,38738,38738,0,1999_boxofficemojo_rankings.csv,1999,1.0,0.0
14667,Bluebeard,38696,33490,5206,2010_boxofficemojo_rankings.csv,2010,0.8654641306594997,0.1345358693405003
14668,Paul Williams Still Alive,38691,38691,0,2012_boxofficemojo_rankings.csv,2012,1.0,0.0
14669,The Blossoming of Maximo Oliveros,38691,28041,10650,2006_boxofficemojo_rankings.csv,2006,0.7247421881057611,0.275257811894239
14670,Catching the Sun,38613,38613,0,2016_boxofficemojo_rankings.csv,2016,1.0,0.0
14671,A Rumor of Angels,38610,38610,0,2002_boxofficemojo_rankings.csv,2002,1.0,0.0
14672,The Year of the Yao,38585,35591,2994,2005_boxofficemojo_rankings.csv,2005,0.9224050796941817,0.07759492030581833
14673,Spa Night,38578,38578,0,2016_boxofficemojo_rankings.csv,2016,1.0,0.0
14674,Troublemakers: The Story of Land Art,38571,29462,9109,2016_boxofficemojo_rankings.csv,2016,0.7638381167198154,0.2361618832801846
14675,Divide and Conquer,38510,38510,0,2018_boxofficemojo_rankings.csv,2018,1.0,0.0
14676,Death by China,38492,38492,0,2012_boxofficemojo_rankings.csv,2012,1.0,0.0
14677,Multiple Maniacs,38403,33036,5367,2016_boxofficemojo_rankings.csv,2016,0.860245293336458,0.13975470666354192
14678,Araby,38399,38399,0,2018_boxofficemojo_rankings.csv,2018,1.0,0.0
14679,Batman Forever 2019 Re-release,38387,38014,373,2019_boxofficemojo_rankings.csv,2019,0.9902831687810978,0.009716831218902232
14680,Nine Nation Animation,38382,38382,0,2010_boxofficemojo_rankings.csv,2010,1.0,0.0
14681,The Blackcoat's Daughter,38348,20435,17913,2017_boxofficemojo_rankings.csv,2017,0.5328830708250756,0.46711692917492437
14682,Small Change,38296,38296,0,2009_boxofficemojo_rankings.csv,2009,1.0,0.0
14683,Drunks,38268,38268,0,1997_boxofficemojo_rankings.csv,1997,1.0,0.0
14684,Policeman,38263,11263,27000,2013_boxofficemojo_rankings.csv,2013,0.29435747327705614,0.7056425267229438
14685,No Intenso Agora,38223,24955,13268,2018_boxofficemojo_rankings.csv,2018,0.6528791565287916,0.3471208434712084
14686,Shadow Hours,38181,38181,0,2000_boxofficemojo_rankings.csv,2000,1.0,0.0
14687,Germans & Jews,38100,38100,0,2016_boxofficemojo_rankings.csv,2016,1.0,0.0
14688,The Legend of Pale Male,38083,38083,0,2010_boxofficemojo_rankings.csv,2010,1.0,0.0
14689,All About Lily Chou-Chou,38082,26485,11597,2002_boxofficemojo_rankings.csv,2002,0.6954729268420776,0.3045270731579224
14690,Gray Matter,38034,38034,0,2018_boxofficemojo_rankings.csv,2018,1.0,0.0
14691,Band of Outsiders 2016 Re-release,38004,38004,0,2016_boxofficemojo_rankings.csv,2016,1.0,0.0
14692,Moscow Never Sleeps,38004,25306,12698,2016_boxofficemojo_rankings.csv,2016,0.6658772760762025,0.3341227239237975
14693,The Crime of Monsieur Lange,38002,36438,1564,2017_boxofficemojo_rankings.csv,2017,0.9588442713541393,0.04115572864586074
14694,Russian Ark 2013 Re-release,37984,37984,0,2013_boxofficemojo_rankings.csv,2013,1.0,0.0
14695,Bollywood/Hollywood 2003 Re-release,37962,37962,0,2003_boxofficemojo_rankings.csv,2003,1.0,0.0
14696,Moondance Alexander,37895,37895,0,2007_boxofficemojo_rankings.csv,2007,1.0,0.0
14697,Adult World,37887,25368,12519,2014_boxofficemojo_rankings.csv,2014,0.6695700372159316,0.3304299627840684
14698,I Am the Blues,37849,37849,0,2017_boxofficemojo_rankings.csv,2017,1.0,0.0
14699,Koyla,37795,37795,0,1997_boxofficemojo_rankings.csv,1997,1.0,0.0
14700,The Heart of Nuba,37788,37788,0,2018_boxofficemojo_rankings.csv,2018,1.0,0.0
14701,Khadak,37781,3139,34642,2007_boxofficemojo_rankings.csv,2007,0.08308408988645086,0.9169159101135491
14702,Out 1,37743,31539,6204,2015_boxofficemojo_rankings.csv,2015,0.835625149034258,0.164374850965742
14703,Mumia: Long Distance Revolutionary,37731,37731,0,2013_boxofficemojo_rankings.csv,2013,1.0,0.0
14704,Millennium Actress,37641,37641,0,2003_boxofficemojo_rankings.csv,2003,1.0,0.0
14705,Welcome to Woop Woop,37621,37621,0,1998_boxofficemojo_rankings.csv,1998,1.0,0.0
14706,Krystal,37516,37516,0,2018_boxofficemojo_rankings.csv,2018,1.0,0.0
14707,News from Planet Mars,37507,310,37197,2016_boxofficemojo_rankings.csv,2016,0.008265123843549204,0.9917348761564508
14708,Incident at Loch Ness,37493,37493,0,2004_boxofficemojo_rankings.csv,2004,1.0,0.0
14709,Salmonberries,37484,37484,0,1994_boxofficemojo_rankings.csv,1994,1.0,0.0
14710,Big Sur,37466,37466,0,2013_boxofficemojo_rankings.csv,2013,1.0,0.0
14711,Back to Normandy,37430,503,36927,2007_boxofficemojo_rankings.csv,2007,0.013438418380977825,0.9865615816190222
14712,Raising Flagg,37329,4130,33199,2007_boxofficemojo_rankings.csv,2007,0.1106378418923625,0.8893621581076375
14713,Match 2015 Re-release,37285,37285,0,2015_boxofficemojo_rankings.csv,2015,1.0,0.0
14714,Memory: The Origins of Alien,37272,31378,5894,2019_boxofficemojo_rankings.csv,2019,0.8418652071259927,0.1581347928740073
14715,Savannah,37240,37240,0,2013_boxofficemojo_rankings.csv,2013,1.0,0.0
14716,This Thing of Ours,37227,37227,0,2003_boxofficemojo_rankings.csv,2003,1.0,0.0
14717,Benjamin Smoke,37111,37111,0,2000_boxofficemojo_rankings.csv,2000,1.0,0.0
14718,Dadetown,37092,37092,0,1996_boxofficemojo_rankings.csv,1996,1.0,0.0
14719,Eating Out 2: Sloppy Seconds,37072,37072,0,2006_boxofficemojo_rankings.csv,2006,1.0,0.0
14720,Small Group,37058,37058,0,2018_boxofficemojo_rankings.csv,2018,1.0,0.0
14721,24 Frames,37045,34482,2563,2018_boxofficemojo_rankings.csv,2018,0.9308138750168714,0.06918612498312862
14722,The Quiet One,37010,37010,0,2019_boxofficemojo_rankings.csv,2019,1.0,0.0
14723,Pavilion of Women,36992,36992,0,2001_boxofficemojo_rankings.csv,2001,1.0,0.0
14724,Children of Paradise 2012 Re-release,36986,36986,0,2012_boxofficemojo_rankings.csv,2012,1.0,0.0
14725,Grey Gardens,36923,36923,0,2015_boxofficemojo_rankings.csv,2015,1.0,0.0
14726,Kurukshetra,36890,36890,0,2000_boxofficemojo_rankings.csv,2000,1.0,0.0
14727,Trust Fund,36885,36885,0,2016_boxofficemojo_rankings.csv,2016,1.0,0.0
14728,Monkey Warfare,36875,36875,0,2006_boxofficemojo_rankings.csv,2006,1.0,0.0
14729,Twist,36875,36875,0,1993_boxofficemojo_rankings.csv,1993,1.0,0.0
14730,The Death of Dick Long,36856,36856,0,2019_boxofficemojo_rankings.csv,2019,1.0,0.0
14731,"Forever, Lulu",36786,36786,0,1987_boxofficemojo_rankings.csv,1987,1.0,0.0
14732,Three Christs,36723,36723,0,2020_boxofficemojo_rankings.csv,2020,1.0,0.0
14733,Uncertainty,36689,36689,0,2009_boxofficemojo_rankings.csv,2009,1.0,0.0
14734,Sister Code,36676,36676,0,2015_boxofficemojo_rankings.csv,2015,1.0,0.0
14735,Blind Mountain,36615,13164,23451,2007_boxofficemojo_rankings.csv,2007,0.3595247849242114,0.6404752150757886
14736,Mind Game,36613,36613,0,2018_boxofficemojo_rankings.csv,2018,1.0,0.0
14737,Bending the Arc,36586,21907,14679,2017_boxofficemojo_rankings.csv,2017,0.5987809544634559,0.40121904553654403
14738,Yoga Hosers,36585,0,36585,2016_boxofficemojo_rankings.csv,2016,0.0,1.0
14739,Paper Dolls,36577,36577,0,2006_boxofficemojo_rankings.csv,2006,1.0,0.0
14740,Hit So Hard,36576,34025,2551,2012_boxofficemojo_rankings.csv,2012,0.9302548118985127,0.06974518810148732
14741,Tread,36527,36527,0,2020_boxofficemojo_rankings.csv,2020,1.0,0.0
14742,For Those Who Don't Read Me,36506,36506,0,2018_boxofficemojo_rankings.csv,2018,1.0,0.0
14743,Cherry,36465,11362,25103,2010_boxofficemojo_rankings.csv,2010,0.31158645276292335,0.6884135472370766
14744,The Servant,36463,36463,0,2013_boxofficemojo_rankings.csv,2013,1.0,0.0
14745,The Umbrellas of Cherbourg,36432,28030,8402,2004_boxofficemojo_rankings.csv,2004,0.7693785682916118,0.23062143170838822
14746,From Here to Eternity,36416,36416,0,2003_boxofficemojo_rankings.csv,2003,1.0,0.0
14747,Been Rich All My Life,36406,36406,0,2006_boxofficemojo_rankings.csv,2006,1.0,0.0
14748,Waiting for Anya,36404,0,36404,2020_boxofficemojo_rankings.csv,2020,0.0,1.0
14749,Unexpected,36402,23986,12416,2015_boxofficemojo_rankings.csv,2015,0.6589198395692545,0.34108016043074557
14750,How to Let Go of the World: and Love All the Things Climate Can't Change,36386,36386,0,2016_boxofficemojo_rankings.csv,2016,1.0,0.0
14751,Welcome to Leith,36380,36010,370,2015_boxofficemojo_rankings.csv,2015,0.9898295766904893,0.01017042330951072
14752,Mansome,36280,36280,0,2012_boxofficemojo_rankings.csv,2012,1.0,0.0
14753,Loosies,36145,3519,32626,2012_boxofficemojo_rankings.csv,2012,0.09735786415825148,0.9026421358417485
14754,Touchy Feely,36128,36128,0,2013_boxofficemojo_rankings.csv,2013,1.0,0.0
14755,New Year's Day,36106,36106,0,1989_boxofficemojo_rankings.csv,1989,1.0,0.0
14756,Dirty Love,36099,36099,0,2005_boxofficemojo_rankings.csv,2005,1.0,0.0
14757,Le Corbeau,36089,36089,0,2018_boxofficemojo_rankings.csv,2018,1.0,0.0
14758,Jiminy Glick in Lalawood,36039,36039,0,2005_boxofficemojo_rankings.csv,2005,1.0,0.0
14759,Brimstone & Glory,36036,32059,3977,2017_boxofficemojo_rankings.csv,2017,0.8896381396381396,0.11036186036186037
14760,"Kill Me, Deadly",36027,36027,0,2016_boxofficemojo_rankings.csv,2016,1.0,0.0
14761,Not Cool,36026,36026,0,2014_boxofficemojo_rankings.csv,2014,1.0,0.0
14762,Day Night Day Night,35933,31856,4077,2007_boxofficemojo_rankings.csv,2007,0.8865388361673114,0.11346116383268862
14763,Gentlemen Don't Eat Poets,35855,35855,0,1997_boxofficemojo_rankings.csv,1997,1.0,0.0
14764,Almost Friends,35842,1481,34361,2017_boxofficemojo_rankings.csv,2017,0.04132023882595837,0.9586797611740416
14765,The House of Tomorrow,35821,35821,0,2018_boxofficemojo_rankings.csv,2018,1.0,0.0
14766,Bangkok Revenge,35784,35784,0,2012_boxofficemojo_rankings.csv,2012,1.0,0.0
14767,The Road Movie,35757,35757,0,2018_boxofficemojo_rankings.csv,2018,1.0,0.0
14768,Good Manners,35714,31177,4537,2018_boxofficemojo_rankings.csv,2018,0.8729629837038696,0.12703701629613037
14769,Fighting Words,35688,35688,0,2007_boxofficemojo_rankings.csv,2007,1.0,0.0
14770,Paul Goodman Changed My Life,35671,35671,0,2011_boxofficemojo_rankings.csv,2011,1.0,0.0
14771,Far Out Isn't Far Enough: The Tomi Ungerer Story,35647,35647,0,2013_boxofficemojo_rankings.csv,2013,1.0,0.0
14772,After Freedom,35639,35639,0,2004_boxofficemojo_rankings.csv,2004,1.0,0.0
14773,M 2013 Re-release,35566,35566,0,2013_boxofficemojo_rankings.csv,2013,1.0,0.0
14774,Guy and Madeline on a Park Bench,35556,35556,0,2010_boxofficemojo_rankings.csv,2010,1.0,0.0
14775,Finders Keepers,35555,35555,0,2015_boxofficemojo_rankings.csv,2015,1.0,0.0
14776,The Event,35554,35554,0,2003_boxofficemojo_rankings.csv,2003,1.0,0.0
14777,Cosi,35489,35489,0,1997_boxofficemojo_rankings.csv,1997,1.0,0.0
14778,PGS: Intuition Is Your Personal Guidance System,35423,35423,0,2018_boxofficemojo_rankings.csv,2018,1.0,0.0
14779,Kinyarwanda,35412,35412,0,2011_boxofficemojo_rankings.csv,2011,1.0,0.0
14780,Can Mr. Smith Get to Washington Anymore?,35397,35397,0,2006_boxofficemojo_rankings.csv,2006,1.0,0.0
14781,Max and the Junkmen,35387,35387,0,2012_boxofficemojo_rankings.csv,2012,1.0,0.0
14782,Le Jour Se Leve,35321,35321,0,2014_boxofficemojo_rankings.csv,2014,1.0,0.0
14783,Growing Up Smith,35312,35312,0,2017_boxofficemojo_rankings.csv,2017,1.0,0.0
14784,The Decent One,35282,21327,13955,2014_boxofficemojo_rankings.csv,2014,0.6044725355705459,0.39552746442945413
14785,Underdogs,35271,35271,0,2013_boxofficemojo_rankings.csv,2013,1.0,0.0
14786,Love and a .45,35200,35200,0,1994_boxofficemojo_rankings.csv,1994,1.0,0.0
14787,Rat Film,35195,35195,0,2017_boxofficemojo_rankings.csv,2017,1.0,0.0
14788,Ága,35178,35178,0,2019_boxofficemojo_rankings.csv,2019,1.0,0.0
14789,Bloodfist III: Forced to Fight,35154,35154,0,1992_boxofficemojo_rankings.csv,1992,1.0,0.0
14790,That Man from Rio,35144,35144,0,2014_boxofficemojo_rankings.csv,2014,1.0,0.0
14791,"Goodbye, Dragon Inn",35120,35120,0,2004_boxofficemojo_rankings.csv,2004,1.0,0.0
14792,When Harry Tries to Marry,35100,35100,0,2011_boxofficemojo_rankings.csv,2011,1.0,0.0
14793,The Girl,35048,35048,0,2013_boxofficemojo_rankings.csv,2013,1.0,0.0
14794,Bon Jovi: Lost Highway - The Concert,35000,35000,0,2007_boxofficemojo_rankings.csv,2007,1.0,0.0
14795,A Killing Affair,35000,35000,0,1988_boxofficemojo_rankings.csv,1988,1.0,0.0
14796,Our City Dreams,34972,34972,0,2009_boxofficemojo_rankings.csv,2009,1.0,0.0
14797,Hotel,34971,29813,5158,2003_boxofficemojo_rankings.csv,2003,0.8525063624145721,0.14749363758542794
14798,Man of the Century,34857,34857,0,1999_boxofficemojo_rankings.csv,1999,1.0,0.0
14799,A Decade Under the Influence,34837,34837,0,2003_boxofficemojo_rankings.csv,2003,1.0,0.0
14800,Campfire,34835,34835,0,2005_boxofficemojo_rankings.csv,2005,1.0,0.0
14801,Swimmers,34812,34812,0,2006_boxofficemojo_rankings.csv,2006,1.0,0.0
14802,Beneath the Harvest Sky,34768,34768,0,2014_boxofficemojo_rankings.csv,2014,1.0,0.0
14803,This Ain't No Mouse Music,34754,34754,0,2014_boxofficemojo_rankings.csv,2014,1.0,0.0
14804,Comic-Con Episode IV: A Fan's Hope,34665,34665,0,2012_boxofficemojo_rankings.csv,2012,1.0,0.0
14805,The Old Dark House,34649,25678,8971,2017_boxofficemojo_rankings.csv,2017,0.7410892089237785,0.25891079107622156
14806,Showboy,34646,34646,0,2004_boxofficemojo_rankings.csv,2004,1.0,0.0
14807,Sophie and the Rising Sun,34630,34630,0,2017_boxofficemojo_rankings.csv,2017,1.0,0.0
14808,Le Trou,34588,34588,0,2017_boxofficemojo_rankings.csv,2017,1.0,0.0
14809,Orchestra of Exiles,34577,34577,0,2012_boxofficemojo_rankings.csv,2012,1.0,0.0
14810,Rakuen Tsuiho: Expelled from Paradise,34510,34510,0,2014_boxofficemojo_rankings.csv,2014,1.0,0.0
14811,Heidi Fleiss: Hollywood Madam,34402,34402,0,1996_boxofficemojo_rankings.csv,1996,1.0,0.0
14812,Cosmos,34393,25856,8537,2015_boxofficemojo_rankings.csv,2015,0.7517808856453349,0.2482191143546652
14813,Pierrot le Fou 2015 Re-release,34371,34371,0,2015_boxofficemojo_rankings.csv,2015,1.0,0.0
14814,Holy Hell,34366,34366,0,2018_boxofficemojo_rankings.csv,2018,1.0,0.0
14815,Off the Rails,34249,34249,0,2016_boxofficemojo_rankings.csv,2016,1.0,0.0
14816,Rocks in My Pockets,34236,34236,0,2014_boxofficemojo_rankings.csv,2014,1.0,0.0
14817,Martin & Orloff,34222,34222,0,2003_boxofficemojo_rankings.csv,2003,1.0,0.0
14818,Just Like a Woman,34206,11403,22803,2013_boxofficemojo_rankings.csv,2013,0.3333625679705315,0.6666374320294686
14819,American Gun,34138,24098,10040,2006_boxofficemojo_rankings.csv,2006,0.7058995840412443,0.29410041595875563
14820,Dave Made a Maze,34117,34117,0,2017_boxofficemojo_rankings.csv,2017,1.0,0.0
14821,Beautiful Darling,34096,34096,0,2011_boxofficemojo_rankings.csv,2011,1.0,0.0
14822,Familiar Strangers,34068,34068,0,2008_boxofficemojo_rankings.csv,2008,1.0,0.0
14823,Kilo Two Bravo,34017,7891,26126,2015_boxofficemojo_rankings.csv,2015,0.23197224916953288,0.7680277508304671
14824,Bert Stern: Original Madman,34005,34005,0,2013_boxofficemojo_rankings.csv,2013,1.0,0.0
14825,RBG 2020 Re-release,34000,34000,0,2020_boxofficemojo_rankings.csv,2020,1.0,0.0
14826,Your Mommy Kills Animals!,34000,34000,0,2007_boxofficemojo_rankings.csv,2007,1.0,0.0
14827,Maui,33953,33953,0,2018_boxofficemojo_rankings.csv,2018,1.0,0.0
14828,Killer Unicorn,33901,33901,0,2019_boxofficemojo_rankings.csv,2019,1.0,0.0
14829,Signs & Wonders,33842,33842,0,2001_boxofficemojo_rankings.csv,2001,1.0,0.0
14830,Moonlight Sonata: Deafness in Three Movements,33823,33823,0,2019_boxofficemojo_rankings.csv,2019,1.0,0.0
14831,It Felt Like Love,33817,33817,0,2014_boxofficemojo_rankings.csv,2014,1.0,0.0
14832,The Lighthorsemen,33779,33779,0,1988_boxofficemojo_rankings.csv,1988,1.0,0.0
14833,Brief Interviews with Hideous Men,33745,33745,0,2009_boxofficemojo_rankings.csv,2009,1.0,0.0
14834,Closed Curtain,33735,28098,5637,2014_boxofficemojo_rankings.csv,2014,0.8329035126722988,0.1670964873277012
14835,Itty Bitty Titty Committee,33723,18445,15278,2007_boxofficemojo_rankings.csv,2007,0.5469560833852267,0.4530439166147733
14836,Below Her Mouth,33673,0,33673,2017_boxofficemojo_rankings.csv,2017,0.0,1.0
14837,"My Country, My Country",33620,33620,0,2006_boxofficemojo_rankings.csv,2006,1.0,0.0
14838,Friends & Lovers,33543,33543,0,1999_boxofficemojo_rankings.csv,1999,1.0,0.0
14839,The Turandot Project,33504,33504,0,2001_boxofficemojo_rankings.csv,2001,1.0,0.0
14840,Twister,33455,33455,0,1990_boxofficemojo_rankings.csv,1990,1.0,0.0
14841,Making the Boys,33443,33443,0,2011_boxofficemojo_rankings.csv,2011,1.0,0.0
14842,The Winding Stream,33420,33420,0,2015_boxofficemojo_rankings.csv,2015,1.0,0.0
14843,Final Girl,33411,0,33411,2015_boxofficemojo_rankings.csv,2015,0.0,1.0
14844,Man with a Plan,33402,33402,0,1996_boxofficemojo_rankings.csv,1996,1.0,0.0
14845,"Distant Voices, Still Lives 2018 Re-release",33301,5234,28067,2018_boxofficemojo_rankings.csv,2018,0.15717245728356505,0.8428275427164349
14846,Running from Crazy,33300,33300,0,2013_boxofficemojo_rankings.csv,2013,1.0,0.0
14847,Life: A User's Manual,33236,33236,0,2001_boxofficemojo_rankings.csv,2001,1.0,0.0
14848,Loverboy 2006 Re-release,33223,33223,0,2006_boxofficemojo_rankings.csv,2006,1.0,0.0
14849,Daddy Longlegs,33217,21766,11451,2010_boxofficemojo_rankings.csv,2010,0.6552668814161423,0.3447331185838577
14850,Mississippi Mermaid,33216,33216,0,2009_boxofficemojo_rankings.csv,2009,1.0,0.0
14851,Wasted! The Story of Food Waste,33211,33211,0,2017_boxofficemojo_rankings.csv,2017,1.0,0.0
14852,Redoubt,33155,33155,0,2019_boxofficemojo_rankings.csv,2019,1.0,0.0
14853,Love & Taxes,33150,33150,0,2017_boxofficemojo_rankings.csv,2017,1.0,0.0
14854,American Teacher,33144,33144,0,2011_boxofficemojo_rankings.csv,2011,1.0,0.0
14855,Behind the Lines,33131,33131,0,1998_boxofficemojo_rankings.csv,1998,1.0,0.0
14856,Super Dark Times,33109,33109,0,2017_boxofficemojo_rankings.csv,2017,1.0,0.0
14857,Dislecksia: The Movie,33066,33066,0,2013_boxofficemojo_rankings.csv,2013,1.0,0.0
14858,Falling for Grace,33060,33060,0,2007_boxofficemojo_rankings.csv,2007,1.0,0.0
14859,Meet Monica Velour,33042,33042,0,2011_boxofficemojo_rankings.csv,2011,1.0,0.0
14860,Ahead of Time: The Extraordinary Journey of Ruth Gruber,33024,33024,0,2010_boxofficemojo_rankings.csv,2010,1.0,0.0
14861,Albatross,32992,0,32992,2011_boxofficemojo_rankings.csv,2011,0.0,1.0
14862,Being Charlie,32964,30400,2564,2016_boxofficemojo_rankings.csv,2016,0.9222181774056547,0.07778182259434535
14863,Spoken Word,32961,32961,0,2010_boxofficemojo_rankings.csv,2010,1.0,0.0
14864,The Intervention,32919,32919,0,2016_boxofficemojo_rankings.csv,2016,1.0,0.0
14865,Smile,32833,32833,0,2005_boxofficemojo_rankings.csv,2005,1.0,0.0
14866,Shooting the Mafia,32792,10881,21911,2019_boxofficemojo_rankings.csv,2019,0.33181873627714076,0.6681812637228592
14867,Local Color,32788,32788,0,2007_boxofficemojo_rankings.csv,2007,1.0,0.0
14868,No Home Movie,32757,32757,0,2016_boxofficemojo_rankings.csv,2016,1.0,0.0
14869,Controlled Chaos 2007 Re-release,32740,32740,0,2007_boxofficemojo_rankings.csv,2007,1.0,0.0
14870,L'Age d'Or,32712,32712,0,2004_boxofficemojo_rankings.csv,2004,1.0,0.0
14871,The Nun,32659,30245,2414,2018_boxofficemojo_rankings.csv,2018,0.9260846933463976,0.07391530665360238
14872,Mean Streets 1998 Re-release,32645,32645,0,1998_boxofficemojo_rankings.csv,1998,1.0,0.0
14873,Boesman and Lena,32625,32625,0,2000_boxofficemojo_rankings.csv,2000,1.0,0.0
14874,Sollers Point,32608,32608,0,2018_boxofficemojo_rankings.csv,2018,1.0,0.0
14875,The Day I Saw Your Heart 2012 Re-release,32567,3546,29021,2012_boxofficemojo_rankings.csv,2012,0.10888322535081524,0.8911167746491847
14876,Spettacolo,32494,32494,0,2017_boxofficemojo_rankings.csv,2017,1.0,0.0
14877,Boxing Gym,32476,32476,0,2010_boxofficemojo_rankings.csv,2010,1.0,0.0
14878,Fuel,32465,32465,0,2009_boxofficemojo_rankings.csv,2009,1.0,0.0
14879,Rurouni Kenshin Part I: Origins 2016 Re-release,32445,32445,0,2016_boxofficemojo_rankings.csv,2016,1.0,0.0
14880,An Acceptable Loss,32427,32427,0,2019_boxofficemojo_rankings.csv,2019,1.0,0.0
14881,Brotherhood,32416,19722,12694,2010_boxofficemojo_rankings.csv,2010,0.6084032576505429,0.39159674234945707
14882,10E,32413,32413,0,2019_boxofficemojo_rankings.csv,2019,1.0,0.0
14883,Beetle Queen Conquers Tokyo,32308,32308,0,2010_boxofficemojo_rankings.csv,2010,1.0,0.0
14884,Head Above Water,32212,32212,0,1997_boxofficemojo_rankings.csv,1997,1.0,0.0
14885,Living in Emergency,32208,32208,0,2010_boxofficemojo_rankings.csv,2010,1.0,0.0
14886,Sacco and Vanzetti,32203,32203,0,2007_boxofficemojo_rankings.csv,2007,1.0,0.0
14887,The Hero of Color City,32188,32188,0,2014_boxofficemojo_rankings.csv,2014,1.0,0.0
14888,Goodland,32140,32140,0,2018_boxofficemojo_rankings.csv,2018,1.0,0.0
14889,Pontypool,32118,3865,28253,2009_boxofficemojo_rankings.csv,2009,0.12033750544865807,0.8796624945513419
14890,Glass: A Portrait of Philip in Twelve Parts,32089,20018,12071,2008_boxofficemojo_rankings.csv,2008,0.6238274798217458,0.37617252017825425
14891,The Weekend,32050,32050,0,2000_boxofficemojo_rankings.csv,2000,1.0,0.0
14892,Kiss the Bride,32033,32033,0,2008_boxofficemojo_rankings.csv,2008,1.0,0.0
14893,Desolation Center,32016,32016,0,2019_boxofficemojo_rankings.csv,2019,1.0,0.0
14894,Last Life in the Universe,32014,32014,0,2004_boxofficemojo_rankings.csv,2004,1.0,0.0
14895,"Rio, I Love You 2016 Re-release",31982,31982,0,2016_boxofficemojo_rankings.csv,2016,1.0,0.0
14896,Moynihan,31970,31970,0,2018_boxofficemojo_rankings.csv,2018,1.0,0.0
14897,District of Corruption,31954,31954,0,2012_boxofficemojo_rankings.csv,2012,1.0,0.0
14898,Reel Paradise,31918,31918,0,2005_boxofficemojo_rankings.csv,2005,1.0,0.0
14899,Going Shopping,31908,31908,0,2005_boxofficemojo_rankings.csv,2005,1.0,0.0
14900,Amira & Sam,31849,31849,0,2015_boxofficemojo_rankings.csv,2015,1.0,0.0
14901,The Pleasure of Being Robbed,31823,10687,21136,2008_boxofficemojo_rankings.csv,2008,0.3358262891619269,0.6641737108380731
14902,Diary of a Hitman,31815,31815,0,1992_boxofficemojo_rankings.csv,1992,1.0,0.0
14903,Paths of the Soul,31747,31747,0,2016_boxofficemojo_rankings.csv,2016,1.0,0.0
14904,180° South,31745,31745,0,2010_boxofficemojo_rankings.csv,2010,1.0,0.0
14905,Beyond the Clouds,31738,31738,0,1999_boxofficemojo_rankings.csv,1999,1.0,0.0
14906,At Berkeley,31736,31736,0,2013_boxofficemojo_rankings.csv,2013,1.0,0.0
14907,Aurora,31720,5677,26043,2011_boxofficemojo_rankings.csv,2011,0.1789722572509458,0.8210277427490542
14908,Bad Manners,31687,31687,0,1998_boxofficemojo_rankings.csv,1998,1.0,0.0
14909,Porn Theatre,31653,31653,0,2003_boxofficemojo_rankings.csv,2003,1.0,0.0
14910,The Substance of Fire,31638,31638,0,1997_boxofficemojo_rankings.csv,1997,1.0,0.0
14911,Gift,31588,31588,0,2019_boxofficemojo_rankings.csv,2019,1.0,0.0
14912,Signature Move,31551,31551,0,2017_boxofficemojo_rankings.csv,2017,1.0,0.0
14913,The Cat Rescuers,31540,31540,0,2019_boxofficemojo_rankings.csv,2019,1.0,0.0
14914,The Passionate Thief,31539,31539,0,2014_boxofficemojo_rankings.csv,2014,1.0,0.0
14915,Forever,31502,31502,0,2007_boxofficemojo_rankings.csv,2007,1.0,0.0
14916,Musical Chairs,31478,31478,0,2012_boxofficemojo_rankings.csv,2012,1.0,0.0
14917,Celine and Julie Go Boating,31452,31452,0,2012_boxofficemojo_rankings.csv,2012,1.0,0.0
14918,Beyond the Farthest Star,31433,31433,0,2013_boxofficemojo_rankings.csv,2013,1.0,0.0
14919,Here,31428,26743,4685,2012_boxofficemojo_rankings.csv,2012,0.8509291078019601,0.14907089219803996
14920,Fabled,31425,31425,0,2004_boxofficemojo_rankings.csv,2004,1.0,0.0
14921,Sidemen: Long Road to Glory,31399,31399,0,2017_boxofficemojo_rankings.csv,2017,1.0,0.0
14922,Don Verdean,31309,31309,0,2015_boxofficemojo_rankings.csv,2015,1.0,0.0
14923,Funny Money,31290,2844,28446,2007_boxofficemojo_rankings.csv,2007,0.09089165867689358,0.9091083413231065
14924,Bootmen,31288,31288,0,2000_boxofficemojo_rankings.csv,2000,1.0,0.0
14925,Hats Off,31272,31272,0,2008_boxofficemojo_rankings.csv,2008,1.0,0.0
14926,Max Winslow and the House of Secrets,31250,31250,0,2020_boxofficemojo_rankings.csv,2020,1.0,0.0
14927,The Raspberry Reich,31211,31211,0,2004_boxofficemojo_rankings.csv,2004,1.0,0.0
14928,Buddy,31203,31203,0,2019_boxofficemojo_rankings.csv,2019,1.0,0.0
14929,I'm Glad My Mother Is Alive,31140,8705,22435,2009_boxofficemojo_rankings.csv,2009,0.27954399486191395,0.720456005138086
14930,"Hey, Boo: Harper Lee and 'To Kill a Mockingbird'",31135,31135,0,2011_boxofficemojo_rankings.csv,2011,1.0,0.0
14931,Small Town Murder Songs,31133,31133,0,2011_boxofficemojo_rankings.csv,2011,1.0,0.0
14932,7 Witches,31100,31100,0,2017_boxofficemojo_rankings.csv,2017,1.0,0.0
14933,White Irish Drinkers,31056,31056,0,2011_boxofficemojo_rankings.csv,2011,1.0,0.0
14934,Poor Boy,31031,31031,0,2018_boxofficemojo_rankings.csv,2018,1.0,0.0
14935,Chooch,31015,31015,0,2004_boxofficemojo_rankings.csv,2004,1.0,0.0
14936,"2 Autumns, 3 Winters",30985,5819,25166,2014_boxofficemojo_rankings.csv,2014,0.18780054865257384,0.8121994513474262
14937,The Seventh Fire,30977,30112,865,2016_boxofficemojo_rankings.csv,2016,0.9720760564289634,0.027923943571036575
14938,Who Is Harry Nilsson (And Why Is Everybody Talkin' About Him?),30975,30975,0,2010_boxofficemojo_rankings.csv,2010,1.0,0.0
14939,Crooked Hearts,30964,30964,0,1991_boxofficemojo_rankings.csv,1991,1.0,0.0
14940,Super Capers: The Origins of Ed and the Missing Bullion,30955,30955,0,2009_boxofficemojo_rankings.csv,2009,1.0,0.0
14941,The Exiles,30945,30945,0,2008_boxofficemojo_rankings.csv,2008,1.0,0.0
14942,Gangster No. 1,30915,30915,0,2002_boxofficemojo_rankings.csv,2002,1.0,0.0
14943,Rent-A-Pal,30901,30901,0,2020_boxofficemojo_rankings.csv,2020,1.0,0.0
14944,Sans Soleil,30878,30878,0,2003_boxofficemojo_rankings.csv,2003,1.0,0.0
14945,Checking Out,30877,30877,0,1989_boxofficemojo_rankings.csv,1989,1.0,0.0
14946,La Chinoise,30857,30857,0,2007_boxofficemojo_rankings.csv,2007,1.0,0.0
14947,Lamb,30844,14547,16297,2016_boxofficemojo_rankings.csv,2016,0.47163143561146414,0.5283685643885359
14948,Meet the Fokkens,30810,30810,0,2012_boxofficemojo_rankings.csv,2012,1.0,0.0
14949,Pasolini 2019 Re-release,30757,30757,0,2019_boxofficemojo_rankings.csv,2019,1.0,0.0
14950,Soul in the Hole,30697,30697,0,1997_boxofficemojo_rankings.csv,1997,1.0,0.0
14951,Under the Skin of the City,30666,30666,0,2003_boxofficemojo_rankings.csv,2003,1.0,0.0
14952,Documented,30662,30662,0,2014_boxofficemojo_rankings.csv,2014,1.0,0.0
14953,Hide Away,30655,30655,0,2012_boxofficemojo_rankings.csv,2012,1.0,0.0
14954,Fighting for Life,30606,30606,0,2008_boxofficemojo_rankings.csv,2008,1.0,0.0
14955,Fanfan la Tulipe,30590,30590,0,2006_boxofficemojo_rankings.csv,2006,1.0,0.0
14956,The Chaperone,30514,0,30514,2011_boxofficemojo_rankings.csv,2011,0.0,1.0
14957,Gang of Roses,30497,30497,0,2003_boxofficemojo_rankings.csv,2003,1.0,0.0
14958,Take My Eyes 2006 Re-release,30496,30496,0,2006_boxofficemojo_rankings.csv,2006,1.0,0.0
14959,The Boondock Saints,30471,30471,0,2000_boxofficemojo_rankings.csv,2000,1.0,0.0
14960,After Parkland,30444,30444,0,2020_boxofficemojo_rankings.csv,2020,1.0,0.0
14961,Los Reyes,30418,30418,0,2019_boxofficemojo_rankings.csv,2019,1.0,0.0
14962,Dealt,30414,30414,0,2017_boxofficemojo_rankings.csv,2017,1.0,0.0
14963,These Birds Walk,30408,30408,0,2013_boxofficemojo_rankings.csv,2013,1.0,0.0
14964,The Take,30380,30380,0,2004_boxofficemojo_rankings.csv,2004,1.0,0.0
14965,"Hare Krishna! The Mantra, the Movement and the Swami Who Started It 2017 Re-release",30380,19278,11102,2017_boxofficemojo_rankings.csv,2017,0.6345622119815668,0.3654377880184332
14966,Rock & Rule,30379,30379,0,1983_boxofficemojo_rankings.csv,1983,1.0,0.0
14967,Shanghai Red 2010 Re-release,30353,30353,0,2010_boxofficemojo_rankings.csv,2010,1.0,0.0
14968,Heavy Trip,30351,10153,20198,2018_boxofficemojo_rankings.csv,2018,0.33451945570162434,0.6654805442983757
14969,39 Pounds of Love,30330,28195,2135,2005_boxofficemojo_rankings.csv,2005,0.9296076491922189,0.07039235080778107
14970,Walking on Dead Fish,30328,30328,0,2008_boxofficemojo_rankings.csv,2008,1.0,0.0
14971,Happy Christmas,30312,30312,0,2014_boxofficemojo_rankings.csv,2014,1.0,0.0
14972,No Greater Love,30247,30247,0,2017_boxofficemojo_rankings.csv,2017,1.0,0.0
14973,Down to the Bone,30241,30241,0,2005_boxofficemojo_rankings.csv,2005,1.0,0.0
14974,Free Enterprise,30229,30229,0,1999_boxofficemojo_rankings.csv,1999,1.0,0.0
14975,WMD: Weapons of Mass Deception,30210,30210,0,2004_boxofficemojo_rankings.csv,2004,1.0,0.0
14976,Cold Water,30209,30209,0,2018_boxofficemojo_rankings.csv,2018,1.0,0.0
14977,Army of Shadows 2015 Re-release,30190,30190,0,2015_boxofficemojo_rankings.csv,2015,1.0,0.0
14978,The Times of Harvey Milk,30187,13801,16386,2000_boxofficemojo_rankings.csv,2000,0.45718355583529335,0.5428164441647066
14979,Runoff,30186,30186,0,2015_boxofficemojo_rankings.csv,2015,1.0,0.0
14980,Paul Taylor: Creative Domain,30168,30168,0,2015_boxofficemojo_rankings.csv,2015,1.0,0.0
14981,Southern Baptist Sissies,30160,30160,0,2014_boxofficemojo_rankings.csv,2014,1.0,0.0
14982,In My Sleep,30158,30158,0,2010_boxofficemojo_rankings.csv,2010,1.0,0.0
14983,American Swing,30156,30156,0,2009_boxofficemojo_rankings.csv,2009,1.0,0.0
14984,Standing Still,30142,30142,0,2006_boxofficemojo_rankings.csv,2006,1.0,0.0
14985,Lionel Richie at Glastonbury,30123,30123,0,2019_boxofficemojo_rankings.csv,2019,1.0,0.0
14986,Therapy for a Vampire 2016 Re-release,30115,30115,0,2016_boxofficemojo_rankings.csv,2016,1.0,0.0
14987,A Long Way Off,30104,30104,0,2014_boxofficemojo_rankings.csv,2014,1.0,0.0
14988,The Windmill Movie,30050,30050,0,2009_boxofficemojo_rankings.csv,2009,1.0,0.0
14989,Runaways,30032,27908,2124,2008_boxofficemojo_rankings.csv,2008,0.9292754395311668,0.07072456046883324
14990,Manakamana,30029,30029,0,2014_boxofficemojo_rankings.csv,2014,1.0,0.0
14991,Cat Run,30000,30000,0,2011_boxofficemojo_rankings.csv,2011,1.0,0.0
14992,Evidence of a Haunting,29904,29904,0,2011_boxofficemojo_rankings.csv,2011,1.0,0.0
14993,Saint Misbehavin': The Wavy Gravy Movie,29893,29893,0,2010_boxofficemojo_rankings.csv,2010,1.0,0.0
14994,Praise,29874,29874,0,2000_boxofficemojo_rankings.csv,2000,1.0,0.0
14995,Lbs.,29866,29866,0,2010_boxofficemojo_rankings.csv,2010,1.0,0.0
14996,Brother 2012 Re-release,29864,29864,0,2012_boxofficemojo_rankings.csv,2012,1.0,0.0
14997,Long Shot: The Kevin Laue Story 2013 Re-release,29863,29863,0,2013_boxofficemojo_rankings.csv,2013,1.0,0.0
14998,A Fierce Green Fire: The Battle for A Living Planet,29817,29817,0,2013_boxofficemojo_rankings.csv,2013,1.0,0.0
14999,O.C. and Stiggs,29815,29815,0,1987_boxofficemojo_rankings.csv,1987,1.0,0.0
15000,Uncertain,29736,29736,0,2017_boxofficemojo_rankings.csv,2017,1.0,0.0
15001,Multiple Sarcasms,29731,29731,0,2010_boxofficemojo_rankings.csv,2010,1.0,0.0
15002,Henri Cartier-Bresson: The Impassioned Eye,29710,29710,0,2006_boxofficemojo_rankings.csv,2006,1.0,0.0
15003,The Lovers on the Bridge,29679,29679,0,1999_boxofficemojo_rankings.csv,1999,1.0,0.0
15004,Yellow Day,29656,29656,0,2014_boxofficemojo_rankings.csv,2014,1.0,0.0
15005,My Faraway Bride,29655,0,29655,2007_boxofficemojo_rankings.csv,2007,0.0,1.0
15006,Memories of Underdevelopment 2018 Re-release,29647,29647,0,2018_boxofficemojo_rankings.csv,2018,1.0,0.0
15007,The Perfect Race,29644,29644,0,2019_boxofficemojo_rankings.csv,2019,1.0,0.0
15008,Dead Man's Burden,29634,29634,0,2013_boxofficemojo_rankings.csv,2013,1.0,0.0
15009,Doin' Time on Planet Earth,29576,29576,0,1988_boxofficemojo_rankings.csv,1988,1.0,0.0
15010,The Eyes of My Mother,29539,27099,2440,2016_boxofficemojo_rankings.csv,2016,0.9173973391110057,0.0826026608889942
15011,Little Fugitive 2013 Re-release,29505,29505,0,2013_boxofficemojo_rankings.csv,2013,1.0,0.0
15012,The Best Democracy Money Can Buy,29500,29500,0,2016_boxofficemojo_rankings.csv,2016,1.0,0.0
15013,The Dog Wedding,29495,29495,0,2016_boxofficemojo_rankings.csv,2016,1.0,0.0
15014,Beyond Beautiful,29480,29480,0,1999_boxofficemojo_rankings.csv,1999,1.0,0.0
15015,Poisoned by Polonium: The Litvinenko File,29467,5080,24387,2007_boxofficemojo_rankings.csv,2007,0.17239623986154004,0.8276037601384599
15016,Romántico,29460,29460,0,2006_boxofficemojo_rankings.csv,2006,1.0,0.0
15017,Olympic Dreams,29450,29450,0,2020_boxofficemojo_rankings.csv,2020,1.0,0.0
15018,The Official Story,29426,29426,0,1985_boxofficemojo_rankings.csv,1985,1.0,0.0
15019,Redemption Road,29384,29384,0,2011_boxofficemojo_rankings.csv,2011,1.0,0.0
15020,Gypsy 83,29367,29367,0,2004_boxofficemojo_rankings.csv,2004,1.0,0.0
15021,Big Girls Don't Cry,29361,1238,28123,2003_boxofficemojo_rankings.csv,2003,0.04216477640407343,0.9578352235959265
15022,Empathy,29345,29345,0,2004_boxofficemojo_rankings.csv,2004,1.0,0.0
15023,Cousin Jules,29337,29337,0,2013_boxofficemojo_rankings.csv,2013,1.0,0.0
15024,Charm City,29335,29335,0,2018_boxofficemojo_rankings.csv,2018,1.0,0.0
15025,The Topp Twins: Untouchable Girls 2011 Re-release,29316,29316,0,2011_boxofficemojo_rankings.csv,2011,1.0,0.0
15026,Freaked,29296,29296,0,1993_boxofficemojo_rankings.csv,1993,1.0,0.0
15027,Xenia 2015 Re-release,29274,3181,26093,2015_boxofficemojo_rankings.csv,2015,0.10866297738607639,0.8913370226139237
15028,Lemon,29258,29258,0,2017_boxofficemojo_rankings.csv,2017,1.0,0.0
15029,The Ground Beneath My Feet,29251,29251,0,2019_boxofficemojo_rankings.csv,2019,1.0,0.0
15030,Sinbad: Beyond the Veil of Mists,29245,29245,0,2000_boxofficemojo_rankings.csv,2000,1.0,0.0
15031,Time to Choose,29233,29233,0,2016_boxofficemojo_rankings.csv,2016,1.0,0.0
15032,Naked Fame,29220,29220,0,2005_boxofficemojo_rankings.csv,2005,1.0,0.0
15033,The PianoTuner of EarthQuakes,29121,29121,0,2006_boxofficemojo_rankings.csv,2006,1.0,0.0
15034,Buffaloed,29118,29118,0,2020_boxofficemojo_rankings.csv,2020,1.0,0.0
15035,Gray's Anatomy,29090,29090,0,1997_boxofficemojo_rankings.csv,1997,1.0,0.0
15036,Daybreak,29081,6995,22086,2004_boxofficemojo_rankings.csv,2004,0.2405350572538771,0.7594649427461229
15037,The Heart Is Deceitful Above All Things 2006 Re-release,29058,29058,0,2006_boxofficemojo_rankings.csv,2006,1.0,0.0
15038,Fire in the Blood,28994,28994,0,2013_boxofficemojo_rankings.csv,2013,1.0,0.0
15039,Othello,28980,28980,0,2014_boxofficemojo_rankings.csv,2014,1.0,0.0
15040,A Foreign Affair,28909,28909,0,2004_boxofficemojo_rankings.csv,2004,1.0,0.0
15041,Plush,28864,3080,25784,2013_boxofficemojo_rankings.csv,2013,0.10670731707317073,0.8932926829268293
15042,Teknolust,28811,28811,0,2003_boxofficemojo_rankings.csv,2003,1.0,0.0
15043,Two in the Wave,28808,28808,0,2010_boxofficemojo_rankings.csv,2010,1.0,0.0
15044,Batman & Robin 2019 Re-release,28793,28597,196,2019_boxofficemojo_rankings.csv,2019,0.9931927899142152,0.00680721008578474
15045,Rebels of the Neon God,28791,28791,0,2015_boxofficemojo_rankings.csv,2015,1.0,0.0
15046,Americons,28782,28782,0,2015_boxofficemojo_rankings.csv,2015,1.0,0.0
15047,Metropolis 2007 Re-release,28779,28779,0,2007_boxofficemojo_rankings.csv,2007,1.0,0.0
15048,Hearts and Minds,28754,28754,0,2004_boxofficemojo_rankings.csv,2004,1.0,0.0
15049,Nénette,28699,18009,10690,2010_boxofficemojo_rankings.csv,2010,0.627513153768424,0.372486846231576
15050,Catwalk,28672,28672,0,1996_boxofficemojo_rankings.csv,1996,1.0,0.0
15051,Hitler's Children,28663,28663,0,2012_boxofficemojo_rankings.csv,2012,1.0,0.0
15052,Abe,28657,0,28657,2020_boxofficemojo_rankings.csv,2020,0.0,1.0
15053,Band of Outsiders,28656,28656,0,2001_boxofficemojo_rankings.csv,2001,1.0,0.0
15054,The Dark Backward,28654,28654,0,1991_boxofficemojo_rankings.csv,1991,1.0,0.0
15055,Streetballers,28642,28642,0,2009_boxofficemojo_rankings.csv,2009,1.0,0.0
15056,The Transfiguration,28631,22091,6540,2017_boxofficemojo_rankings.csv,2017,0.771576263490622,0.22842373650937794
15057,Explicit Ills,28564,28564,0,2009_boxofficemojo_rankings.csv,2009,1.0,0.0
15058,Garbo: El espía 2011 Re-release,28563,28563,0,2011_boxofficemojo_rankings.csv,2011,1.0,0.0
15059,Restoring Tomorrow,28556,28556,0,2018_boxofficemojo_rankings.csv,2018,1.0,0.0
15060,L.627,28540,28540,0,1994_boxofficemojo_rankings.csv,1994,1.0,0.0
15061,Stations of the Elevated,28516,28516,0,2014_boxofficemojo_rankings.csv,2014,1.0,0.0
15062,P.S. Your Cat Is Dead!,28454,28454,0,2003_boxofficemojo_rankings.csv,2003,1.0,0.0
15063,Carrie Pilby,28430,18957,9473,2017_boxofficemojo_rankings.csv,2017,0.6667956384101301,0.3332043615898699
15064,"Rabin, the Last Day",28411,28411,0,2016_boxofficemojo_rankings.csv,2016,1.0,0.0
15065,The Load,28410,28410,0,2019_boxofficemojo_rankings.csv,2019,1.0,0.0
15066,Morning Glory,28409,28409,0,1993_boxofficemojo_rankings.csv,1993,1.0,0.0
15067,Struck by Lightning,28378,28378,0,2013_boxofficemojo_rankings.csv,2013,1.0,0.0
15068,The Strange Ones,28374,0,28374,2017_boxofficemojo_rankings.csv,2017,0.0,1.0
15069,Southpaw,28365,28365,0,2000_boxofficemojo_rankings.csv,2000,1.0,0.0
15070,Guys and Balls 2006 Re-release,28324,28324,0,2006_boxofficemojo_rankings.csv,2006,1.0,0.0
15071,North Sea Texas 2012 Re-release,28307,28307,0,2012_boxofficemojo_rankings.csv,2012,1.0,0.0
15072,"Arabian Nights - Volume 1, The Restless One",28245,12260,15985,2015_boxofficemojo_rankings.csv,2015,0.43405912550893966,0.5659408744910603
15073,"Like Sunday, Like Rain",28208,28208,0,2015_boxofficemojo_rankings.csv,2015,1.0,0.0
15074,7 Chinese Brothers,28180,28180,0,2015_boxofficemojo_rankings.csv,2015,1.0,0.0
15075,"South of Heaven, West of Hell",28149,28149,0,2001_boxofficemojo_rankings.csv,2001,1.0,0.0
15076,Teddy Bears' Picnic,28149,28149,0,2002_boxofficemojo_rankings.csv,2002,1.0,0.0
15077,Sunflower,28146,23919,4227,2007_boxofficemojo_rankings.csv,2007,0.8498188019612023,0.1501811980387977
15078,The Ambassador,28102,28102,0,2012_boxofficemojo_rankings.csv,2012,1.0,0.0
15079,Eternal,28089,28089,0,2005_boxofficemojo_rankings.csv,2005,1.0,0.0
15080,Bikes vs Cars,28072,28072,0,2015_boxofficemojo_rankings.csv,2015,1.0,0.0
15081,Sembene!,28059,28059,0,2015_boxofficemojo_rankings.csv,2015,1.0,0.0
15082,An American Affair,28044,28044,0,2009_boxofficemojo_rankings.csv,2009,1.0,0.0
15083,Take Me to the River,28041,28041,0,2016_boxofficemojo_rankings.csv,2016,1.0,0.0
15084,Superstar in a Housedress,28032,28032,0,2004_boxofficemojo_rankings.csv,2004,1.0,0.0
15085,Least Among Saints,28026,28026,0,2012_boxofficemojo_rankings.csv,2012,1.0,0.0
15086,Quai des Orfèvres 2018 Re-release,28013,28013,0,2018_boxofficemojo_rankings.csv,2018,1.0,0.0
15087,The Amendment,27961,27961,0,2018_boxofficemojo_rankings.csv,2018,1.0,0.0
15088,Ribbons,27959,27959,0,2017_boxofficemojo_rankings.csv,2017,1.0,0.0
15089,El Norte 2019 Re-release,27920,27920,0,2019_boxofficemojo_rankings.csv,2019,1.0,0.0
15090,Teen Witch,27843,27843,0,1989_boxofficemojo_rankings.csv,1989,1.0,0.0
15091,King of the Jungle,27841,27841,0,2001_boxofficemojo_rankings.csv,2001,1.0,0.0
15092,Radio Dreams,27836,27836,0,2017_boxofficemojo_rankings.csv,2017,1.0,0.0
15093,Don Carlo,27834,27834,0,2008_boxofficemojo_rankings.csv,2008,1.0,0.0
15094,Best Laid Plans,27816,27816,0,1999_boxofficemojo_rankings.csv,1999,1.0,0.0
15095,Slipstream,27769,8965,18804,2007_boxofficemojo_rankings.csv,2007,0.32284201807771257,0.6771579819222875
15096,Bauhaus Spirit: 100 Years of Bauhaus,27768,17122,10646,2019_boxofficemojo_rankings.csv,2019,0.6166090463843272,0.3833909536156727
15097,La león,27765,1708,26057,2007_boxofficemojo_rankings.csv,2007,0.06151629749684855,0.9384837025031515
15098,Simon Killer,27740,27740,0,2013_boxofficemojo_rankings.csv,2013,1.0,0.0
15099,30 Years of Garbage: The Garbage Pail Kids Story,27739,27739,0,2017_boxofficemojo_rankings.csv,2017,1.0,0.0
15100,Senso,27723,27723,0,2018_boxofficemojo_rankings.csv,2018,1.0,0.0
15101,Broadway Idiot,27595,27595,0,2013_boxofficemojo_rankings.csv,2013,1.0,0.0
15102,"Léon Morin, Priest",27567,27567,0,2009_boxofficemojo_rankings.csv,2009,1.0,0.0
15103,The King and the Mockingbird 2014 Re-release,27513,27513,0,2014_boxofficemojo_rankings.csv,2014,1.0,0.0
15104,Finding North,27466,27466,0,1999_boxofficemojo_rankings.csv,1999,1.0,0.0
15105,Heaven's a Drag,27455,27455,0,1995_boxofficemojo_rankings.csv,1995,1.0,0.0
15106,Boys Briefs 4,27449,27449,0,2006_boxofficemojo_rankings.csv,2006,1.0,0.0
15107,Beyond Vanilla,27396,27396,0,2003_boxofficemojo_rankings.csv,2003,1.0,0.0
15108,Kate Plays Christine,27364,25564,1800,2016_boxofficemojo_rankings.csv,2016,0.9342201432539102,0.06577985674608976
15109,Who Gets to Call It Art?,27344,27344,0,2006_boxofficemojo_rankings.csv,2006,1.0,0.0
15110,Cane River 2020 Re-release,27317,27317,0,2020_boxofficemojo_rankings.csv,2020,1.0,0.0
15111,Unlocking the Cage,27284,27284,0,2016_boxofficemojo_rankings.csv,2016,1.0,0.0
15112,Three 2004 Re-release,27256,27256,0,2004_boxofficemojo_rankings.csv,2004,1.0,0.0
15113,Everybody Says I'm Fine!,27225,27225,0,2003_boxofficemojo_rankings.csv,2003,1.0,0.0
15114,Nest of Vipers,27182,27182,0,1979_boxofficemojo_rankings.csv,1979,1.0,0.0
15115,Iron Island,27177,27177,0,2006_boxofficemojo_rankings.csv,2006,1.0,0.0
15116,Tiger Eyes,27160,27160,0,2013_boxofficemojo_rankings.csv,2013,1.0,0.0
15117,Bronx Gothic,27151,27151,0,2017_boxofficemojo_rankings.csv,2017,1.0,0.0
15118,"Leaving Home, Coming Home: A Portrait of Robert Frank",27073,27073,0,2019_boxofficemojo_rankings.csv,2019,1.0,0.0
15119,Last Weekend,27053,27053,0,2014_boxofficemojo_rankings.csv,2014,1.0,0.0
15120,Guest of Cindy Sherman,27052,27052,0,2009_boxofficemojo_rankings.csv,2009,1.0,0.0
15121,Clash,27052,27052,0,2011_boxofficemojo_rankings.csv,2011,1.0,0.0
15122,The Last Ride,27000,27000,0,2011_boxofficemojo_rankings.csv,2011,1.0,0.0
15123,Level Five,27000,27000,0,2014_boxofficemojo_rankings.csv,2014,1.0,0.0
15124,The Joyriders,26999,26999,0,1999_boxofficemojo_rankings.csv,1999,1.0,0.0
15125,Frontrunners,26976,26976,0,2008_boxofficemojo_rankings.csv,2008,1.0,0.0
15126,Mali Blues,26950,26950,0,2017_boxofficemojo_rankings.csv,2017,1.0,0.0
15127,Gringo Wedding,26946,26946,0,2007_boxofficemojo_rankings.csv,2007,1.0,0.0
15128,The Garden,26931,26931,0,2009_boxofficemojo_rankings.csv,2009,1.0,0.0
15129,Cape of Good Hope,26904,26904,0,2005_boxofficemojo_rankings.csv,2005,1.0,0.0
15130,The Dukes,26875,26875,0,2008_boxofficemojo_rankings.csv,2008,1.0,0.0
15131,A Monster with a Thousand Heads,26865,24852,2013,2016_boxofficemojo_rankings.csv,2016,0.925069793411502,0.07493020658849804
15132,Abduction: The Megumi Yokota Story,26859,26859,0,2006_boxofficemojo_rankings.csv,2006,1.0,0.0
15133,"The Devil, Probably",26816,26816,0,2012_boxofficemojo_rankings.csv,2012,1.0,0.0
15134,Fish Without a Bicycle,26799,26799,0,2004_boxofficemojo_rankings.csv,2004,1.0,0.0
15135,Trudell,26756,26756,0,2006_boxofficemojo_rankings.csv,2006,1.0,0.0
15136,Earth Days,26748,26748,0,2009_boxofficemojo_rankings.csv,2009,1.0,0.0
15137,"Massoud, the Afghan 2002 Re-release",26747,26747,0,2002_boxofficemojo_rankings.csv,2002,1.0,0.0
15138,Tap World,26747,26747,0,2015_boxofficemojo_rankings.csv,2015,1.0,0.0
15139,Khiladi 420,26731,26731,0,2000_boxofficemojo_rankings.csv,2000,1.0,0.0
15140,Metroland,26682,26682,0,1999_boxofficemojo_rankings.csv,1999,1.0,0.0
15141,The Answer Man,26676,26676,0,2009_boxofficemojo_rankings.csv,2009,1.0,0.0
15142,Lyrisch nitraat,26662,26662,0,1991_boxofficemojo_rankings.csv,1991,1.0,0.0
15143,Peace Officer,26632,26632,0,2015_boxofficemojo_rankings.csv,2015,1.0,0.0
15144,"Pink Ribbons, Inc.",26608,26608,0,2012_boxofficemojo_rankings.csv,2012,1.0,0.0
15145,Wrestle,26597,26597,0,2019_boxofficemojo_rankings.csv,2019,1.0,0.0
15146,Milford Graves Full Mantis,26566,26566,0,2018_boxofficemojo_rankings.csv,2018,1.0,0.0
15147,José,26563,26563,0,2020_boxofficemojo_rankings.csv,2020,1.0,0.0
15148,All the Little Animals,26558,26558,0,1999_boxofficemojo_rankings.csv,1999,1.0,0.0
15149,Forgotten Silver,26459,26459,0,1997_boxofficemojo_rankings.csv,1997,1.0,0.0
15150,Front Cover,26409,26409,0,2016_boxofficemojo_rankings.csv,2016,1.0,0.0
15151,9 Dead Gay Guys,26377,26377,0,2003_boxofficemojo_rankings.csv,2003,1.0,0.0
15152,"Clean, Shaven",26351,26351,0,1995_boxofficemojo_rankings.csv,1995,1.0,0.0
15153,At First Light,26338,3292,23046,2018_boxofficemojo_rankings.csv,2018,0.12499050801123851,0.8750094919887614
15154,Marlina the Murderer in Four Acts,26331,17788,8543,2018_boxofficemojo_rankings.csv,2018,0.6755535300596255,0.32444646994037446
15155,Donnybrook,26284,26284,0,2019_boxofficemojo_rankings.csv,2019,1.0,0.0
15156,Two Bits,26282,26282,0,1995_boxofficemojo_rankings.csv,1995,1.0,0.0
15157,Endgame,26260,9645,16615,2009_boxofficemojo_rankings.csv,2009,0.3672886519421173,0.6327113480578828
15158,October Country,26185,26185,0,2010_boxofficemojo_rankings.csv,2010,1.0,0.0
15159,The Misandrists,26123,26123,0,2018_boxofficemojo_rankings.csv,2018,1.0,0.0
15160,"Sex, Politics & Cocktails",26087,26087,0,2005_boxofficemojo_rankings.csv,2005,1.0,0.0
15161,They Call us Monsters,26080,26080,0,2017_boxofficemojo_rankings.csv,2017,1.0,0.0
15162,"Lipstick & Dynamite, Piss & Vinegar: The First Ladies of Wrestling",26073,26073,0,2005_boxofficemojo_rankings.csv,2005,1.0,0.0
15163,Perestroika,26064,26064,0,2009_boxofficemojo_rankings.csv,2009,1.0,0.0
15164,Highway to Hell,26055,26055,0,1992_boxofficemojo_rankings.csv,1992,1.0,0.0
15165,Nursery University,26042,26042,0,2009_boxofficemojo_rankings.csv,2009,1.0,0.0
15166,Maze,26041,26041,0,2001_boxofficemojo_rankings.csv,2001,1.0,0.0
15167,Ridge Runners,26019,26019,0,2018_boxofficemojo_rankings.csv,2018,1.0,0.0
15168,I'm Not Rappaport,26011,26011,0,1996_boxofficemojo_rankings.csv,1996,1.0,0.0
15169,Main Street,26011,2560,23451,2011_boxofficemojo_rankings.csv,2011,0.09841989927338433,0.9015801007266157
15170,The Winner,26004,26004,0,1997_boxofficemojo_rankings.csv,1997,1.0,0.0
15171,Jet Trash 2018 Re-release,26002,26002,0,2018_boxofficemojo_rankings.csv,2018,1.0,0.0
15172,Black Mother,25919,18762,7157,2018_boxofficemojo_rankings.csv,2018,0.7238705196959759,0.27612948030402407
15173,Django,25916,25916,0,2012_boxofficemojo_rankings.csv,2012,1.0,0.0
15174,Hood of Horror,25900,25900,0,2007_boxofficemojo_rankings.csv,2007,1.0,0.0
15175,Cowards Bend the Knee,25860,25860,0,2004_boxofficemojo_rankings.csv,2004,1.0,0.0
15176,Women Like Us,25859,25859,0,2017_boxofficemojo_rankings.csv,2017,1.0,0.0
15177,Carla's Song,25845,25845,0,1998_boxofficemojo_rankings.csv,1998,1.0,0.0
15178,Caesar and Otto's Summer Camp Massacre,25844,25844,0,2011_boxofficemojo_rankings.csv,2011,1.0,0.0
15179,Spriggan,25824,25824,0,2001_boxofficemojo_rankings.csv,2001,1.0,0.0
15180,Elena,25788,25788,0,2014_boxofficemojo_rankings.csv,2014,1.0,0.0
15181,Through the Fire,25752,25752,0,2006_boxofficemojo_rankings.csv,2006,1.0,0.0
15182,Stephanie Daley,25751,25751,0,2007_boxofficemojo_rankings.csv,2007,1.0,0.0
15183,"Ladies and Gentlemen, the Fabulous Stains",25728,25728,0,1982_boxofficemojo_rankings.csv,1982,1.0,0.0
15184,Quitting,25717,18531,7186,2002_boxofficemojo_rankings.csv,2002,0.7205739394175059,0.2794260605824941
15185,Go Now,25695,25695,0,1998_boxofficemojo_rankings.csv,1998,1.0,0.0
15186,Gurukulam,25651,25651,0,2016_boxofficemojo_rankings.csv,2016,1.0,0.0
15187,Immortality,25648,25648,0,2000_boxofficemojo_rankings.csv,2000,1.0,0.0
15188,Passion Play,25603,3669,21934,2011_boxofficemojo_rankings.csv,2011,0.14330351911885325,0.8566964808811467
15189,The Exploding Girl,25572,25572,0,2010_boxofficemojo_rankings.csv,2010,1.0,0.0
15190,Banjo,25531,25531,0,2016_boxofficemojo_rankings.csv,2016,1.0,0.0
15191,Naked Boys Singing!,25526,25526,0,2007_boxofficemojo_rankings.csv,2007,1.0,0.0
15192,Waiting for Forever,25517,25517,0,2011_boxofficemojo_rankings.csv,2011,1.0,0.0
15193,Unsubscribe,25488,25488,0,2020_boxofficemojo_rankings.csv,2020,1.0,0.0
15194,Falling,25484,509,24975,2007_boxofficemojo_rankings.csv,2007,0.019973316590802072,0.980026683409198
15195,Christian Mingle,25480,25480,0,2014_boxofficemojo_rankings.csv,2014,1.0,0.0
15196,Werckmeister Harmonies,25461,25461,0,2001_boxofficemojo_rankings.csv,2001,1.0,0.0
15197,Fuck,25428,22359,3069,2006_boxofficemojo_rankings.csv,2006,0.8793062765455404,0.12069372345445965
15198,Kill Command,25427,0,25427,2016_boxofficemojo_rankings.csv,2016,0.0,1.0
15199,Nobody Walks,25342,25342,0,2012_boxofficemojo_rankings.csv,2012,1.0,0.0
15200,Lake of Fire,25317,25317,0,2007_boxofficemojo_rankings.csv,2007,1.0,0.0
15201,Maestro,25315,25315,0,2004_boxofficemojo_rankings.csv,2004,1.0,0.0
15202,Rediscover Sautet,25314,25314,0,2015_boxofficemojo_rankings.csv,2015,1.0,0.0
15203,Badland,25309,1924,23385,2007_boxofficemojo_rankings.csv,2007,0.07602038800426726,0.9239796119957328
15204,Disturbing the Peace,25287,25287,0,2016_boxofficemojo_rankings.csv,2016,1.0,0.0
15205,In Search of Fellini,25269,12772,12497,2017_boxofficemojo_rankings.csv,2017,0.5054414499980213,0.49455855000197874
15206,Death of the Virgin,25247,25247,0,2012_boxofficemojo_rankings.csv,2012,1.0,0.0
15207,The Worst Movie Ever!,25206,25206,0,2011_boxofficemojo_rankings.csv,2011,1.0,0.0
15208,Drivers Wanted,25189,25189,0,2005_boxofficemojo_rankings.csv,2005,1.0,0.0
15209,Fresh,25115,25115,0,2010_boxofficemojo_rankings.csv,2010,1.0,0.0
15210,Gotta Dance,25108,25108,0,2009_boxofficemojo_rankings.csv,2009,1.0,0.0
15211,Vazante,25091,23884,1207,2018_boxofficemojo_rankings.csv,2018,0.9518951018293412,0.0481048981706588
15212,Disappearance at Clifton Hill,25084,25084,0,2020_boxofficemojo_rankings.csv,2020,1.0,0.0
15213,Bonnie & Clyde vs. Dracula,25027,25027,0,2011_boxofficemojo_rankings.csv,2011,1.0,0.0
15214,The Lucky Man,25015,25015,0,2017_boxofficemojo_rankings.csv,2017,1.0,0.0
15215,For Ever Mozart,25000,25000,0,1997_boxofficemojo_rankings.csv,1997,1.0,0.0
15216,End of the Line,25000,25000,0,1987_boxofficemojo_rankings.csv,1987,1.0,0.0
15217,My Little Girl,25000,25000,0,1987_boxofficemojo_rankings.csv,1987,1.0,0.0
15218,The Power of Few,25000,25000,0,2013_boxofficemojo_rankings.csv,2013,1.0,0.0
15219,Shadow Glories,24997,24997,0,2001_boxofficemojo_rankings.csv,2001,1.0,0.0
15220,The Isle,24963,20666,4297,2002_boxofficemojo_rankings.csv,2002,0.827865240556023,0.17213475944397708
15221,Ugetsu,24959,11197,13762,2017_boxofficemojo_rankings.csv,2017,0.44861572979686687,0.5513842702031332
15222,R100,24956,24956,0,2015_boxofficemojo_rankings.csv,2015,1.0,0.0
15223,Rana's Wedding,24930,10604,14326,2003_boxofficemojo_rankings.csv,2003,0.4253509827517048,0.5746490172482952
15224,Hannah Takes the Stairs,24869,22815,2054,2007_boxofficemojo_rankings.csv,2007,0.9174072138003136,0.08259278619968635
15225,Naples '44,24863,24620,243,2017_boxofficemojo_rankings.csv,2017,0.9902264408961107,0.009773559103889313
15226,An Elephant's Journey,24844,24844,0,2018_boxofficemojo_rankings.csv,2018,1.0,0.0
15227,Madaari,24822,0,24822,2016_boxofficemojo_rankings.csv,2016,0.0,1.0
15228,Light from Light,24808,24808,0,2019_boxofficemojo_rankings.csv,2019,1.0,0.0
15229,Marius/Fanny/César,24787,24787,0,2017_boxofficemojo_rankings.csv,2017,1.0,0.0
15230,Paradise 2017 Re-release,24749,24749,0,2017_boxofficemojo_rankings.csv,2017,1.0,0.0
15231,Strike,24743,15758,8985,2019_boxofficemojo_rankings.csv,2019,0.6368669926847997,0.36313300731520026
15232,Stage Mother,24736,0,24736,2020_boxofficemojo_rankings.csv,2020,0.0,1.0
15233,Cold Comes the Night,24732,16971,7761,2013_boxofficemojo_rankings.csv,2013,0.6861960213488598,0.31380397865114024
15234,Wrestling with Angels: Playwright Tony Kushner,24729,24729,0,2006_boxofficemojo_rankings.csv,2006,1.0,0.0
15235,Dream for an Insomniac,24727,24727,0,1998_boxofficemojo_rankings.csv,1998,1.0,0.0
15236,Horses: The Story of Equus,24716,0,24716,2002_boxofficemojo_rankings.csv,2002,0.0,1.0
15237,The Day,24686,20984,3702,2012_boxofficemojo_rankings.csv,2012,0.8500364579113667,0.14996354208863324
15238,Hyenas,24672,24672,0,2019_boxofficemojo_rankings.csv,2019,1.0,0.0
15239,The Departure,24662,24662,0,2017_boxofficemojo_rankings.csv,2017,1.0,0.0
15240,Harvest,24657,24657,0,2011_boxofficemojo_rankings.csv,2011,1.0,0.0
15241,Knuckle,24655,2647,22008,2011_boxofficemojo_rankings.csv,2011,0.1073615899411884,0.8926384100588116
15242,Eat This New York,24640,24640,0,2004_boxofficemojo_rankings.csv,2004,1.0,0.0
15243,Olvidados 2015 Re-release,24638,24638,0,2015_boxofficemojo_rankings.csv,2015,1.0,0.0
15244,Born to Fly: Elizabeth Streb vs. Gravity,24630,24630,0,2014_boxofficemojo_rankings.csv,2014,1.0,0.0
15245,Bang Rajan 2004 Re-release,24629,24629,0,2004_boxofficemojo_rankings.csv,2004,1.0,0.0
15246,Immigration Tango,24554,24554,0,2011_boxofficemojo_rankings.csv,2011,1.0,0.0
15247,The Aspern Papers,24554,9277,15277,2019_boxofficemojo_rankings.csv,2019,0.3778203144090576,0.6221796855909424
15248,After,24544,24544,0,2011_boxofficemojo_rankings.csv,2011,1.0,0.0
15249,Graceland,24529,24529,0,2013_boxofficemojo_rankings.csv,2013,1.0,0.0
15250,Dreaming Lhasa,24523,21504,3019,2007_boxofficemojo_rankings.csv,2007,0.8768910818415365,0.12310891815846349
15251,Vivre Sa Vie,24517,24517,0,2008_boxofficemojo_rankings.csv,2008,1.0,0.0
15252,Too Late to Die Young,24487,16591,7896,2018_boxofficemojo_rankings.csv,2018,0.6775431861804223,0.32245681381957775
15253,Sudden Fear,24476,24476,0,2016_boxofficemojo_rankings.csv,2016,1.0,0.0
15254,Two Drifters,24452,24452,0,2006_boxofficemojo_rankings.csv,2006,1.0,0.0
15255,Otter 501,24449,24449,0,2012_boxofficemojo_rankings.csv,2012,1.0,0.0
15256,Off the Black,24425,24425,0,2006_boxofficemojo_rankings.csv,2006,1.0,0.0
15257,The Man Who Copied,24391,24391,0,2005_boxofficemojo_rankings.csv,2005,1.0,0.0
15258,Coyote County Loser,24375,24375,0,2009_boxofficemojo_rankings.csv,2009,1.0,0.0
15259,Last Days in the Desert,24352,0,24352,2016_boxofficemojo_rankings.csv,2016,0.0,1.0
15260,Honeymoon,24343,9318,15025,2014_boxofficemojo_rankings.csv,2014,0.3827794437826069,0.6172205562173931
15261,Le Petit Soldat,24296,24296,0,2013_boxofficemojo_rankings.csv,2013,1.0,0.0
15262,Jasmine,24248,24248,0,2017_boxofficemojo_rankings.csv,2017,1.0,0.0
15263,The Big Gay Musical,24140,24140,0,2009_boxofficemojo_rankings.csv,2009,1.0,0.0
15264,Heart of Africa,24139,24139,0,2020_boxofficemojo_rankings.csv,2020,1.0,0.0
15265,Luster,24137,24137,0,2003_boxofficemojo_rankings.csv,2003,1.0,0.0
15266,I'll Believe You,24110,24110,0,2007_boxofficemojo_rankings.csv,2007,1.0,0.0
15267,Radio Unnameable,24090,24090,0,2012_boxofficemojo_rankings.csv,2012,1.0,0.0
15268,Level Up,24083,1469,22614,2016_boxofficemojo_rankings.csv,2016,0.06099738404683802,0.939002615953162
15269,American Storytellers,24082,24082,0,2003_boxofficemojo_rankings.csv,2003,1.0,0.0
15270,Wild West,24079,24079,0,1993_boxofficemojo_rankings.csv,1993,1.0,0.0
15271,Chasing Einstein,24057,24057,0,2019_boxofficemojo_rankings.csv,2019,1.0,0.0
15272,When the Sea Rises 2006 Re-release,24038,24038,0,2006_boxofficemojo_rankings.csv,2006,1.0,0.0
15273,Ranchero,24036,24036,0,2011_boxofficemojo_rankings.csv,2011,1.0,0.0
15274,Steven Universe: The Movie,24012,0,24012,2019_boxofficemojo_rankings.csv,2019,0.0,1.0
15275,Beneath the Darkness,23998,0,23998,2012_boxofficemojo_rankings.csv,2012,0.0,1.0
15276,The Fiancé,23986,23986,0,2016_boxofficemojo_rankings.csv,2016,1.0,0.0
15277,On Broadway,23968,23968,0,2008_boxofficemojo_rankings.csv,2008,1.0,0.0
15278,Harry Dean Stanton: Partly Fiction,23959,23959,0,2013_boxofficemojo_rankings.csv,2013,1.0,0.0
15279,Almost Holy,23957,21142,2815,2016_boxofficemojo_rankings.csv,2016,0.8824978085736945,0.11750219142630547
15280,Chicago Cab,23946,23946,0,1998_boxofficemojo_rankings.csv,1998,1.0,0.0
15281,Simple Creature,23918,23918,0,2017_boxofficemojo_rankings.csv,2017,1.0,0.0
15282,Shut Up Little Man! An Audio Misadventure,23901,23901,0,2011_boxofficemojo_rankings.csv,2011,1.0,0.0
15283,Dear Mr. Watterson,23899,23899,0,2013_boxofficemojo_rankings.csv,2013,1.0,0.0
15284,Under The Wire,23897,3429,20468,2018_boxofficemojo_rankings.csv,2018,0.14349081474662093,0.856509185253379
15285,Vincent N Roxxy,23896,0,23896,2017_boxofficemojo_rankings.csv,2017,0.0,1.0
15286,Behind the Burly Q,23889,23889,0,2010_boxofficemojo_rankings.csv,2010,1.0,0.0
15287,Emoticon ;),23881,23881,0,2014_boxofficemojo_rankings.csv,2014,1.0,0.0
15288,Happy Valley,23868,23868,0,2014_boxofficemojo_rankings.csv,2014,1.0,0.0
15289,Argentina,23864,14869,8995,2015_boxofficemojo_rankings.csv,2015,0.623072410325176,0.376927589674824
15290,Death House,23833,23833,0,2018_boxofficemojo_rankings.csv,2018,1.0,0.0
15291,Frequently Asked Questions About Time Travel,23820,0,23820,2009_boxofficemojo_rankings.csv,2009,0.0,1.0
15292,Live Nude Girls,23808,23808,0,1995_boxofficemojo_rankings.csv,1995,1.0,0.0
15293,Liars Club,23792,23792,0,2002_boxofficemojo_rankings.csv,2002,1.0,0.0
15294,Emmanuel's Gift,23728,23728,0,2005_boxofficemojo_rankings.csv,2005,1.0,0.0
15295,Diminished Capacity,23719,21659,2060,2008_boxofficemojo_rankings.csv,2008,0.9131497955225768,0.08685020447742316
15296,Echoes of Paradise,23717,23717,0,1989_boxofficemojo_rankings.csv,1989,1.0,0.0
15297,Greenwich Village: Music That Defined a Generation,23701,23701,0,2013_boxofficemojo_rankings.csv,2013,1.0,0.0
15298,Dangerous Game,23671,23671,0,1993_boxofficemojo_rankings.csv,1993,1.0,0.0
15299,Raw Faith,23667,23667,0,2011_boxofficemojo_rankings.csv,2011,1.0,0.0
15300,Southbound,23665,23665,0,2016_boxofficemojo_rankings.csv,2016,1.0,0.0
15301,Good Kids,23627,0,23627,2016_boxofficemojo_rankings.csv,2016,0.0,1.0
15302,Arnolds Park,23616,23616,0,2007_boxofficemojo_rankings.csv,2007,1.0,0.0
15303,"Phoenix, Oregon",23613,23613,0,2020_boxofficemojo_rankings.csv,2020,1.0,0.0
15304,Lost Bohemia,23584,23584,0,2011_boxofficemojo_rankings.csv,2011,1.0,0.0
15305,"A Woman, a Part",23562,23562,0,2017_boxofficemojo_rankings.csv,2017,1.0,0.0
15306,An Evening with Beverly Luff Linn,23515,6701,16814,2018_boxofficemojo_rankings.csv,2018,0.28496704231341696,0.715032957686583
15307,Opening Night,23488,23488,0,1991_boxofficemojo_rankings.csv,1991,1.0,0.0
15308,The Hill Chris Climbed: The Gridiron Heroes Story,23487,23487,0,2016_boxofficemojo_rankings.csv,2016,1.0,0.0
15309,Letter from Masanjia,23481,23481,0,2018_boxofficemojo_rankings.csv,2018,1.0,0.0
15310,The Sensation of Sight,23457,23457,0,2007_boxofficemojo_rankings.csv,2007,1.0,0.0
15311,Robert the Bruce,23425,0,23425,2019_boxofficemojo_rankings.csv,2019,0.0,1.0
15312,Believe Me,23419,23419,0,2014_boxofficemojo_rankings.csv,2014,1.0,0.0
15313,Death in Love,23412,23412,0,2009_boxofficemojo_rankings.csv,2009,1.0,0.0
15314,Esther Kahn,23371,23371,0,2002_boxofficemojo_rankings.csv,2002,1.0,0.0
15315,Can't Stand Losing You: Surviving the Police,23262,23262,0,2015_boxofficemojo_rankings.csv,2015,1.0,0.0
15316,For Ahkeem,23136,23136,0,2017_boxofficemojo_rankings.csv,2017,1.0,0.0
15317,Never Too Late,23135,0,23135,2020_boxofficemojo_rankings.csv,2020,0.0,1.0
15318,The Judge,23127,22257,870,2018_boxofficemojo_rankings.csv,2018,0.9623816318588663,0.03761836814113374
15319,Finding Oscar,23116,23116,0,2017_boxofficemojo_rankings.csv,2017,1.0,0.0
15320,The Iran Job,23115,23115,0,2012_boxofficemojo_rankings.csv,2012,1.0,0.0
15321,The World Unseen,23101,17808,5293,2008_boxofficemojo_rankings.csv,2008,0.7708757196658154,0.22912428033418467
15322,The Grace of Jake,23078,23078,0,2017_boxofficemojo_rankings.csv,2017,1.0,0.0
15323,S21: The Khmer Rouge Killing Machine,23078,22606,472,2004_boxofficemojo_rankings.csv,2004,0.9795476211110148,0.02045237888898518
15324,Premature,23071,23071,0,2020_boxofficemojo_rankings.csv,2020,1.0,0.0
15325,Three Peaks,23069,16216,6853,2018_boxofficemojo_rankings.csv,2018,0.7029346742381551,0.2970653257618449
15326,History of Jazz: Oxygen for the Ears,23048,23048,0,2014_boxofficemojo_rankings.csv,2014,1.0,0.0
15327,Video Games: The Movie,23043,23043,0,2014_boxofficemojo_rankings.csv,2014,1.0,0.0
15328,Incantato 2004 Re-release,23039,23039,0,2004_boxofficemojo_rankings.csv,2004,1.0,0.0
15329,American Friends,23034,23034,0,1993_boxofficemojo_rankings.csv,1993,1.0,0.0
15330,Goat,23020,23020,0,2016_boxofficemojo_rankings.csv,2016,1.0,0.0
15331,Islam: What the West Needs to Know,22938,22938,0,2006_boxofficemojo_rankings.csv,2006,1.0,0.0
15332,Ambrose Bierce: Civil War Stories,22918,22918,0,2006_boxofficemojo_rankings.csv,2006,1.0,0.0
15333,Frankie and Johnny Are Married,22900,22900,0,2004_boxofficemojo_rankings.csv,2004,1.0,0.0
15334,Normal Life,22891,22891,0,1996_boxofficemojo_rankings.csv,1996,1.0,0.0
15335,Hellbound?,22887,22887,0,2012_boxofficemojo_rankings.csv,2012,1.0,0.0
15336,Mirza's Lady,22886,0,22886,2016_boxofficemojo_rankings.csv,2016,0.0,1.0
15337,ABC Africa,22881,9075,13806,2001_boxofficemojo_rankings.csv,2001,0.3966172807132555,0.6033827192867445
15338,Keyhole,22826,22826,0,2012_boxofficemojo_rankings.csv,2012,1.0,0.0
15339,The Monster 1999 Re-release,22819,22819,0,1999_boxofficemojo_rankings.csv,1999,1.0,0.0
15340,Weather Girl,22779,22779,0,2009_boxofficemojo_rankings.csv,2009,1.0,0.0
15341,The Long Day Closes,22765,22765,0,2012_boxofficemojo_rankings.csv,2012,1.0,0.0
15342,Carol Channing: Larger Than Life,22740,22740,0,2012_boxofficemojo_rankings.csv,2012,1.0,0.0
15343,The Last Big Thing,22731,22731,0,1998_boxofficemojo_rankings.csv,1998,1.0,0.0
15344,American Masters: The Life and Times of Allen Ginsberg,22692,22692,0,1994_boxofficemojo_rankings.csv,1994,1.0,0.0
15345,Dead Fish,22679,0,22679,2006_boxofficemojo_rankings.csv,2006,0.0,1.0
15346,The Revisionaries,22664,22664,0,2012_boxofficemojo_rankings.csv,2012,1.0,0.0
15347,Poultrygeist: Night of the Chicken Dead,22623,13804,8819,2007_boxofficemojo_rankings.csv,2007,0.6101754851257569,0.389824514874243
15348,Ode to Joy,22594,17303,5291,2019_boxofficemojo_rankings.csv,2019,0.7658227848101266,0.23417721518987342
15349,Trophy,22553,21439,1114,2017_boxofficemojo_rankings.csv,2017,0.9506052409878952,0.04939475901210482
15350,L'Innocente,22549,22549,0,2020_boxofficemojo_rankings.csv,2020,1.0,0.0
15351,The Other City,22539,22539,0,2010_boxofficemojo_rankings.csv,2010,1.0,0.0
15352,Anything,22537,19037,3500,2018_boxofficemojo_rankings.csv,2018,0.8446998269512358,0.15530017304876426
15353,The Black Dove,22517,22517,0,2016_boxofficemojo_rankings.csv,2016,1.0,0.0
15354,Casting By,22497,18164,4333,2013_boxofficemojo_rankings.csv,2013,0.8073965417611237,0.19260345823887629
15355,Middleground,22490,0,22490,2017_boxofficemojo_rankings.csv,2017,0.0,1.0
15356,Midnight Dancers,22480,22480,0,1995_boxofficemojo_rankings.csv,1995,1.0,0.0
15357,Happy Tears,22464,22464,0,2010_boxofficemojo_rankings.csv,2010,1.0,0.0
15358,Incendiary,22457,22457,0,2011_boxofficemojo_rankings.csv,2011,1.0,0.0
15359,Realms,22443,147,22296,2017_boxofficemojo_rankings.csv,2017,0.006549926480417056,0.9934500735195829
15360,Kamikaze 89,22440,22440,0,2016_boxofficemojo_rankings.csv,2016,1.0,0.0
15361,Be Here Now,22424,22424,0,2016_boxofficemojo_rankings.csv,2016,1.0,0.0
15362,Blackmail Boy 2005 Re-release,22393,22393,0,2005_boxofficemojo_rankings.csv,2005,1.0,0.0
15363,Paradise Club,22381,22381,0,2017_boxofficemojo_rankings.csv,2017,1.0,0.0
15364,Girl Model,22369,21154,1215,2012_boxofficemojo_rankings.csv,2012,0.9456837587733024,0.05431624122669766
15365,Picture Me,22369,12008,10361,2010_boxofficemojo_rankings.csv,2010,0.5368143412758729,0.46318565872412715
15366,The Painting,22313,21008,1305,2012_boxofficemojo_rankings.csv,2012,0.9415139156545511,0.058486084345448844
15367,Falcone,22300,22300,0,2006_boxofficemojo_rankings.csv,2006,1.0,0.0
15368,The Atomic Cafe,22293,22293,0,2018_boxofficemojo_rankings.csv,2018,1.0,0.0
15369,Metropolitan 2015 Re-release,22284,22284,0,2015_boxofficemojo_rankings.csv,2015,1.0,0.0
15370,Downloading Nancy,22282,22282,0,2009_boxofficemojo_rankings.csv,2009,1.0,0.0
15371,Slow Learners,22272,22272,0,2015_boxofficemojo_rankings.csv,2015,1.0,0.0
15372,Generation Startup,22271,22271,0,2016_boxofficemojo_rankings.csv,2016,1.0,0.0
15373,Reparation,22267,22267,0,2016_boxofficemojo_rankings.csv,2016,1.0,0.0
15374,Winning Formula,22189,22189,0,2018_boxofficemojo_rankings.csv,2018,1.0,0.0
15375,All's Faire in Love,22180,22180,0,2011_boxofficemojo_rankings.csv,2011,1.0,0.0
15376,Princess Cut,22167,22167,0,2015_boxofficemojo_rankings.csv,2015,1.0,0.0
15377,Rails & Ties,22136,22136,0,2007_boxofficemojo_rankings.csv,2007,1.0,0.0
15378,Murder Eleven,22107,22107,0,2013_boxofficemojo_rankings.csv,2013,1.0,0.0
15379,The Garden of Eden,22083,22083,0,2010_boxofficemojo_rankings.csv,2010,1.0,0.0
15380,Losing Control,22081,22081,0,2012_boxofficemojo_rankings.csv,2012,1.0,0.0
15381,And Everything Is Going Fine,22080,22080,0,2010_boxofficemojo_rankings.csv,2010,1.0,0.0
15382,Cuba feliz,22071,22071,0,2002_boxofficemojo_rankings.csv,2002,1.0,0.0
15383,Four Adventures of Reinette and Mirabelle,22039,22039,0,2011_boxofficemojo_rankings.csv,2011,1.0,0.0
15384,Answers to Nothing,22029,22029,0,2011_boxofficemojo_rankings.csv,2011,1.0,0.0
15385,Great World of Sound,22011,22011,0,2007_boxofficemojo_rankings.csv,2007,1.0,0.0
15386,Pet,22003,8004,13999,2016_boxofficemojo_rankings.csv,2016,0.3637685770122256,0.6362314229877744
15387,Lovesickness,22000,22000,0,2008_boxofficemojo_rankings.csv,2008,1.0,0.0
15388,The Sound of Silence,21994,20013,1981,2019_boxofficemojo_rankings.csv,2019,0.9099299809038829,0.09007001909611713
15389,Giuliani Time,21967,21967,0,2006_boxofficemojo_rankings.csv,2006,1.0,0.0
15390,Zombie High,21905,21905,0,1987_boxofficemojo_rankings.csv,1987,1.0,0.0
15391,Three Dancing Slaves,21888,21888,0,2005_boxofficemojo_rankings.csv,2005,1.0,0.0
15392,Garden Party,21886,21886,0,2008_boxofficemojo_rankings.csv,2008,1.0,0.0
15393,The Passion of Joan of Arc,21877,21877,0,2017_boxofficemojo_rankings.csv,2017,1.0,0.0
15394,Deep Gold 3D,21868,12000,9868,2011_boxofficemojo_rankings.csv,2011,0.5487470276202671,0.45125297237973294
15395,The ABCs of Death,21832,21832,0,2013_boxofficemojo_rankings.csv,2013,1.0,0.0
15396,Animals 2015 Re-release,21821,21821,0,2015_boxofficemojo_rankings.csv,2015,1.0,0.0
15397,Viola,21818,21818,0,2013_boxofficemojo_rankings.csv,2013,1.0,0.0
15398,The Matador,21816,21816,0,2008_boxofficemojo_rankings.csv,2008,1.0,0.0
15399,The Female Brain,21786,21786,0,2018_boxofficemojo_rankings.csv,2018,1.0,0.0
15400,Master of the Flying Guillotine,21779,21779,0,2002_boxofficemojo_rankings.csv,2002,1.0,0.0
15401,Better Than Something: Jay Reatard,21697,21697,0,2012_boxofficemojo_rankings.csv,2012,1.0,0.0
15402,Crazy as Hell,21679,21679,0,2002_boxofficemojo_rankings.csv,2002,1.0,0.0
15403,Antarctica,21679,21679,0,2008_boxofficemojo_rankings.csv,2008,1.0,0.0
15404,Dead Awake,21675,11528,10147,2017_boxofficemojo_rankings.csv,2017,0.5318569780853518,0.46814302191464824
15405,Évocateur: The Morton Downey Jr. Movie,21652,21652,0,2013_boxofficemojo_rankings.csv,2013,1.0,0.0
15406,Toe to Toe,21648,21648,0,2010_boxofficemojo_rankings.csv,2010,1.0,0.0
15407,Sedona,21638,21638,0,2012_boxofficemojo_rankings.csv,2012,1.0,0.0
15408,Blue Jay,21626,21626,0,2016_boxofficemojo_rankings.csv,2016,1.0,0.0
15409,Czech Dream 2007 Re-release,21603,21603,0,2007_boxofficemojo_rankings.csv,2007,1.0,0.0
15410,Wicked Witches,21600,21600,0,2019_boxofficemojo_rankings.csv,2019,1.0,0.0
15411,Frogs for Snakes,21589,21589,0,1999_boxofficemojo_rankings.csv,1999,1.0,0.0
15412,Half the Picture,21589,21589,0,2018_boxofficemojo_rankings.csv,2018,1.0,0.0
15413,Dr. Bronner's Magic Soapbox,21579,21579,0,2007_boxofficemojo_rankings.csv,2007,1.0,0.0
15414,Waiting for Lightning,21577,21577,0,2012_boxofficemojo_rankings.csv,2012,1.0,0.0
15415,10 timer til Paradis,21561,16000,5561,2012_boxofficemojo_rankings.csv,2012,0.742080608506099,0.25791939149390103
15416,Monogamy,21527,21527,0,2011_boxofficemojo_rankings.csv,2011,1.0,0.0
15417,So Much So Fast,21525,21525,0,2006_boxofficemojo_rankings.csv,2006,1.0,0.0
15418,New Rose Hotel,21521,21521,0,1999_boxofficemojo_rankings.csv,1999,1.0,0.0
15419,Slutty Summer,21515,21515,0,2005_boxofficemojo_rankings.csv,2005,1.0,0.0
15420,The Sunchaser,21508,21508,0,1996_boxofficemojo_rankings.csv,1996,1.0,0.0
15421,Imaginary Witness: Hollywood and the Holocaust,21507,21507,0,2007_boxofficemojo_rankings.csv,2007,1.0,0.0
15422,Thank You for Your Service,21497,21497,0,2016_boxofficemojo_rankings.csv,2016,1.0,0.0
15423,Hagazussa,21487,13253,8234,2018_boxofficemojo_rankings.csv,2018,0.616791548378089,0.3832084516219109
15424,Tyrel,21456,21456,0,2018_boxofficemojo_rankings.csv,2018,1.0,0.0
15425,Three of Hearts 2005 Re-release,21429,21429,0,2005_boxofficemojo_rankings.csv,2005,1.0,0.0
15426,The Cry,21427,21427,0,2008_boxofficemojo_rankings.csv,2008,1.0,0.0
15427,Almost Salinas,21419,21419,0,2003_boxofficemojo_rankings.csv,2003,1.0,0.0
15428,Bigger Than the Sky,21398,21398,0,2005_boxofficemojo_rankings.csv,2005,1.0,0.0
15429,The Guys,21366,21366,0,2003_boxofficemojo_rankings.csv,2003,1.0,0.0
15430,Song Of Granite,21349,16182,5167,2017_boxofficemojo_rankings.csv,2017,0.7579746123940231,0.24202538760597686
15431,Tio Papi,21316,21316,0,2013_boxofficemojo_rankings.csv,2013,1.0,0.0
15432,Memphis,21286,21286,0,2014_boxofficemojo_rankings.csv,2014,1.0,0.0
15433,The Burial Society,21285,21285,0,2004_boxofficemojo_rankings.csv,2004,1.0,0.0
15434,Trojan Eddie,21264,21264,0,1997_boxofficemojo_rankings.csv,1997,1.0,0.0
15435,Yang Ban Xi: The 8 Modelworks,21244,21244,0,2006_boxofficemojo_rankings.csv,2006,1.0,0.0
15436,Resurrect Dead: The Mystery of the Toynbee Tiles,21242,21242,0,2011_boxofficemojo_rankings.csv,2011,1.0,0.0
15437,Already Tomorrow in Hong Kong,21206,21206,0,2016_boxofficemojo_rankings.csv,2016,1.0,0.0
15438,Ganja & Hess,21197,21197,0,2018_boxofficemojo_rankings.csv,2018,1.0,0.0
15439,NightLights,21147,21147,0,2014_boxofficemojo_rankings.csv,2014,1.0,0.0
15440,God Knows Where I Am,21135,21135,0,2017_boxofficemojo_rankings.csv,2017,1.0,0.0
15441,The Happys,21108,21108,0,2018_boxofficemojo_rankings.csv,2018,1.0,0.0
15442,Dallas 362,21108,21108,0,2005_boxofficemojo_rankings.csv,2005,1.0,0.0
15443,Massacre on Aisle 12,21106,21106,0,2017_boxofficemojo_rankings.csv,2017,1.0,0.0
15444,A Beginner's Guide to Snuff,21031,21031,0,2017_boxofficemojo_rankings.csv,2017,1.0,0.0
15445,We Think the World of You,20998,20998,0,1988_boxofficemojo_rankings.csv,1988,1.0,0.0
15446,The Sacrifice 2014 Re-release,20945,20945,0,2014_boxofficemojo_rankings.csv,2014,1.0,0.0
15447,The Case of the Grinning Cat,20944,20944,0,2006_boxofficemojo_rankings.csv,2006,1.0,0.0
15448,Round of Your Life,20941,20941,0,2019_boxofficemojo_rankings.csv,2019,1.0,0.0
15449,Ava,20940,20940,0,2018_boxofficemojo_rankings.csv,2018,1.0,0.0
15450,Man Underground,20907,20907,0,2017_boxofficemojo_rankings.csv,2017,1.0,0.0
15451,Lekar Hum Deewana Dil,20874,20874,0,2014_boxofficemojo_rankings.csv,2014,1.0,0.0
15452,Cameraman: The Life and Work of Jack Cardiff,20840,20840,0,2011_boxofficemojo_rankings.csv,2011,1.0,0.0
15453,The Tripper,20840,20840,0,2007_boxofficemojo_rankings.csv,2007,1.0,0.0
15454,Small Wonders,20819,20819,0,1996_boxofficemojo_rankings.csv,1996,1.0,0.0
15455,Major Dundee,20807,20807,0,2005_boxofficemojo_rankings.csv,2005,1.0,0.0
15456,Time Changer 2016 Re-release,20797,20797,0,2016_boxofficemojo_rankings.csv,2016,1.0,0.0
15457,Killer Diller,20795,20795,0,2006_boxofficemojo_rankings.csv,2006,1.0,0.0
15458,Did You Wonder Who Fired the Gun?,20765,20765,0,2018_boxofficemojo_rankings.csv,2018,1.0,0.0
15459,All These Sleepless Nights,20762,20762,0,2017_boxofficemojo_rankings.csv,2017,1.0,0.0
15460,For Ellen,20746,12396,8350,2012_boxofficemojo_rankings.csv,2012,0.5975127735467078,0.4024872264532922
15461,The Ghosts in Our Machine,20709,20709,0,2013_boxofficemojo_rankings.csv,2013,1.0,0.0
15462,Voices in Wartime,20702,20702,0,2005_boxofficemojo_rankings.csv,2005,1.0,0.0
15463,The Great Flood,20694,20694,0,2014_boxofficemojo_rankings.csv,2014,1.0,0.0
15464,The Last Dispatch,20684,20684,0,2005_boxofficemojo_rankings.csv,2005,1.0,0.0
15465,"I Love You, I Love You Not",20677,20677,0,1997_boxofficemojo_rankings.csv,1997,1.0,0.0
15466,Freak Show,20657,19696,961,2018_boxofficemojo_rankings.csv,2018,0.9534782398218522,0.046521760178147846
15467,Meeting Resistance,20616,20616,0,2007_boxofficemojo_rankings.csv,2007,1.0,0.0
15468,Shoot the Piano Player,20615,20615,0,2008_boxofficemojo_rankings.csv,2008,1.0,0.0
15469,Douchebag,20615,20615,0,2010_boxofficemojo_rankings.csv,2010,1.0,0.0
15470,Our Nixon,20584,20584,0,2013_boxofficemojo_rankings.csv,2013,1.0,0.0
15471,Fidelio: Alice's Odyssey,20571,3580,16991,2015_boxofficemojo_rankings.csv,2015,0.17403140343201595,0.825968596567984
15472,Coming Up Roses 2014 Re-release,20567,20567,0,2014_boxofficemojo_rankings.csv,2014,1.0,0.0
15473,Band of Robbers,20555,20555,0,2016_boxofficemojo_rankings.csv,2016,1.0,0.0
15474,The Work,20554,5853,14701,2017_boxofficemojo_rankings.csv,2017,0.28476209010411596,0.715237909895884
15475,Ice Dragon: Legend of the Blue Daisies,20549,20549,0,2018_boxofficemojo_rankings.csv,2018,1.0,0.0
15476,4,20523,20523,0,2006_boxofficemojo_rankings.csv,2006,1.0,0.0
15477,Walt & El Grupo,20521,20521,0,2009_boxofficemojo_rankings.csv,2009,1.0,0.0
15478,This Last Lonely Place,20507,20507,0,2016_boxofficemojo_rankings.csv,2016,1.0,0.0
15479,Consumed,20476,20476,0,2015_boxofficemojo_rankings.csv,2015,1.0,0.0
15480,The Devil and Father Amorth,20449,20449,0,2018_boxofficemojo_rankings.csv,2018,1.0,0.0
15481,Boy Meets Girl,20441,20441,0,2015_boxofficemojo_rankings.csv,2015,1.0,0.0
15482,The First Basket,20440,20440,0,2008_boxofficemojo_rankings.csv,2008,1.0,0.0
15483,Burden,20437,18440,1997,2017_boxofficemojo_rankings.csv,2017,0.9022850711944023,0.09771492880559769
15484,Never,20431,20431,0,2016_boxofficemojo_rankings.csv,2016,1.0,0.0
15485,Crossing the Line,20429,9258,11171,2007_boxofficemojo_rankings.csv,2007,0.4531793039306868,0.5468206960693133
15486,Orwell Rolls in His Grave,20389,20389,0,2004_boxofficemojo_rankings.csv,2004,1.0,0.0
15487,The Highest Pass,20386,20386,0,2012_boxofficemojo_rankings.csv,2012,1.0,0.0
15488,London,20361,20361,0,2006_boxofficemojo_rankings.csv,2006,1.0,0.0
15489,The All Americans,20324,20324,0,2019_boxofficemojo_rankings.csv,2019,1.0,0.0
15490,Words of My Perfect Teacher,20318,20318,0,2006_boxofficemojo_rankings.csv,2006,1.0,0.0
15491,Koroshiya 1 2017 Re-release,20285,20285,0,2017_boxofficemojo_rankings.csv,2017,1.0,0.0
15492,The Korean,20279,20279,0,2010_boxofficemojo_rankings.csv,2010,1.0,0.0
15493,Double Take,20218,20218,0,2010_boxofficemojo_rankings.csv,2010,1.0,0.0
15494,If I Die Tonight,20214,20214,0,2009_boxofficemojo_rankings.csv,2009,1.0,0.0
15495,Izzy Gets the F*ck Across Town,20208,20208,0,2018_boxofficemojo_rankings.csv,2018,1.0,0.0
15496,New World Order,20205,20205,0,2016_boxofficemojo_rankings.csv,2016,1.0,0.0
15497,That Night,20194,20194,0,1993_boxofficemojo_rankings.csv,1993,1.0,0.0
15498,Jesus Henry Christ,20183,20183,0,2012_boxofficemojo_rankings.csv,2012,1.0,0.0
15499,Shoah,20175,20175,0,2010_boxofficemojo_rankings.csv,2010,1.0,0.0
15500,A Wink and a Smile,20169,20169,0,2009_boxofficemojo_rankings.csv,2009,1.0,0.0
15501,Chaos,20166,10289,9877,2005_boxofficemojo_rankings.csv,2005,0.5102152137260736,0.4897847862739264
15502,Flying: Confessions of a Free Woman,20157,20157,0,2007_boxofficemojo_rankings.csv,2007,1.0,0.0
15503,Dirty Laundry,20138,20138,0,2007_boxofficemojo_rankings.csv,2007,1.0,0.0
15504,Friends and Romans,20136,20136,0,2015_boxofficemojo_rankings.csv,2015,1.0,0.0
15505,How to Grow a Band,20135,20135,0,2012_boxofficemojo_rankings.csv,2012,1.0,0.0
15506,The Man from Outer Space,20102,20102,0,2017_boxofficemojo_rankings.csv,2017,1.0,0.0
15507,Love Me True,20100,20100,0,2016_boxofficemojo_rankings.csv,2016,1.0,0.0
15508,Harmony and Me,20099,20099,0,2009_boxofficemojo_rankings.csv,2009,1.0,0.0
15509,"Float Like a Butterfly, Sting Like a Bee",20073,20073,0,2003_boxofficemojo_rankings.csv,2003,1.0,0.0
15510,The Past is a Grotesque Animal,20056,20056,0,2014_boxofficemojo_rankings.csv,2014,1.0,0.0
15511,State of Fear,20055,20055,0,2006_boxofficemojo_rankings.csv,2006,1.0,0.0
15512,Apocalypsis,20052,20052,0,2018_boxofficemojo_rankings.csv,2018,1.0,0.0
15513,General Magic,20046,20046,0,2019_boxofficemojo_rankings.csv,2019,1.0,0.0
15514,The Gospel of Eureka,20039,20039,0,2019_boxofficemojo_rankings.csv,2019,1.0,0.0
15515,The Deal,20035,0,20035,2005_boxofficemojo_rankings.csv,2005,0.0,1.0
15516,Floundering,20031,20031,0,1994_boxofficemojo_rankings.csv,1994,1.0,0.0
15517,"No Pay, Nudity",20017,20017,0,2016_boxofficemojo_rankings.csv,2016,1.0,0.0
15518,The Ground Truth,20013,20013,0,2006_boxofficemojo_rankings.csv,2006,1.0,0.0
15519,Lore,20006,20006,0,2020_boxofficemojo_rankings.csv,2020,1.0,0.0
15520,Eight Hours Don't Make a Day,19987,19987,0,2018_boxofficemojo_rankings.csv,2018,1.0,0.0
15521,"One Sings, the Other Doesn't",19919,19919,0,2018_boxofficemojo_rankings.csv,2018,1.0,0.0
15522,Wedding Palace,19908,19908,0,2013_boxofficemojo_rankings.csv,2013,1.0,0.0
15523,Forbidden Games,19889,19889,0,2015_boxofficemojo_rankings.csv,2015,1.0,0.0
15524,Foster Boy,19873,19873,0,2020_boxofficemojo_rankings.csv,2020,1.0,0.0
15525,Merci Dr Rey!,19867,19867,0,2004_boxofficemojo_rankings.csv,2004,1.0,0.0
15526,Active Measures,19862,19862,0,2018_boxofficemojo_rankings.csv,2018,1.0,0.0
15527,Heat and Dust 2017 Re-release,19856,19856,0,2017_boxofficemojo_rankings.csv,2017,1.0,0.0
15528,"Sia, the Dream of the Python",19830,4662,15168,2002_boxofficemojo_rankings.csv,2002,0.2350983358547655,0.7649016641452345
15529,The Simian Line,19823,19823,0,2001_boxofficemojo_rankings.csv,2001,1.0,0.0
15530,The Journey,19800,19800,0,2003_boxofficemojo_rankings.csv,2003,1.0,0.0
15531,L'iceberg,19789,19789,0,2007_boxofficemojo_rankings.csv,2007,1.0,0.0
15532,Favela Rising,19781,19781,0,2006_boxofficemojo_rankings.csv,2006,1.0,0.0
15533,Wild Canaries,19777,19777,0,2015_boxofficemojo_rankings.csv,2015,1.0,0.0
15534,The Trial,19753,19753,0,2010_boxofficemojo_rankings.csv,2010,1.0,0.0
15535,The Open Road,19716,19716,0,2009_boxofficemojo_rankings.csv,2009,1.0,0.0
15536,Trying to Get Good: The Jazz Odyssey of Jack Sheldon,19712,19712,0,2008_boxofficemojo_rankings.csv,2008,1.0,0.0
15537,Of Love and Shadows,19710,19710,0,1996_boxofficemojo_rankings.csv,1996,1.0,0.0
15538,The Romans,19705,19705,0,2016_boxofficemojo_rankings.csv,2016,1.0,0.0
15539,Trafficked,19698,19698,0,2017_boxofficemojo_rankings.csv,2017,1.0,0.0
15540,Kills On Wheels 2016 Re-release,19680,15898,3782,2016_boxofficemojo_rankings.csv,2016,0.8078252032520326,0.19217479674796747
15541,Misery Loves Comedy,19634,19634,0,2015_boxofficemojo_rankings.csv,2015,1.0,0.0
15542,Trouble in Mind,19632,19632,0,1985_boxofficemojo_rankings.csv,1985,1.0,0.0
15543,Bad Milo,19613,19613,0,2013_boxofficemojo_rankings.csv,2013,1.0,0.0
15544,Art Bastard,19600,19600,0,2016_boxofficemojo_rankings.csv,2016,1.0,0.0
15545,Uzumasa Limelight,19597,19597,0,2014_boxofficemojo_rankings.csv,2014,1.0,0.0
15546,Zoology,19572,0,19572,2016_boxofficemojo_rankings.csv,2016,0.0,1.0
15547,Damascus Cover,19532,0,19532,2018_boxofficemojo_rankings.csv,2018,0.0,1.0
15548,Comet,19530,8623,10907,2014_boxofficemojo_rankings.csv,2014,0.4415258576548899,0.5584741423451101
15549,Hannah: Buddhism's Untold Journey,19526,396,19130,2016_boxofficemojo_rankings.csv,2016,0.02028065143910683,0.9797193485608932
15550,BOSTON: An American Running Story 2017 Re-release,19499,19499,0,2017_boxofficemojo_rankings.csv,2017,1.0,0.0
15551,Grassroots,19492,12356,7136,2012_boxofficemojo_rankings.csv,2012,0.6339010876256926,0.3660989123743074
15552,In Over My Head,19482,19482,0,2012_boxofficemojo_rankings.csv,2012,1.0,0.0
15553,Guardian Angel,19480,19480,0,2014_boxofficemojo_rankings.csv,2014,1.0,0.0
15554,A Picture of You,19480,19480,0,2014_boxofficemojo_rankings.csv,2014,1.0,0.0
15555,A Room for Romeo Brass,19478,19478,0,2000_boxofficemojo_rankings.csv,2000,1.0,0.0
15556,Whensday,19463,19463,0,2013_boxofficemojo_rankings.csv,2013,1.0,0.0
15557,Hunter Gatherer,19462,19462,0,2016_boxofficemojo_rankings.csv,2016,1.0,0.0
15558,Second-Hand Hearts,19450,19450,0,1981_boxofficemojo_rankings.csv,1981,1.0,0.0
15559,Skateland,19411,19411,0,2011_boxofficemojo_rankings.csv,2011,1.0,0.0
15560,Garmento,19402,19402,0,2003_boxofficemojo_rankings.csv,2003,1.0,0.0
15561,Mansfield 66/67,19390,17930,1460,2017_boxofficemojo_rankings.csv,2017,0.9247034553893759,0.07529654461062403
15562,Tchoupitoulas,19375,19375,0,2012_boxofficemojo_rankings.csv,2012,1.0,0.0
15563,Everything's Gone Green,19373,19373,0,2007_boxofficemojo_rankings.csv,2007,1.0,0.0
15564,Windrider,19367,19367,0,1987_boxofficemojo_rankings.csv,1987,1.0,0.0
15565,Actress,19365,19365,0,2014_boxofficemojo_rankings.csv,2014,1.0,0.0
15566,Peter Brook: The Tightrope,19365,19365,0,2014_boxofficemojo_rankings.csv,2014,1.0,0.0
15567,Wild Tigers I Have Known,19351,9946,9405,2007_boxofficemojo_rankings.csv,2007,0.5139786057568084,0.4860213942431916
15568,Watchers of the Sky,19339,19339,0,2014_boxofficemojo_rankings.csv,2014,1.0,0.0
15569,Gabo: The Creation of Gabriel Garcia Marquez,19337,19337,0,2015_boxofficemojo_rankings.csv,2015,1.0,0.0
15570,Melancholian 3 huonetta,19317,19317,0,2005_boxofficemojo_rankings.csv,2005,1.0,0.0
15571,Jackie & Ryan,19305,0,19305,2015_boxofficemojo_rankings.csv,2015,0.0,1.0
15572,Beauty in Trouble 2008 Re-release,19300,19300,0,2008_boxofficemojo_rankings.csv,2008,1.0,0.0
15573,Invisible Waves,19293,0,19293,2006_boxofficemojo_rankings.csv,2006,0.0,1.0
15574,Reuniting the Rubins,19288,13569,5719,2011_boxofficemojo_rankings.csv,2011,0.703494400663625,0.29650559933637494
15575,Off the Menu: The Last Days of Chasen's,19285,19285,0,1998_boxofficemojo_rankings.csv,1998,1.0,0.0
15576,Romeos,19248,1081,18167,2011_boxofficemojo_rankings.csv,2011,0.056161679135494594,0.9438383208645054
15577,Neshoba,19245,19245,0,2010_boxofficemojo_rankings.csv,2010,1.0,0.0
15578,City Lights 2007 Re-release,19181,19181,0,2007_boxofficemojo_rankings.csv,2007,1.0,0.0
15579,The Manson Family,19140,19140,0,2004_boxofficemojo_rankings.csv,2004,1.0,0.0
15580,The People I've Slept With,19137,19137,0,2010_boxofficemojo_rankings.csv,2010,1.0,0.0
15581,Who We Are Now,19128,19128,0,2018_boxofficemojo_rankings.csv,2018,1.0,0.0
15582,L'important c'est d'aimer,19120,19120,0,2017_boxofficemojo_rankings.csv,2017,1.0,0.0
15583,Revelation: Dawn of Global Government,19107,19107,0,2016_boxofficemojo_rankings.csv,2016,1.0,0.0
15584,Make Believe,19085,19085,0,2011_boxofficemojo_rankings.csv,2011,1.0,0.0
15585,November,19084,19084,0,2018_boxofficemojo_rankings.csv,2018,1.0,0.0
15586,Daddy Cool: Join the Fun,19069,14319,4750,2009_boxofficemojo_rankings.csv,2009,0.7509046095757512,0.24909539042424877
15587,Search Engines,19033,19033,0,2016_boxofficemojo_rankings.csv,2016,1.0,0.0
15588,The Challenger,19003,19003,0,2015_boxofficemojo_rankings.csv,2015,1.0,0.0
15589,The Color Wheel,19001,19001,0,2012_boxofficemojo_rankings.csv,2012,1.0,0.0
15590,The Kill Team,18983,18983,0,2014_boxofficemojo_rankings.csv,2014,1.0,0.0
15591,Sophomore,18945,18945,0,2012_boxofficemojo_rankings.csv,2012,1.0,0.0
15592,Devils on the Doorstep,18944,18944,0,2002_boxofficemojo_rankings.csv,2002,1.0,0.0
15593,Smash & Grab: The Story of the Pink Panthers,18938,18938,0,2013_boxofficemojo_rankings.csv,2013,1.0,0.0
15594,Love and a Bullet,18926,18926,0,2002_boxofficemojo_rankings.csv,2002,1.0,0.0
15595,Steal a Pencil for Me,18918,18918,0,2007_boxofficemojo_rankings.csv,2007,1.0,0.0
15596,What Love Is,18901,18901,0,2007_boxofficemojo_rankings.csv,2007,1.0,0.0
15597,The Deserted Station,18867,18867,0,2004_boxofficemojo_rankings.csv,2004,1.0,0.0
15598,Ktown Cowboys,18863,18863,0,2016_boxofficemojo_rankings.csv,2016,1.0,0.0
15599,Nostalgia,18846,18846,0,2013_boxofficemojo_rankings.csv,2013,1.0,0.0
15600,Frank and Ava,18829,18829,0,2018_boxofficemojo_rankings.csv,2018,1.0,0.0
15601,Test,18823,18823,0,2014_boxofficemojo_rankings.csv,2014,1.0,0.0
15602,Dial M for Murder 1999 Re-release,18816,12562,6254,1999_boxofficemojo_rankings.csv,1999,0.6676232993197279,0.3323767006802721
15603,A League of Ordinary Gentlemen 2005 Re-release,18807,18807,0,2005_boxofficemojo_rankings.csv,2005,1.0,0.0
15604,The Sorcerer and the White Snake 2013 Re-release,18759,18759,0,2013_boxofficemojo_rankings.csv,2013,1.0,0.0
15605,Scandalous: The True Story of the National Enquirer,18759,18759,0,2019_boxofficemojo_rankings.csv,2019,1.0,0.0
15606,Severed Ways: The Norse Discovery of America,18728,18728,0,2009_boxofficemojo_rankings.csv,2009,1.0,0.0
15607,Before Stonewall,18724,18724,0,2019_boxofficemojo_rankings.csv,2019,1.0,0.0
15608,Saving Marriage,18720,18720,0,2008_boxofficemojo_rankings.csv,2008,1.0,0.0
15609,The Secret Rapture,18719,18719,0,1994_boxofficemojo_rankings.csv,1994,1.0,0.0
15610,Blessed Is the Match,18654,18654,0,2009_boxofficemojo_rankings.csv,2009,1.0,0.0
15611,Seoul Searching,18654,18654,0,2016_boxofficemojo_rankings.csv,2016,1.0,0.0
15612,Crime + Punishment,18644,18644,0,2018_boxofficemojo_rankings.csv,2018,1.0,0.0
15613,A Single Shot,18642,18642,0,2013_boxofficemojo_rankings.csv,2013,1.0,0.0
15614,Wish Me Away,18618,18618,0,2012_boxofficemojo_rankings.csv,2012,1.0,0.0
15615,The Return of Martin Guerre 2019 Re-release,18603,18603,0,2019_boxofficemojo_rankings.csv,2019,1.0,0.0
15616,The Pagan King: The Battle of Death,18598,0,18598,2018_boxofficemojo_rankings.csv,2018,0.0,1.0
15617,Bobbi Jene,18579,18579,0,2017_boxofficemojo_rankings.csv,2017,1.0,0.0
15618,La Camioneta: The Journey of One American School Bus,18558,18558,0,2013_boxofficemojo_rankings.csv,2013,1.0,0.0
15619,Let My People Go!,18529,18529,0,2013_boxofficemojo_rankings.csv,2013,1.0,0.0
15620,Clubland,18529,18529,0,1999_boxofficemojo_rankings.csv,1999,1.0,0.0
15621,Allegiance to Broadway,18527,18527,0,2018_boxofficemojo_rankings.csv,2018,1.0,0.0
15622,Mr Ya Miss,18516,18516,0,2005_boxofficemojo_rankings.csv,2005,1.0,0.0
15623,Venus Boyz 2003 Re-release,18515,18515,0,2003_boxofficemojo_rankings.csv,2003,1.0,0.0
15624,Desolation,18490,18490,0,2018_boxofficemojo_rankings.csv,2018,1.0,0.0
15625,All the Rage,18489,18489,0,2017_boxofficemojo_rankings.csv,2017,1.0,0.0
15626,Between Love & Goodbye,18480,18480,0,2009_boxofficemojo_rankings.csv,2009,1.0,0.0
15627,Ski School,18476,18476,0,1991_boxofficemojo_rankings.csv,1991,1.0,0.0
15628,The Ghoul,18459,2032,16427,2017_boxofficemojo_rankings.csv,2017,0.11008180291456741,0.8899181970854326
15629,One to Another,18435,18435,0,2007_boxofficemojo_rankings.csv,2007,1.0,0.0
15630,306 Hollywood,18399,18399,0,2018_boxofficemojo_rankings.csv,2018,1.0,0.0
15631,The Reception,18389,18389,0,2005_boxofficemojo_rankings.csv,2005,1.0,0.0
15632,Deadfall,18369,18369,0,1993_boxofficemojo_rankings.csv,1993,1.0,0.0
15633,Oka!,18364,18364,0,2011_boxofficemojo_rankings.csv,2011,1.0,0.0
15634,"Phoenix, Oregon",18356,18356,0,2019_boxofficemojo_rankings.csv,2019,1.0,0.0
15635,"Intent to Destroy: Death, Denial & Depiction 2017 Re-release",18340,18340,0,2017_boxofficemojo_rankings.csv,2017,1.0,0.0
15636,"Live Fast, Die Young",18335,18335,0,2008_boxofficemojo_rankings.csv,2008,1.0,0.0
15637,Dear Zachary: A Letter to a Son About His Father,18334,18334,0,2008_boxofficemojo_rankings.csv,2008,1.0,0.0
15638,The Channel,18319,18319,0,2016_boxofficemojo_rankings.csv,2016,1.0,0.0
15639,The Life: What's Your Pleasure?,18297,5130,13167,2004_boxofficemojo_rankings.csv,2004,0.2803738317757009,0.719626168224299
15640,Four Bags Full,18297,18297,0,2013_boxofficemojo_rankings.csv,2013,1.0,0.0
15641,SHOT! The Psycho-Spiritual Mantra of Rock,18295,15157,3138,2017_boxofficemojo_rankings.csv,2017,0.8284777261546871,0.17152227384531293
15642,Talk of Angels,18281,18281,0,1998_boxofficemojo_rankings.csv,1998,1.0,0.0
15643,Hell House,18279,18279,0,2002_boxofficemojo_rankings.csv,2002,1.0,0.0
15644,Off and Running,18262,18262,0,2010_boxofficemojo_rankings.csv,2010,1.0,0.0
15645,Suicide Killers,18239,18239,0,2006_boxofficemojo_rankings.csv,2006,1.0,0.0
15646,Tosca's Kiss,18236,18236,0,2014_boxofficemojo_rankings.csv,2014,1.0,0.0
15647,Torn,18202,18202,0,2013_boxofficemojo_rankings.csv,2013,1.0,0.0
15648,Marcelino Pan y Vino 2012 Re-release,18193,18193,0,2012_boxofficemojo_rankings.csv,2012,1.0,0.0
15649,Who is Dayani Cristal?,18190,18190,0,2014_boxofficemojo_rankings.csv,2014,1.0,0.0
15650,The Lion in Winter 2016 Re-release,18177,18177,0,2016_boxofficemojo_rankings.csv,2016,1.0,0.0
15651,Restless,18154,18154,0,2000_boxofficemojo_rankings.csv,2000,1.0,0.0
15652,Coming Through the Rye,18137,18137,0,2016_boxofficemojo_rankings.csv,2016,1.0,0.0
15653,King of Hearts,18130,17646,484,2018_boxofficemojo_rankings.csv,2018,0.973303916161059,0.02669608383894098
15654,Peter and the Farm,18123,18123,0,2016_boxofficemojo_rankings.csv,2016,1.0,0.0
15655,Somebody to Love,18112,18112,0,1996_boxofficemojo_rankings.csv,1996,1.0,0.0
15656,Harry Benson: Shoot First,18092,18092,0,2016_boxofficemojo_rankings.csv,2016,1.0,0.0
15657,A Bit of Bad Luck,18089,18089,0,2016_boxofficemojo_rankings.csv,2016,1.0,0.0
15658,Total Recall 2012 Re-release,18081,18081,0,2012_boxofficemojo_rankings.csv,2012,1.0,0.0
15659,Scarlet Diva,18062,18062,0,2002_boxofficemojo_rankings.csv,2002,1.0,0.0
15660,Holy Hell,18051,18051,0,2016_boxofficemojo_rankings.csv,2016,1.0,0.0
15661,On Tour with Pina Bausch,18016,18016,0,2014_boxofficemojo_rankings.csv,2014,1.0,0.0
15662,The Leading Man,18012,18012,0,1998_boxofficemojo_rankings.csv,1998,1.0,0.0
15663,I Knew Her Well,18010,18010,0,2016_boxofficemojo_rankings.csv,2016,1.0,0.0
15664,Men Go to Battle,18006,18006,0,2016_boxofficemojo_rankings.csv,2016,1.0,0.0
15665,Battle for Brooklyn,18000,18000,0,2011_boxofficemojo_rankings.csv,2011,1.0,0.0
15666,Women in Trouble,18000,18000,0,2009_boxofficemojo_rankings.csv,2009,1.0,0.0
15667,Dare,18000,18000,0,2009_boxofficemojo_rankings.csv,2009,1.0,0.0
15668,Girlfriends,18000,18000,0,1996_boxofficemojo_rankings.csv,1996,1.0,0.0
15669,Jamel Shabazz Street Photographer,17992,17992,0,2013_boxofficemojo_rankings.csv,2013,1.0,0.0
15670,Cruel World,17986,17986,0,2006_boxofficemojo_rankings.csv,2006,1.0,0.0
15671,Payback,17979,17979,0,2012_boxofficemojo_rankings.csv,2012,1.0,0.0
15672,Cook County,17977,17977,0,2011_boxofficemojo_rankings.csv,2011,1.0,0.0
15673,The King Is Alive,17929,17929,0,2001_boxofficemojo_rankings.csv,2001,1.0,0.0
15674,The Cranes Are Flying,17923,17923,0,2019_boxofficemojo_rankings.csv,2019,1.0,0.0
15675,Great Directors,17921,17921,0,2010_boxofficemojo_rankings.csv,2010,1.0,0.0
15676,Dealin' with Idiots,17909,17909,0,2013_boxofficemojo_rankings.csv,2013,1.0,0.0
15677,The Missing Person,17896,17896,0,2009_boxofficemojo_rankings.csv,2009,1.0,0.0
15678,Li'l Quinquin,17868,7192,10676,2015_boxofficemojo_rankings.csv,2015,0.4025072755764495,0.5974927244235505
15679,The Thorn in the Heart,17849,7376,10473,2010_boxofficemojo_rankings.csv,2010,0.41324443946439576,0.5867555605356042
15680,The Last Shaman,17844,17844,0,2017_boxofficemojo_rankings.csv,2017,1.0,0.0
15681,Made in Hong Kong,17843,17843,0,2020_boxofficemojo_rankings.csv,2020,1.0,0.0
15682,David,17828,0,17828,2013_boxofficemojo_rankings.csv,2013,0.0,1.0
15683,Batman: Mask of the Phantasm 2018 Re-release,17813,17813,0,2018_boxofficemojo_rankings.csv,2018,1.0,0.0
15684,Purple Butterfly,17790,17790,0,2004_boxofficemojo_rankings.csv,2004,1.0,0.0
15685,Spookies,17785,17785,0,1987_boxofficemojo_rankings.csv,1987,1.0,0.0
15686,Escapes,17778,17778,0,2017_boxofficemojo_rankings.csv,2017,1.0,0.0
15687,Dear Jesse,17744,17744,0,1998_boxofficemojo_rankings.csv,1998,1.0,0.0
15688,Sacred,17740,17740,0,2017_boxofficemojo_rankings.csv,2017,1.0,0.0
15689,Little Birds,17739,17739,0,2012_boxofficemojo_rankings.csv,2012,1.0,0.0
15690,The Other One,17727,17727,0,2015_boxofficemojo_rankings.csv,2015,1.0,0.0
15691,Kelly & Cal,17702,17702,0,2014_boxofficemojo_rankings.csv,2014,1.0,0.0
15692,Bad Grandmas,17688,17688,0,2017_boxofficemojo_rankings.csv,2017,1.0,0.0
15693,"Comrades, Almost a Love Story",17676,17676,0,1998_boxofficemojo_rankings.csv,1998,1.0,0.0
15694,Molly,17650,17650,0,1999_boxofficemojo_rankings.csv,1999,1.0,0.0
15695,The History of Future Folk,17646,17646,0,2013_boxofficemojo_rankings.csv,2013,1.0,0.0
15696,Night at the Golden Eagle,17643,17643,0,2002_boxofficemojo_rankings.csv,2002,1.0,0.0
15697,20 Centimeters 2006 Re-release,17632,6635,10997,2006_boxofficemojo_rankings.csv,2006,0.37630444646098005,0.62369555353902
15698,The New Twenty,17625,17625,0,2009_boxofficemojo_rankings.csv,2009,1.0,0.0
15699,How He Fell in Love,17575,17575,0,2016_boxofficemojo_rankings.csv,2016,1.0,0.0
15700,"Milwaukee, Minnesota",17528,17528,0,2005_boxofficemojo_rankings.csv,2005,1.0,0.0
15701,The Chronicle of Anna Magdalena Bach,17527,17527,0,2018_boxofficemojo_rankings.csv,2018,1.0,0.0
15702,Sunset Story,17508,17508,0,2005_boxofficemojo_rankings.csv,2005,1.0,0.0
15703,Streit's: Matzo and the American Dream,17506,17506,0,2016_boxofficemojo_rankings.csv,2016,1.0,0.0
15704,Butterfly Girl,17503,17503,0,2015_boxofficemojo_rankings.csv,2015,1.0,0.0
15705,Chained for Life,17431,17431,0,2019_boxofficemojo_rankings.csv,2019,1.0,0.0
15706,Adventures of Power,17419,17419,0,2009_boxofficemojo_rankings.csv,2009,1.0,0.0
15707,Pandora and the Flying Dutchman 2020 Re-release,17401,17401,0,2020_boxofficemojo_rankings.csv,2020,1.0,0.0
15708,A Skin Too Few: The Days of Nick Drake,17384,17384,0,2002_boxofficemojo_rankings.csv,2002,1.0,0.0
15709,The Mighty Peking Man,17368,17368,0,1999_boxofficemojo_rankings.csv,1999,1.0,0.0
15710,Transfixed,17361,17361,0,2004_boxofficemojo_rankings.csv,2004,1.0,0.0
15711,The Law,17351,17351,0,2010_boxofficemojo_rankings.csv,2010,1.0,0.0
15712,Film Geek,17341,17341,0,2006_boxofficemojo_rankings.csv,2006,1.0,0.0
15713,"A Bread Factory, Part One/A Bread Factory, Part Two",17325,17325,0,2018_boxofficemojo_rankings.csv,2018,1.0,0.0
15714,Defamation,17309,12038,5271,2009_boxofficemojo_rankings.csv,2009,0.6954763417875094,0.3045236582124906
15715,Littlerock,17309,17309,0,2011_boxofficemojo_rankings.csv,2011,1.0,0.0
15716,The Homestretch,17306,17306,0,2014_boxofficemojo_rankings.csv,2014,1.0,0.0
15717,Ever Again,17304,17304,0,2006_boxofficemojo_rankings.csv,2006,1.0,0.0
15718,Archie's Final Project,17282,17282,0,2011_boxofficemojo_rankings.csv,2011,1.0,0.0
15719,Stand Clear of the Closing Doors,17282,17282,0,2014_boxofficemojo_rankings.csv,2014,1.0,0.0
15720,The Great Water,17257,17257,0,2005_boxofficemojo_rankings.csv,2005,1.0,0.0
15721,Revival,17252,17252,0,2018_boxofficemojo_rankings.csv,2018,1.0,0.0
15722,Speedway Junky,17246,17246,0,2001_boxofficemojo_rankings.csv,2001,1.0,0.0
15723,A Real Young Girl,17245,17245,0,2001_boxofficemojo_rankings.csv,2001,1.0,0.0
15724,Baby Blues,17234,17234,0,2008_boxofficemojo_rankings.csv,2008,1.0,0.0
15725,Landfill Harmonic,17205,17205,0,2016_boxofficemojo_rankings.csv,2016,1.0,0.0
15726,My Brother's Wedding,17197,8217,8980,2007_boxofficemojo_rankings.csv,2007,0.47781589812176545,0.5221841018782346
15727,Home,17182,9478,7704,2009_boxofficemojo_rankings.csv,2009,0.5516237923408218,0.4483762076591782
15728,Food Evolution,17181,17181,0,2017_boxofficemojo_rankings.csv,2017,1.0,0.0
15729,2by4,17162,17162,0,1999_boxofficemojo_rankings.csv,1999,1.0,0.0
15730,Accident 2014 Re-release,17161,17161,0,2014_boxofficemojo_rankings.csv,2014,1.0,0.0
15731,Pandaemonium,17113,5151,11962,2001_boxofficemojo_rankings.csv,2001,0.30099924034359843,0.6990007596564015
15732,Le Pont du Nord,17110,17110,0,2013_boxofficemojo_rankings.csv,2013,1.0,0.0
15733,Always Shine,17102,17102,0,2016_boxofficemojo_rankings.csv,2016,1.0,0.0
15734,On the Map,17099,17099,0,2016_boxofficemojo_rankings.csv,2016,1.0,0.0
15735,Grandmaster,17077,17077,0,2012_boxofficemojo_rankings.csv,2012,1.0,0.0
15736,The Reflecting Skin,17042,17042,0,1991_boxofficemojo_rankings.csv,1991,1.0,0.0
15737,The Understudy,17036,17036,0,2012_boxofficemojo_rankings.csv,2012,1.0,0.0
15738,Goodbye to All That,16986,16986,0,2014_boxofficemojo_rankings.csv,2014,1.0,0.0
15739,The Prophet's Son,16983,16983,0,2012_boxofficemojo_rankings.csv,2012,1.0,0.0
15740,Joseph Pulitzer: Voice of the People,16970,16970,0,2019_boxofficemojo_rankings.csv,2019,1.0,0.0
15741,Advocate,16942,16942,0,2020_boxofficemojo_rankings.csv,2020,1.0,0.0
15742,Noise,16934,16513,421,2008_boxofficemojo_rankings.csv,2008,0.9751387740640133,0.02486122593598677
15743,Eban and Charley,16918,16918,0,2001_boxofficemojo_rankings.csv,2001,1.0,0.0
15744,Carbon Nation,16901,16901,0,2010_boxofficemojo_rankings.csv,2010,1.0,0.0
15745,Return,16886,16124,762,2012_boxofficemojo_rankings.csv,2012,0.9548738600023688,0.045126139997631175
15746,April Showers,16880,16880,0,2009_boxofficemojo_rankings.csv,2009,1.0,0.0
15747,Hank and Asha,16878,16878,0,2014_boxofficemojo_rankings.csv,2014,1.0,0.0
15748,Dark Streets,16815,16815,0,2008_boxofficemojo_rankings.csv,2008,1.0,0.0
15749,Holding Trevor,16814,16814,0,2008_boxofficemojo_rankings.csv,2008,1.0,0.0
15750,Hidden in Plain Sight,16803,16803,0,2003_boxofficemojo_rankings.csv,2003,1.0,0.0
15751,Seven Days,16791,16791,0,2007_boxofficemojo_rankings.csv,2007,1.0,0.0
15752,Smooth Talk,16785,16785,0,1985_boxofficemojo_rankings.csv,1985,1.0,0.0
15753,Swim Team,16783,16783,0,2017_boxofficemojo_rankings.csv,2017,1.0,0.0
15754,Cuban Rafters 2003 Re-release,16783,16783,0,2003_boxofficemojo_rankings.csv,2003,1.0,0.0
15755,Night Across the Street,16778,16778,0,2013_boxofficemojo_rankings.csv,2013,1.0,0.0
15756,Eva 2015 Re-release,16738,16738,0,2015_boxofficemojo_rankings.csv,2015,1.0,0.0
15757,Inventing Our Life: The Kibbutz Experiment,16734,16734,0,2012_boxofficemojo_rankings.csv,2012,1.0,0.0
15758,Medea,16714,16714,0,2003_boxofficemojo_rankings.csv,2003,1.0,0.0
15759,This Changes Everything,16692,16692,0,2015_boxofficemojo_rankings.csv,2015,1.0,0.0
15760,Fascination,16670,16670,0,2005_boxofficemojo_rankings.csv,2005,1.0,0.0
15761,Day Zero,16659,16659,0,2008_boxofficemojo_rankings.csv,2008,1.0,0.0
15762,The World of Kanako 2015 Re-release,16627,16627,0,2015_boxofficemojo_rankings.csv,2015,1.0,0.0
15763,The Freebie,16613,16613,0,2010_boxofficemojo_rankings.csv,2010,1.0,0.0
15764,The Freedom to Marry,16611,16611,0,2017_boxofficemojo_rankings.csv,2017,1.0,0.0
15765,Who Took Johnny,16595,16595,0,2015_boxofficemojo_rankings.csv,2015,1.0,0.0
15766,Haikara-San: Here Comes Miss Modern,16572,16572,0,2018_boxofficemojo_rankings.csv,2018,1.0,0.0
15767,American Cannibal,16566,16566,0,2007_boxofficemojo_rankings.csv,2007,1.0,0.0
15768,Life in a Walk,16557,16557,0,2015_boxofficemojo_rankings.csv,2015,1.0,0.0
15769,Brave New Jersey,16544,16544,0,2017_boxofficemojo_rankings.csv,2017,1.0,0.0
15770,33 & Beyond: The Royal Art of Freemasonry,16533,16533,0,2017_boxofficemojo_rankings.csv,2017,1.0,0.0
15771,A Fine Romance,16497,16497,0,1992_boxofficemojo_rankings.csv,1992,1.0,0.0
15772,Bright Future,16483,5166,11317,2004_boxofficemojo_rankings.csv,2004,0.3134138202997027,0.6865861797002972
15773,The Last Mogul,16469,16469,0,2005_boxofficemojo_rankings.csv,2005,1.0,0.0
15774,Ethan Mao,16444,10178,6266,2005_boxofficemojo_rankings.csv,2005,0.6189491607881294,0.3810508392118706
15775,Mission Control: The Unsung Heroes of Apollo,16405,16405,0,2017_boxofficemojo_rankings.csv,2017,1.0,0.0
15776,Magician: The Astonishing Life and Work of Orson Welles,16400,16400,0,2014_boxofficemojo_rankings.csv,2014,1.0,0.0
15777,Dying to Know: Ram Dass & Timothy Leary,16397,16397,0,2017_boxofficemojo_rankings.csv,2017,1.0,0.0
15778,Splinterheads,16392,16392,0,2009_boxofficemojo_rankings.csv,2009,1.0,0.0
15779,Design Is One: The Vignellis,16386,16386,0,2013_boxofficemojo_rankings.csv,2013,1.0,0.0
15780,April's Shower,16377,16377,0,2006_boxofficemojo_rankings.csv,2006,1.0,0.0
15781,Breathing Room,16299,16299,0,1996_boxofficemojo_rankings.csv,1996,1.0,0.0
15782,The Intended,16290,8106,8184,2003_boxofficemojo_rankings.csv,2003,0.4976058931860037,0.5023941068139963
15783,Pray: The Story of Patrick Peyton,16270,16270,0,2020_boxofficemojo_rankings.csv,2020,1.0,0.0
15784,Faster,16265,16265,0,2004_boxofficemojo_rankings.csv,2004,1.0,0.0
15785,Centigrade,16263,16263,0,2020_boxofficemojo_rankings.csv,2020,1.0,0.0
15786,Captive,16259,16259,0,2006_boxofficemojo_rankings.csv,2006,1.0,0.0
15787,Onmyoji: The Yin Yang Master,16234,16234,0,2003_boxofficemojo_rankings.csv,2003,1.0,0.0
15788,I Melt with You,16232,6361,9871,2011_boxofficemojo_rankings.csv,2011,0.3918802365697388,0.6081197634302612
15789,I Like Killing Flies,16214,16214,0,2006_boxofficemojo_rankings.csv,2006,1.0,0.0
15790,Perfect Opposites,16201,16201,0,2004_boxofficemojo_rankings.csv,2004,1.0,0.0
15791,Coldblooded,16198,16198,0,1995_boxofficemojo_rankings.csv,1995,1.0,0.0
15792,The Human Centipede III (Final Sequence),16184,16184,0,2015_boxofficemojo_rankings.csv,2015,1.0,0.0
15793,This is Our Land,16182,11567,4615,2017_boxofficemojo_rankings.csv,2017,0.7148065752070202,0.2851934247929799
15794,Detour,16172,16172,0,2018_boxofficemojo_rankings.csv,2018,1.0,0.0
15795,All the Queen's Horses,16172,16172,0,2017_boxofficemojo_rankings.csv,2017,1.0,0.0
15796,Look,16136,16136,0,2007_boxofficemojo_rankings.csv,2007,1.0,0.0
15797,Matthew Barney: No Restraint,16136,16136,0,2006_boxofficemojo_rankings.csv,2006,1.0,0.0
15798,When Father Was Away on Business,16131,16131,0,1985_boxofficemojo_rankings.csv,1985,1.0,0.0
15799,Virginia Minnesota,16118,16118,0,2019_boxofficemojo_rankings.csv,2019,1.0,0.0
15800,Tennessee,16100,16100,0,2009_boxofficemojo_rankings.csv,2009,1.0,0.0
15801,Levitated Mass,16086,16086,0,2014_boxofficemojo_rankings.csv,2014,1.0,0.0
15802,Who's That Knocking at My Door,16085,0,16085,2009_boxofficemojo_rankings.csv,2009,0.0,1.0
15803,Straight Up,16080,16080,0,2020_boxofficemojo_rankings.csv,2020,1.0,0.0
15804,1920 London,16077,0,16077,2016_boxofficemojo_rankings.csv,2016,0.0,1.0
15805,Out of the Clear Blue Sky,16050,16050,0,2013_boxofficemojo_rankings.csv,2013,1.0,0.0
15806,Night of Henna,16027,16027,0,2005_boxofficemojo_rankings.csv,2005,1.0,0.0
15807,Long Shot: The Kevin Laue Story,16011,16011,0,2012_boxofficemojo_rankings.csv,2012,1.0,0.0
15808,Planet of Snail,16002,13957,2045,2012_boxofficemojo_rankings.csv,2012,0.8722034745656793,0.1277965254343207
15809,Supercapitalist,16000,16000,0,2012_boxofficemojo_rankings.csv,2012,1.0,0.0
15810,Wattstax,16000,16000,0,2003_boxofficemojo_rankings.csv,2003,1.0,0.0
15811,Vulgar,15927,15927,0,2002_boxofficemojo_rankings.csv,2002,1.0,0.0
15812,Charged: The Eduardo Garcia Story,15920,15920,0,2017_boxofficemojo_rankings.csv,2017,1.0,0.0
15813,Can You Dig This,15909,15909,0,2015_boxofficemojo_rankings.csv,2015,1.0,0.0
15814,Bobby G. Can't Swim,15900,15900,0,2002_boxofficemojo_rankings.csv,2002,1.0,0.0
15815,The Bay of Silence,15889,1941,13948,2020_boxofficemojo_rankings.csv,2020,0.12215998489521052,0.8778400151047895
15816,This Binary Universe,15875,15875,0,2012_boxofficemojo_rankings.csv,2012,1.0,0.0
15817,Starfish,15849,15849,0,2019_boxofficemojo_rankings.csv,2019,1.0,0.0
15818,Ten Benny,15843,15843,0,1998_boxofficemojo_rankings.csv,1998,1.0,0.0
15819,A Reason,15792,15792,0,2015_boxofficemojo_rankings.csv,2015,1.0,0.0
15820,Defining Hope,15788,15788,0,2017_boxofficemojo_rankings.csv,2017,1.0,0.0
15821,Take Me Home,15760,15760,0,2012_boxofficemojo_rankings.csv,2012,1.0,0.0
15822,Full Moon in Paris,15726,15726,0,2015_boxofficemojo_rankings.csv,2015,1.0,0.0
15823,Trinity Seven The Movie 2: Heavens Library & Crimson Lord,15712,15712,0,2019_boxofficemojo_rankings.csv,2019,1.0,0.0
15824,Jumpin' at the Boneyard,15706,15706,0,1992_boxofficemojo_rankings.csv,1992,1.0,0.0
15825,People Say I'm Crazy,15679,15679,0,2004_boxofficemojo_rankings.csv,2004,1.0,0.0
15826,Rubin and Ed,15675,15675,0,1992_boxofficemojo_rankings.csv,1992,1.0,0.0
15827,Esmeralda Comes by Night,15671,15671,0,1998_boxofficemojo_rankings.csv,1998,1.0,0.0
15828,A Letter to True,15635,15635,0,2004_boxofficemojo_rankings.csv,2004,1.0,0.0
15829,7th Street,15629,15629,0,2003_boxofficemojo_rankings.csv,2003,1.0,0.0
15830,Breakdance Academy,15628,15628,0,2010_boxofficemojo_rankings.csv,2010,1.0,0.0
15831,Dreams Rewired,15626,11843,3783,2015_boxofficemojo_rankings.csv,2015,0.7579034941763727,0.2420965058236273
15832,Out on Stage,15623,15623,0,2018_boxofficemojo_rankings.csv,2018,1.0,0.0
15833,The Competition 2019 Re-release,15622,15622,0,2019_boxofficemojo_rankings.csv,2019,1.0,0.0
15834,Red,15617,4643,10974,2008_boxofficemojo_rankings.csv,2008,0.2973042197605174,0.7026957802394826
15835,Eden,15611,15611,0,2008_boxofficemojo_rankings.csv,2008,1.0,0.0
15836,Quiet City,15610,15610,0,2007_boxofficemojo_rankings.csv,2007,1.0,0.0
15837,Basmati Blues,15605,0,15605,2017_boxofficemojo_rankings.csv,2017,0.0,1.0
15838,Five Nights in Maine,15587,15587,0,2016_boxofficemojo_rankings.csv,2016,1.0,0.0
15839,Bob le Flambeur,15586,15586,0,2018_boxofficemojo_rankings.csv,2018,1.0,0.0
15840,When You Read This Letter,15552,15552,0,2018_boxofficemojo_rankings.csv,2018,1.0,0.0
15841,Postcards from London,15548,5312,10236,2018_boxofficemojo_rankings.csv,2018,0.3416516593774119,0.6583483406225881
15842,Stuffed,15532,15532,0,2019_boxofficemojo_rankings.csv,2019,1.0,0.0
15843,Six in Paris,15532,15532,0,2008_boxofficemojo_rankings.csv,2008,1.0,0.0
15844,Bomb the System,15520,15520,0,2005_boxofficemojo_rankings.csv,2005,1.0,0.0
15845,Save the Green Planet!,15516,15516,0,2005_boxofficemojo_rankings.csv,2005,1.0,0.0
15846,Last Dance,15515,15515,0,2002_boxofficemojo_rankings.csv,2002,1.0,0.0
15847,Dreamkiller,15514,15514,0,2010_boxofficemojo_rankings.csv,2010,1.0,0.0
15848,Blood Red,15510,15510,0,1989_boxofficemojo_rankings.csv,1989,1.0,0.0
15849,One Bright Shining Moment,15504,15504,0,2005_boxofficemojo_rankings.csv,2005,1.0,0.0
15850,Spanish Fly,15503,15503,0,1999_boxofficemojo_rankings.csv,1999,1.0,0.0
15851,Tom of Finland 2018 Re-release,15483,3314,12169,2018_boxofficemojo_rankings.csv,2018,0.21404120648453143,0.7859587935154686
15852,Our Father,15476,3290,12186,2003_boxofficemojo_rankings.csv,2003,0.21258723184285344,0.7874127681571466
15853,They Will Have to Kill Us First: Malian Music In Exile,15453,7516,7937,2015_boxofficemojo_rankings.csv,2015,0.48637804956966285,0.5136219504303372
15854,California Solo,15433,15433,0,2012_boxofficemojo_rankings.csv,2012,1.0,0.0
15855,Pipe Dream,15430,15430,0,2002_boxofficemojo_rankings.csv,2002,1.0,0.0
15856,Formula 17 2005 Re-release,15427,15427,0,2005_boxofficemojo_rankings.csv,2005,1.0,0.0
15857,Be Somebody,15395,15395,0,2016_boxofficemojo_rankings.csv,2016,1.0,0.0
15858,Keeper of the Flame,15392,0,15392,2002_boxofficemojo_rankings.csv,2002,0.0,1.0
15859,The Beautiful Truth,15387,15387,0,2008_boxofficemojo_rankings.csv,2008,1.0,0.0
15860,Between the Lines,15383,15383,0,2019_boxofficemojo_rankings.csv,2019,1.0,0.0
15861,Dumbstruck,15379,15379,0,2011_boxofficemojo_rankings.csv,2011,1.0,0.0
15862,The Adderall Diaries,15364,13191,2173,2016_boxofficemojo_rankings.csv,2016,0.8585654777401718,0.14143452225982817
15863,Wild Side,15355,15355,0,2005_boxofficemojo_rankings.csv,2005,1.0,0.0
15864,No Regret 2008 Re-release,15347,15347,0,2008_boxofficemojo_rankings.csv,2008,1.0,0.0
15865,The President,15338,7578,7760,2016_boxofficemojo_rankings.csv,2016,0.4940670230799322,0.5059329769200678
15866,Narcissister Organ Player,15334,15334,0,2018_boxofficemojo_rankings.csv,2018,1.0,0.0
15867,Full Tilt Boogie,15313,15313,0,1998_boxofficemojo_rankings.csv,1998,1.0,0.0
15868,Only the Young,15312,15312,0,2012_boxofficemojo_rankings.csv,2012,1.0,0.0
15869,Contemporary Color,15305,15305,0,2017_boxofficemojo_rankings.csv,2017,1.0,0.0
15870,The Hawk Is Dying,15285,7006,8279,2007_boxofficemojo_rankings.csv,2007,0.4583578671900556,0.5416421328099444
15871,American Deep State,15269,15269,0,2020_boxofficemojo_rankings.csv,2020,1.0,0.0
15872,Starcrossed,15263,15263,0,2016_boxofficemojo_rankings.csv,2016,1.0,0.0
15873,Harry + Max,15247,15247,0,2005_boxofficemojo_rankings.csv,2005,1.0,0.0
15874,"Arabian Nights - Volume 2, The Desolate One",15245,6398,8847,2015_boxofficemojo_rankings.csv,2015,0.4196785831420138,0.5803214168579862
15875,People's Republic of Desire,15241,15241,0,2018_boxofficemojo_rankings.csv,2018,1.0,0.0
15876,Descent,15233,15233,0,2007_boxofficemojo_rankings.csv,2007,1.0,0.0
15877,The Samaritan,15220,2521,12699,2012_boxofficemojo_rankings.csv,2012,0.16563731931668857,0.8343626806833114
15878,Off the Lip,15217,15217,0,2004_boxofficemojo_rankings.csv,2004,1.0,0.0
15879,Cthulhu,15213,15213,0,2008_boxofficemojo_rankings.csv,2008,1.0,0.0
15880,The Apple,15207,15207,0,1999_boxofficemojo_rankings.csv,1999,1.0,0.0
15881,All Hat,15198,15198,0,2008_boxofficemojo_rankings.csv,2008,1.0,0.0
15882,Land of the Blind,15180,5244,9936,2006_boxofficemojo_rankings.csv,2006,0.34545454545454546,0.6545454545454545
15883,Funan,15152,15152,0,2019_boxofficemojo_rankings.csv,2019,1.0,0.0
15884,Chelsea on the Rocks,15148,11799,3349,2009_boxofficemojo_rankings.csv,2009,0.7789147082123052,0.22108529178769473
15885,Glory Daze,15134,15134,0,1996_boxofficemojo_rankings.csv,1996,1.0,0.0
15886,The Olivia Experiment,15122,15122,0,2014_boxofficemojo_rankings.csv,2014,1.0,0.0
15887,Nora,15120,15120,0,2001_boxofficemojo_rankings.csv,2001,1.0,0.0
15888,Kung Fu Joe,15120,15120,0,2012_boxofficemojo_rankings.csv,2012,1.0,0.0
15889,El inmigrante,15100,15100,0,2007_boxofficemojo_rankings.csv,2007,1.0,0.0
15890,Trade of Innocents,15091,15091,0,2012_boxofficemojo_rankings.csv,2012,1.0,0.0
15891,Rebels on Pointe,15088,15088,0,2017_boxofficemojo_rankings.csv,2017,1.0,0.0
15892,Drive,15084,15084,0,1992_boxofficemojo_rankings.csv,1992,1.0,0.0
15893,Khachaturian,15084,15084,0,2003_boxofficemojo_rankings.csv,2003,1.0,0.0
15894,The Education of Charlie Banks,15078,15078,0,2009_boxofficemojo_rankings.csv,2009,1.0,0.0
15895,Cheatin',15077,15077,0,2015_boxofficemojo_rankings.csv,2015,1.0,0.0
15896,Barefoot,15071,15071,0,2014_boxofficemojo_rankings.csv,2014,1.0,0.0
15897,"Blood, Guts, Bullets and Octane",15035,15035,0,1999_boxofficemojo_rankings.csv,1999,1.0,0.0
15898,Caught in the Web,15033,1067,13966,2012_boxofficemojo_rankings.csv,2012,0.07097718352956828,0.9290228164704317
15899,I'm Not Jesus Mommy,15005,15005,0,2011_boxofficemojo_rankings.csv,2011,1.0,0.0
15900,The Tenant,15003,15003,0,2011_boxofficemojo_rankings.csv,2011,1.0,0.0
15901,Hannari: Geisha Modern,14974,14974,0,2006_boxofficemojo_rankings.csv,2006,1.0,0.0
15902,Wrinkles the Clown,14938,14938,0,2019_boxofficemojo_rankings.csv,2019,1.0,0.0
15903,I Declare War,14928,14928,0,2013_boxofficemojo_rankings.csv,2013,1.0,0.0
15904,Dry Cleaning,14919,14919,0,1999_boxofficemojo_rankings.csv,1999,1.0,0.0
15905,La Maison de la radio,14905,8095,6810,2013_boxofficemojo_rankings.csv,2013,0.5431063401543106,0.45689365984568936
15906,Trust Machine: The Story of Blockchain,14905,14905,0,2018_boxofficemojo_rankings.csv,2018,1.0,0.0
15907,ZZ Top: That Little Ol' Band from Texas,14879,14879,0,2019_boxofficemojo_rankings.csv,2019,1.0,0.0
15908,A Tale of Two Pizzas,14831,14831,0,2005_boxofficemojo_rankings.csv,2005,1.0,0.0
15909,Reeseville,14824,14824,0,2004_boxofficemojo_rankings.csv,2004,1.0,0.0
15910,Horses of God 2014 Re-release,14817,14817,0,2014_boxofficemojo_rankings.csv,2014,1.0,0.0
15911,Vince Giordano: There's a Future in the Past,14807,14807,0,2017_boxofficemojo_rankings.csv,2017,1.0,0.0
15912,Shem,14804,14804,0,2006_boxofficemojo_rankings.csv,2006,1.0,0.0
15913,The Break,14760,14760,0,1998_boxofficemojo_rankings.csv,1998,1.0,0.0
15914,Kiss of the Damned,14752,14752,0,2013_boxofficemojo_rankings.csv,2013,1.0,0.0
15915,The Prey 2012 Re-release,14738,13959,779,2012_boxofficemojo_rankings.csv,2012,0.9471434387298141,0.05285656127018591
15916,Two Ninas,14725,14725,0,2001_boxofficemojo_rankings.csv,2001,1.0,0.0
15917,Sweet Virginia,14725,11753,2972,2017_boxofficemojo_rankings.csv,2017,0.7981663837011884,0.20183361629881155
15918,Gloria,14701,14701,0,2015_boxofficemojo_rankings.csv,2015,1.0,0.0
15919,30 Beats,14693,14693,0,2012_boxofficemojo_rankings.csv,2012,1.0,0.0
15920,Circus,14693,14693,0,2000_boxofficemojo_rankings.csv,2000,1.0,0.0
15921,La Cucaracha,14692,14692,0,1999_boxofficemojo_rankings.csv,1999,1.0,0.0
15922,Last Men in Aleppo,14637,14637,0,2017_boxofficemojo_rankings.csv,2017,1.0,0.0
15923,10 Days in a Madhouse,14616,14616,0,2015_boxofficemojo_rankings.csv,2015,1.0,0.0
15924,Unraveled,14615,14615,0,2012_boxofficemojo_rankings.csv,2012,1.0,0.0
15925,The Next Big Thing,14600,14600,0,2002_boxofficemojo_rankings.csv,2002,1.0,0.0
15926,Buzzard,14591,14591,0,2015_boxofficemojo_rankings.csv,2015,1.0,0.0
15927,Tristana,14586,14586,0,2012_boxofficemojo_rankings.csv,2012,1.0,0.0
15928,The Settlers,14556,14556,0,2002_boxofficemojo_rankings.csv,2002,1.0,0.0
15929,Hard Core Logo,14540,14540,0,1998_boxofficemojo_rankings.csv,1998,1.0,0.0
15930,Carmen Miranda: Bananas Is My Business,14528,14528,0,1995_boxofficemojo_rankings.csv,1995,1.0,0.0
15931,Ferrante Fever,14518,11137,3381,2018_boxofficemojo_rankings.csv,2018,0.7671166827386693,0.23288331726133077
15932,Oxen,14513,14513,0,1992_boxofficemojo_rankings.csv,1992,1.0,0.0
15933,Cruising 1995 Re-release,14495,14495,0,1995_boxofficemojo_rankings.csv,1995,1.0,0.0
15934,The Wanderers 2016 Re-release,14492,14492,0,2016_boxofficemojo_rankings.csv,2016,1.0,0.0
15935,Antarctica: Ice and Sky 2017 Re-release,14475,14475,0,2017_boxofficemojo_rankings.csv,2017,1.0,0.0
15936,Yuri Gagarin Conspiracy: Fallen Idol,14471,14471,0,2009_boxofficemojo_rankings.csv,2009,1.0,0.0
15937,The Public Image is Rotten,14464,11293,3171,2018_boxofficemojo_rankings.csv,2018,0.7807660398230089,0.21923396017699115
15938,The 24th Day,14460,14460,0,2004_boxofficemojo_rankings.csv,2004,1.0,0.0
15939,YPF,14459,9359,5100,2008_boxofficemojo_rankings.csv,2008,0.6472785116536414,0.3527214883463587
15940,The Two Escobars,14457,14457,0,2010_boxofficemojo_rankings.csv,2010,1.0,0.0
15941,My Son 2019 Re-release,14450,14450,0,2019_boxofficemojo_rankings.csv,2019,1.0,0.0
15942,The Last Movie Star,14410,14410,0,2018_boxofficemojo_rankings.csv,2018,1.0,0.0
15943,The Unbelievers,14400,14400,0,2013_boxofficemojo_rankings.csv,2013,1.0,0.0
15944,The Uncondemned,14393,14393,0,2016_boxofficemojo_rankings.csv,2016,1.0,0.0
15945,A Silent Love,14389,14389,0,2004_boxofficemojo_rankings.csv,2004,1.0,0.0
15946,The Journey of August King,14381,14381,0,1995_boxofficemojo_rankings.csv,1995,1.0,0.0
15947,Exhibition,14378,14344,34,2014_boxofficemojo_rankings.csv,2014,0.9976352761162888,0.0023647238837112253
15948,The Anarchist Cookbook,14369,14369,0,2003_boxofficemojo_rankings.csv,2003,1.0,0.0
15949,Justice Is Mind,14360,14360,0,2013_boxofficemojo_rankings.csv,2013,1.0,0.0
15950,Gone Doggy Gone,14354,14354,0,2015_boxofficemojo_rankings.csv,2015,1.0,0.0
15951,Peep World,14351,14351,0,2011_boxofficemojo_rankings.csv,2011,1.0,0.0
15952,Desert Bayou,14350,14350,0,2007_boxofficemojo_rankings.csv,2007,1.0,0.0
15953,Machines,14331,9710,4621,2017_boxofficemojo_rankings.csv,2017,0.6775521596538971,0.32244784034610285
15954,Savior,14328,14328,0,1998_boxofficemojo_rankings.csv,1998,1.0,0.0
15955,Whore 2,14320,14320,0,1994_boxofficemojo_rankings.csv,1994,1.0,0.0
15956,The Devil's Miner,14289,14289,0,2006_boxofficemojo_rankings.csv,2006,1.0,0.0
15957,A Modern Affair,14286,14286,0,1996_boxofficemojo_rankings.csv,1996,1.0,0.0
15958,It Always Rains on Sunday,14276,14276,0,2008_boxofficemojo_rankings.csv,2008,1.0,0.0
15959,Never Stand Still,14272,14272,0,2012_boxofficemojo_rankings.csv,2012,1.0,0.0
15960,Nobody,14271,14271,0,2009_boxofficemojo_rankings.csv,2009,1.0,0.0
15961,Military Intelligence and You!,14251,14251,0,2008_boxofficemojo_rankings.csv,2008,1.0,0.0
15962,Combat Obscura,14242,14242,0,2019_boxofficemojo_rankings.csv,2019,1.0,0.0
15963,Saheb Biwi Aur Gangster,14231,14231,0,2011_boxofficemojo_rankings.csv,2011,1.0,0.0
15964,Brother Nature,14218,14218,0,2016_boxofficemojo_rankings.csv,2016,1.0,0.0
15965,Crutch,14189,14189,0,2004_boxofficemojo_rankings.csv,2004,1.0,0.0
15966,A Perfect Man,14147,7117,7030,2013_boxofficemojo_rankings.csv,2013,0.5030748568601117,0.49692514313988834
15967,Carmen and Geoffrey,14130,14130,0,2009_boxofficemojo_rankings.csv,2009,1.0,0.0
15968,Newtown,14109,14109,0,2016_boxofficemojo_rankings.csv,2016,1.0,0.0
15969,We Won't Grow Old Together,14104,14104,0,2012_boxofficemojo_rankings.csv,2012,1.0,0.0
15970,"I Was at Home, But...",14078,14078,0,2020_boxofficemojo_rankings.csv,2020,1.0,0.0
15971,Shangri-La Suite,14073,14073,0,2016_boxofficemojo_rankings.csv,2016,1.0,0.0
15972,Gayby,14062,14062,0,2012_boxofficemojo_rankings.csv,2012,1.0,0.0
15973,Ripple Effect,14059,14059,0,2008_boxofficemojo_rankings.csv,2008,1.0,0.0
15974,6 Month Rule,14057,14057,0,2012_boxofficemojo_rankings.csv,2012,1.0,0.0
15975,Head Games,14056,14056,0,2012_boxofficemojo_rankings.csv,2012,1.0,0.0
15976,Ghetto Physics,14034,14034,0,2010_boxofficemojo_rankings.csv,2010,1.0,0.0
15977,Chasing the Blues,14030,14030,0,2018_boxofficemojo_rankings.csv,2018,1.0,0.0
15978,Love & Money,14009,14009,0,1982_boxofficemojo_rankings.csv,1982,1.0,0.0
15979,Il Futuro,14001,14001,0,2013_boxofficemojo_rankings.csv,2013,1.0,0.0
15980,I'm Losing You,13996,13996,0,1999_boxofficemojo_rankings.csv,1999,1.0,0.0
15981,Screwball,13967,13967,0,2019_boxofficemojo_rankings.csv,2019,1.0,0.0
15982,And Then Came Love,13944,13944,0,2007_boxofficemojo_rankings.csv,2007,1.0,0.0
15983,Up for Grabs,13931,13931,0,2005_boxofficemojo_rankings.csv,2005,1.0,0.0
15984,Yosemite,13931,13931,0,2016_boxofficemojo_rankings.csv,2016,1.0,0.0
15985,Weed the People,13926,13926,0,2018_boxofficemojo_rankings.csv,2018,1.0,0.0
15986,This Is Martin Bonner,13888,13888,0,2013_boxofficemojo_rankings.csv,2013,1.0,0.0
15987,Cut Sleeve Boys,13875,13875,0,2007_boxofficemojo_rankings.csv,2007,1.0,0.0
15988,Macbeth,13870,9613,4257,2007_boxofficemojo_rankings.csv,2007,0.6930785868781543,0.30692141312184573
15989,Falling Away,13869,13869,0,2012_boxofficemojo_rankings.csv,2012,1.0,0.0
15990,Genesis,13856,6784,7072,2019_boxofficemojo_rankings.csv,2019,0.4896073903002309,0.5103926096997691
15991,Protagonist,13850,13850,0,2007_boxofficemojo_rankings.csv,2007,1.0,0.0
15992,Blackfoot Trail,13848,13848,0,2015_boxofficemojo_rankings.csv,2015,1.0,0.0
15993,Live Free or Die,13836,13836,0,2007_boxofficemojo_rankings.csv,2007,1.0,0.0
15994,Sympathy for Delicious,13826,13826,0,2011_boxofficemojo_rankings.csv,2011,1.0,0.0
15995,Stavisky...,13793,13793,0,2018_boxofficemojo_rankings.csv,2018,1.0,0.0
15996,The Pretty One,13769,13769,0,2014_boxofficemojo_rankings.csv,2014,1.0,0.0
15997,A Space Program,13739,13739,0,2016_boxofficemojo_rankings.csv,2016,1.0,0.0
15998,The Architect,13737,13737,0,2006_boxofficemojo_rankings.csv,2006,1.0,0.0
15999,Dorfman in Love,13737,13737,0,2013_boxofficemojo_rankings.csv,2013,1.0,0.0
16000,Don McKay,13722,13722,0,2010_boxofficemojo_rankings.csv,2010,1.0,0.0
16001,Full Grown Men,13716,13716,0,2008_boxofficemojo_rankings.csv,2008,1.0,0.0
16002,Who the #$&% Is Jackson Pollock?,13710,13710,0,2006_boxofficemojo_rankings.csv,2006,1.0,0.0
16003,Time to Die,13707,13707,0,2017_boxofficemojo_rankings.csv,2017,1.0,0.0
16004,Love for Sale,13703,13703,0,2007_boxofficemojo_rankings.csv,2007,1.0,0.0
16005,Daisies,13692,13692,0,2012_boxofficemojo_rankings.csv,2012,1.0,0.0
16006,This One's for the Ladies,13688,13688,0,2019_boxofficemojo_rankings.csv,2019,1.0,0.0
16007,The Law in These Parts,13683,13683,0,2012_boxofficemojo_rankings.csv,2012,1.0,0.0
16008,Tikkun,13671,13671,0,2016_boxofficemojo_rankings.csv,2016,1.0,0.0
16009,Red Trees,13666,13666,0,2017_boxofficemojo_rankings.csv,2017,1.0,0.0
16010,Soft Fruit,13654,13654,0,2000_boxofficemojo_rankings.csv,2000,1.0,0.0
16011,Convicts,13623,13623,0,1991_boxofficemojo_rankings.csv,1991,1.0,0.0
16012,Fifi Howls from Happiness,13614,13614,0,2014_boxofficemojo_rankings.csv,2014,1.0,0.0
16013,When the Iron Bird Flies: Tibetan Buddhism Arrives in the West,13598,13598,0,2012_boxofficemojo_rankings.csv,2012,1.0,0.0
16014,Stray Dogs,13573,10433,3140,2014_boxofficemojo_rankings.csv,2014,0.7686583658734252,0.23134163412657482
16015,Eli,13547,13547,0,2015_boxofficemojo_rankings.csv,2015,1.0,0.0
16016,Dysfunctional Friends,13546,13546,0,2012_boxofficemojo_rankings.csv,2012,1.0,0.0
16017,Paper Man,13514,13514,0,2010_boxofficemojo_rankings.csv,2010,1.0,0.0
16018,Duane Hopwood,13510,13510,0,2005_boxofficemojo_rankings.csv,2005,1.0,0.0
16019,Handsome Harry,13500,13500,0,2010_boxofficemojo_rankings.csv,2010,1.0,0.0
16020,Shadowman,13498,13498,0,2017_boxofficemojo_rankings.csv,2017,1.0,0.0
16021,Written on the Wind,13495,0,13495,2008_boxofficemojo_rankings.csv,2008,0.0,1.0
16022,Looking for an Echo,13465,13465,0,2000_boxofficemojo_rankings.csv,2000,1.0,0.0
16023,Spices of Liberty,13463,13463,0,2016_boxofficemojo_rankings.csv,2016,1.0,0.0
16024,The Slaughter Rule,13411,13411,0,2003_boxofficemojo_rankings.csv,2003,1.0,0.0
16025,War of the Worlds: Goliath,13385,13385,0,2014_boxofficemojo_rankings.csv,2014,1.0,0.0
16026,Solaris 2017 Re-release,13352,0,13352,2017_boxofficemojo_rankings.csv,2017,0.0,1.0
16027,One Last Thing...,13334,13334,0,2006_boxofficemojo_rankings.csv,2006,1.0,0.0
16028,Hugo Pool,13330,13330,0,1997_boxofficemojo_rankings.csv,1997,1.0,0.0
16029,Yes Nurse! No Nurse! 2004 Re-release,13325,13325,0,2004_boxofficemojo_rankings.csv,2004,1.0,0.0
16030,Violet Tendencies,13304,13304,0,2010_boxofficemojo_rankings.csv,2010,1.0,0.0
16031,Rapid Response,13294,13294,0,2019_boxofficemojo_rankings.csv,2019,1.0,0.0
16032,Sherman's Way,13282,13282,0,2009_boxofficemojo_rankings.csv,2009,1.0,0.0
16033,The Specials,13276,13276,0,2000_boxofficemojo_rankings.csv,2000,1.0,0.0
16034,Kicking It,13266,13266,0,2008_boxofficemojo_rankings.csv,2008,1.0,0.0
16035,Late Spring,13254,13254,0,2016_boxofficemojo_rankings.csv,2016,1.0,0.0
16036,Days and Nights,13243,13243,0,2014_boxofficemojo_rankings.csv,2014,1.0,0.0
16037,Harold,13229,13229,0,2008_boxofficemojo_rankings.csv,2008,1.0,0.0
16038,Our Blood is Wine,13210,13210,0,2018_boxofficemojo_rankings.csv,2018,1.0,0.0
16039,"Intent to Destroy: Death, Denial & Depiction",13194,13194,0,2017_boxofficemojo_rankings.csv,2017,1.0,0.0
16040,Sol LeWitt,13146,13146,0,2014_boxofficemojo_rankings.csv,2014,1.0,0.0
16041,The Pleasures of Being Out of Step,13137,13137,0,2014_boxofficemojo_rankings.csv,2014,1.0,0.0
16042,Red Surf,13136,13136,0,1990_boxofficemojo_rankings.csv,1990,1.0,0.0
16043,Love Lessons,13128,13128,0,1996_boxofficemojo_rankings.csv,1996,1.0,0.0
16044,The Trouble with Bliss,13093,13093,0,2012_boxofficemojo_rankings.csv,2012,1.0,0.0
16045,Under the Boardwalk: The Monopoly Story,13080,13080,0,2011_boxofficemojo_rankings.csv,2011,1.0,0.0
16046,The Winners,13066,13066,0,1999_boxofficemojo_rankings.csv,1999,1.0,0.0
16047,Nothing But a Man,13063,13063,0,2012_boxofficemojo_rankings.csv,2012,1.0,0.0
16048,Betty Blue 2009 Director's Cut,13029,13029,0,2009_boxofficemojo_rankings.csv,2009,1.0,0.0
16049,"How Much Does Your Building Weigh, Mr Foster? 2012 Re-release",13013,13013,0,2012_boxofficemojo_rankings.csv,2012,1.0,0.0
16050,Jim,13000,13000,0,2010_boxofficemojo_rankings.csv,2010,1.0,0.0
16051,Bloodworth,12971,12971,0,2011_boxofficemojo_rankings.csv,2011,1.0,0.0
16052,Like Me,12965,12965,0,2018_boxofficemojo_rankings.csv,2018,1.0,0.0
16053,Duet for Cannibals 2019 re-release,12962,12962,0,2019_boxofficemojo_rankings.csv,2019,1.0,0.0
16054,K2: Siren of the Himalayas,12959,12959,0,2014_boxofficemojo_rankings.csv,2014,1.0,0.0
16055,Skid Marks,12959,12959,0,2007_boxofficemojo_rankings.csv,2007,1.0,0.0
16056,Little Boy Blue,12958,12958,0,1998_boxofficemojo_rankings.csv,1998,1.0,0.0
16057,Puss in Boots,12951,12951,0,1988_boxofficemojo_rankings.csv,1988,1.0,0.0
16058,The Last Rampage,12944,6294,6650,2017_boxofficemojo_rankings.csv,2017,0.48624845488257107,0.5137515451174289
16059,The World According to Shorts,12908,12908,0,2006_boxofficemojo_rankings.csv,2006,1.0,0.0
16060,A Green Story,12901,12901,0,2013_boxofficemojo_rankings.csv,2013,1.0,0.0
16061,Taipei Story,12897,12897,0,2017_boxofficemojo_rankings.csv,2017,1.0,0.0
16062,Rock Bottom,12890,12890,0,2007_boxofficemojo_rankings.csv,2007,1.0,0.0
16063,I Can No Longer Hear the Guitar,12876,12876,0,2008_boxofficemojo_rankings.csv,2008,1.0,0.0
16064,I Trust You to Kill Me,12854,12854,0,2006_boxofficemojo_rankings.csv,2006,1.0,0.0
16065,Permanent,12847,12847,0,2017_boxofficemojo_rankings.csv,2017,1.0,0.0
16066,The Taqwacores,12839,11445,1394,2010_boxofficemojo_rankings.csv,2010,0.8914245657761508,0.10857543422384922
16067,The Art of Being Straight,12831,12831,0,2009_boxofficemojo_rankings.csv,2009,1.0,0.0
16068,Children Underground,12798,12798,0,2001_boxofficemojo_rankings.csv,2001,1.0,0.0
16069,Junction 48,12795,12795,0,2017_boxofficemojo_rankings.csv,2017,1.0,0.0
16070,Christmas at Maxwell's,12781,12781,0,2006_boxofficemojo_rankings.csv,2006,1.0,0.0
16071,Lake City,12767,12767,0,2008_boxofficemojo_rankings.csv,2008,1.0,0.0
16072,Yakuza Apocalypse,12756,12756,0,2015_boxofficemojo_rankings.csv,2015,1.0,0.0
16073,Diamond's Edge,12751,12751,0,1990_boxofficemojo_rankings.csv,1990,1.0,0.0
16074,Virginia,12728,12728,0,2012_boxofficemojo_rankings.csv,2012,1.0,0.0
16075,War of the Buttons,12712,12712,0,1995_boxofficemojo_rankings.csv,1995,1.0,0.0
16076,Breakdance Academy 2013 Re-release,12708,12708,0,2013_boxofficemojo_rankings.csv,2013,1.0,0.0
16077,Cobra Verde,12702,12702,0,2007_boxofficemojo_rankings.csv,2007,1.0,0.0
16078,The Time Guardian,12682,12682,0,1989_boxofficemojo_rankings.csv,1989,1.0,0.0
16079,Concerning Violence,12680,12680,0,2014_boxofficemojo_rankings.csv,2014,1.0,0.0
16080,Heal,12668,12668,0,2017_boxofficemojo_rankings.csv,2017,1.0,0.0
16081,Autumn,12655,12655,0,2006_boxofficemojo_rankings.csv,2006,1.0,0.0
16082,August,12636,12636,0,2008_boxofficemojo_rankings.csv,2008,1.0,0.0
16083,Bhopal: A Prayer for Rain,12628,12628,0,2014_boxofficemojo_rankings.csv,2014,1.0,0.0
16084,Kangaroo,12626,4547,8079,2018_boxofficemojo_rankings.csv,2018,0.3601298907017266,0.6398701092982734
16085,Lansdown,12614,12614,0,2002_boxofficemojo_rankings.csv,2002,1.0,0.0
16086,American Socialist: The Life and Times of Eugene Victor Debs,12609,12609,0,2018_boxofficemojo_rankings.csv,2018,1.0,0.0
16087,Gory Gory Hallelujah,12604,12604,0,2005_boxofficemojo_rankings.csv,2005,1.0,0.0
16088,Freestyle: The Art of Rhyme,12600,12600,0,2004_boxofficemojo_rankings.csv,2004,1.0,0.0
16089,Buddy Boy,12597,12597,0,2000_boxofficemojo_rankings.csv,2000,1.0,0.0
16090,Boy Meets Girl,12589,12589,0,2014_boxofficemojo_rankings.csv,2014,1.0,0.0
16091,Husbands in Goa,12588,10135,2453,2012_boxofficemojo_rankings.csv,2012,0.8051318716237686,0.19486812837623133
16092,Of Fathers and Sons,12579,12579,0,2018_boxofficemojo_rankings.csv,2018,1.0,0.0
16093,Around June,12578,12578,0,2012_boxofficemojo_rankings.csv,2012,1.0,0.0
16094,My Art,12554,12554,0,2018_boxofficemojo_rankings.csv,2018,1.0,0.0
16095,Daltry Calhoun,12551,12551,0,2005_boxofficemojo_rankings.csv,2005,1.0,0.0
16096,"The Photographer, His Wife, Her Lover",12546,12546,0,2006_boxofficemojo_rankings.csv,2006,1.0,0.0
16097,Off Season,12544,12544,0,2019_boxofficemojo_rankings.csv,2019,1.0,0.0
16098,The Far Side of the Moon 2005 Re-release,12534,12534,0,2005_boxofficemojo_rankings.csv,2005,1.0,0.0
16099,Jake's Corner,12522,12522,0,2008_boxofficemojo_rankings.csv,2008,1.0,0.0
16100,City of Women,12516,12516,0,2016_boxofficemojo_rankings.csv,2016,1.0,0.0
16101,Hit Me,12500,12500,0,1998_boxofficemojo_rankings.csv,1998,1.0,0.0
16102,Seven Beauties,12408,12408,0,2017_boxofficemojo_rankings.csv,2017,1.0,0.0
16103,Killer Raccoons! 2! Dark Christmas in the Dark!,12382,12382,0,2020_boxofficemojo_rankings.csv,2020,1.0,0.0
16104,The Pale Door,12374,0,12374,2020_boxofficemojo_rankings.csv,2020,0.0,1.0
16105,American Chaos,12368,12368,0,2018_boxofficemojo_rankings.csv,2018,1.0,0.0
16106,America the Beautiful 2: The Thin Commandments,12366,12366,0,2011_boxofficemojo_rankings.csv,2011,1.0,0.0
16107,Rebirth,12358,12358,0,2011_boxofficemojo_rankings.csv,2011,1.0,0.0
16108,Storefront Hitchcock,12355,12355,0,1998_boxofficemojo_rankings.csv,1998,1.0,0.0
16109,Spin,12355,12355,0,2004_boxofficemojo_rankings.csv,2004,1.0,0.0
16110,Backseat,12343,12343,0,2008_boxofficemojo_rankings.csv,2008,1.0,0.0
16111,3 Needles,12327,0,12327,2006_boxofficemojo_rankings.csv,2006,0.0,1.0
16112,L'héritage de la chouette,12316,12316,0,2018_boxofficemojo_rankings.csv,2018,1.0,0.0
16113,The Dust Factory,12311,12311,0,2004_boxofficemojo_rankings.csv,2004,1.0,0.0
16114,Full Battle Rattle,12306,12306,0,2008_boxofficemojo_rankings.csv,2008,1.0,0.0
16115,Big Ain't Bad,12288,12288,0,2004_boxofficemojo_rankings.csv,2004,1.0,0.0
16116,4 Days in France,12273,12273,0,2017_boxofficemojo_rankings.csv,2017,1.0,0.0
16117,The Armor of Light,12267,12267,0,2015_boxofficemojo_rankings.csv,2015,1.0,0.0
16118,Wa-shoku Dream: Beyond Sushi,12240,12240,0,2015_boxofficemojo_rankings.csv,2015,1.0,0.0
16119,The Living Wake,12232,12232,0,2010_boxofficemojo_rankings.csv,2010,1.0,0.0
16120,True Friends,12231,12231,0,1998_boxofficemojo_rankings.csv,1998,1.0,0.0
16121,Bricked,12201,12201,0,2019_boxofficemojo_rankings.csv,2019,1.0,0.0
16122,China Blue,12185,12185,0,2007_boxofficemojo_rankings.csv,2007,1.0,0.0
16123,Elstree 1976,12173,12173,0,2016_boxofficemojo_rankings.csv,2016,1.0,0.0
16124,Destiny,12156,12156,0,2016_boxofficemojo_rankings.csv,2016,1.0,0.0
16125,Touch the Wall,12156,12156,0,2014_boxofficemojo_rankings.csv,2014,1.0,0.0
16126,Greetings from Tim Buckley,12155,11157,998,2013_boxofficemojo_rankings.csv,2013,0.9178938708350473,0.08210612916495269
16127,Back Door Channels: The Price of Peace,12139,12139,0,2011_boxofficemojo_rankings.csv,2011,1.0,0.0
16128,In No Great Hurry: 13 Lessons in Life with Saul Leiter,12133,12133,0,2014_boxofficemojo_rankings.csv,2014,1.0,0.0
16129,The Most Unknown,12119,12119,0,2018_boxofficemojo_rankings.csv,2018,1.0,0.0
16130,What the Snow Brings,12113,4816,7297,2007_boxofficemojo_rankings.csv,2007,0.3975893667960043,0.6024106332039957
16131,Call Me Kuchu,12110,9124,2986,2012_boxofficemojo_rankings.csv,2012,0.7534269199009084,0.24657308009909165
16132,Zen for Nothing,12107,12107,0,2019_boxofficemojo_rankings.csv,2019,1.0,0.0
16133,Hot Water,12101,12101,0,2016_boxofficemojo_rankings.csv,2016,1.0,0.0
16134,The Last Broadcast,12097,12097,0,1998_boxofficemojo_rankings.csv,1998,1.0,0.0
16135,The Kids Grow Up,12095,12095,0,2010_boxofficemojo_rankings.csv,2010,1.0,0.0
16136,A Murder in the Park,12088,12088,0,2015_boxofficemojo_rankings.csv,2015,1.0,0.0
16137,When Two Worlds Collide,12080,12080,0,2016_boxofficemojo_rankings.csv,2016,1.0,0.0
16138,Close Call,12077,12077,0,2004_boxofficemojo_rankings.csv,2004,1.0,0.0
16139,Little England 2015 Re-release,12077,12077,0,2015_boxofficemojo_rankings.csv,2015,1.0,0.0
16140,Sex Positive,12069,12069,0,2009_boxofficemojo_rankings.csv,2009,1.0,0.0
16141,Imprisoned,12050,12050,0,2019_boxofficemojo_rankings.csv,2019,1.0,0.0
16142,Dreaming of Joseph Lees,12044,12044,0,1999_boxofficemojo_rankings.csv,1999,1.0,0.0
16143,Quartet,12042,12042,0,2019_boxofficemojo_rankings.csv,2019,1.0,0.0
16144,Lost Angels: Skid Row Is My Home,12025,12025,0,2012_boxofficemojo_rankings.csv,2012,1.0,0.0
16145,Queen Margot 2014 Re-release,12005,12005,0,2014_boxofficemojo_rankings.csv,2014,1.0,0.0
16146,Shaye & Kiki,12000,12000,0,2002_boxofficemojo_rankings.csv,2002,1.0,0.0
16147,The Vindicator,12000,12000,0,1986_boxofficemojo_rankings.csv,1986,1.0,0.0
16148,Rick,11991,11991,0,2004_boxofficemojo_rankings.csv,2004,1.0,0.0
16149,The Legend of Leigh Bowery,11989,11989,0,2003_boxofficemojo_rankings.csv,2003,1.0,0.0
16150,All Babes Want to Kill Me,11975,11975,0,2005_boxofficemojo_rankings.csv,2005,1.0,0.0
16151,Autumn Sonata 2017 Re-release,11959,0,11959,2017_boxofficemojo_rankings.csv,2017,0.0,1.0
16152,The Strange Little Cat,11956,5885,6071,2014_boxofficemojo_rankings.csv,2014,0.4922214787554366,0.5077785212445634
16153,Last Stop for Paul,11951,11951,0,2008_boxofficemojo_rankings.csv,2008,1.0,0.0
16154,The Last Race,11947,11947,0,2018_boxofficemojo_rankings.csv,2018,1.0,0.0
16155,The Go-Getter,11931,11931,0,2008_boxofficemojo_rankings.csv,2008,1.0,0.0
16156,Frank Serpico,11925,11925,0,2017_boxofficemojo_rankings.csv,2017,1.0,0.0
16157,Yellow Asphalt,11907,11907,0,2002_boxofficemojo_rankings.csv,2002,1.0,0.0
16158,"Cassandro, The Exotico!",11897,11897,0,2019_boxofficemojo_rankings.csv,2019,1.0,0.0
16159,Vengeance Is Mine,11891,11891,0,2007_boxofficemojo_rankings.csv,2007,1.0,0.0
16160,Hollywould,11888,11888,0,2019_boxofficemojo_rankings.csv,2019,1.0,0.0
16161,New York in the 50's,11882,11882,0,2001_boxofficemojo_rankings.csv,2001,1.0,0.0
16162,Smokers Only,11871,11871,0,2002_boxofficemojo_rankings.csv,2002,1.0,0.0
16163,Quid Pro Quo,11864,11864,0,2008_boxofficemojo_rankings.csv,2008,1.0,0.0
16164,Revenge of the Mekons,11861,11861,0,2014_boxofficemojo_rankings.csv,2014,1.0,0.0
16165,Far from Home,11859,11859,0,1989_boxofficemojo_rankings.csv,1989,1.0,0.0
16166,Les Parents Terribles,11818,11818,0,2018_boxofficemojo_rankings.csv,2018,1.0,0.0
16167,Janice Beard,11816,11816,0,2002_boxofficemojo_rankings.csv,2002,1.0,0.0
16168,Emptying the Skies,11811,11811,0,2015_boxofficemojo_rankings.csv,2015,1.0,0.0
16169,Woman Is the Future of Man 2006 Re-release,11807,11807,0,2006_boxofficemojo_rankings.csv,2006,1.0,0.0
16170,Dead Man's Shoes 2006 Re-release,11777,6408,5369,2006_boxofficemojo_rankings.csv,2006,0.5441114035832555,0.4558885964167445
16171,The Dry Land,11777,11777,0,2010_boxofficemojo_rankings.csv,2010,1.0,0.0
16172,Blockade,11750,11750,0,2007_boxofficemojo_rankings.csv,2007,1.0,0.0
16173,Summer '03,11746,11746,0,2018_boxofficemojo_rankings.csv,2018,1.0,0.0
16174,Rid of Me,11740,11740,0,2011_boxofficemojo_rankings.csv,2011,1.0,0.0
16175,Writer of O,11728,11728,0,2005_boxofficemojo_rankings.csv,2005,1.0,0.0
16176,Lucha Mexico,11722,11722,0,2016_boxofficemojo_rankings.csv,2016,1.0,0.0
16177,Hell's Kitchen,11710,11710,0,1999_boxofficemojo_rankings.csv,1999,1.0,0.0
16178,White Wedding 2010 Re-release,11710,11710,0,2010_boxofficemojo_rankings.csv,2010,1.0,0.0
16179,One Peace at a Time,11698,11698,0,2009_boxofficemojo_rankings.csv,2009,1.0,0.0
16180,Breaking Up,11690,11690,0,1997_boxofficemojo_rankings.csv,1997,1.0,0.0
16181,My Voyage to Italy,11683,11683,0,2001_boxofficemojo_rankings.csv,2001,1.0,0.0
16182,Pontiac Moon,11669,11669,0,1994_boxofficemojo_rankings.csv,1994,1.0,0.0
16183,Home Is Where the Hart Is,11660,11660,0,1987_boxofficemojo_rankings.csv,1987,1.0,0.0
16184,The Grizzlies,11650,11650,0,2020_boxofficemojo_rankings.csv,2020,1.0,0.0
16185,36 Saints,11640,11640,0,2013_boxofficemojo_rankings.csv,2013,1.0,0.0
16186,Angels in the Dust,11606,11606,0,2007_boxofficemojo_rankings.csv,2007,1.0,0.0
16187,The Tribes of Palos Verdes,11603,11603,0,2017_boxofficemojo_rankings.csv,2017,1.0,0.0
16188,11 Flowers,11599,9213,2386,2012_boxofficemojo_rankings.csv,2012,0.79429261143202,0.20570738856798
16189,Operation Filmmaker,11573,11573,0,2008_boxofficemojo_rankings.csv,2008,1.0,0.0
16190,Around India with a Movie Camera,11568,10389,1179,2018_boxofficemojo_rankings.csv,2018,0.8980809128630706,0.10191908713692946
16191,Crop Circles: Quest for Truth,11562,11562,0,2002_boxofficemojo_rankings.csv,2002,1.0,0.0
16192,Intoxicating,11560,11560,0,2004_boxofficemojo_rankings.csv,2004,1.0,0.0
16193,The Preppie Connection,11558,11558,0,2016_boxofficemojo_rankings.csv,2016,1.0,0.0
16194,River of Grass,11553,11553,0,2016_boxofficemojo_rankings.csv,2016,1.0,0.0
16195,East of Havana,11550,11550,0,2007_boxofficemojo_rankings.csv,2007,1.0,0.0
16196,The Ruins of Lifta,11548,11548,0,2016_boxofficemojo_rankings.csv,2016,1.0,0.0
16197,Ultrasuede: In Search of Halston,11539,11539,0,2012_boxofficemojo_rankings.csv,2012,1.0,0.0
16198,After the Cup: Sons of Sakhnin United,11538,11538,0,2010_boxofficemojo_rankings.csv,2010,1.0,0.0
16199,Girl Play,11523,11523,0,2005_boxofficemojo_rankings.csv,2005,1.0,0.0
16200,Elektra Luxx,11514,11514,0,2011_boxofficemojo_rankings.csv,2011,1.0,0.0
16201,Peter and Vandy,11495,11495,0,2009_boxofficemojo_rankings.csv,2009,1.0,0.0
16202,Manfast,11480,11480,0,2003_boxofficemojo_rankings.csv,2003,1.0,0.0
16203,Waltzing Anna,11455,11455,0,2006_boxofficemojo_rankings.csv,2006,1.0,0.0
16204,Whole New Thing,11445,11445,0,2007_boxofficemojo_rankings.csv,2007,1.0,0.0
16205,Sputnik Fever,11441,11441,0,2008_boxofficemojo_rankings.csv,2008,1.0,0.0
16206,Gardens of the Night,11436,11436,0,2008_boxofficemojo_rankings.csv,2008,1.0,0.0
16207,The Final Member,11428,11428,0,2014_boxofficemojo_rankings.csv,2014,1.0,0.0
16208,The Great Invisible,11428,11428,0,2014_boxofficemojo_rankings.csv,2014,1.0,0.0
16209,The Mesmerist,11422,11422,0,2002_boxofficemojo_rankings.csv,2002,1.0,0.0
16210,Love Forbidden 2003 Re-release,11421,11421,0,2003_boxofficemojo_rankings.csv,2003,1.0,0.0
16211,Taxidermia 2009 Re-release,11408,11408,0,2009_boxofficemojo_rankings.csv,2009,1.0,0.0
16212,Beside Bowie: The Mick Ronson Story,11400,11400,0,2017_boxofficemojo_rankings.csv,2017,1.0,0.0
16213,Strafsache 4 Ks 2/63 - Auschwitz vor dem Frankfurter Schwurgericht,11396,11396,0,2007_boxofficemojo_rankings.csv,2007,1.0,0.0
16214,Iron Warrior,11385,11385,0,1987_boxofficemojo_rankings.csv,1987,1.0,0.0
16215,Camera Obscura,11384,11384,0,2003_boxofficemojo_rankings.csv,2003,1.0,0.0
16216,Family Fundamentals,11344,11344,0,2002_boxofficemojo_rankings.csv,2002,1.0,0.0
16217,Rendezvous in July,11321,11321,0,2018_boxofficemojo_rankings.csv,2018,1.0,0.0
16218,Powerbomb,11319,11319,0,2020_boxofficemojo_rankings.csv,2020,1.0,0.0
16219,Viktoria,11314,11314,0,2016_boxofficemojo_rankings.csv,2016,1.0,0.0
16220,Saigon Bodyguards,11314,11314,0,2017_boxofficemojo_rankings.csv,2017,1.0,0.0
16221,Cinemania,11305,11305,0,2003_boxofficemojo_rankings.csv,2003,1.0,0.0
16222,Lost in America,11301,11301,0,2020_boxofficemojo_rankings.csv,2020,1.0,0.0
16223,"Otto; or, Up with Dead People",11295,11295,0,2008_boxofficemojo_rankings.csv,2008,1.0,0.0
16224,Live Freaky Die Freaky,11290,11290,0,2006_boxofficemojo_rankings.csv,2006,1.0,0.0
16225,Dishkiyaoon,11288,11288,0,2014_boxofficemojo_rankings.csv,2014,1.0,0.0
16226,Theo Who Lived,11271,11271,0,2016_boxofficemojo_rankings.csv,2016,1.0,0.0
16227,Looking for Palladin,11268,11268,0,2009_boxofficemojo_rankings.csv,2009,1.0,0.0
16228,Daylight's End,11257,0,11257,2016_boxofficemojo_rankings.csv,2016,0.0,1.0
16229,Bullitt County,11257,11257,0,2018_boxofficemojo_rankings.csv,2018,1.0,0.0
16230,In Like Flynn,11255,11255,0,2019_boxofficemojo_rankings.csv,2019,1.0,0.0
16231,Hacker,11239,11239,0,2016_boxofficemojo_rankings.csv,2016,1.0,0.0
16232,The Pathological Optimist,11222,11222,0,2017_boxofficemojo_rankings.csv,2017,1.0,0.0
16233,Tout Truffaut,11206,11206,0,1999_boxofficemojo_rankings.csv,1999,1.0,0.0
16234,Fat Girls,11204,11204,0,2007_boxofficemojo_rankings.csv,2007,1.0,0.0
16235,Children of Invention,11183,11183,0,2010_boxofficemojo_rankings.csv,2010,1.0,0.0
16236,The Last Party,11156,11156,0,1993_boxofficemojo_rankings.csv,1993,1.0,0.0
16237,Made Me Do It,11151,11151,0,2019_boxofficemojo_rankings.csv,2019,1.0,0.0
16238,"Now, Forager",11146,11146,0,2012_boxofficemojo_rankings.csv,2012,1.0,0.0
16239,The Suburbans 1999 Re-release,11130,11130,0,1999_boxofficemojo_rankings.csv,1999,1.0,0.0
16240,The Suburbans,11130,11130,0,1999_boxofficemojo_rankings.csv,1999,1.0,0.0
16241,InSight,11100,11100,0,2011_boxofficemojo_rankings.csv,2011,1.0,0.0
16242,Winning Girls Through Psychic Mind Control,11089,11089,0,2005_boxofficemojo_rankings.csv,2005,1.0,0.0
16243,Edward II 2018 Re-release,11055,4826,6229,2018_boxofficemojo_rankings.csv,2018,0.4365445499773858,0.5634554500226142
16244,The Challenge,11043,11043,0,2017_boxofficemojo_rankings.csv,2017,1.0,0.0
16245,The Woman with the 5 Elephants 2011 Re-release,11026,11026,0,2011_boxofficemojo_rankings.csv,2011,1.0,0.0
16246,Draupadi Unleashed,11025,11025,0,2020_boxofficemojo_rankings.csv,2020,1.0,0.0
16247,Gasoline,11023,11023,0,2003_boxofficemojo_rankings.csv,2003,1.0,0.0
16248,PAY 2 PLAY: Democracy's High Stakes,11021,11021,0,2014_boxofficemojo_rankings.csv,2014,1.0,0.0
16249,Midget Zombie Takeover,11006,11006,0,2013_boxofficemojo_rankings.csv,2013,1.0,0.0
16250,The Conrad Boys,11001,11001,0,2006_boxofficemojo_rankings.csv,2006,1.0,0.0
16251,Pauly Shore Is Dead,11000,11000,0,2004_boxofficemojo_rankings.csv,2004,1.0,0.0
16252,Christina,11000,11000,0,2010_boxofficemojo_rankings.csv,2010,1.0,0.0
16253,Manito,11000,11000,0,2003_boxofficemojo_rankings.csv,2003,1.0,0.0
16254,Suburban Birds,10997,10997,0,2019_boxofficemojo_rankings.csv,2019,1.0,0.0
16255,16 Bars,10985,10985,0,2019_boxofficemojo_rankings.csv,2019,1.0,0.0
16256,Just Before I Go,10970,10970,0,2015_boxofficemojo_rankings.csv,2015,1.0,0.0
16257,Digging Up the Marrow,10969,10969,0,2015_boxofficemojo_rankings.csv,2015,1.0,0.0
16258,Very Good Girls,10963,6940,4023,2014_boxofficemojo_rankings.csv,2014,0.6330384018972909,0.3669615981027091
16259,Wallander: Hämnden 2012 Re-release,10960,10960,0,2012_boxofficemojo_rankings.csv,2012,1.0,0.0
16260,Sarah Palin: You Betcha!,10935,10935,0,2011_boxofficemojo_rankings.csv,2011,1.0,0.0
16261,If the Dancer Dances,10912,10912,0,2019_boxofficemojo_rankings.csv,2019,1.0,0.0
16262,The Unknown Soldier,10907,9602,1305,2007_boxofficemojo_rankings.csv,2007,0.8803520674796003,0.11964793252039975
16263,MC5*: A True Testimonial,10888,10888,0,2004_boxofficemojo_rankings.csv,2004,1.0,0.0
16264,Stardom,10886,10886,0,2000_boxofficemojo_rankings.csv,2000,1.0,0.0
16265,As It Is in Heaven,10850,10850,0,2014_boxofficemojo_rankings.csv,2014,1.0,0.0
16266,What Happened Last Night,10844,10844,0,2016_boxofficemojo_rankings.csv,2016,1.0,0.0
16267,The Forecaster,10824,10172,652,2015_boxofficemojo_rankings.csv,2015,0.9397634885439764,0.06023651145602365
16268,Bleeding Heart,10815,0,10815,2015_boxofficemojo_rankings.csv,2015,0.0,1.0
16269,Terkel in Trouble 2010 Re-release,10783,10783,0,2010_boxofficemojo_rankings.csv,2010,1.0,0.0
16270,The Man Who Shook the Hand of Vicente Fernandez,10782,10782,0,2012_boxofficemojo_rankings.csv,2012,1.0,0.0
16271,Vision Portraits,10771,10771,0,2019_boxofficemojo_rankings.csv,2019,1.0,0.0
16272,Mala Mala,10761,10761,0,2015_boxofficemojo_rankings.csv,2015,1.0,0.0
16273,A Resurrection,10730,10730,0,2013_boxofficemojo_rankings.csv,2013,1.0,0.0
16274,Freshman Orientation,10718,10718,0,2007_boxofficemojo_rankings.csv,2007,1.0,0.0
16275,Hollow in the Land,10688,0,10688,2017_boxofficemojo_rankings.csv,2017,0.0,1.0
16276,You Go to My Head,10682,10682,0,2020_boxofficemojo_rankings.csv,2020,1.0,0.0
16277,Made in Cleveland,10681,10681,0,2013_boxofficemojo_rankings.csv,2013,1.0,0.0
16278,Frankie & Alice,10670,10670,0,2010_boxofficemojo_rankings.csv,2010,1.0,0.0
16279,National Bird,10656,10656,0,2016_boxofficemojo_rankings.csv,2016,1.0,0.0
16280,American Meat,10650,10650,0,2013_boxofficemojo_rankings.csv,2013,1.0,0.0
16281,Caucus,10645,10645,0,2013_boxofficemojo_rankings.csv,2013,1.0,0.0
16282,Robot Carnival,10642,10642,0,1991_boxofficemojo_rankings.csv,1991,1.0,0.0
16283,Mind the Gap,10637,10637,0,2004_boxofficemojo_rankings.csv,2004,1.0,0.0
16284,One More Round,10629,10629,0,2005_boxofficemojo_rankings.csv,2005,1.0,0.0
16285,Lovesong,10626,10626,0,2017_boxofficemojo_rankings.csv,2017,1.0,0.0
16286,Jupiter's Wife,10622,10622,0,1995_boxofficemojo_rankings.csv,1995,1.0,0.0
16287,Intuitions,10606,10606,0,2019_boxofficemojo_rankings.csv,2019,1.0,0.0
16288,Marriage Italian Style 2011 Re-release,10600,10600,0,2011_boxofficemojo_rankings.csv,2011,1.0,0.0
16289,Inside the Mind of Leonardo,10600,10600,0,2014_boxofficemojo_rankings.csv,2014,1.0,0.0
16290,Whaledreamers,10584,10584,0,2008_boxofficemojo_rankings.csv,2008,1.0,0.0
16291,Schizopolis,10580,10580,0,1997_boxofficemojo_rankings.csv,1997,1.0,0.0
16292,China Heavyweight,10550,10550,0,2012_boxofficemojo_rankings.csv,2012,1.0,0.0
16293,Nola,10550,10550,0,2003_boxofficemojo_rankings.csv,2003,1.0,0.0
16294,Motorama,10535,10535,0,1993_boxofficemojo_rankings.csv,1993,1.0,0.0
16295,White Rainbow,10529,10529,0,2006_boxofficemojo_rankings.csv,2006,1.0,0.0
16296,"Fast Trip, Long Drop",10524,10524,0,1995_boxofficemojo_rankings.csv,1995,1.0,0.0
16297,I'll Take Your Dead,10523,10523,0,2019_boxofficemojo_rankings.csv,2019,1.0,0.0
16298,Fighting Tommy Riley,10514,10514,0,2005_boxofficemojo_rankings.csv,2005,1.0,0.0
16299,Waiting for Armageddon,10501,10501,0,2010_boxofficemojo_rankings.csv,2010,1.0,0.0
16300,Splinter,10497,10497,0,2007_boxofficemojo_rankings.csv,2007,1.0,0.0
16301,Clarence,10495,10495,0,2017_boxofficemojo_rankings.csv,2017,1.0,0.0
16302,Zero Kelvin,10493,10493,0,1996_boxofficemojo_rankings.csv,1996,1.0,0.0
16303,Santa Mesa,10490,10490,0,2012_boxofficemojo_rankings.csv,2012,1.0,0.0
16304,Neon Flesh 2012 Re-release,10483,0,10483,2012_boxofficemojo_rankings.csv,2012,0.0,1.0
16305,"Norte, the End of History",10457,10457,0,2014_boxofficemojo_rankings.csv,2014,1.0,0.0
16306,Evil Intent,10454,10454,0,2013_boxofficemojo_rankings.csv,2013,1.0,0.0
16307,Class Rank,10452,10452,0,2018_boxofficemojo_rankings.csv,2018,1.0,0.0
16308,Let's Get Frank,10440,10440,0,2004_boxofficemojo_rankings.csv,2004,1.0,0.0
16309,Mama Africa 2018 Re-release,10430,10430,0,2018_boxofficemojo_rankings.csv,2018,1.0,0.0
16310,Love in the Time of Money,10410,10410,0,2002_boxofficemojo_rankings.csv,2002,1.0,0.0
16311,Forgiving Dr. Mengele,10403,10403,0,2006_boxofficemojo_rankings.csv,2006,1.0,0.0
16312,The Advocates,10402,10402,0,2018_boxofficemojo_rankings.csv,2018,1.0,0.0
16313,Shanghai Calling,10400,10400,0,2013_boxofficemojo_rankings.csv,2013,1.0,0.0
16314,Elemental,10358,10358,0,2013_boxofficemojo_rankings.csv,2013,1.0,0.0
16315,Zero Bridge,10357,10357,0,2011_boxofficemojo_rankings.csv,2011,1.0,0.0
16316,...So Goes the Nation,10337,10337,0,2006_boxofficemojo_rankings.csv,2006,1.0,0.0
16317,SK1 2016 Re-release,10330,10330,0,2016_boxofficemojo_rankings.csv,2016,1.0,0.0
16318,Oasis 2004 Re-release,10304,10304,0,2004_boxofficemojo_rankings.csv,2004,1.0,0.0
16319,Painted Woman,10298,10298,0,2017_boxofficemojo_rankings.csv,2017,1.0,0.0
16320,Vanished Empire 2009 Re-release,10289,10289,0,2009_boxofficemojo_rankings.csv,2009,1.0,0.0
16321,Shepard & Dark,10278,10278,0,2013_boxofficemojo_rankings.csv,2013,1.0,0.0
16322,Moebius,10254,2340,7914,2014_boxofficemojo_rankings.csv,2014,0.22820362785254536,0.7717963721474547
16323,As It Is in Heaven 2008 Re-release,10236,10236,0,2008_boxofficemojo_rankings.csv,2008,1.0,0.0
16324,The Endless Summer,10233,10233,0,2014_boxofficemojo_rankings.csv,2014,1.0,0.0
16325,Amelia 2.0,10233,10233,0,2017_boxofficemojo_rankings.csv,2017,1.0,0.0
16326,Approaching the Unknown,10232,10232,0,2016_boxofficemojo_rankings.csv,2016,1.0,0.0
16327,Steel City,10227,10227,0,2007_boxofficemojo_rankings.csv,2007,1.0,0.0
16328,Allegro,10208,7404,2804,2007_boxofficemojo_rankings.csv,2007,0.7253134796238244,0.2746865203761755
16329,Tip Top,10201,6050,4151,2013_boxofficemojo_rankings.csv,2013,0.5930791098911872,0.4069208901088129
16330,When Lambs Become Lions,10197,9337,860,2019_boxofficemojo_rankings.csv,2019,0.9156614690595273,0.0843385309404727
16331,Prince of the Himalayas,10190,10190,0,2011_boxofficemojo_rankings.csv,2011,1.0,0.0
16332,Miss Minoes 2011 Re-release,10189,10189,0,2011_boxofficemojo_rankings.csv,2011,1.0,0.0
16333,Zindaggi Rocks,10172,10172,0,2006_boxofficemojo_rankings.csv,2006,1.0,0.0
16334,Black Is... Black Ain't,10171,10171,0,1995_boxofficemojo_rankings.csv,1995,1.0,0.0
16335,Glen or Glenda 1981 Re-release,10158,10158,0,1981_boxofficemojo_rankings.csv,1981,1.0,0.0
16336,A Bird of the Air,10152,10152,0,2011_boxofficemojo_rankings.csv,2011,1.0,0.0
16337,Broken Arrow,10145,0,10145,2008_boxofficemojo_rankings.csv,2008,0.0,1.0
16338,Revolution #9,10133,10133,0,2002_boxofficemojo_rankings.csv,2002,1.0,0.0
16339,Beta Test,10104,10104,0,2016_boxofficemojo_rankings.csv,2016,1.0,0.0
16340,Putin's Kiss,10082,10082,0,2012_boxofficemojo_rankings.csv,2012,1.0,0.0
16341,Pawn Shop Chronicles,10080,8088,1992,2013_boxofficemojo_rankings.csv,2013,0.8023809523809524,0.1976190476190476
16342,Before I Disappear,10078,10078,0,2014_boxofficemojo_rankings.csv,2014,1.0,0.0
16343,Little Accidents,10071,10071,0,2015_boxofficemojo_rankings.csv,2015,1.0,0.0
16344,Informant,10068,10068,0,2013_boxofficemojo_rankings.csv,2013,1.0,0.0
16345,Choking Man,10053,5474,4579,2007_boxofficemojo_rankings.csv,2007,0.544514075400378,0.455485924599622
16346,The Sunshine Makers,10042,10042,0,2017_boxofficemojo_rankings.csv,2017,1.0,0.0
16347,Circle,10024,10024,0,2010_boxofficemojo_rankings.csv,2010,1.0,0.0
16348,The Life and Mind of Mark DeFriest,10021,10021,0,2015_boxofficemojo_rankings.csv,2015,1.0,0.0
16349,Arjun: The Warrior Prince,10017,10017,0,2012_boxofficemojo_rankings.csv,2012,1.0,0.0
16350,Guest Artist,10017,10017,0,2020_boxofficemojo_rankings.csv,2020,1.0,0.0
16351,The Do-Deca-Pentathlon,10000,10000,0,2012_boxofficemojo_rankings.csv,2012,1.0,0.0
16352,"Hugh Hefner: Playboy, Activist and Rebel",10000,10000,0,2010_boxofficemojo_rankings.csv,2010,1.0,0.0
16353,Tere Bin Laden: Dead Or Alive,9995,0,9995,2016_boxofficemojo_rankings.csv,2016,0.0,1.0
16354,Black White + Gray: A Portrait of Sam Wagstaff and Robert Mapplethorpe,9975,8939,1036,2007_boxofficemojo_rankings.csv,2007,0.896140350877193,0.10385964912280701
16355,Foosballers,9966,9966,0,2020_boxofficemojo_rankings.csv,2020,1.0,0.0
16356,Made in France,9956,9956,0,2016_boxofficemojo_rankings.csv,2016,1.0,0.0
16357,Act of God,9955,9955,0,2009_boxofficemojo_rankings.csv,2009,1.0,0.0
16358,Nina's Heavenly Delights 2007 Re-release,9936,9936,0,2007_boxofficemojo_rankings.csv,2007,1.0,0.0
16359,Olivia,9934,9934,0,2019_boxofficemojo_rankings.csv,2019,1.0,0.0
16360,Sólo con tu pareja,9915,9915,0,2006_boxofficemojo_rankings.csv,2006,1.0,0.0
16361,Haunted Summer,9911,9911,0,1988_boxofficemojo_rankings.csv,1988,1.0,0.0
16362,Streetwise,9904,9904,0,2019_boxofficemojo_rankings.csv,2019,1.0,0.0
16363,If I Didn't Care,9902,9902,0,2007_boxofficemojo_rankings.csv,2007,1.0,0.0
16364,Fix,9890,9890,0,2009_boxofficemojo_rankings.csv,2009,1.0,0.0
16365,Taxman,9871,9871,0,1999_boxofficemojo_rankings.csv,1999,1.0,0.0
16366,Take Care of My Cat,9866,9866,0,2002_boxofficemojo_rankings.csv,2002,1.0,0.0
16367,52 Tuesdays,9844,0,9844,2015_boxofficemojo_rankings.csv,2015,0.0,1.0
16368,Kabbalah Me,9816,9816,0,2014_boxofficemojo_rankings.csv,2014,1.0,0.0
16369,Down Terrace,9812,9812,0,2010_boxofficemojo_rankings.csv,2010,1.0,0.0
16370,The River Within,9811,9811,0,2009_boxofficemojo_rankings.csv,2009,1.0,0.0
16371,Birth of the Living Dead,9802,9802,0,2013_boxofficemojo_rankings.csv,2013,1.0,0.0
16372,Cuba: Island of Music,9791,9791,0,2004_boxofficemojo_rankings.csv,2004,1.0,0.0
16373,Something to Cheer About,9777,9777,0,2007_boxofficemojo_rankings.csv,2007,1.0,0.0
16374,Pelle the Conqueror 2017 Re-release,9757,9757,0,2017_boxofficemojo_rankings.csv,2017,1.0,0.0
16375,Stolen Moments,9743,9743,0,1998_boxofficemojo_rankings.csv,1998,1.0,0.0
16376,The Book of Life,9740,9740,0,1999_boxofficemojo_rankings.csv,1999,1.0,0.0
16377,Finding Home,9736,9736,0,2005_boxofficemojo_rankings.csv,2005,1.0,0.0
16378,All the Rage,9730,9730,0,2000_boxofficemojo_rankings.csv,2000,1.0,0.0
16379,The President's Last Bang,9724,9724,0,2005_boxofficemojo_rankings.csv,2005,1.0,0.0
16380,"If You Don't, I Will",9719,9719,0,2014_boxofficemojo_rankings.csv,2014,1.0,0.0
16381,Antoine and Antoinette,9704,9704,0,2013_boxofficemojo_rankings.csv,2013,1.0,0.0
16382,Weirdsville,9700,8161,1539,2007_boxofficemojo_rankings.csv,2007,0.841340206185567,0.158659793814433
16383,Brutal Beauty: Tales of the Rose City Rollers,9677,9677,0,2010_boxofficemojo_rankings.csv,2010,1.0,0.0
16384,The Quest of Alain Ducasse,9627,9627,0,2018_boxofficemojo_rankings.csv,2018,1.0,0.0
16385,Virgin,9614,9614,0,2004_boxofficemojo_rankings.csv,2004,1.0,0.0
16386,The Spanish Prisoner 2019 Re-release,9589,9589,0,2019_boxofficemojo_rankings.csv,2019,1.0,0.0
16387,Vito Bonafacci,9570,9570,0,2011_boxofficemojo_rankings.csv,2011,1.0,0.0
16388,Chosen,9536,9283,253,2016_boxofficemojo_rankings.csv,2016,0.9734689597315436,0.026531040268456377
16389,Blackballed: The Bobby Dukes Story,9528,9528,0,2006_boxofficemojo_rankings.csv,2006,1.0,0.0
16390,Hotel Colonial,9526,9526,0,1987_boxofficemojo_rankings.csv,1987,1.0,0.0
16391,The Lost Arcade,9522,9522,0,2016_boxofficemojo_rankings.csv,2016,1.0,0.0
16392,Strangers on the Earth,9518,9518,0,2018_boxofficemojo_rankings.csv,2018,1.0,0.0
16393,Living Proof,9512,9512,0,2017_boxofficemojo_rankings.csv,2017,1.0,0.0
16394,Open Season,9481,9481,0,1996_boxofficemojo_rankings.csv,1996,1.0,0.0
16395,Claire Dolan,9480,9480,0,2000_boxofficemojo_rankings.csv,2000,1.0,0.0
16396,In the House of Flies,9480,9480,0,2014_boxofficemojo_rankings.csv,2014,1.0,0.0
16397,Tru Loved,9467,9467,0,2008_boxofficemojo_rankings.csv,2008,1.0,0.0
16398,The Sasquatch Gang,9458,9458,0,2007_boxofficemojo_rankings.csv,2007,1.0,0.0
16399,Northern Lights,9453,9453,0,2013_boxofficemojo_rankings.csv,2013,1.0,0.0
16400,As Tears Go By,9436,9436,0,2008_boxofficemojo_rankings.csv,2008,1.0,0.0
16401,If I Were You,9432,9432,0,2013_boxofficemojo_rankings.csv,2013,1.0,0.0
16402,I'll Sing for You 2004 Re-release,9425,9425,0,2004_boxofficemojo_rankings.csv,2004,1.0,0.0
16403,Zero Charisma,9417,9417,0,2013_boxofficemojo_rankings.csv,2013,1.0,0.0
16404,"One Cut, One Life",9406,9406,0,2015_boxofficemojo_rankings.csv,2015,1.0,0.0
16405,"L'Chayim, Comrade Stalin",9397,9397,0,2003_boxofficemojo_rankings.csv,2003,1.0,0.0
16406,Innocence and Experience: The Making of 'The Age of Innocence',9395,9395,0,2005_boxofficemojo_rankings.csv,2005,1.0,0.0
16407,First Love 2005 Re-release,9392,9392,0,2005_boxofficemojo_rankings.csv,2005,1.0,0.0
16408,Miss Kiet's Children 2017 Re-release,9384,9384,0,2017_boxofficemojo_rankings.csv,2017,1.0,0.0
16409,Acts of Worship,9377,9377,0,2003_boxofficemojo_rankings.csv,2003,1.0,0.0
16410,Crazy Like a Fox,9376,9376,0,2006_boxofficemojo_rankings.csv,2006,1.0,0.0
16411,The Tree of Wooden Clogs,9367,0,9367,2016_boxofficemojo_rankings.csv,2016,0.0,1.0
16412,Radio Free Albemuth,9365,9365,0,2014_boxofficemojo_rankings.csv,2014,1.0,0.0
16413,Fritz Lang's Indian Epic 2019 re-release,9345,9345,0,2019_boxofficemojo_rankings.csv,2019,1.0,0.0
16414,The End of Love,9342,9342,0,2013_boxofficemojo_rankings.csv,2013,1.0,0.0
16415,Looking for Maria Sanchez,9338,9338,0,2013_boxofficemojo_rankings.csv,2013,1.0,0.0
16416,The Immortalists,9331,9331,0,2014_boxofficemojo_rankings.csv,2014,1.0,0.0
16417,Milk and Honey,9331,9331,0,2005_boxofficemojo_rankings.csv,2005,1.0,0.0
16418,Better Mus' Come,9318,9318,0,2013_boxofficemojo_rankings.csv,2013,1.0,0.0
16419,Wonderful World,9309,9309,0,2010_boxofficemojo_rankings.csv,2010,1.0,0.0
16420,Rolling Family 2006 Re-release,9291,9291,0,2006_boxofficemojo_rankings.csv,2006,1.0,0.0
16421,The City Dark,9269,9269,0,2012_boxofficemojo_rankings.csv,2012,1.0,0.0
16422,Hooligan Sparrow,9263,9263,0,2016_boxofficemojo_rankings.csv,2016,1.0,0.0
16423,Illusion,9261,9261,0,2006_boxofficemojo_rankings.csv,2006,1.0,0.0
16424,The Sacrament,9221,9221,0,2014_boxofficemojo_rankings.csv,2014,1.0,0.0
16425,A Dark Place,9212,0,9212,2019_boxofficemojo_rankings.csv,2019,0.0,1.0
16426,Cracked Up,9197,9197,0,2019_boxofficemojo_rankings.csv,2019,1.0,0.0
16427,Ghost Team One,9195,9195,0,2013_boxofficemojo_rankings.csv,2013,1.0,0.0
16428,Trouble Every Day 2013 Re-release,9189,9189,0,2013_boxofficemojo_rankings.csv,2013,1.0,0.0
16429,Frank & Lola,9188,9188,0,2016_boxofficemojo_rankings.csv,2016,1.0,0.0
16430,The Young Girl and the Monsoon,9186,9186,0,2001_boxofficemojo_rankings.csv,2001,1.0,0.0
16431,Robert Blecker Wants Me Dead,9166,9166,0,2009_boxofficemojo_rankings.csv,2009,1.0,0.0
16432,The Hottest August,9163,9163,0,2019_boxofficemojo_rankings.csv,2019,1.0,0.0
16433,The Hollow Point,9149,0,9149,2016_boxofficemojo_rankings.csv,2016,0.0,1.0
16434,Just One More Kiss,9130,9130,0,2020_boxofficemojo_rankings.csv,2020,1.0,0.0
16435,Thirst Street,9129,9129,0,2017_boxofficemojo_rankings.csv,2017,1.0,0.0
16436,Cupcakes,9129,9129,0,2015_boxofficemojo_rankings.csv,2015,1.0,0.0
16437,The Ardennes 2016 Re-release,9116,5638,3478,2016_boxofficemojo_rankings.csv,2016,0.6184730144800351,0.3815269855199649
16438,Faith Connections,9111,9111,0,2014_boxofficemojo_rankings.csv,2014,1.0,0.0
16439,Lycan,9110,9110,0,2017_boxofficemojo_rankings.csv,2017,1.0,0.0
16440,The Eyes,9104,9104,0,2017_boxofficemojo_rankings.csv,2017,1.0,0.0
16441,Julian Schnabel: A Private Portrait,9103,9103,0,2017_boxofficemojo_rankings.csv,2017,1.0,0.0
16442,Decoding Deepak,9100,9100,0,2012_boxofficemojo_rankings.csv,2012,1.0,0.0
16443,Eight Days a Week,9090,9090,0,1999_boxofficemojo_rankings.csv,1999,1.0,0.0
16444,Il Posto,9080,9080,0,2002_boxofficemojo_rankings.csv,2002,1.0,0.0
16445,Out of the Past,9078,9078,0,1998_boxofficemojo_rankings.csv,1998,1.0,0.0
16446,Gerontophilia 2015 Re-release,9074,4916,4158,2015_boxofficemojo_rankings.csv,2015,0.541767687899493,0.45823231210050697
16447,The Janky Promoters,9069,9069,0,2009_boxofficemojo_rankings.csv,2009,1.0,0.0
16448,Hi-Life,9066,9066,0,1998_boxofficemojo_rankings.csv,1998,1.0,0.0
16449,El Mar La Mar,9065,9065,0,2018_boxofficemojo_rankings.csv,2018,1.0,0.0
16450,Living Life,9064,9064,0,2005_boxofficemojo_rankings.csv,2005,1.0,0.0
16451,Tequila Body Shots,9037,9037,0,1999_boxofficemojo_rankings.csv,1999,1.0,0.0
16452,Frantz Fanon: Black Skin White Mask,9025,9025,0,2019_boxofficemojo_rankings.csv,2019,1.0,0.0
16453,Step Up: High Water,9005,9005,0,2018_boxofficemojo_rankings.csv,2018,1.0,0.0
16454,Money Fight,9004,9004,0,2012_boxofficemojo_rankings.csv,2012,1.0,0.0
16455,Mosquita y Mari,9000,9000,0,2012_boxofficemojo_rankings.csv,2012,1.0,0.0
16456,Station to Station,9000,9000,0,2015_boxofficemojo_rankings.csv,2015,1.0,0.0
16457,Zoo Wars,8998,8998,0,2018_boxofficemojo_rankings.csv,2018,1.0,0.0
16458,Revolt,8986,0,8986,2017_boxofficemojo_rankings.csv,2017,0.0,1.0
16459,Survivors Guide To Prison,8982,8982,0,2018_boxofficemojo_rankings.csv,2018,1.0,0.0
16460,Colossal Youth,8968,8331,637,2018_boxofficemojo_rankings.csv,2018,0.9289696699375558,0.07103033006244425
16461,Big Words,8965,8965,0,2013_boxofficemojo_rankings.csv,2013,1.0,0.0
16462,Three Stars,8942,8942,0,2012_boxofficemojo_rankings.csv,2012,1.0,0.0
16463,Summer of '67,8941,8941,0,2018_boxofficemojo_rankings.csv,2018,1.0,0.0
16464,The Hawk,8906,8906,0,1993_boxofficemojo_rankings.csv,1993,1.0,0.0
16465,This is Congo,8905,7051,1854,2018_boxofficemojo_rankings.csv,2018,0.7918023582257159,0.2081976417742841
16466,Strike,8872,8872,0,2007_boxofficemojo_rankings.csv,2007,1.0,0.0
16467,B-Side,8870,8870,0,2015_boxofficemojo_rankings.csv,2015,1.0,0.0
16468,The Swenkas,8860,8860,0,2005_boxofficemojo_rankings.csv,2005,1.0,0.0
16469,Missing Young Woman,8858,8858,0,2003_boxofficemojo_rankings.csv,2003,1.0,0.0
16470,The Meanest Man in Texas,8850,8850,0,2019_boxofficemojo_rankings.csv,2019,1.0,0.0
16471,The Pardon,8845,8845,0,2015_boxofficemojo_rankings.csv,2015,1.0,0.0
16472,Providence,8840,8840,0,2016_boxofficemojo_rankings.csv,2016,1.0,0.0
16473,Out of the Blue 2007 Re-release,8826,1477,7349,2007_boxofficemojo_rankings.csv,2007,0.16734647631996374,0.8326535236800363
16474,Home Run Showdown,8824,8824,0,2012_boxofficemojo_rankings.csv,2012,1.0,0.0
16475,That Part Feeling - the Universe of Arvo Part,8812,8812,0,2019_boxofficemojo_rankings.csv,2019,1.0,0.0
16476,The Cabinet of Dr. Caligari 2014 Re-release,8811,8811,0,2014_boxofficemojo_rankings.csv,2014,1.0,0.0
16477,Dawn of the Crescent Moon,8799,8799,0,2015_boxofficemojo_rankings.csv,2015,1.0,0.0
16478,Hell Baby,8785,8785,0,2013_boxofficemojo_rankings.csv,2013,1.0,0.0
16479,Blood and Concrete,8780,8780,0,1991_boxofficemojo_rankings.csv,1991,1.0,0.0
16480,Bounce: Behind the Velvet Rope,8779,8779,0,2001_boxofficemojo_rankings.csv,2001,1.0,0.0
16481,Evil Remains,8747,8747,0,2004_boxofficemojo_rankings.csv,2004,1.0,0.0
16482,Everything Put Together,8741,2963,5778,2001_boxofficemojo_rankings.csv,2001,0.33897723372611827,0.6610227662738817
16483,Only When I Dance,8738,8738,0,2010_boxofficemojo_rankings.csv,2010,1.0,0.0
16484,Duet for One,8736,8736,0,1986_boxofficemojo_rankings.csv,1986,1.0,0.0
16485,Closing Escrow,8719,8719,0,2007_boxofficemojo_rankings.csv,2007,1.0,0.0
16486,The Man in the White Suit,8718,8718,0,2012_boxofficemojo_rankings.csv,2012,1.0,0.0
16487,Blood Feast,8708,8708,0,2018_boxofficemojo_rankings.csv,2018,1.0,0.0
16488,Amnesia,8700,8700,0,2017_boxofficemojo_rankings.csv,2017,1.0,0.0
16489,Man on a Mission: Richard Garriott's Road to the Stars,8688,8688,0,2012_boxofficemojo_rankings.csv,2012,1.0,0.0
16490,Without the King,8663,8663,0,2008_boxofficemojo_rankings.csv,2008,1.0,0.0
16491,Amexicano,8655,8655,0,2008_boxofficemojo_rankings.csv,2008,1.0,0.0
16492,Dosed,8643,0,8643,2019_boxofficemojo_rankings.csv,2019,0.0,1.0
16493,"Small, Beautifully Moving Parts",8631,8631,0,2012_boxofficemojo_rankings.csv,2012,1.0,0.0
16494,A Good Day to Be Black & Sexy,8629,8629,0,2008_boxofficemojo_rankings.csv,2008,1.0,0.0
16495,Meet Me in Montenegro,8612,8612,0,2015_boxofficemojo_rankings.csv,2015,1.0,0.0
16496,Almost Human,8608,8447,161,2014_boxofficemojo_rankings.csv,2014,0.981296468401487,0.018703531598513012
16497,Mojave,8602,8253,349,2016_boxofficemojo_rankings.csv,2016,0.9594280399906998,0.04057196000930016
16498,General Education,8601,8601,0,2012_boxofficemojo_rankings.csv,2012,1.0,0.0
16499,Farewell to Hollywood,8601,8601,0,2015_boxofficemojo_rankings.csv,2015,1.0,0.0
16500,G.I. Jesus,8593,8593,0,2007_boxofficemojo_rankings.csv,2007,1.0,0.0
16501,Kaena: The Prophecy 2004 Re-release,8593,8593,0,2004_boxofficemojo_rankings.csv,2004,1.0,0.0
16502,Lucky,8564,8564,0,2011_boxofficemojo_rankings.csv,2011,1.0,0.0
16503,From the East,8540,8540,0,2016_boxofficemojo_rankings.csv,2016,1.0,0.0
16504,Inspector Maigret,8528,8528,0,2017_boxofficemojo_rankings.csv,2017,1.0,0.0
16505,I Was a Jewish Sex Worker,8526,8526,0,1997_boxofficemojo_rankings.csv,1997,1.0,0.0
16506,The Quitter,8512,8512,0,2014_boxofficemojo_rankings.csv,2014,1.0,0.0
16507,The Empty Hours,8478,8244,234,2014_boxofficemojo_rankings.csv,2014,0.9723991507430998,0.027600849256900213
16508,Furlough,8472,8472,0,2018_boxofficemojo_rankings.csv,2018,1.0,0.0
16509,Zero Day,8466,8466,0,2003_boxofficemojo_rankings.csv,2003,1.0,0.0
16510,Canopy,8462,8462,0,2014_boxofficemojo_rankings.csv,2014,1.0,0.0
16511,Salvador Allende 2007 Re-release,8454,8454,0,2007_boxofficemojo_rankings.csv,2007,1.0,0.0
16512,Goodbye Momo,8453,8453,0,2007_boxofficemojo_rankings.csv,2007,1.0,0.0
16513,Blind Date,8449,8449,0,2009_boxofficemojo_rankings.csv,2009,1.0,0.0
16514,The Institute,8445,8445,0,2013_boxofficemojo_rankings.csv,2013,1.0,0.0
16515,We Are the Flesh,8438,8438,0,2017_boxofficemojo_rankings.csv,2017,1.0,0.0
16516,Hello Herman,8437,8437,0,2013_boxofficemojo_rankings.csv,2013,1.0,0.0
16517,Red Hollywood,8426,8426,0,2014_boxofficemojo_rankings.csv,2014,1.0,0.0
16518,The Happy Sad,8395,8395,0,2013_boxofficemojo_rankings.csv,2013,1.0,0.0
16519,Downloaded,8377,8377,0,2013_boxofficemojo_rankings.csv,2013,1.0,0.0
16520,Counting,8374,8374,0,2015_boxofficemojo_rankings.csv,2015,1.0,0.0
16521,Gilbert,8362,8362,0,2017_boxofficemojo_rankings.csv,2017,1.0,0.0
16522,The Rising Place,8360,8360,0,2002_boxofficemojo_rankings.csv,2002,1.0,0.0
16523,Eternity: The Movie,8350,8350,0,2014_boxofficemojo_rankings.csv,2014,1.0,0.0
16524,Stealing America: Vote by Vote,8350,8350,0,2008_boxofficemojo_rankings.csv,2008,1.0,0.0
16525,Gringo Trails,8349,8349,0,2014_boxofficemojo_rankings.csv,2014,1.0,0.0
16526,A Teacher,8348,8348,0,2013_boxofficemojo_rankings.csv,2013,1.0,0.0
16527,Ill Gotten Gains,8329,8329,0,1998_boxofficemojo_rankings.csv,1998,1.0,0.0
16528,Natasha,8325,8325,0,2017_boxofficemojo_rankings.csv,2017,1.0,0.0
16529,Winter of Frozen Dreams,8321,8321,0,2009_boxofficemojo_rankings.csv,2009,1.0,0.0
16530,The Dead Center,8320,8320,0,2019_boxofficemojo_rankings.csv,2019,1.0,0.0
16531,About Cherry,8315,3003,5312,2012_boxofficemojo_rankings.csv,2012,0.36115453998797353,0.6388454600120265
16532,Mr. Chibbs,8302,8302,0,2017_boxofficemojo_rankings.csv,2017,1.0,0.0
16533,Grace,8297,8297,0,2009_boxofficemojo_rankings.csv,2009,1.0,0.0
16534,Served Like a Girl,8290,8290,0,2017_boxofficemojo_rankings.csv,2017,1.0,0.0
16535,Yonkers Joe,8286,8286,0,2009_boxofficemojo_rankings.csv,2009,1.0,0.0
16536,We Are Twisted Fucking Sister!,8277,8277,0,2016_boxofficemojo_rankings.csv,2016,1.0,0.0
16537,Life Partners,8265,8265,0,2014_boxofficemojo_rankings.csv,2014,1.0,0.0
16538,Aliyah,8253,8253,0,2013_boxofficemojo_rankings.csv,2013,1.0,0.0
16539,Silicon Cowboys,8239,8239,0,2016_boxofficemojo_rankings.csv,2016,1.0,0.0
16540,The Innocent Sleep,8225,8225,0,1997_boxofficemojo_rankings.csv,1997,1.0,0.0
16541,The Etruscan Smile 2019 release,8213,8213,0,2019_boxofficemojo_rankings.csv,2019,1.0,0.0
16542,Brooklyn Brothers Beat the Best,8210,7466,744,2012_boxofficemojo_rankings.csv,2012,0.9093788063337394,0.09062119366626066
16543,Spiral,8190,8190,0,2018_boxofficemojo_rankings.csv,2018,1.0,0.0
16544,Jellyfish Eyes,8176,8176,0,2015_boxofficemojo_rankings.csv,2015,1.0,0.0
16545,Anatahan,8171,8171,0,2017_boxofficemojo_rankings.csv,2017,1.0,0.0
16546,Suspended Animation,8169,8169,0,2003_boxofficemojo_rankings.csv,2003,1.0,0.0
16547,The Other Side,8168,8074,94,2016_boxofficemojo_rankings.csv,2016,0.9884916748285995,0.011508325171400588
16548,Inside the Rain,8140,8140,0,2020_boxofficemojo_rankings.csv,2020,1.0,0.0
16549,Far from Vietnam,8132,8132,0,2013_boxofficemojo_rankings.csv,2013,1.0,0.0
16550,Twist of Faith,8129,8129,0,2005_boxofficemojo_rankings.csv,2005,1.0,0.0
16551,Loren Cass,8125,8125,0,2009_boxofficemojo_rankings.csv,2009,1.0,0.0
16552,From Nowhere,8109,8109,0,2017_boxofficemojo_rankings.csv,2017,1.0,0.0
16553,The Wave,8101,8101,0,2020_boxofficemojo_rankings.csv,2020,1.0,0.0
16554,Restless City,8100,8100,0,2012_boxofficemojo_rankings.csv,2012,1.0,0.0
16555,Next Year Jerusalem,8093,8093,0,2014_boxofficemojo_rankings.csv,2014,1.0,0.0
16556,In the Mirror of Maya Deren,8077,8077,0,2003_boxofficemojo_rankings.csv,2003,1.0,0.0
16557,Golden Kingdom,8077,8077,0,2016_boxofficemojo_rankings.csv,2016,1.0,0.0
16558,Spinning Into Butter,8064,8064,0,2009_boxofficemojo_rankings.csv,2009,1.0,0.0
16559,I Sell the Dead,8050,8050,0,2009_boxofficemojo_rankings.csv,2009,1.0,0.0
16560,16 Years of Alcohol,8046,8046,0,2005_boxofficemojo_rankings.csv,2005,1.0,0.0
16561,Fall to Grace,8043,8043,0,2006_boxofficemojo_rankings.csv,2006,1.0,0.0
16562,No Turning Back,8042,8042,0,2003_boxofficemojo_rankings.csv,2003,1.0,0.0
16563,Steak (R)evolution,8038,8025,13,2015_boxofficemojo_rankings.csv,2015,0.9983826822592685,0.0016173177407315252
16564,Reunion,8030,8030,0,2009_boxofficemojo_rankings.csv,2009,1.0,0.0
16565,The Iron Man,8025,8025,0,2007_boxofficemojo_rankings.csv,2007,1.0,0.0
16566,Straight Outta Tompkins,8022,8022,0,2015_boxofficemojo_rankings.csv,2015,1.0,0.0
16567,Occupation: Dreamland,8018,8018,0,2005_boxofficemojo_rankings.csv,2005,1.0,0.0
16568,The Scoundrel's Wife,8018,8018,0,2003_boxofficemojo_rankings.csv,2003,1.0,0.0
16569,La otra conquista 2007 Re-release,8000,8000,0,2007_boxofficemojo_rankings.csv,2007,1.0,0.0
16570,Brothers in Trouble,8000,8000,0,1997_boxofficemojo_rankings.csv,1997,1.0,0.0
16571,Talent Has Hunger,7998,7998,0,2016_boxofficemojo_rankings.csv,2016,1.0,0.0
16572,All About Evil,7995,7995,0,2010_boxofficemojo_rankings.csv,2010,1.0,0.0
16573,Paper Mask,7991,7991,0,1991_boxofficemojo_rankings.csv,1991,1.0,0.0
16574,Eleven Minutes,7986,7986,0,2009_boxofficemojo_rankings.csv,2009,1.0,0.0
16575,One Small Hitch 2015 Re-release,7965,7965,0,2015_boxofficemojo_rankings.csv,2015,1.0,0.0
16576,Roseanne for President!,7960,7960,0,2016_boxofficemojo_rankings.csv,2016,1.0,0.0
16577,Stolen,7943,7943,0,2010_boxofficemojo_rankings.csv,2010,1.0,0.0
16578,A Decent Factory,7925,7925,0,2005_boxofficemojo_rankings.csv,2005,1.0,0.0
16579,Mugabe and the White African,7924,7924,0,2010_boxofficemojo_rankings.csv,2010,1.0,0.0
16580,Angels Are Made Of Light,7919,7919,0,2019_boxofficemojo_rankings.csv,2019,1.0,0.0
16581,Portrait of a Garden,7914,7914,0,2016_boxofficemojo_rankings.csv,2016,1.0,0.0
16582,This Magnificent Cake!,7888,7888,0,2019_boxofficemojo_rankings.csv,2019,1.0,0.0
16583,Bleak Street,7888,0,7888,2015_boxofficemojo_rankings.csv,2015,0.0,1.0
16584,Coastlines,7883,7883,0,2006_boxofficemojo_rankings.csv,2006,1.0,0.0
16585,I AM PATRICK,7880,0,7880,2020_boxofficemojo_rankings.csv,2020,0.0,1.0
16586,Swept Away,7876,7876,0,2017_boxofficemojo_rankings.csv,2017,1.0,0.0
16587,Resident Alien,7867,7867,0,1991_boxofficemojo_rankings.csv,1991,1.0,0.0
16588,Zenith,7862,7862,0,2010_boxofficemojo_rankings.csv,2010,1.0,0.0
16589,The Ballad of Lefty Brown,7856,7856,0,2017_boxofficemojo_rankings.csv,2017,1.0,0.0
16590,Ghost Fleet,7850,7850,0,2019_boxofficemojo_rankings.csv,2019,1.0,0.0
16591,Prince of Central Park,7838,7838,0,2000_boxofficemojo_rankings.csv,2000,1.0,0.0
16592,Roadie,7825,7825,0,2012_boxofficemojo_rankings.csv,2012,1.0,0.0
16593,Photographic Memory,7822,7822,0,2012_boxofficemojo_rankings.csv,2012,1.0,0.0
16594,The Great Man,7814,7814,0,2015_boxofficemojo_rankings.csv,2015,1.0,0.0
16595,Archipelago 2014 Re-release,7791,7791,0,2014_boxofficemojo_rankings.csv,2014,1.0,0.0
16596,The Plagiarists,7768,7768,0,2019_boxofficemojo_rankings.csv,2019,1.0,0.0
16597,Old Stone,7768,7476,292,2016_boxofficemojo_rankings.csv,2016,0.962409886714727,0.03759011328527292
16598,Zerophilia,7763,7763,0,2006_boxofficemojo_rankings.csv,2006,1.0,0.0
16599,Kill Your Idols,7753,7753,0,2006_boxofficemojo_rankings.csv,2006,1.0,0.0
16600,And While We Were Here,7750,7750,0,2013_boxofficemojo_rankings.csv,2013,1.0,0.0
16601,Come Back to Me,7744,7744,0,2014_boxofficemojo_rankings.csv,2014,1.0,0.0
16602,Young Ones,7740,0,7740,2014_boxofficemojo_rankings.csv,2014,0.0,1.0
16603,A Walk to Beautiful,7718,7718,0,2008_boxofficemojo_rankings.csv,2008,1.0,0.0
16604,Gregory's Girl,7710,7710,0,2019_boxofficemojo_rankings.csv,2019,1.0,0.0
16605,Maurizio Cattelan: Be Right Back,7706,7706,0,2017_boxofficemojo_rankings.csv,2017,1.0,0.0
16606,I Don't Belong Anywhere: The Cinema of Chantal Akerman,7703,7703,0,2016_boxofficemojo_rankings.csv,2016,1.0,0.0
16607,Witness for the Prosecution,7693,0,7693,2003_boxofficemojo_rankings.csv,2003,0.0,1.0
16608,With All Deliberate Speed,7690,7690,0,2004_boxofficemojo_rankings.csv,2004,1.0,0.0
16609,Space Rage,7689,7689,0,1986_boxofficemojo_rankings.csv,1986,1.0,0.0
16610,The Last of the High Kings,7682,7682,0,1998_boxofficemojo_rankings.csv,1998,1.0,0.0
16611,Running Shaadi,7674,0,7674,2017_boxofficemojo_rankings.csv,2017,0.0,1.0
16612,Valley Girl,7671,0,7671,2020_boxofficemojo_rankings.csv,2020,0.0,1.0
16613,El sueño del regreso,7668,7668,0,2006_boxofficemojo_rankings.csv,2006,1.0,0.0
16614,The Whore's Son,7656,7656,0,2006_boxofficemojo_rankings.csv,2006,1.0,0.0
16615,Masai: The Rain Warriors 2006 Re-release,7650,7650,0,2006_boxofficemojo_rankings.csv,2006,1.0,0.0
16616,Last Days Here,7643,7643,0,2012_boxofficemojo_rankings.csv,2012,1.0,0.0
16617,Legend of the Mountain,7640,7640,0,2018_boxofficemojo_rankings.csv,2018,1.0,0.0
16618,Jazz in the Diamond District,7634,7634,0,2009_boxofficemojo_rankings.csv,2009,1.0,0.0
16619,Wasabi Tuna,7631,7631,0,2004_boxofficemojo_rankings.csv,2004,1.0,0.0
16620,Psycho Raman,7612,0,7612,2016_boxofficemojo_rankings.csv,2016,0.0,1.0
16621,Area 51,7556,7556,0,2015_boxofficemojo_rankings.csv,2015,1.0,0.0
16622,A Business Affair,7556,7556,0,1995_boxofficemojo_rankings.csv,1995,1.0,0.0
16623,The Wrong Light,7553,7553,0,2017_boxofficemojo_rankings.csv,2017,1.0,0.0
16624,Controlled Chaos,7549,7549,0,2003_boxofficemojo_rankings.csv,2003,1.0,0.0
16625,Tales from the Script,7535,7535,0,2010_boxofficemojo_rankings.csv,2010,1.0,0.0
16626,Girls Against Boys,7529,7529,0,2013_boxofficemojo_rankings.csv,2013,1.0,0.0
16627,Birthright: A War Story,7519,7519,0,2017_boxofficemojo_rankings.csv,2017,1.0,0.0
16628,loudQUIETloud: A Film About the Pixies,7506,7506,0,2006_boxofficemojo_rankings.csv,2006,1.0,0.0
16629,Disappearances,7506,7506,0,2007_boxofficemojo_rankings.csv,2007,1.0,0.0
16630,Udaan,7461,7461,0,2010_boxofficemojo_rankings.csv,2010,1.0,0.0
16631,The Cult of the Suicide Bomber,7451,7451,0,2006_boxofficemojo_rankings.csv,2006,1.0,0.0
16632,The Little Bedroom 2014 Re-release,7440,7440,0,2014_boxofficemojo_rankings.csv,2014,1.0,0.0
16633,Raze,7429,7429,0,2014_boxofficemojo_rankings.csv,2014,1.0,0.0
16634,Bel Borba Aqui,7426,7426,0,2012_boxofficemojo_rankings.csv,2012,1.0,0.0
16635,The Dogwalker,7420,7420,0,2002_boxofficemojo_rankings.csv,2002,1.0,0.0
16636,Rubble Kings,7416,7416,0,2015_boxofficemojo_rankings.csv,2015,1.0,0.0
16637,Price Check,7413,7413,0,2012_boxofficemojo_rankings.csv,2012,1.0,0.0
16638,The Giant Mechanical Man,7396,7396,0,2012_boxofficemojo_rankings.csv,2012,1.0,0.0
16639,Silent Waters,7384,7384,0,2004_boxofficemojo_rankings.csv,2004,1.0,0.0
16640,Desperate Acts of Magic,7373,7373,0,2013_boxofficemojo_rankings.csv,2013,1.0,0.0
16641,Gendernauts: A Journey Through Shifting Identities,7358,7358,0,2000_boxofficemojo_rankings.csv,2000,1.0,0.0
16642,Big Time,7347,7347,0,2017_boxofficemojo_rankings.csv,2017,1.0,0.0
16643,The Amazing Truth About Queen Raquela,7328,5597,1731,2008_boxofficemojo_rankings.csv,2008,0.763782751091703,0.23621724890829696
16644,Sparkler,7326,7326,0,1999_boxofficemojo_rankings.csv,1999,1.0,0.0
16645,Shoah: Four Sisters,7323,7323,0,2018_boxofficemojo_rankings.csv,2018,1.0,0.0
16646,Beloved Beast,7301,7301,0,2019_boxofficemojo_rankings.csv,2019,1.0,0.0
16647,A Piece of Eden,7296,7296,0,2000_boxofficemojo_rankings.csv,2000,1.0,0.0
16648,Gangster's Paradise: Jerusalema 2010 Re-release,7294,7294,0,2010_boxofficemojo_rankings.csv,2010,1.0,0.0
16649,Another WolfCop,7285,7285,0,2017_boxofficemojo_rankings.csv,2017,1.0,0.0
16650,Group,7281,7281,0,2002_boxofficemojo_rankings.csv,2002,1.0,0.0
16651,Casting About,7279,7279,0,2007_boxofficemojo_rankings.csv,2007,1.0,0.0
16652,Century,7271,7271,0,1994_boxofficemojo_rankings.csv,1994,1.0,0.0
16653,Indian Point,7251,7251,0,2016_boxofficemojo_rankings.csv,2016,1.0,0.0
16654,Too Outrageous Animation,7241,7241,0,1995_boxofficemojo_rankings.csv,1995,1.0,0.0
16655,Outside Satan,7226,0,7226,2013_boxofficemojo_rankings.csv,2013,0.0,1.0
16656,Tall: The American Skyscraper and Louis Sullivan,7216,7216,0,2018_boxofficemojo_rankings.csv,2018,1.0,0.0
16657,Wake,7212,7212,0,2004_boxofficemojo_rankings.csv,2004,1.0,0.0
16658,I Am Ali,7205,7205,0,2014_boxofficemojo_rankings.csv,2014,1.0,0.0
16659,Special 2008 Re-release,7202,7202,0,2008_boxofficemojo_rankings.csv,2008,1.0,0.0
16660,London River 2011 Re-release,7200,7200,0,2011_boxofficemojo_rankings.csv,2011,1.0,0.0
16661,Happiness Runs,7199,7199,0,2010_boxofficemojo_rankings.csv,2010,1.0,0.0
16662,Kettle of Fish,7196,7196,0,2006_boxofficemojo_rankings.csv,2006,1.0,0.0
16663,Antarctic Edge: 70° South,7193,7193,0,2015_boxofficemojo_rankings.csv,2015,1.0,0.0
16664,The Strange Color of Your Body's Tears,7182,7182,0,2014_boxofficemojo_rankings.csv,2014,1.0,0.0
16665,ABCs of Death 2,7171,7171,0,2014_boxofficemojo_rankings.csv,2014,1.0,0.0
16666,It Had to Be You,7162,7162,0,2016_boxofficemojo_rankings.csv,2016,1.0,0.0
16667,"Brutti, sporchi e cattivi",7144,7144,0,2016_boxofficemojo_rankings.csv,2016,1.0,0.0
16668,Logan,7137,7137,0,2010_boxofficemojo_rankings.csv,2010,1.0,0.0
16669,Saint of 9/11,7137,7137,0,2006_boxofficemojo_rankings.csv,2006,1.0,0.0
16670,"Sorry, Haters",7129,7129,0,2006_boxofficemojo_rankings.csv,2006,1.0,0.0
16671,Mendy,7123,7123,0,2006_boxofficemojo_rankings.csv,2006,1.0,0.0
16672,The Reagan Show,7109,5500,1609,2017_boxofficemojo_rankings.csv,2017,0.7736671824447883,0.2263328175552117
16673,Domain 2012 Re-release,7105,7105,0,2012_boxofficemojo_rankings.csv,2012,1.0,0.0
16674,The Jazz Funeral,7103,7103,0,2017_boxofficemojo_rankings.csv,2017,1.0,0.0
16675,The Dark Below,7095,7095,0,2017_boxofficemojo_rankings.csv,2017,1.0,0.0
16676,Painless,7082,7082,0,2018_boxofficemojo_rankings.csv,2018,1.0,0.0
16677,Stage Fright,7078,7078,0,2014_boxofficemojo_rankings.csv,2014,1.0,0.0
16678,Quantum Hoops,7075,7075,0,2007_boxofficemojo_rankings.csv,2007,1.0,0.0
16679,Good Neighbours,7072,7072,0,2011_boxofficemojo_rankings.csv,2011,1.0,0.0
16680,In Echo Park,7072,7072,0,2018_boxofficemojo_rankings.csv,2018,1.0,0.0
16681,The Brainwashing of My Dad,7028,7028,0,2016_boxofficemojo_rankings.csv,2016,1.0,0.0
16682,In the Land of Pomegranates,7014,7014,0,2018_boxofficemojo_rankings.csv,2018,1.0,0.0
16683,Corman's World: Exploits of a Hollywood Rebel,7000,7000,0,2011_boxofficemojo_rankings.csv,2011,1.0,0.0
16684,Aristide and the Endless Revolution,6998,6998,0,2005_boxofficemojo_rankings.csv,2005,1.0,0.0
16685,The Brass Teapot,6997,6997,0,2013_boxofficemojo_rankings.csv,2013,1.0,0.0
16686,The Camden 28,6983,6983,0,2007_boxofficemojo_rankings.csv,2007,1.0,0.0
16687,What We Found,6976,6976,0,2020_boxofficemojo_rankings.csv,2020,1.0,0.0
16688,Fathers & Sons,6960,6960,0,1992_boxofficemojo_rankings.csv,1992,1.0,0.0
16689,Gabriel,6959,6959,0,2015_boxofficemojo_rankings.csv,2015,1.0,0.0
16690,I Stand Alone,6955,6955,0,1999_boxofficemojo_rankings.csv,1999,1.0,0.0
16691,"Love, Marilyn",6950,6950,0,2012_boxofficemojo_rankings.csv,2012,1.0,0.0
16692,Los Angeles Plays Itself,6945,6945,0,2004_boxofficemojo_rankings.csv,2004,1.0,0.0
16693,The Jew in the Lotus,6940,6940,0,1998_boxofficemojo_rankings.csv,1998,1.0,0.0
16694,A Kind of Loving,6912,6912,0,2017_boxofficemojo_rankings.csv,2017,1.0,0.0
16695,Assaulted: Civil Rights Under Fire,6905,6905,0,2013_boxofficemojo_rankings.csv,2013,1.0,0.0
16696,Black Irish,6900,6900,0,2007_boxofficemojo_rankings.csv,2007,1.0,0.0
16697,Boom Bust Boom,6896,6896,0,2016_boxofficemojo_rankings.csv,2016,1.0,0.0
16698,Misconceptions,6892,6892,0,2010_boxofficemojo_rankings.csv,2010,1.0,0.0
16699,Sal,6883,6883,0,2013_boxofficemojo_rankings.csv,2013,1.0,0.0
16700,The Human Scale,6878,6878,0,2013_boxofficemojo_rankings.csv,2013,1.0,0.0
16701,Duck Butter,6877,6877,0,2018_boxofficemojo_rankings.csv,2018,1.0,0.0
16702,The Sisterhood of Night,6870,6870,0,2015_boxofficemojo_rankings.csv,2015,1.0,0.0
16703,Speaking in Strings,6859,6859,0,1999_boxofficemojo_rankings.csv,1999,1.0,0.0
16704,Last Ride 2012 Re-release,6853,6853,0,2012_boxofficemojo_rankings.csv,2012,1.0,0.0
16705,Pursuit of Happiness,6850,6850,0,2003_boxofficemojo_rankings.csv,2003,1.0,0.0
16706,Janie Jones,6840,6840,0,2011_boxofficemojo_rankings.csv,2011,1.0,0.0
16707,Farce of the Penguins,6832,0,6832,2007_boxofficemojo_rankings.csv,2007,0.0,1.0
16708,Mad Tiger,6823,6823,0,2016_boxofficemojo_rankings.csv,2016,1.0,0.0
16709,"No God, No Master",6796,6796,0,2014_boxofficemojo_rankings.csv,2014,1.0,0.0
16710,Operation Homecoming: Writing the Wartime Experience,6795,6795,0,2007_boxofficemojo_rankings.csv,2007,1.0,0.0
16711,Blood of His Own,6792,6792,0,1998_boxofficemojo_rankings.csv,1998,1.0,0.0
16712,Finding Bliss,6783,6783,0,2010_boxofficemojo_rankings.csv,2010,1.0,0.0
16713,Mercy,6780,6780,0,2010_boxofficemojo_rankings.csv,2010,1.0,0.0
16714,Going Attractions: The Definitive Story of the Movie Palace,6763,6763,0,2019_boxofficemojo_rankings.csv,2019,1.0,0.0
16715,The Other Lamb,6760,6024,736,2020_boxofficemojo_rankings.csv,2020,0.8911242603550296,0.10887573964497041
16716,Calling All Earthlings,6756,6756,0,2018_boxofficemojo_rankings.csv,2018,1.0,0.0
16717,Dying to Survive 2019 Re-release,6752,6752,0,2019_boxofficemojo_rankings.csv,2019,1.0,0.0
16718,A Whale of a Tale,6747,6747,0,2018_boxofficemojo_rankings.csv,2018,1.0,0.0
16719,Buddha Heads,6739,6739,0,2002_boxofficemojo_rankings.csv,2002,1.0,0.0
16720,Dreaming Grand Avenue,6726,6726,0,2020_boxofficemojo_rankings.csv,2020,1.0,0.0
16721,Iceman,6719,2138,4581,2018_boxofficemojo_rankings.csv,2018,0.3182021134097336,0.6817978865902664
16722,Before You Know It,6717,6717,0,2014_boxofficemojo_rankings.csv,2014,1.0,0.0
16723,Regina Spektor Live in London,6684,6684,0,2010_boxofficemojo_rankings.csv,2010,1.0,0.0
16724,"Arabian Nights - Volume 3, The Enchanted One",6681,4502,2179,2015_boxofficemojo_rankings.csv,2015,0.6738512198772639,0.3261487801227361
16725,Footnotes 2017 Re-release,6660,6660,0,2017_boxofficemojo_rankings.csv,2017,1.0,0.0
16726,Ghost Team,6639,6639,0,2016_boxofficemojo_rankings.csv,2016,1.0,0.0
16727,The Persian Connection,6634,6634,0,2017_boxofficemojo_rankings.csv,2017,1.0,0.0
16728,Breakfast with Curtis,6629,6629,0,2013_boxofficemojo_rankings.csv,2013,1.0,0.0
16729,Take,6627,6627,0,2008_boxofficemojo_rankings.csv,2008,1.0,0.0
16730,The Dying of the Light,6627,6627,0,2016_boxofficemojo_rankings.csv,2016,1.0,0.0
16731,Skid Row,6627,6627,0,2007_boxofficemojo_rankings.csv,2007,1.0,0.0
16732,Sweet Country,6614,6614,0,1987_boxofficemojo_rankings.csv,1987,1.0,0.0
16733,Aatsinki: The Story of Arctic Cowboys,6601,6601,0,2014_boxofficemojo_rankings.csv,2014,1.0,0.0
16734,Brief Reunion,6601,6601,0,2013_boxofficemojo_rankings.csv,2013,1.0,0.0
16735,Human Capital,6596,6596,0,2020_boxofficemojo_rankings.csv,2020,1.0,0.0
16736,Down the Shore,6558,6558,0,2013_boxofficemojo_rankings.csv,2013,1.0,0.0
16737,Master of the Game,6554,6554,0,2004_boxofficemojo_rankings.csv,2004,1.0,0.0
16738,In Our Nature,6543,6543,0,2012_boxofficemojo_rankings.csv,2012,1.0,0.0
16739,Elizabeth Blue,6542,6542,0,2017_boxofficemojo_rankings.csv,2017,1.0,0.0
16740,Pretty Ugly People,6537,6537,0,2009_boxofficemojo_rankings.csv,2009,1.0,0.0
16741,Dream Boy,6534,6534,0,2010_boxofficemojo_rankings.csv,2010,1.0,0.0
16742,The Aggressives,6533,6533,0,2005_boxofficemojo_rankings.csv,2005,1.0,0.0
16743,We Go Way Back,6529,6529,0,2006_boxofficemojo_rankings.csv,2006,1.0,0.0
16744,Spiral Farm,6517,6517,0,2019_boxofficemojo_rankings.csv,2019,1.0,0.0
16745,Bloody Angels,6509,6509,0,2001_boxofficemojo_rankings.csv,2001,1.0,0.0
16746,Horse Money,6508,6508,0,2015_boxofficemojo_rankings.csv,2015,1.0,0.0
16747,Jews of Egypt,6505,6505,0,2014_boxofficemojo_rankings.csv,2014,1.0,0.0
16748,The Last Place on Earth,6505,6505,0,2004_boxofficemojo_rankings.csv,2004,1.0,0.0
16749,Windfall,6504,6504,0,2012_boxofficemojo_rankings.csv,2012,1.0,0.0
16750,Ride,6489,0,6489,2015_boxofficemojo_rankings.csv,2015,0.0,1.0
16751,The Beat Hotel,6480,6480,0,2012_boxofficemojo_rankings.csv,2012,1.0,0.0
16752,Afterward,6477,6477,0,2020_boxofficemojo_rankings.csv,2020,1.0,0.0
16753,Santa santita,6470,6470,0,2005_boxofficemojo_rankings.csv,2005,1.0,0.0
16754,Scum,6461,6461,0,2017_boxofficemojo_rankings.csv,2017,1.0,0.0
16755,"White King, Red Rubber, Black Death",6458,6458,0,2005_boxofficemojo_rankings.csv,2005,1.0,0.0
16756,McLibel,6450,4337,2113,2005_boxofficemojo_rankings.csv,2005,0.6724031007751938,0.3275968992248062
16757,Tu Dors Nicole,6445,5662,783,2015_boxofficemojo_rankings.csv,2015,0.8785104732350659,0.12148952676493406
16758,Beyond Honor,6437,6437,0,2006_boxofficemojo_rankings.csv,2006,1.0,0.0
16759,The Suicide Theory,6434,6434,0,2015_boxofficemojo_rankings.csv,2015,1.0,0.0
16760,Some Velvet Morning,6420,6420,0,2013_boxofficemojo_rankings.csv,2013,1.0,0.0
16761,Ten 'til Noon,6404,6404,0,2007_boxofficemojo_rankings.csv,2007,1.0,0.0
16762,Nuit et jour,6397,6397,0,1992_boxofficemojo_rankings.csv,1992,1.0,0.0
16763,100 Bloody Acres,6388,6388,0,2013_boxofficemojo_rankings.csv,2013,1.0,0.0
16764,Dreamland,6383,6383,0,2006_boxofficemojo_rankings.csv,2006,1.0,0.0
16765,Forty Guns,6344,0,6344,2002_boxofficemojo_rankings.csv,2002,0.0,1.0
16766,Inescapable,6334,6334,0,2013_boxofficemojo_rankings.csv,2013,1.0,0.0
16767,The Charnel House,6332,6332,0,2016_boxofficemojo_rankings.csv,2016,1.0,0.0
16768,Zardoz,6320,0,6320,2008_boxofficemojo_rankings.csv,2008,0.0,1.0
16769,Watercolors,6305,6305,0,2010_boxofficemojo_rankings.csv,2010,1.0,0.0
16770,Manuscripts Don't Burn,6295,6295,0,2014_boxofficemojo_rankings.csv,2014,1.0,0.0
16771,Under the Eiffel Tower,6291,6291,0,2019_boxofficemojo_rankings.csv,2019,1.0,0.0
16772,Solitude,6260,6260,0,2005_boxofficemojo_rankings.csv,2005,1.0,0.0
16773,The Skyjacker's Tale,6253,6253,0,2017_boxofficemojo_rankings.csv,2017,1.0,0.0
16774,Tar,6241,6241,0,2020_boxofficemojo_rankings.csv,2020,1.0,0.0
16775,All My Loved Ones,6237,6237,0,2002_boxofficemojo_rankings.csv,2002,1.0,0.0
16776,Tarantella,6235,6235,0,1996_boxofficemojo_rankings.csv,1996,1.0,0.0
16777,One Last Thing,6232,6232,0,2018_boxofficemojo_rankings.csv,2018,1.0,0.0
16778,In the Steps of Trisha Brown,6230,6230,0,2017_boxofficemojo_rankings.csv,2017,1.0,0.0
16779,The Bad Kids,6226,6226,0,2016_boxofficemojo_rankings.csv,2016,1.0,0.0
16780,By the Sword,6220,6220,0,1993_boxofficemojo_rankings.csv,1993,1.0,0.0
16781,A Man Vanishes 2012 Re-release,6201,6201,0,2012_boxofficemojo_rankings.csv,2012,1.0,0.0
16782,Heavy Metal in Baghdad,6197,4070,2127,2008_boxofficemojo_rankings.csv,2008,0.656769404550589,0.343230595449411
16783,The Red Chapel,6196,6196,0,2010_boxofficemojo_rankings.csv,2010,1.0,0.0
16784,The Night of the Shooting Stars 2015 Re-release,6186,6186,0,2015_boxofficemojo_rankings.csv,2015,1.0,0.0
16785,To Be of Service,6173,6173,0,2019_boxofficemojo_rankings.csv,2019,1.0,0.0
16786,The Phantom of Liberty 2002 Re-release,6172,6172,0,2002_boxofficemojo_rankings.csv,2002,1.0,0.0
16787,Not Bad for a Girl,6152,6152,0,1996_boxofficemojo_rankings.csv,1996,1.0,0.0
16788,Forget Baghdad: Jews and Arabs - The Iraqi Connection,6151,3741,2410,2003_boxofficemojo_rankings.csv,2003,0.6081937896277028,0.3918062103722972
16789,Sweetwater,6147,6147,0,2013_boxofficemojo_rankings.csv,2013,1.0,0.0
16790,Crazy Eyes,6141,6141,0,2012_boxofficemojo_rankings.csv,2012,1.0,0.0
16791,Relaxer,6133,6133,0,2019_boxofficemojo_rankings.csv,2019,1.0,0.0
16792,Guitar Innovators: John Fahey & Nels Cline,6132,6132,0,2013_boxofficemojo_rankings.csv,2013,1.0,0.0
16793,Missing Link,6127,6127,0,1988_boxofficemojo_rankings.csv,1988,1.0,0.0
16794,"El Sicario, Room 164",6123,6123,0,2011_boxofficemojo_rankings.csv,2011,1.0,0.0
16795,Scottsboro: An American Tragedy,6123,6123,0,2001_boxofficemojo_rankings.csv,2001,1.0,0.0
16796,Welcome to Pine Hill,6115,6115,0,2013_boxofficemojo_rankings.csv,2013,1.0,0.0
16797,Arise from Darkness,6112,6112,0,2017_boxofficemojo_rankings.csv,2017,1.0,0.0
16798,Rangrezz,6108,6108,0,2013_boxofficemojo_rankings.csv,2013,1.0,0.0
16799,The Last Fall,6100,6100,0,2012_boxofficemojo_rankings.csv,2012,1.0,0.0
16800,The Last Time I Saw Macao,6095,6095,0,2013_boxofficemojo_rankings.csv,2013,1.0,0.0
16801,The Calling 2003 Re-release,6092,6092,0,2003_boxofficemojo_rankings.csv,2003,1.0,0.0
16802,The Fuzz,6067,6067,0,2017_boxofficemojo_rankings.csv,2017,1.0,0.0
16803,The Miners' Hymns,6051,6051,0,2012_boxofficemojo_rankings.csv,2012,1.0,0.0
16804,The Marquise of O,6048,6048,0,2015_boxofficemojo_rankings.csv,2015,1.0,0.0
16805,Love & Air Sex,6047,6047,0,2014_boxofficemojo_rankings.csv,2014,1.0,0.0
16806,Blood Widow,6047,6047,0,2019_boxofficemojo_rankings.csv,2019,1.0,0.0
16807,The Family Tree,6035,6035,0,2011_boxofficemojo_rankings.csv,2011,1.0,0.0
16808,Love Object,6028,6028,0,2004_boxofficemojo_rankings.csv,2004,1.0,0.0
16809,On the Rumba River,6021,1698,4323,2008_boxofficemojo_rankings.csv,2008,0.2820129546586946,0.7179870453413054
16810,BearCity,6000,6000,0,2010_boxofficemojo_rankings.csv,2010,1.0,0.0
16811,The Bride & The Grooms,5995,5995,0,2009_boxofficemojo_rankings.csv,2009,1.0,0.0
16812,Rat,5980,2630,3350,2001_boxofficemojo_rankings.csv,2001,0.4397993311036789,0.560200668896321
16813,On Wings of Eagles 2017 Re-release,5975,5975,0,2017_boxofficemojo_rankings.csv,2017,1.0,0.0
16814,"Sex, Death and Bowling",5972,5972,0,2015_boxofficemojo_rankings.csv,2015,1.0,0.0
16815,The Playroom,5964,5964,0,2013_boxofficemojo_rankings.csv,2013,1.0,0.0
16816,Cavemen,5948,5948,0,2014_boxofficemojo_rankings.csv,2014,1.0,0.0
16817,Starless Dreams,5937,5937,0,2017_boxofficemojo_rankings.csv,2017,1.0,0.0
16818,American Animal,5928,5928,0,2012_boxofficemojo_rankings.csv,2012,1.0,0.0
16819,Waiting for Dublin,5925,5925,0,2009_boxofficemojo_rankings.csv,2009,1.0,0.0
16820,Sweethearts of the Prison Rodeo,5922,5922,0,2010_boxofficemojo_rankings.csv,2010,1.0,0.0
16821,I Am MLK Jr.,5918,5918,0,2018_boxofficemojo_rankings.csv,2018,1.0,0.0
16822,Gang of Ghosts,5906,5906,0,2014_boxofficemojo_rankings.csv,2014,1.0,0.0
16823,Slash,5902,5902,0,2016_boxofficemojo_rankings.csv,2016,1.0,0.0
16824,The Vagrant,5900,5900,0,1992_boxofficemojo_rankings.csv,1992,1.0,0.0
16825,Medeas,5895,5895,0,2015_boxofficemojo_rankings.csv,2015,1.0,0.0
16826,An Actor Prepares,5891,1743,4148,2018_boxofficemojo_rankings.csv,2018,0.2958750636564251,0.704124936343575
16827,Infliction,5875,5875,0,2014_boxofficemojo_rankings.csv,2014,1.0,0.0
16828,The Imperialists Are Still Alive!,5874,5874,0,2011_boxofficemojo_rankings.csv,2011,1.0,0.0
16829,Let It Come Down: The Life of Paul Bowles,5869,5869,0,1999_boxofficemojo_rankings.csv,1999,1.0,0.0
16830,December,5868,5868,0,1991_boxofficemojo_rankings.csv,1991,1.0,0.0
16831,Empire of Silver 2011 Re-release,5867,0,5867,2011_boxofficemojo_rankings.csv,2011,0.0,1.0
16832,BuzzKill,5860,5860,0,2012_boxofficemojo_rankings.csv,2012,1.0,0.0
16833,Top Spin,5858,5858,0,2015_boxofficemojo_rankings.csv,2015,1.0,0.0
16834,Bourek,5844,5844,0,2016_boxofficemojo_rankings.csv,2016,1.0,0.0
16835,Shout Gladi Gladi,5839,5839,0,2015_boxofficemojo_rankings.csv,2015,1.0,0.0
16836,Strike! 2000 Re-release,5838,5838,0,2000_boxofficemojo_rankings.csv,2000,1.0,0.0
16837,Human Nature,5834,5487,347,2019_boxofficemojo_rankings.csv,2019,0.9405210833047651,0.05947891669523483
16838,Devil's Island,5814,5814,0,1999_boxofficemojo_rankings.csv,1999,1.0,0.0
16839,Bad Blood,5812,5812,0,2001_boxofficemojo_rankings.csv,2001,1.0,0.0
16840,Emile,5799,5799,0,2005_boxofficemojo_rankings.csv,2005,1.0,0.0
16841,Choose Connor,5788,5788,0,2008_boxofficemojo_rankings.csv,2008,1.0,0.0
16842,Five Dances,5788,5788,0,2013_boxofficemojo_rankings.csv,2013,1.0,0.0
16843,Black November,5782,5782,0,2015_boxofficemojo_rankings.csv,2015,1.0,0.0
16844,Undrafted,5777,5777,0,2016_boxofficemojo_rankings.csv,2016,1.0,0.0
16845,In the Life of Music,5772,5772,0,2020_boxofficemojo_rankings.csv,2020,1.0,0.0
16846,Sushi: The Global Catch,5757,5757,0,2012_boxofficemojo_rankings.csv,2012,1.0,0.0
16847,A Dark Truth,5750,5750,0,2013_boxofficemojo_rankings.csv,2013,1.0,0.0
16848,Sex and the Future,5745,5745,0,2020_boxofficemojo_rankings.csv,2020,1.0,0.0
16849,Jailbait,5741,5741,0,2006_boxofficemojo_rankings.csv,2006,1.0,0.0
16850,The Overture 2005 Re-release,5740,2254,3486,2005_boxofficemojo_rankings.csv,2005,0.3926829268292683,0.6073170731707317
16851,Love Goes Public,5738,5738,0,2019_boxofficemojo_rankings.csv,2019,1.0,0.0
16852,Dream,5729,5729,0,2005_boxofficemojo_rankings.csv,2005,1.0,0.0
16853,Klezmer on Fish Street,5724,5724,0,2004_boxofficemojo_rankings.csv,2004,1.0,0.0
16854,Save the Date,5719,5719,0,2012_boxofficemojo_rankings.csv,2012,1.0,0.0
16855,Pizza,5716,5716,0,2006_boxofficemojo_rankings.csv,2006,1.0,0.0
16856,Fraulein,5715,5715,0,2008_boxofficemojo_rankings.csv,2008,1.0,0.0
16857,Mr. Blue Sky,5713,5713,0,2007_boxofficemojo_rankings.csv,2007,1.0,0.0
16858,Knockin' on Heaven's Door,5710,5710,0,1999_boxofficemojo_rankings.csv,1999,1.0,0.0
16859,The Wanted 18,5680,5680,0,2015_boxofficemojo_rankings.csv,2015,1.0,0.0
16860,People of a Feather,5677,5677,0,2013_boxofficemojo_rankings.csv,2013,1.0,0.0
16861,The Fall of Night,5673,5673,0,2010_boxofficemojo_rankings.csv,2010,1.0,0.0
16862,Fired!,5661,5661,0,2007_boxofficemojo_rankings.csv,2007,1.0,0.0
16863,Knife Fight,5661,5661,0,2013_boxofficemojo_rankings.csv,2013,1.0,0.0
16864,Papirosen,5658,5658,0,2014_boxofficemojo_rankings.csv,2014,1.0,0.0
16865,This Isn't Funny,5654,5654,0,2015_boxofficemojo_rankings.csv,2015,1.0,0.0
16866,The Roost,5642,5642,0,2005_boxofficemojo_rankings.csv,2005,1.0,0.0
16867,Série noire,5633,5633,0,2019_boxofficemojo_rankings.csv,2019,1.0,0.0
16868,La Chinoise 2017 Re-release,5631,5631,0,2017_boxofficemojo_rankings.csv,2017,1.0,0.0
16869,Elevate,5580,5580,0,2011_boxofficemojo_rankings.csv,2011,1.0,0.0
16870,Our Man in Tehran,5573,5573,0,2015_boxofficemojo_rankings.csv,2015,1.0,0.0
16871,Kid Cannabis,5565,5565,0,2014_boxofficemojo_rankings.csv,2014,1.0,0.0
16872,The Miracle of the Little Prince,5553,5553,0,2019_boxofficemojo_rankings.csv,2019,1.0,0.0
16873,Booker's Place: A Mississippi Story,5549,5549,0,2012_boxofficemojo_rankings.csv,2012,1.0,0.0
16874,Gogol Bordello Non-Stop,5532,5532,0,2009_boxofficemojo_rankings.csv,2009,1.0,0.0
16875,American Grindhouse,5529,5529,0,2010_boxofficemojo_rankings.csv,2010,1.0,0.0
16876,Are We Not Cats,5518,5518,0,2018_boxofficemojo_rankings.csv,2018,1.0,0.0
16877,The Living,5514,5514,0,2015_boxofficemojo_rankings.csv,2015,1.0,0.0
16878,Icaros: A Vision,5510,5510,0,2017_boxofficemojo_rankings.csv,2017,1.0,0.0
16879,The First $20 Million Is Always the Hardest,5491,5491,0,2002_boxofficemojo_rankings.csv,2002,1.0,0.0
16880,The Man from Earth: Holocene,5472,5472,0,2017_boxofficemojo_rankings.csv,2017,1.0,0.0
16881,Quattro Noza,5471,5471,0,2005_boxofficemojo_rankings.csv,2005,1.0,0.0
16882,Race You to the Bottom,5468,5468,0,2007_boxofficemojo_rankings.csv,2007,1.0,0.0
16883,Coming Soon,5453,5453,0,2000_boxofficemojo_rankings.csv,2000,1.0,0.0
16884,Cuban Food Stories,5434,5434,0,2018_boxofficemojo_rankings.csv,2018,1.0,0.0
16885,Nights and Weekends,5430,5430,0,2008_boxofficemojo_rankings.csv,2008,1.0,0.0
16886,Fratricide,5428,5428,0,2007_boxofficemojo_rankings.csv,2007,1.0,0.0
16887,Unnatural & Accidental,5420,5420,0,2006_boxofficemojo_rankings.csv,2006,1.0,0.0
16888,Flex Is Kings,5418,5418,0,2014_boxofficemojo_rankings.csv,2014,1.0,0.0
16889,The Prince of Pennsylvania,5415,5415,0,1988_boxofficemojo_rankings.csv,1988,1.0,0.0
16890,Whiz Kids,5386,5386,0,2010_boxofficemojo_rankings.csv,2010,1.0,0.0
16891,The Only Real Game,5384,5384,0,2014_boxofficemojo_rankings.csv,2014,1.0,0.0
16892,Dog Days of Summer,5383,5383,0,2008_boxofficemojo_rankings.csv,2008,1.0,0.0
16893,Hatsujô kateikyôshi: Sensei no aijiru,5383,5383,0,2007_boxofficemojo_rankings.csv,2007,1.0,0.0
16894,Say Uncle,5361,5361,0,2006_boxofficemojo_rankings.csv,2006,1.0,0.0
16895,Particles of Truth,5348,5348,0,2004_boxofficemojo_rankings.csv,2004,1.0,0.0
16896,Rock the Bells,5347,5347,0,2007_boxofficemojo_rankings.csv,2007,1.0,0.0
16897,Hair High,5342,5342,0,2006_boxofficemojo_rankings.csv,2006,1.0,0.0
16898,"La Commune (Paris, 1871)",5340,5340,0,2003_boxofficemojo_rankings.csv,2003,1.0,0.0
16899,12 Hour Shift,5319,5319,0,2020_boxofficemojo_rankings.csv,2020,1.0,0.0
16900,She's Lost Control,5319,5319,0,2015_boxofficemojo_rankings.csv,2015,1.0,0.0
16901,Mouth to Mouth,5318,2150,3168,2006_boxofficemojo_rankings.csv,2006,0.4042873260624295,0.5957126739375705
16902,Leila,5294,5294,0,1999_boxofficemojo_rankings.csv,1999,1.0,0.0
16903,When the Wind Blows,5274,5274,0,1988_boxofficemojo_rankings.csv,1988,1.0,0.0
16904,The Time Being,5274,5274,0,2013_boxofficemojo_rankings.csv,2013,1.0,0.0
16905,It's Not Yet Dark,5269,1227,4042,2017_boxofficemojo_rankings.csv,2017,0.2328715126209907,0.7671284873790093
16906,Still Here,5268,5268,0,2020_boxofficemojo_rankings.csv,2020,1.0,0.0
16907,Killers,5248,0,5248,2014_boxofficemojo_rankings.csv,2014,0.0,1.0
16908,Sarajevo,5247,5247,0,2015_boxofficemojo_rankings.csv,2015,1.0,0.0
16909,Speed-Dating,5240,5240,0,2010_boxofficemojo_rankings.csv,2010,1.0,0.0
16910,Room,5228,5228,0,2006_boxofficemojo_rankings.csv,2006,1.0,0.0
16911,Home Room,5216,5216,0,2003_boxofficemojo_rankings.csv,2003,1.0,0.0
16912,The Princess of France,5212,5212,0,2015_boxofficemojo_rankings.csv,2015,1.0,0.0
16913,Death Valley,5211,5211,0,2015_boxofficemojo_rankings.csv,2015,1.0,0.0
16914,In Searching,5210,5210,0,2018_boxofficemojo_rankings.csv,2018,1.0,0.0
16915,A Lawyer Walks Into a Bar...,5202,5202,0,2008_boxofficemojo_rankings.csv,2008,1.0,0.0
16916,Chokehold,5200,5200,0,2019_boxofficemojo_rankings.csv,2019,1.0,0.0
16917,King Leopold's Ghost,5194,5194,0,2006_boxofficemojo_rankings.csv,2006,1.0,0.0
16918,Cold Around the Heart,5171,5171,0,1997_boxofficemojo_rankings.csv,1997,1.0,0.0
16919,The Gliksmans,5166,5166,0,2019_boxofficemojo_rankings.csv,2019,1.0,0.0
16920,"Vendetta: No Conscience, No Mercy",5161,5161,0,2003_boxofficemojo_rankings.csv,2003,1.0,0.0
16921,Lakeboat,5159,5159,0,2001_boxofficemojo_rankings.csv,2001,1.0,0.0
16922,And They're Off,5154,5154,0,2011_boxofficemojo_rankings.csv,2011,1.0,0.0
16923,100 Acres of Hell,5152,5152,0,2019_boxofficemojo_rankings.csv,2019,1.0,0.0
16924,Turn the River,5149,5149,0,2008_boxofficemojo_rankings.csv,2008,1.0,0.0
16925,To Die Is Hard,5129,5129,0,2010_boxofficemojo_rankings.csv,2010,1.0,0.0
16926,Body at Brighton Rock,5123,5123,0,2019_boxofficemojo_rankings.csv,2019,1.0,0.0
16927,Return to Nuke 'Em High Volume 1,5122,5122,0,2014_boxofficemojo_rankings.csv,2014,1.0,0.0
16928,Intersection,5116,5116,0,2018_boxofficemojo_rankings.csv,2018,1.0,0.0
16929,The Strip,5107,5107,0,2009_boxofficemojo_rankings.csv,2009,1.0,0.0
16930,Crimewave,5101,5101,0,1986_boxofficemojo_rankings.csv,1986,1.0,0.0
16931,God and Gays: Bridging the Gap,5095,5095,0,2008_boxofficemojo_rankings.csv,2008,1.0,0.0
16932,Bad Lucky Goat,5088,5088,0,2017_boxofficemojo_rankings.csv,2017,1.0,0.0
16933,On War 2015 Re-release,5086,5086,0,2015_boxofficemojo_rankings.csv,2015,1.0,0.0
16934,Welcome to Happiness,5083,5083,0,2016_boxofficemojo_rankings.csv,2016,1.0,0.0
16935,2307: Winter's Dream,5078,0,5078,2017_boxofficemojo_rankings.csv,2017,0.0,1.0
16936,Lamb,5076,5076,0,1995_boxofficemojo_rankings.csv,1995,1.0,0.0
16937,Bidder 70,5074,5074,0,2013_boxofficemojo_rankings.csv,2013,1.0,0.0
16938,My Dinner with Andre,5073,5073,0,1999_boxofficemojo_rankings.csv,1999,1.0,0.0
16939,Tanner Hall,5073,5073,0,2011_boxofficemojo_rankings.csv,2011,1.0,0.0
16940,Notes on an Appearance,5065,5065,0,2018_boxofficemojo_rankings.csv,2018,1.0,0.0
16941,Chulas Fronteras,5021,5021,0,2019_boxofficemojo_rankings.csv,2019,1.0,0.0
16942,The Sleepwalker,5012,5012,0,2014_boxofficemojo_rankings.csv,2014,1.0,0.0
16943,The Texture of Falling,5010,5010,0,2018_boxofficemojo_rankings.csv,2018,1.0,0.0
16944,Downtown Express,5010,5010,0,2012_boxofficemojo_rankings.csv,2012,1.0,0.0
16945,Social Animals,5007,5007,0,2018_boxofficemojo_rankings.csv,2018,1.0,0.0
16946,The Garden,5006,5006,0,2019_boxofficemojo_rankings.csv,2019,1.0,0.0
16947,An L.A. Minute,5004,5004,0,2018_boxofficemojo_rankings.csv,2018,1.0,0.0
16948,Newlyweds,5000,5000,0,2012_boxofficemojo_rankings.csv,2012,1.0,0.0
16949,Perfect Pie,5000,5000,0,2002_boxofficemojo_rankings.csv,2002,1.0,0.0
16950,Weekend of a Champion,4976,4100,876,2013_boxofficemojo_rankings.csv,2013,0.8239549839228296,0.1760450160771704
16951,Bringing Up Bobby,4975,4975,0,2012_boxofficemojo_rankings.csv,2012,1.0,0.0
16952,sxtape,4961,0,4961,2014_boxofficemojo_rankings.csv,2014,0.0,1.0
16953,Futaba kara tooku hanarete,4960,4960,0,2013_boxofficemojo_rankings.csv,2013,1.0,0.0
16954,Reach the Rock,4960,4960,0,1998_boxofficemojo_rankings.csv,1998,1.0,0.0
16955,Herman's House,4956,4956,0,2013_boxofficemojo_rankings.csv,2013,1.0,0.0
16956,To Die Like a Man,4955,4029,926,2011_boxofficemojo_rankings.csv,2011,0.8131180625630676,0.1868819374369324
16957,SBK: The Movie,4950,4950,0,2015_boxofficemojo_rankings.csv,2015,1.0,0.0
16958,Tournament,4942,4942,0,2017_boxofficemojo_rankings.csv,2017,1.0,0.0
16959,Company Town,4934,4934,0,2017_boxofficemojo_rankings.csv,2017,1.0,0.0
16960,"Peace, Propaganda & the Promised Land",4930,4930,0,2005_boxofficemojo_rankings.csv,2005,1.0,0.0
16961,Supporting Characters,4917,4917,0,2013_boxofficemojo_rankings.csv,2013,1.0,0.0
16962,Guidance,4900,4900,0,2015_boxofficemojo_rankings.csv,2015,1.0,0.0
16963,Malek,4898,4898,0,2019_boxofficemojo_rankings.csv,2019,1.0,0.0
16964,Everything's Cool,4890,4890,0,2007_boxofficemojo_rankings.csv,2007,1.0,0.0
16965,Home of the Brave,4874,4874,0,2004_boxofficemojo_rankings.csv,2004,1.0,0.0
16966,Revelation Road 2: The Sea of Glass and Fire,4871,4871,0,2013_boxofficemojo_rankings.csv,2013,1.0,0.0
16967,Nothing Bad Can Happen,4870,4870,0,2014_boxofficemojo_rankings.csv,2014,1.0,0.0
16968,Nô,4868,4868,0,1999_boxofficemojo_rankings.csv,1999,1.0,0.0
16969,Kira's Reason: A Love Story,4847,4847,0,2003_boxofficemojo_rankings.csv,2003,1.0,0.0
16970,Crepitus,4846,4846,0,2019_boxofficemojo_rankings.csv,2019,1.0,0.0
16971,Call Her Applebroog,4842,4842,0,2016_boxofficemojo_rankings.csv,2016,1.0,0.0
16972,Ballet Blanc,4832,4832,0,2019_boxofficemojo_rankings.csv,2019,1.0,0.0
16973,High Times Potluck,4827,4827,0,2003_boxofficemojo_rankings.csv,2003,1.0,0.0
16974,Ferlinghetti: A Rebirth of Wonder,4816,4816,0,2013_boxofficemojo_rankings.csv,2013,1.0,0.0
16975,The Pusher Trilogy,4815,4815,0,2006_boxofficemojo_rankings.csv,2006,1.0,0.0
16976,50 Ways of Saying Fabulous,4800,4800,0,2006_boxofficemojo_rankings.csv,2006,1.0,0.0
16977,"Half The Road: The Passion, Pitfalls & Power of Women's Professional Cycling",4783,4783,0,2014_boxofficemojo_rankings.csv,2014,1.0,0.0
16978,High Stakes,4780,4780,0,1989_boxofficemojo_rankings.csv,1989,1.0,0.0
16979,Perlasca,4780,4780,0,2005_boxofficemojo_rankings.csv,2005,1.0,0.0
16980,Street Fight,4779,4779,0,2006_boxofficemojo_rankings.csv,2006,1.0,0.0
16981,Behind the White Glasses,4770,2223,2547,2016_boxofficemojo_rankings.csv,2016,0.4660377358490566,0.5339622641509434
16982,The Other Side of Sunday,4769,4769,0,1998_boxofficemojo_rankings.csv,1998,1.0,0.0
16983,Tre,4759,4759,0,2008_boxofficemojo_rankings.csv,2008,1.0,0.0
16984,Secret Society,4725,4725,0,2002_boxofficemojo_rankings.csv,2002,1.0,0.0
16985,Miss Hill: Making Dance Matter,4706,4706,0,2015_boxofficemojo_rankings.csv,2015,1.0,0.0
16986,Shot,4701,4701,0,2017_boxofficemojo_rankings.csv,2017,1.0,0.0
16987,Marinoni: The Fire in the Frame,4696,4696,0,2016_boxofficemojo_rankings.csv,2016,1.0,0.0
16988,The Empty Mirror,4688,4688,0,1999_boxofficemojo_rankings.csv,1999,1.0,0.0
16989,The Other Side of Everything,4685,4685,0,2018_boxofficemojo_rankings.csv,2018,1.0,0.0
16990,Isn't This a Time! A Tribute Concert for Harold Leventhal,4683,4683,0,2005_boxofficemojo_rankings.csv,2005,1.0,0.0
16991,Death Metal Angola,4674,4674,0,2014_boxofficemojo_rankings.csv,2014,1.0,0.0
16992,The Long Dumb Road,4667,4667,0,2018_boxofficemojo_rankings.csv,2018,1.0,0.0
16993,Blood on the Mountain,4664,4664,0,2016_boxofficemojo_rankings.csv,2016,1.0,0.0
16994,Night School,4663,4663,0,2017_boxofficemojo_rankings.csv,2017,1.0,0.0
16995,I Love You Both,4661,4661,0,2017_boxofficemojo_rankings.csv,2017,1.0,0.0
16996,How to Draw a Bunny,4658,4658,0,2004_boxofficemojo_rankings.csv,2004,1.0,0.0
16997,Shakespeare-Wallah,4650,4650,0,2017_boxofficemojo_rankings.csv,2017,1.0,0.0
16998,Against the Sun,4646,4646,0,2015_boxofficemojo_rankings.csv,2015,1.0,0.0
16999,The Death Factory Bloodletting,4638,4638,0,2009_boxofficemojo_rankings.csv,2009,1.0,0.0
17000,Seeds of Time,4630,4630,0,2015_boxofficemojo_rankings.csv,2015,1.0,0.0
17001,The Fall of Fujimori,4630,4630,0,2006_boxofficemojo_rankings.csv,2006,1.0,0.0
17002,Miss Stevens,4611,4611,0,2016_boxofficemojo_rankings.csv,2016,1.0,0.0
17003,Chaos,4608,4608,0,2003_boxofficemojo_rankings.csv,2003,1.0,0.0
17004,The Dogwalker 2006 Re-release,4604,4604,0,2006_boxofficemojo_rankings.csv,2006,1.0,0.0
17005,The Automatic Hate,4603,4603,0,2016_boxofficemojo_rankings.csv,2016,1.0,0.0
17006,Protector 2010 Re-release,4576,2968,1608,2010_boxofficemojo_rankings.csv,2010,0.6486013986013986,0.3513986013986014
17007,Search Party 2016 Re-release,4571,4571,0,2016_boxofficemojo_rankings.csv,2016,1.0,0.0
17008,Hit List,4564,4564,0,1989_boxofficemojo_rankings.csv,1989,1.0,0.0
17009,Smiling Through the Apocalypse,4560,4560,0,2014_boxofficemojo_rankings.csv,2014,1.0,0.0
17010,Laura Smiles,4558,4558,0,2007_boxofficemojo_rankings.csv,2007,1.0,0.0
17011,All Is Bright,4556,4556,0,2013_boxofficemojo_rankings.csv,2013,1.0,0.0
17012,A Boy Called Po,4550,4550,0,2017_boxofficemojo_rankings.csv,2017,1.0,0.0
17013,The Tollbooth,4546,4546,0,2006_boxofficemojo_rankings.csv,2006,1.0,0.0
17014,Promised Lands,4546,4546,0,2010_boxofficemojo_rankings.csv,2010,1.0,0.0
17015,Lie Exposed,4546,4546,0,2020_boxofficemojo_rankings.csv,2020,1.0,0.0
17016,Blue Juice,4535,4535,0,1996_boxofficemojo_rankings.csv,1996,1.0,0.0
17017,Here Comes the Devil,4534,4534,0,2013_boxofficemojo_rankings.csv,2013,1.0,0.0
17018,Weightless,4530,4461,69,2018_boxofficemojo_rankings.csv,2018,0.9847682119205298,0.015231788079470199
17019,Unrelated 2014 Re-release,4529,4529,0,2014_boxofficemojo_rankings.csv,2014,1.0,0.0
17020,House of the Sleeping Beauties,4509,4509,0,2008_boxofficemojo_rankings.csv,2008,1.0,0.0
17021,Synchronicity,4505,4505,0,2016_boxofficemojo_rankings.csv,2016,1.0,0.0
17022,Those Glory Glory Days,4504,4504,0,1986_boxofficemojo_rankings.csv,1986,1.0,0.0
17023,The Pulitzer at 100,4489,4489,0,2017_boxofficemojo_rankings.csv,2017,1.0,0.0
17024,I'm Leaving Now,4488,4488,0,2019_boxofficemojo_rankings.csv,2019,1.0,0.0
17025,Looking for Kitty,4480,4480,0,2006_boxofficemojo_rankings.csv,2006,1.0,0.0
17026,German Concentration Camps Factual Survey,4468,4468,0,2017_boxofficemojo_rankings.csv,2017,1.0,0.0
17027,The Ministers,4447,4447,0,2009_boxofficemojo_rankings.csv,2009,1.0,0.0
17028,"Farewell, Herr Schwarz",4445,4445,0,2015_boxofficemojo_rankings.csv,2015,1.0,0.0
17029,Generation Iron 2,4439,4439,0,2017_boxofficemojo_rankings.csv,2017,1.0,0.0
17030,Cowboy del Amor,4438,4438,0,2006_boxofficemojo_rankings.csv,2006,1.0,0.0
17031,Jeanne and the Perfect Guy,4417,4417,0,1999_boxofficemojo_rankings.csv,1999,1.0,0.0
17032,Coffee Date,4412,4412,0,2006_boxofficemojo_rankings.csv,2006,1.0,0.0
17033,Sacred Stage: The Mariinsky Theater,4410,4410,0,2005_boxofficemojo_rankings.csv,2005,1.0,0.0
17034,SGT. Will Gardner,4405,4405,0,2019_boxofficemojo_rankings.csv,2019,1.0,0.0
17035,The Truth About Emanuel,4404,4404,0,2014_boxofficemojo_rankings.csv,2014,1.0,0.0
17036,The Peacemaker,4400,4400,0,2018_boxofficemojo_rankings.csv,2018,1.0,0.0
17037,30-LOVE,4392,4392,0,2017_boxofficemojo_rankings.csv,2017,1.0,0.0
17038,"A Cool, Dry Place",4390,4390,0,1999_boxofficemojo_rankings.csv,1999,1.0,0.0
17039,Open My Heart,4381,4381,0,2004_boxofficemojo_rankings.csv,2004,1.0,0.0
17040,Between Us,4380,4380,0,2013_boxofficemojo_rankings.csv,2013,1.0,0.0
17041,The End of Time,4375,4375,0,2013_boxofficemojo_rankings.csv,2013,1.0,0.0
17042,The Catechism Cataclysm,4373,4373,0,2011_boxofficemojo_rankings.csv,2011,1.0,0.0
17043,The Woman Who Left,4373,3974,399,2017_boxofficemojo_rankings.csv,2017,0.9087582895037731,0.09124171049622684
17044,The Party's Just Beginning,4371,4145,226,2018_boxofficemojo_rankings.csv,2018,0.9482955845344315,0.05170441546556852
17045,Blood & Tears,4364,4364,0,2007_boxofficemojo_rankings.csv,2007,1.0,0.0
17046,The Flower of Kim Jong II,4362,4362,0,2010_boxofficemojo_rankings.csv,2010,1.0,0.0
17047,Tito and the Birds,4332,4332,0,2019_boxofficemojo_rankings.csv,2019,1.0,0.0
17048,On Meditation,4322,4322,0,2016_boxofficemojo_rankings.csv,2016,1.0,0.0
17049,Het ondergronds orkest,4315,4315,0,1999_boxofficemojo_rankings.csv,1999,1.0,0.0
17050,Days of Grace 2015 Re-release,4308,4308,0,2015_boxofficemojo_rankings.csv,2015,1.0,0.0
17051,The Tower,4305,1117,3188,2014_boxofficemojo_rankings.csv,2014,0.259465737514518,0.740534262485482
17052,Auto Shop of Horrors,4300,4300,0,2016_boxofficemojo_rankings.csv,2016,1.0,0.0
17053,Coming Up Roses,4299,4299,0,1987_boxofficemojo_rankings.csv,1987,1.0,0.0
17054,Beauty Remains,4298,4298,0,2007_boxofficemojo_rankings.csv,2007,1.0,0.0
17055,My Kingdom,4296,4296,0,2002_boxofficemojo_rankings.csv,2002,1.0,0.0
17056,The Fate of Lee Khan,4295,4295,0,2019_boxofficemojo_rankings.csv,2019,1.0,0.0
17057,Art Is... The Permanent Revolution,4291,4291,0,2012_boxofficemojo_rankings.csv,2012,1.0,0.0
17058,Brown's Requiem,4287,4287,0,2000_boxofficemojo_rankings.csv,2000,1.0,0.0
17059,State Like Sleep,4282,4282,0,2019_boxofficemojo_rankings.csv,2019,1.0,0.0
17060,Set Fire to the Stars,4280,4280,0,2015_boxofficemojo_rankings.csv,2015,1.0,0.0
17061,Jersey Guy,4268,4268,0,2003_boxofficemojo_rankings.csv,2003,1.0,0.0
17062,This Divided State,4255,4255,0,2005_boxofficemojo_rankings.csv,2005,1.0,0.0
17063,Corked,4254,4254,0,2009_boxofficemojo_rankings.csv,2009,1.0,0.0
17064,The Knife of Don Juan,4254,4254,0,2015_boxofficemojo_rankings.csv,2015,1.0,0.0
17065,My Father Die,4252,4252,0,2017_boxofficemojo_rankings.csv,2017,1.0,0.0
17066,Cocote,4224,3815,409,2018_boxofficemojo_rankings.csv,2018,0.9031723484848485,0.09682765151515152
17067,Stella Does Tricks,4224,4224,0,2000_boxofficemojo_rankings.csv,2000,1.0,0.0
17068,Twisted: A Balloonamentary,4218,4218,0,2008_boxofficemojo_rankings.csv,2008,1.0,0.0
17069,Maximum Ride,4218,4218,0,2016_boxofficemojo_rankings.csv,2016,1.0,0.0
17070,Stella's Last Weekend,4215,4215,0,2018_boxofficemojo_rankings.csv,2018,1.0,0.0
17071,Breaking a Monster,4212,4212,0,2016_boxofficemojo_rankings.csv,2016,1.0,0.0
17072,Eden,4210,4210,0,1998_boxofficemojo_rankings.csv,1998,1.0,0.0
17073,Free the Nipple,4198,4198,0,2014_boxofficemojo_rankings.csv,2014,1.0,0.0
17074,Helena from the Wedding,4190,4190,0,2010_boxofficemojo_rankings.csv,2010,1.0,0.0
17075,Among the Believers,4189,4189,0,2016_boxofficemojo_rankings.csv,2016,1.0,0.0
17076,3 Geezers!,4175,4175,0,2013_boxofficemojo_rankings.csv,2013,1.0,0.0
17077,Daylight,4171,4171,0,2011_boxofficemojo_rankings.csv,2011,1.0,0.0
17078,Melvin Goes to Dinner,4168,4168,0,2003_boxofficemojo_rankings.csv,2003,1.0,0.0
17079,Badsville,4153,4153,0,2017_boxofficemojo_rankings.csv,2017,1.0,0.0
17080,The Hillside Strangler,4143,4143,0,2004_boxofficemojo_rankings.csv,2004,1.0,0.0
17081,Pawn,4141,4141,0,2013_boxofficemojo_rankings.csv,2013,1.0,0.0
17082,Chinese Portrait,4140,4140,0,2019_boxofficemojo_rankings.csv,2019,1.0,0.0
17083,Guy,4134,4134,0,1997_boxofficemojo_rankings.csv,1997,1.0,0.0
17084,Hera Purple,4123,4123,0,2002_boxofficemojo_rankings.csv,2002,1.0,0.0
17085,Stella Street,4119,4119,0,2004_boxofficemojo_rankings.csv,2004,1.0,0.0
17086,The Painting,4115,4115,0,2005_boxofficemojo_rankings.csv,2005,1.0,0.0
17087,Contracted,4105,4105,0,2013_boxofficemojo_rankings.csv,2013,1.0,0.0
17088,Solar Flare,4098,4098,0,2008_boxofficemojo_rankings.csv,2008,1.0,0.0
17089,Ordinary Sinner,4083,4083,0,2003_boxofficemojo_rankings.csv,2003,1.0,0.0
17090,Jason Becker: Not Dead Yet,4080,1294,2786,2012_boxofficemojo_rankings.csv,2012,0.317156862745098,0.682843137254902
17091,Silver Circle,4080,4080,0,2013_boxofficemojo_rankings.csv,2013,1.0,0.0
17092,Three Night Stand,4076,4076,0,2015_boxofficemojo_rankings.csv,2015,1.0,0.0
17093,Bandido,4064,4064,0,2004_boxofficemojo_rankings.csv,2004,1.0,0.0
17094,Simon 2006 Re-release,4055,4055,0,2006_boxofficemojo_rankings.csv,2006,1.0,0.0
17095,The Kitchen,4054,4054,0,2013_boxofficemojo_rankings.csv,2013,1.0,0.0
17096,La Flor,4032,4032,0,2019_boxofficemojo_rankings.csv,2019,1.0,0.0
17097,Morning,4029,4029,0,2013_boxofficemojo_rankings.csv,2013,1.0,0.0
17098,Approved for Adoption 2013 Re-release,4015,4015,0,2013_boxofficemojo_rankings.csv,2013,1.0,0.0
17099,Psychopathia Sexualis,4012,4012,0,2006_boxofficemojo_rankings.csv,2006,1.0,0.0
17100,Yangsi,4008,4008,0,2012_boxofficemojo_rankings.csv,2012,1.0,0.0
17101,Building Hope,4000,4000,0,2011_boxofficemojo_rankings.csv,2011,1.0,0.0
17102,Pickin' & Grinnin',4000,4000,0,2012_boxofficemojo_rankings.csv,2012,1.0,0.0
17103,Campus Radio,4000,4000,0,2011_boxofficemojo_rankings.csv,2011,1.0,0.0
17104,Emily,3982,3982,0,2017_boxofficemojo_rankings.csv,2017,1.0,0.0
17105,Dream Boat,3981,3981,0,2017_boxofficemojo_rankings.csv,2017,1.0,0.0
17106,After School,3967,3967,0,1988_boxofficemojo_rankings.csv,1988,1.0,0.0
17107,Armed,3948,3948,0,2018_boxofficemojo_rankings.csv,2018,1.0,0.0
17108,Just Say Love,3944,3944,0,2010_boxofficemojo_rankings.csv,2010,1.0,0.0
17109,"C'est pas moi, c'est l'autre",3935,3935,0,2007_boxofficemojo_rankings.csv,2007,1.0,0.0
17110,"Blood, Friends and Money",3930,3930,0,2000_boxofficemojo_rankings.csv,2000,1.0,0.0
17111,Mother of a Day,3919,3919,0,2019_boxofficemojo_rankings.csv,2019,1.0,0.0
17112,Going Under,3917,3917,0,2006_boxofficemojo_rankings.csv,2006,1.0,0.0
17113,Where God Left His Shoes,3911,3911,0,2008_boxofficemojo_rankings.csv,2008,1.0,0.0
17114,Maidan,3909,3909,0,2014_boxofficemojo_rankings.csv,2014,1.0,0.0
17115,Find Your Voice,3897,3897,0,2020_boxofficemojo_rankings.csv,2020,1.0,0.0
17116,American Dresser,3895,3895,0,2018_boxofficemojo_rankings.csv,2018,1.0,0.0
17117,The Iron Ministry,3885,3340,545,2015_boxofficemojo_rankings.csv,2015,0.8597168597168597,0.1402831402831403
17118,Crown Vic,3868,3868,0,2019_boxofficemojo_rankings.csv,2019,1.0,0.0
17119,Hollidaysburg,3861,3861,0,2014_boxofficemojo_rankings.csv,2014,1.0,0.0
17120,The Second Time Around,3837,3837,0,2018_boxofficemojo_rankings.csv,2018,1.0,0.0
17121,"High Tech, Low Life",3836,3836,0,2013_boxofficemojo_rankings.csv,2013,1.0,0.0
17122,Aashayein,3836,0,3836,2010_boxofficemojo_rankings.csv,2010,0.0,1.0
17123,Saints and Sinners,3826,3826,0,2004_boxofficemojo_rankings.csv,2004,1.0,0.0
17124,King's Gambit,3816,3816,0,2020_boxofficemojo_rankings.csv,2020,1.0,0.0
17125,Childhood's End,3804,3804,0,1997_boxofficemojo_rankings.csv,1997,1.0,0.0
17126,Free Radicals: A History of Experimental Film,3804,3804,0,2012_boxofficemojo_rankings.csv,2012,1.0,0.0
17127,My Wife Maurice 2004 Re-release,3803,3803,0,2004_boxofficemojo_rankings.csv,2004,1.0,0.0
17128,Wallflower,3801,3801,0,2019_boxofficemojo_rankings.csv,2019,1.0,0.0
17129,A Hole in My Heart,3784,3784,0,2005_boxofficemojo_rankings.csv,2005,1.0,0.0
17130,The Green Butchers,3783,3783,0,2004_boxofficemojo_rankings.csv,2004,1.0,0.0
17131,Bawandar,3779,3779,0,2003_boxofficemojo_rankings.csv,2003,1.0,0.0
17132,Unfreedom,3778,3778,0,2015_boxofficemojo_rankings.csv,2015,1.0,0.0
17133,They Come to America,3775,3775,0,2012_boxofficemojo_rankings.csv,2012,1.0,0.0
17134,Caravaggio,3774,3774,0,2002_boxofficemojo_rankings.csv,2002,1.0,0.0
17135,The Gender Card Flip,3774,3774,0,2017_boxofficemojo_rankings.csv,2017,1.0,0.0
17136,Berkeley,3770,3770,0,2007_boxofficemojo_rankings.csv,2007,1.0,0.0
17137,Shock to the System,3768,3768,0,2006_boxofficemojo_rankings.csv,2006,1.0,0.0
17138,In/Significant Others,3763,3763,0,2010_boxofficemojo_rankings.csv,2010,1.0,0.0
17139,The Hollow,3755,3755,0,2016_boxofficemojo_rankings.csv,2016,1.0,0.0
17140,Nelly,3751,3751,0,2018_boxofficemojo_rankings.csv,2018,1.0,0.0
17141,A Girl Called Rosemary,3744,3744,0,1999_boxofficemojo_rankings.csv,1999,1.0,0.0
17142,Bugs,3742,3742,0,2017_boxofficemojo_rankings.csv,2017,1.0,0.0
17143,Fever Pitch,3736,3736,0,1999_boxofficemojo_rankings.csv,1999,1.0,0.0
17144,Big Animal,3733,3733,0,2004_boxofficemojo_rankings.csv,2004,1.0,0.0
17145,Bad Blood,3731,3731,0,2012_boxofficemojo_rankings.csv,2012,1.0,0.0
17146,The Free Speech Apocalypse,3726,3726,0,2015_boxofficemojo_rankings.csv,2015,1.0,0.0
17147,The Condemned,3718,3718,0,2013_boxofficemojo_rankings.csv,2013,1.0,0.0
17148,The Harvest/La Cosecha,3709,3709,0,2011_boxofficemojo_rankings.csv,2011,1.0,0.0
17149,The Helix... Loaded,3700,3700,0,2005_boxofficemojo_rankings.csv,2005,1.0,0.0
17150,Heartless,3697,3697,0,2010_boxofficemojo_rankings.csv,2010,1.0,0.0
17151,The Family,3696,3696,0,2018_boxofficemojo_rankings.csv,2018,1.0,0.0
17152,Catch Me If You Can,3686,3686,0,1989_boxofficemojo_rankings.csv,1989,1.0,0.0
17153,"Still, the Children Are Here",3685,3685,0,2004_boxofficemojo_rankings.csv,2004,1.0,0.0
17154,Suits,3676,3676,0,1999_boxofficemojo_rankings.csv,1999,1.0,0.0
17155,Brothers in Arms,3664,3664,0,2004_boxofficemojo_rankings.csv,2004,1.0,0.0
17156,Dr. Benny,3657,3657,0,2003_boxofficemojo_rankings.csv,2003,1.0,0.0
17157,Bird of Prey,3652,3652,0,1996_boxofficemojo_rankings.csv,1996,1.0,0.0
17158,The Word,3648,3648,0,2014_boxofficemojo_rankings.csv,2014,1.0,0.0
17159,Smash His Camera,3644,3644,0,2010_boxofficemojo_rankings.csv,2010,1.0,0.0
17160,Stop The Pounding Heart,3642,3642,0,2014_boxofficemojo_rankings.csv,2014,1.0,0.0
17161,The Wandering Soap Opera,3624,3624,0,2019_boxofficemojo_rankings.csv,2019,1.0,0.0
17162,Mr. Nobody 2013 Re-release,3622,3622,0,2013_boxofficemojo_rankings.csv,2013,1.0,0.0
17163,Warrior of Light,3617,3617,0,2003_boxofficemojo_rankings.csv,2003,1.0,0.0
17164,Moog,3604,3604,0,2004_boxofficemojo_rankings.csv,2004,1.0,0.0
17165,Cockfight,3600,3600,0,2004_boxofficemojo_rankings.csv,2004,1.0,0.0
17166,Journeys with George,3588,3588,0,2003_boxofficemojo_rankings.csv,2003,1.0,0.0
17167,Hyena,3586,3401,185,2015_boxofficemojo_rankings.csv,2015,0.9484104852203011,0.05158951477969883
17168,Hide Your Smiling Faces,3576,3576,0,2014_boxofficemojo_rankings.csv,2014,1.0,0.0
17169,Happy Here and Now,3574,3574,0,2005_boxofficemojo_rankings.csv,2005,1.0,0.0
17170,Evolution of a Criminal,3568,3568,0,2014_boxofficemojo_rankings.csv,2014,1.0,0.0
17171,I'm Reed Fish,3567,3567,0,2007_boxofficemojo_rankings.csv,2007,1.0,0.0
17172,The Last Film Festival,3558,3558,0,2016_boxofficemojo_rankings.csv,2016,1.0,0.0
17173,Fourplay,3550,3550,0,2018_boxofficemojo_rankings.csv,2018,1.0,0.0
17174,Antonia,3550,3550,0,2007_boxofficemojo_rankings.csv,2007,1.0,0.0
17175,Sister Helen,3541,3541,0,2003_boxofficemojo_rankings.csv,2003,1.0,0.0
17176,The Beautiful Troublemaker 2017 Re-release,3540,3540,0,2017_boxofficemojo_rankings.csv,2017,1.0,0.0
17177,Tricked,3533,3533,0,2013_boxofficemojo_rankings.csv,2013,1.0,0.0
17178,A Bloody Aria 2008 Re-release,3532,518,3014,2008_boxofficemojo_rankings.csv,2008,0.14665911664779163,0.8533408833522084
17179,The Loving Story 2016 Re-release,3518,3518,0,2016_boxofficemojo_rankings.csv,2016,1.0,0.0
17180,When the Party's Over,3514,3514,0,1993_boxofficemojo_rankings.csv,1993,1.0,0.0
17181,Revolution OS,3500,3500,0,2002_boxofficemojo_rankings.csv,2002,1.0,0.0
17182,Who's Crazy?,3497,3497,0,2017_boxofficemojo_rankings.csv,2017,1.0,0.0
17183,Locker 13,3496,3496,0,2014_boxofficemojo_rankings.csv,2014,1.0,0.0
17184,The Citizen 2018 Re-release,3495,3495,0,2018_boxofficemojo_rankings.csv,2018,1.0,0.0
17185,Death of a Ghost Hunter,3490,3490,0,2009_boxofficemojo_rankings.csv,2009,1.0,0.0
17186,Dead Awake,3484,0,3484,2010_boxofficemojo_rankings.csv,2010,0.0,1.0
17187,"Love, Sweat and Tears",3482,3482,0,2017_boxofficemojo_rankings.csv,2017,1.0,0.0
17188,Metal Messiah,3476,3476,0,2010_boxofficemojo_rankings.csv,2010,1.0,0.0
17189,The Hacker Wars,3470,3470,0,2014_boxofficemojo_rankings.csv,2014,1.0,0.0
17190,The Full Picture,3467,3467,0,2010_boxofficemojo_rankings.csv,2010,1.0,0.0
17191,Short Eyes,3456,3456,0,2003_boxofficemojo_rankings.csv,2003,1.0,0.0
17192,Aftermath,3451,3451,0,2014_boxofficemojo_rankings.csv,2014,1.0,0.0
17193,Life's a Breeze 2014 Re-release,3450,3450,0,2014_boxofficemojo_rankings.csv,2014,1.0,0.0
17194,Grand Theft Parsons,3438,0,3438,2004_boxofficemojo_rankings.csv,2004,0.0,1.0
17195,Scenic Route,3434,3434,0,2013_boxofficemojo_rankings.csv,2013,1.0,0.0
17196,Mahogany Sunrise,3432,3432,0,2014_boxofficemojo_rankings.csv,2014,1.0,0.0
17197,Restored Me 2016 Re-release,3428,3428,0,2016_boxofficemojo_rankings.csv,2016,1.0,0.0
17198,Speed Sisters,3423,3423,0,2017_boxofficemojo_rankings.csv,2017,1.0,0.0
17199,The Happy Poet,3400,3400,0,2013_boxofficemojo_rankings.csv,2013,1.0,0.0
17200,The Cage Fighter,3392,3392,0,2018_boxofficemojo_rankings.csv,2018,1.0,0.0
17201,Tamala 2010: A Punk Cat in Space,3386,3386,0,2004_boxofficemojo_rankings.csv,2004,1.0,0.0
17202,The Price of Sugar,3384,3384,0,2007_boxofficemojo_rankings.csv,2007,1.0,0.0
17203,Rottentail,3383,3383,0,2019_boxofficemojo_rankings.csv,2019,1.0,0.0
17204,Blossoms of Fire,3365,3365,0,2006_boxofficemojo_rankings.csv,2006,1.0,0.0
17205,American Fork,3359,3359,0,2009_boxofficemojo_rankings.csv,2009,1.0,0.0
17206,Amanda & Jack Go Glamping,3352,3352,0,2017_boxofficemojo_rankings.csv,2017,1.0,0.0
17207,Bad Match,3351,3351,0,2017_boxofficemojo_rankings.csv,2017,1.0,0.0
17208,Followers,3350,3350,0,2018_boxofficemojo_rankings.csv,2018,1.0,0.0
17209,Strawberry Fields,3347,3347,0,1999_boxofficemojo_rankings.csv,1999,1.0,0.0
17210,'Tis Autumn: The Search for Jackie Paris,3347,1476,1871,2007_boxofficemojo_rankings.csv,2007,0.440991933074395,0.559008066925605
17211,Fashion Victim,3346,3346,0,2010_boxofficemojo_rankings.csv,2010,1.0,0.0
17212,Swerve,3338,3338,0,2013_boxofficemojo_rankings.csv,2013,1.0,0.0
17213,Mi America,3330,3330,0,2015_boxofficemojo_rankings.csv,2015,1.0,0.0
17214,Know How,3323,3323,0,2015_boxofficemojo_rankings.csv,2015,1.0,0.0
17215,I'm Crazy About Iris Blond,3303,3303,0,1999_boxofficemojo_rankings.csv,1999,1.0,0.0
17216,Drunk Wedding,3301,3301,0,2015_boxofficemojo_rankings.csv,2015,1.0,0.0
17217,Looking Through Lillian,3300,3300,0,2002_boxofficemojo_rankings.csv,2002,1.0,0.0
17218,Burning Bodhi,3289,3289,0,2016_boxofficemojo_rankings.csv,2016,1.0,0.0
17219,Axe Giant: The Wrath of Paul Bunyan,3287,3287,0,2013_boxofficemojo_rankings.csv,2013,1.0,0.0
17220,El Superstar: The Unlikely Rise of Juan Frances,3271,3271,0,2010_boxofficemojo_rankings.csv,2010,1.0,0.0
17221,I Love Your Work,3264,3264,0,2005_boxofficemojo_rankings.csv,2005,1.0,0.0
17222,Calvaire,3260,3260,0,2006_boxofficemojo_rankings.csv,2006,1.0,0.0
17223,Justice,3259,3259,0,2017_boxofficemojo_rankings.csv,2017,1.0,0.0
17224,Windsor Drive,3256,3256,0,2015_boxofficemojo_rankings.csv,2015,1.0,0.0
17225,Sex Sells: The Making of 'Touché',3252,3252,0,2005_boxofficemojo_rankings.csv,2005,1.0,0.0
17226,Devil Girl,3244,3244,0,2009_boxofficemojo_rankings.csv,2009,1.0,0.0
17227,Over the Limit,3243,3243,0,2018_boxofficemojo_rankings.csv,2018,1.0,0.0
17228,The Sons of Tennessee Williams,3242,3242,0,2011_boxofficemojo_rankings.csv,2011,1.0,0.0
17229,As Cool as I Am,3234,3234,0,2013_boxofficemojo_rankings.csv,2013,1.0,0.0
17230,Gooby,3234,3234,0,2009_boxofficemojo_rankings.csv,2009,1.0,0.0
17231,The Work and the Story,3233,3233,0,2003_boxofficemojo_rankings.csv,2003,1.0,0.0
17232,Blackhats,3216,3216,0,2015_boxofficemojo_rankings.csv,2015,1.0,0.0
17233,A Cuban Legend,3212,3212,0,2002_boxofficemojo_rankings.csv,2002,1.0,0.0
17234,Do You Wanna Dance?,3210,3210,0,1999_boxofficemojo_rankings.csv,1999,1.0,0.0
17235,Tell the Truth and Run: George Seldes and the American Press,3204,3204,0,1996_boxofficemojo_rankings.csv,1996,1.0,0.0
17236,The Backyard,3200,3200,0,2003_boxofficemojo_rankings.csv,2003,1.0,0.0
17237,95 Miles to Go,3195,3195,0,2006_boxofficemojo_rankings.csv,2006,1.0,0.0
17238,After the Wizard,3184,3184,0,2012_boxofficemojo_rankings.csv,2012,1.0,0.0
17239,Detroit 9000,3179,3179,0,1998_boxofficemojo_rankings.csv,1998,1.0,0.0
17240,Apart,3161,3161,0,2012_boxofficemojo_rankings.csv,2012,1.0,0.0
17241,The Boys,3146,3146,0,1999_boxofficemojo_rankings.csv,1999,1.0,0.0
17242,Game Changers,3142,3142,0,2018_boxofficemojo_rankings.csv,2018,1.0,0.0
17243,Balls to the Wall,3140,3140,0,2011_boxofficemojo_rankings.csv,2011,1.0,0.0
17244,Four Eyed Monsters,3135,3135,0,2006_boxofficemojo_rankings.csv,2006,1.0,0.0
17245,Hot to Trot,3133,3133,0,2018_boxofficemojo_rankings.csv,2018,1.0,0.0
17246,American Zombie,3126,3126,0,2008_boxofficemojo_rankings.csv,2008,1.0,0.0
17247,The Girl on the Train,3124,3124,0,2014_boxofficemojo_rankings.csv,2014,1.0,0.0
17248,Thursday,3121,3121,0,1998_boxofficemojo_rankings.csv,1998,1.0,0.0
17249,Beyond Barbed Wire,3109,3109,0,1997_boxofficemojo_rankings.csv,1997,1.0,0.0
17250,Nowhere Man,3105,3105,0,2005_boxofficemojo_rankings.csv,2005,1.0,0.0
17251,The Prisoner or: How I Planned to Kill Tony Blair,3103,3103,0,2007_boxofficemojo_rankings.csv,2007,1.0,0.0
17252,The Feud,3102,3102,0,1990_boxofficemojo_rankings.csv,1990,1.0,0.0
17253,Showrunners: The Art of Running a TV Show,3100,3100,0,2014_boxofficemojo_rankings.csv,2014,1.0,0.0
17254,What Now? Remind Me,3089,3089,0,2014_boxofficemojo_rankings.csv,2014,1.0,0.0
17255,Oxygen,3088,3088,0,1999_boxofficemojo_rankings.csv,1999,1.0,0.0
17256,The Trial of the Chicago 7,3084,0,3084,2020_boxofficemojo_rankings.csv,2020,0.0,1.0
17257,Who Does She Think She Is?,3081,3081,0,2008_boxofficemojo_rankings.csv,2008,1.0,0.0
17258,Drew: The Man Behind the Poster,3078,3078,0,2013_boxofficemojo_rankings.csv,2013,1.0,0.0
17259,Chasing Portraits,3076,3076,0,2019_boxofficemojo_rankings.csv,2019,1.0,0.0
17260,Spiral,3072,3072,0,2008_boxofficemojo_rankings.csv,2008,1.0,0.0
17261,The Weird World of Blowfly,3062,3062,0,2011_boxofficemojo_rankings.csv,2011,1.0,0.0
17262,Shopping,3061,3061,0,1996_boxofficemojo_rankings.csv,1996,1.0,0.0
17263,The Afterlight,3059,3059,0,2010_boxofficemojo_rankings.csv,2010,1.0,0.0
17264,Ottolenghi and the Cakes of Versailles,3028,3028,0,2020_boxofficemojo_rankings.csv,2020,1.0,0.0
17265,Los Muertos 2007 Re-release,3027,3027,0,2007_boxofficemojo_rankings.csv,2007,1.0,0.0
17266,Unveiled,3025,3025,0,2005_boxofficemojo_rankings.csv,2005,1.0,0.0
17267,A French Gigolo 2014 Re-release,3021,3021,0,2014_boxofficemojo_rankings.csv,2014,1.0,0.0
17268,A Girl and a Gun,3018,3018,0,2013_boxofficemojo_rankings.csv,2013,1.0,0.0
17269,Best and Most Beautiful Things,3016,3016,0,2016_boxofficemojo_rankings.csv,2016,1.0,0.0
17270,15,3013,3013,0,2005_boxofficemojo_rankings.csv,2005,1.0,0.0
17271,Fatal Assistance,3000,3000,0,2014_boxofficemojo_rankings.csv,2014,1.0,0.0
17272,The Lie,3000,3000,0,2011_boxofficemojo_rankings.csv,2011,1.0,0.0
17273,The Ghosts of Johnson Woods,3000,3000,0,2016_boxofficemojo_rankings.csv,2016,1.0,0.0
17274,Zokkomon,3000,3000,0,2011_boxofficemojo_rankings.csv,2011,1.0,0.0
17275,Stolen Childhoods,2996,2996,0,2005_boxofficemojo_rankings.csv,2005,1.0,0.0
17276,Moana,2993,2993,0,2015_boxofficemojo_rankings.csv,2015,1.0,0.0
17277,Run for Your Life,2992,2992,0,2008_boxofficemojo_rankings.csv,2008,1.0,0.0
17278,Intervention,2980,279,2701,2007_boxofficemojo_rankings.csv,2007,0.0936241610738255,0.9063758389261745
17279,The Shot,2970,2970,0,1996_boxofficemojo_rankings.csv,1996,1.0,0.0
17280,Philadelphia Experiment II,2970,2970,0,1993_boxofficemojo_rankings.csv,1993,1.0,0.0
17281,Wetlands Preserved: The Story of an Activist Nightclub,2970,2970,0,2008_boxofficemojo_rankings.csv,2008,1.0,0.0
17282,Dog Lover's Symphony,2968,2968,0,2006_boxofficemojo_rankings.csv,2006,1.0,0.0
17283,Mercy,2967,2967,0,1996_boxofficemojo_rankings.csv,1996,1.0,0.0
17284,Tattoo Bar,2964,2964,0,2002_boxofficemojo_rankings.csv,2002,1.0,0.0
17285,Ash Wednesday,2942,2942,0,2002_boxofficemojo_rankings.csv,2002,1.0,0.0
17286,Kepler's Dream,2923,2923,0,2017_boxofficemojo_rankings.csv,2017,1.0,0.0
17287,Demons,2900,2900,0,2017_boxofficemojo_rankings.csv,2017,1.0,0.0
17288,"On the Other Hand, Death",2892,2892,0,2008_boxofficemojo_rankings.csv,2008,1.0,0.0
17289,Beautopia,2870,2870,0,1999_boxofficemojo_rankings.csv,1999,1.0,0.0
17290,The Professor: Tai Chi's Journey West,2852,2852,0,2016_boxofficemojo_rankings.csv,2016,1.0,0.0
17291,Three Days of Rain,2841,2841,0,2005_boxofficemojo_rankings.csv,2005,1.0,0.0
17292,Heaven,2838,2838,0,1999_boxofficemojo_rankings.csv,1999,1.0,0.0
17293,Lower Learning,2804,2804,0,2008_boxofficemojo_rankings.csv,2008,1.0,0.0
17294,Okraina,2797,2797,0,2004_boxofficemojo_rankings.csv,2004,1.0,0.0
17295,Approaching Midnight,2795,2795,0,2013_boxofficemojo_rankings.csv,2013,1.0,0.0
17296,Nana,2784,2784,0,2018_boxofficemojo_rankings.csv,2018,1.0,0.0
17297,Lush,2763,2763,0,2001_boxofficemojo_rankings.csv,2001,1.0,0.0
17298,The Blue Tooth Virgin,2762,2762,0,2009_boxofficemojo_rankings.csv,2009,1.0,0.0
17299,Blood Ties,2760,2760,0,2011_boxofficemojo_rankings.csv,2011,1.0,0.0
17300,White Lies 2016 Re-release,2760,2760,0,2016_boxofficemojo_rankings.csv,2016,1.0,0.0
17301,I Dream in Another Language,2739,2739,0,2017_boxofficemojo_rankings.csv,2017,1.0,0.0
17302,Telling You,2735,2735,0,1999_boxofficemojo_rankings.csv,1999,1.0,0.0
17303,Black Out 2014 Re-release,2734,2734,0,2014_boxofficemojo_rankings.csv,2014,1.0,0.0
17304,The Lesser Blessed,2732,2732,0,2013_boxofficemojo_rankings.csv,2013,1.0,0.0
17305,Agnes and His Brothers 2006 Re-release,2731,2731,0,2006_boxofficemojo_rankings.csv,2006,1.0,0.0
17306,Winter Flight,2729,2729,0,1986_boxofficemojo_rankings.csv,1986,1.0,0.0
17307,Julia,2710,2710,0,2015_boxofficemojo_rankings.csv,2015,1.0,0.0
17308,Chocolat 2015 Re-release,2710,2710,0,2015_boxofficemojo_rankings.csv,2015,1.0,0.0
17309,Adolf Eichmann,2706,2706,0,2010_boxofficemojo_rankings.csv,2010,1.0,0.0
17310,Back to the Fatherland,2697,2697,0,2019_boxofficemojo_rankings.csv,2019,1.0,0.0
17311,The Boys in the Band 2000 Re-release,2695,2695,0,2000_boxofficemojo_rankings.csv,2000,1.0,0.0
17312,Inspecteur Lavardin,2685,2685,0,1991_boxofficemojo_rankings.csv,1991,1.0,0.0
17313,I Shot a Man in Vegas,2684,2684,0,1996_boxofficemojo_rankings.csv,1996,1.0,0.0
17314,Santoalla,2684,2684,0,2017_boxofficemojo_rankings.csv,2017,1.0,0.0
17315,Straight Into a Storm,2684,2684,0,2018_boxofficemojo_rankings.csv,2018,1.0,0.0
17316,Division 19,2680,1699,981,2019_boxofficemojo_rankings.csv,2019,0.633955223880597,0.366044776119403
17317,Restitution,2664,2664,0,2011_boxofficemojo_rankings.csv,2011,1.0,0.0
17318,United Red Army 2011 Re-release,2659,2659,0,2011_boxofficemojo_rankings.csv,2011,1.0,0.0
17319,Eden Valley,2642,2642,0,1996_boxofficemojo_rankings.csv,1996,1.0,0.0
17320,Daughter of the Nile,2640,2640,0,2017_boxofficemojo_rankings.csv,2017,1.0,0.0
17321,Body,2634,2634,0,2015_boxofficemojo_rankings.csv,2015,1.0,0.0
17322,Refuge,2631,2631,0,2014_boxofficemojo_rankings.csv,2014,1.0,0.0
17323,Indigo Children,2621,2621,0,2014_boxofficemojo_rankings.csv,2014,1.0,0.0
17324,ACORN and the Firestorm,2621,2621,0,2018_boxofficemojo_rankings.csv,2018,1.0,0.0
17325,The Child I Never Was,2609,2609,0,2004_boxofficemojo_rankings.csv,2004,1.0,0.0
17326,Sparrows Dance,2602,2602,0,2013_boxofficemojo_rankings.csv,2013,1.0,0.0
17327,Conspiracy of Silence,2598,2598,0,2004_boxofficemojo_rankings.csv,2004,1.0,0.0
17328,Last Flight of the Champion,2597,2597,0,2013_boxofficemojo_rankings.csv,2013,1.0,0.0
17329,Carl,2592,2592,0,2012_boxofficemojo_rankings.csv,2012,1.0,0.0
17330,Jake Squared,2592,2592,0,2014_boxofficemojo_rankings.csv,2014,1.0,0.0
17331,Dead or Alive: Final,2591,2591,0,2002_boxofficemojo_rankings.csv,2002,1.0,0.0
17332,Hammer of the Gods,2590,641,1949,2013_boxofficemojo_rankings.csv,2013,0.24749034749034748,0.7525096525096525
17333,Take Me,2583,2583,0,2017_boxofficemojo_rankings.csv,2017,1.0,0.0
17334,McCanick,2572,2572,0,2014_boxofficemojo_rankings.csv,2014,1.0,0.0
17335,Hayride 2,2571,2571,0,2015_boxofficemojo_rankings.csv,2015,1.0,0.0
17336,Joan the Maid 1: The Battles,2562,2562,0,2019_boxofficemojo_rankings.csv,2019,1.0,0.0
17337,Ginger Snaps,2554,2554,0,2001_boxofficemojo_rankings.csv,2001,1.0,0.0
17338,Out of Place: Memories of Edward Said,2547,2547,0,2006_boxofficemojo_rankings.csv,2006,1.0,0.0
17339,Cassadaga,2544,2544,0,2013_boxofficemojo_rankings.csv,2013,1.0,0.0
17340,Whatever Happened to Harold Smith?,2543,2543,0,2001_boxofficemojo_rankings.csv,2001,1.0,0.0
17341,Two-Bit Waltz,2540,2540,0,2014_boxofficemojo_rankings.csv,2014,1.0,0.0
17342,Miles,2537,2537,0,2017_boxofficemojo_rankings.csv,2017,1.0,0.0
17343,Risk/Reward,2517,2517,0,2004_boxofficemojo_rankings.csv,2004,1.0,0.0
17344,Almost in Love,2510,2510,0,2013_boxofficemojo_rankings.csv,2013,1.0,0.0
17345,Swing,2509,2509,0,2004_boxofficemojo_rankings.csv,2004,1.0,0.0
17346,Mekong Hotel,2502,2502,0,2016_boxofficemojo_rankings.csv,2016,1.0,0.0
17347,Standing by Yourself,2500,2500,0,2002_boxofficemojo_rankings.csv,2002,1.0,0.0
17348,L'autre monde 2004 Re-release,2494,2494,0,2004_boxofficemojo_rankings.csv,2004,1.0,0.0
17349,Herbie Hancock: Possibilities,2493,2493,0,2006_boxofficemojo_rankings.csv,2006,1.0,0.0
17350,The Last Day of August,2492,2492,0,2013_boxofficemojo_rankings.csv,2013,1.0,0.0
17351,Homeland (Iraq Year Zero),2491,2491,0,2016_boxofficemojo_rankings.csv,2016,1.0,0.0
17352,Rank,2485,2485,0,2006_boxofficemojo_rankings.csv,2006,1.0,0.0
17353,Men at Lunch,2483,2483,0,2013_boxofficemojo_rankings.csv,2013,1.0,0.0
17354,The Wait,2480,2480,0,2014_boxofficemojo_rankings.csv,2014,1.0,0.0
17355,Breaking Glass,2471,2471,0,1980_boxofficemojo_rankings.csv,1980,1.0,0.0
17356,TINY: The Life of Erin Blackwell,2465,2465,0,2019_boxofficemojo_rankings.csv,2019,1.0,0.0
17357,Motocross Kids,2462,2462,0,2004_boxofficemojo_rankings.csv,2004,1.0,0.0
17358,The Ghastly Love of Johnny X,2436,2436,0,2012_boxofficemojo_rankings.csv,2012,1.0,0.0
17359,Why Stop Now?,2432,2432,0,2012_boxofficemojo_rankings.csv,2012,1.0,0.0
17360,The Reflektor Tapes,2424,0,2424,2015_boxofficemojo_rankings.csv,2015,0.0,1.0
17361,Firedancer,2422,2422,0,2004_boxofficemojo_rankings.csv,2004,1.0,0.0
17362,L.A. Slasher,2421,2421,0,2015_boxofficemojo_rankings.csv,2015,1.0,0.0
17363,Zig Zag,2418,2418,0,2002_boxofficemojo_rankings.csv,2002,1.0,0.0
17364,Ek Hazarachi Note,2404,2404,0,2016_boxofficemojo_rankings.csv,2016,1.0,0.0
17365,Looking for an Icon,2393,2393,0,2007_boxofficemojo_rankings.csv,2007,1.0,0.0
17366,The Optimists,2377,2377,0,2005_boxofficemojo_rankings.csv,2005,1.0,0.0
17367,Polar Opposites,2377,2377,0,2008_boxofficemojo_rankings.csv,2008,1.0,0.0
17368,Daniel and Ana,2372,2372,0,2010_boxofficemojo_rankings.csv,2010,1.0,0.0
17369,Moondance,2371,2371,0,2020_boxofficemojo_rankings.csv,2020,1.0,0.0
17370,Scissors,2368,2368,0,1991_boxofficemojo_rankings.csv,1991,1.0,0.0
17371,Evergreen: The Road to Legalization,2363,2363,0,2014_boxofficemojo_rankings.csv,2014,1.0,0.0
17372,The Village Barbershop,2359,2359,0,2009_boxofficemojo_rankings.csv,2009,1.0,0.0
17373,Colonel Redl,2357,2357,0,1985_boxofficemojo_rankings.csv,1985,1.0,0.0
17374,I Lost Albert 2019 Re-release,2354,2354,0,2019_boxofficemojo_rankings.csv,2019,1.0,0.0
17375,A German Youth,2343,2343,0,2019_boxofficemojo_rankings.csv,2019,1.0,0.0
17376,Who Shot Pat?,2343,2343,0,1992_boxofficemojo_rankings.csv,1992,1.0,0.0
17377,Detective Chinatown 3,2342,0,2342,2020_boxofficemojo_rankings.csv,2020,0.0,1.0
17378,13 Months of Sunshine,2337,2337,0,2008_boxofficemojo_rankings.csv,2008,1.0,0.0
17379,Lotus Eaters,2325,2325,0,2013_boxofficemojo_rankings.csv,2013,1.0,0.0
17380,You're Gonna Miss Me,2324,2324,0,2007_boxofficemojo_rankings.csv,2007,1.0,0.0
17381,Cheap Shots,2323,2323,0,1991_boxofficemojo_rankings.csv,1991,1.0,0.0
17382,The Happy House,2311,2311,0,2013_boxofficemojo_rankings.csv,2013,1.0,0.0
17383,Goldie,2302,2302,0,2020_boxofficemojo_rankings.csv,2020,1.0,0.0
17384,Serendipity,2298,2298,0,2019_boxofficemojo_rankings.csv,2019,1.0,0.0
17385,The Girl 2010 Re-release,2273,2201,72,2010_boxofficemojo_rankings.csv,2010,0.9683238011438627,0.03167619885613726
17386,The Pool Boys,2269,2269,0,2011_boxofficemojo_rankings.csv,2011,1.0,0.0
17387,The Rook,2264,2264,0,1999_boxofficemojo_rankings.csv,1999,1.0,0.0
17388,Red Christmas,2255,2255,0,2017_boxofficemojo_rankings.csv,2017,1.0,0.0
17389,Anita Ho,2250,2250,0,2015_boxofficemojo_rankings.csv,2015,1.0,0.0
17390,The Big Question,2248,2248,0,2006_boxofficemojo_rankings.csv,2006,1.0,0.0
17391,Memoria,2242,2242,0,2016_boxofficemojo_rankings.csv,2016,1.0,0.0
17392,Mirage,2241,2241,0,2006_boxofficemojo_rankings.csv,2006,1.0,0.0
17393,You Wont Miss Me,2240,2240,0,2010_boxofficemojo_rankings.csv,2010,1.0,0.0
17394,The Night Watchman,2219,2219,0,2012_boxofficemojo_rankings.csv,2012,1.0,0.0
17395,Virgil Bliss,2219,2219,0,2002_boxofficemojo_rankings.csv,2002,1.0,0.0
17396,Side Effects,2216,2216,0,2005_boxofficemojo_rankings.csv,2005,1.0,0.0
17397,Workingman's Death,2214,2214,0,2006_boxofficemojo_rankings.csv,2006,1.0,0.0
17398,7 from Etheria,2208,2208,0,2017_boxofficemojo_rankings.csv,2017,1.0,0.0
17399,InSpectres,2207,2207,0,2013_boxofficemojo_rankings.csv,2013,1.0,0.0
17400,Scorn,2206,2206,0,2012_boxofficemojo_rankings.csv,2012,1.0,0.0
17401,Dischord,2199,2199,0,2003_boxofficemojo_rankings.csv,2003,1.0,0.0
17402,George Bush Goes to Heaven,2192,2192,0,2006_boxofficemojo_rankings.csv,2006,1.0,0.0
17403,Hell's Highway: The True Story of Highway Safety Films,2171,2171,0,2003_boxofficemojo_rankings.csv,2003,1.0,0.0
17404,The 4th Tenor,2152,2152,0,2002_boxofficemojo_rankings.csv,2002,1.0,0.0
17405,Stripped,2151,2151,0,2002_boxofficemojo_rankings.csv,2002,1.0,0.0
17406,Better Living,2147,2147,0,2000_boxofficemojo_rankings.csv,2000,1.0,0.0
17407,The Velocity of Gary,2143,2143,0,1999_boxofficemojo_rankings.csv,1999,1.0,0.0
17408,Stealing the Fire,2139,2139,0,2002_boxofficemojo_rankings.csv,2002,1.0,0.0
17409,NoBody's Perfect 2010 Re-release,2122,2122,0,2010_boxofficemojo_rankings.csv,2010,1.0,0.0
17410,Missionary,2120,2120,0,2014_boxofficemojo_rankings.csv,2014,1.0,0.0
17411,Running with Arnold,2119,2119,0,2008_boxofficemojo_rankings.csv,2008,1.0,0.0
17412,Me You and Five Bucks,2105,2105,0,2015_boxofficemojo_rankings.csv,2015,1.0,0.0
17413,Jihadists,2104,2104,0,2019_boxofficemojo_rankings.csv,2019,1.0,0.0
17414,Dayveon,2077,2077,0,2017_boxofficemojo_rankings.csv,2017,1.0,0.0
17415,Rubberneck,2075,2075,0,2013_boxofficemojo_rankings.csv,2013,1.0,0.0
17416,Red Flag,2075,2075,0,2013_boxofficemojo_rankings.csv,2013,1.0,0.0
17417,Murder.com,2070,2070,0,2008_boxofficemojo_rankings.csv,2008,1.0,0.0
17418,Patagonia Rising,2064,2064,0,2012_boxofficemojo_rankings.csv,2012,1.0,0.0
17419,Some Body,2042,2042,0,2002_boxofficemojo_rankings.csv,2002,1.0,0.0
17420,Gul Makai,2035,0,2035,2020_boxofficemojo_rankings.csv,2020,0.0,1.0
17421,Choice of Weapons,2032,2032,0,2002_boxofficemojo_rankings.csv,2002,1.0,0.0
17422,The Bad and the Beautiful,2025,0,2025,2009_boxofficemojo_rankings.csv,2009,0.0,1.0
17423,Algorithms,2021,2021,0,2014_boxofficemojo_rankings.csv,2014,1.0,0.0
17424,The Tenants,2010,2010,0,2006_boxofficemojo_rankings.csv,2006,1.0,0.0
17425,Beyond Hatred,2003,949,1054,2007_boxofficemojo_rankings.csv,2007,0.4737893160259611,0.5262106839740389
17426,Split: A Deeper Divide,2000,2000,0,2012_boxofficemojo_rankings.csv,2012,1.0,0.0
17427,Enemies of Laughter,2000,2000,0,2003_boxofficemojo_rankings.csv,2003,1.0,0.0
17428,The Surfer King,1990,1990,0,2006_boxofficemojo_rankings.csv,2006,1.0,0.0
17429,The Watermelon Woman,1989,1989,0,2016_boxofficemojo_rankings.csv,2016,1.0,0.0
17430,Falling Awake,1978,1978,0,2010_boxofficemojo_rankings.csv,2010,1.0,0.0
17431,FAQs,1967,1967,0,2006_boxofficemojo_rankings.csv,2006,1.0,0.0
17432,Steal Me,1967,1967,0,2005_boxofficemojo_rankings.csv,2005,1.0,0.0
17433,The Temptation of St. Tony,1963,1963,0,2010_boxofficemojo_rankings.csv,2010,1.0,0.0
17434,Sikandar,1954,1954,0,2009_boxofficemojo_rankings.csv,2009,1.0,0.0
17435,The Transcendents,1953,1953,0,2020_boxofficemojo_rankings.csv,2020,1.0,0.0
17436,"Accidental Courtesy: Daryl Davis, Race & America",1940,1940,0,2017_boxofficemojo_rankings.csv,2017,1.0,0.0
17437,Best Man Down,1938,1938,0,2013_boxofficemojo_rankings.csv,2013,1.0,0.0
17438,Saint Maud,1933,0,1933,2020_boxofficemojo_rankings.csv,2020,0.0,1.0
17439,West Of The Jordan River,1926,1926,0,2018_boxofficemojo_rankings.csv,2018,1.0,0.0
17440,Shuttle,1925,1925,0,2009_boxofficemojo_rankings.csv,2009,1.0,0.0
17441,A Mother's Courage: Talking Back to Autism 2010 Re-release,1916,1916,0,2010_boxofficemojo_rankings.csv,2010,1.0,0.0
17442,Mr. Smith Gets a Hustler,1915,1915,0,2002_boxofficemojo_rankings.csv,2002,1.0,0.0
17443,Greg & Gentillon,1913,1913,0,2007_boxofficemojo_rankings.csv,2007,1.0,0.0
17444,American Strays,1910,1910,0,1996_boxofficemojo_rankings.csv,1996,1.0,0.0
17445,Sneakerheadz,1903,1903,0,2015_boxofficemojo_rankings.csv,2015,1.0,0.0
17446,With God on Our Side: George W. Bush and the Rise of the Religious Right in America,1884,1884,0,2005_boxofficemojo_rankings.csv,2005,1.0,0.0
17447,We Were Here,1873,0,1873,2011_boxofficemojo_rankings.csv,2011,0.0,1.0
17448,She's One of Us 2005 Re-release,1870,1870,0,2005_boxofficemojo_rankings.csv,2005,1.0,0.0
17449,Finding Happiness,1841,1841,0,2018_boxofficemojo_rankings.csv,2018,1.0,0.0
17450,Jimi Hendrix Electric Church,1818,0,1818,2019_boxofficemojo_rankings.csv,2019,0.0,1.0
17451,Abominable,1810,1810,0,2006_boxofficemojo_rankings.csv,2006,1.0,0.0
17452,Now & Later,1808,1808,0,2011_boxofficemojo_rankings.csv,2011,1.0,0.0
17453,By Hook or by Crook,1802,1802,0,2002_boxofficemojo_rankings.csv,2002,1.0,0.0
17454,The Opera Lover,1798,1798,0,2002_boxofficemojo_rankings.csv,2002,1.0,0.0
17455,Oswald's Ghost,1796,1796,0,2007_boxofficemojo_rankings.csv,2007,1.0,0.0
17456,I Kissed a Vampire,1794,1794,0,2012_boxofficemojo_rankings.csv,2012,1.0,0.0
17457,Detour,1788,1788,0,2017_boxofficemojo_rankings.csv,2017,1.0,0.0
17458,The Canyon,1785,1785,0,2009_boxofficemojo_rankings.csv,2009,1.0,0.0
17459,The Lost Village,1780,1780,0,2018_boxofficemojo_rankings.csv,2018,1.0,0.0
17460,Ghosted,1780,1780,0,2009_boxofficemojo_rankings.csv,2009,1.0,0.0
17461,Detention of the Dead,1777,1777,0,2013_boxofficemojo_rankings.csv,2013,1.0,0.0
17462,The Other Man: F.W. de Klerk and the End of Apartheid,1747,1747,0,2015_boxofficemojo_rankings.csv,2015,1.0,0.0
17463,Dark Forest,1739,1739,0,2015_boxofficemojo_rankings.csv,2015,1.0,0.0
17464,Children of Fate: Life and Death in a Sicilian Family,1738,1738,0,1993_boxofficemojo_rankings.csv,1993,1.0,0.0
17465,You Don't Need Feet to Dance,1719,1719,0,2013_boxofficemojo_rankings.csv,2013,1.0,0.0
17466,Das Boot ist voll 2005 Re-release,1718,1718,0,2005_boxofficemojo_rankings.csv,2005,1.0,0.0
17467,The Road to Love,1714,1714,0,2004_boxofficemojo_rankings.csv,2004,1.0,0.0
17468,A Beautiful Now,1714,1714,0,2016_boxofficemojo_rankings.csv,2016,1.0,0.0
17469,The Looking Glass,1711,1711,0,2015_boxofficemojo_rankings.csv,2015,1.0,0.0
17470,Dystopia: 2013,1708,1708,0,2012_boxofficemojo_rankings.csv,2012,1.0,0.0
17471,Power and Terror: Noam Chomsky in Our Times 2006 Re-release,1703,1703,0,2006_boxofficemojo_rankings.csv,2006,1.0,0.0
17472,Marathon,1703,1703,0,2004_boxofficemojo_rankings.csv,2004,1.0,0.0
17473,More Than the Rainbow,1677,1677,0,2014_boxofficemojo_rankings.csv,2014,1.0,0.0
17474,House of Usher,1677,1677,0,2008_boxofficemojo_rankings.csv,2008,1.0,0.0
17475,Persons of Interest,1672,1672,0,2004_boxofficemojo_rankings.csv,2004,1.0,0.0
17476,I Want You,1672,1672,0,1999_boxofficemojo_rankings.csv,1999,1.0,0.0
17477,The Pusher,1656,1656,0,1999_boxofficemojo_rankings.csv,1999,1.0,0.0
17478,They're Out of the Business,1655,1655,0,2011_boxofficemojo_rankings.csv,2011,1.0,0.0
17479,Headspace,1650,1650,0,2006_boxofficemojo_rankings.csv,2006,1.0,0.0
17480,Drown,1631,1631,0,2015_boxofficemojo_rankings.csv,2015,1.0,0.0
17481,Cut Snake,1625,1625,0,2015_boxofficemojo_rankings.csv,2015,1.0,0.0
17482,Game Day,1624,1624,0,2019_boxofficemojo_rankings.csv,2019,1.0,0.0
17483,The Sticky Fingers of Time,1610,1610,0,1999_boxofficemojo_rankings.csv,1999,1.0,0.0
17484,Rockets Redglare!,1605,1605,0,2004_boxofficemojo_rankings.csv,2004,1.0,0.0
17485,Blindness,1602,1602,0,2003_boxofficemojo_rankings.csv,2003,1.0,0.0
17486,Miss India America,1598,1598,0,2016_boxofficemojo_rankings.csv,2016,1.0,0.0
17487,Forever,1598,1598,0,2015_boxofficemojo_rankings.csv,2015,1.0,0.0
17488,Pups,1590,1590,0,2000_boxofficemojo_rankings.csv,2000,1.0,0.0
17489,American Playhouse: The Killing Floor,1583,1583,0,2019_boxofficemojo_rankings.csv,2019,1.0,0.0
17490,Manuela and Manuel,1582,1582,0,2010_boxofficemojo_rankings.csv,2010,1.0,0.0
17491,Mama Africa,1581,1581,0,2002_boxofficemojo_rankings.csv,2002,1.0,0.0
17492,The Fox Hunter,1577,1577,0,2020_boxofficemojo_rankings.csv,2020,1.0,0.0
17493,Wash Dry and Spin Out,1570,1570,0,2003_boxofficemojo_rankings.csv,2003,1.0,0.0
17494,What Boys Like,1554,1554,0,2004_boxofficemojo_rankings.csv,2004,1.0,0.0
17495,Independent Spirits: Faith Hubley/John Hubley,1551,1551,0,2003_boxofficemojo_rankings.csv,2003,1.0,0.0
17496,The Tunnel,1532,1532,0,2011_boxofficemojo_rankings.csv,2011,1.0,0.0
17497,Rhymes for Young Ghouls,1529,1529,0,2014_boxofficemojo_rankings.csv,2014,1.0,0.0
17498,"Carmo, Hit the Road 2010 Re-release",1512,1512,0,2010_boxofficemojo_rankings.csv,2010,1.0,0.0
17499,Blackwoods,1500,1500,0,2002_boxofficemojo_rankings.csv,2002,1.0,0.0
17500,Souldier,1500,1500,0,2014_boxofficemojo_rankings.csv,2014,1.0,0.0
17501,Making Grace,1496,1496,0,2005_boxofficemojo_rankings.csv,2005,1.0,0.0
17502,Where Are You Taking Me?,1492,1492,0,2012_boxofficemojo_rankings.csv,2012,1.0,0.0
17503,Divine Intervention,1485,1485,0,2007_boxofficemojo_rankings.csv,2007,1.0,0.0
17504,Making Rounds,1484,1484,0,2015_boxofficemojo_rankings.csv,2015,1.0,0.0
17505,Heartbreak Hospital,1480,1480,0,2002_boxofficemojo_rankings.csv,2002,1.0,0.0
17506,The Letter: An American Town and the 'Somali Invasion',1479,1479,0,2005_boxofficemojo_rankings.csv,2005,1.0,0.0
17507,Unborn in the USA: Inside the War on Abortion,1475,1475,0,2007_boxofficemojo_rankings.csv,2007,1.0,0.0
17508,The Package,1469,1469,0,2013_boxofficemojo_rankings.csv,2013,1.0,0.0
17509,Henchmen,1469,1469,0,2018_boxofficemojo_rankings.csv,2018,1.0,0.0
17510,That Way Madness Lies...,1447,1447,0,2018_boxofficemojo_rankings.csv,2018,1.0,0.0
17511,The Ballad of Bering Strait,1440,1440,0,2003_boxofficemojo_rankings.csv,2003,1.0,0.0
17512,Kalyug,1435,1435,0,2005_boxofficemojo_rankings.csv,2005,1.0,0.0
17513,Monumental: David Brower's Fight for Wild America,1430,1430,0,2005_boxofficemojo_rankings.csv,2005,1.0,0.0
17514,Bestiaire,1428,1428,0,2012_boxofficemojo_rankings.csv,2012,1.0,0.0
17515,The Silence of Mark Rothko,1422,1422,0,2016_boxofficemojo_rankings.csv,2016,1.0,0.0
17516,Shwaas,1416,1416,0,2004_boxofficemojo_rankings.csv,2004,1.0,0.0
17517,The Forest for the Trees,1410,1410,0,2017_boxofficemojo_rankings.csv,2017,1.0,0.0
17518,Drool,1403,1403,0,2010_boxofficemojo_rankings.csv,2010,1.0,0.0
17519,"Love, Honor and Obey",1400,1400,0,2001_boxofficemojo_rankings.csv,2001,1.0,0.0
17520,Four Lane Highway,1393,1393,0,2007_boxofficemojo_rankings.csv,2007,1.0,0.0
17521,The Execution of Wanda Jean,1386,1386,0,2002_boxofficemojo_rankings.csv,2002,1.0,0.0
17522,Besotted,1379,1379,0,2002_boxofficemojo_rankings.csv,2002,1.0,0.0
17523,Ice Blues,1377,1377,0,2008_boxofficemojo_rankings.csv,2008,1.0,0.0
17524,Beauty and the Beholder,1368,1368,0,2018_boxofficemojo_rankings.csv,2018,1.0,0.0
17525,Along the Roadside 2015 Re-release,1352,1352,0,2015_boxofficemojo_rankings.csv,2015,1.0,0.0
17526,The Dog Problem,1344,1344,0,2007_boxofficemojo_rankings.csv,2007,1.0,0.0
17527,Return to the Land of Wonders,1338,1338,0,2005_boxofficemojo_rankings.csv,2005,1.0,0.0
17528,El Leyton,1332,1332,0,2003_boxofficemojo_rankings.csv,2003,1.0,0.0
17529,America Betrayed,1311,1311,0,2009_boxofficemojo_rankings.csv,2009,1.0,0.0
17530,Exorcism,1303,1303,0,2003_boxofficemojo_rankings.csv,2003,1.0,0.0
17531,3 Nights in the Desert,1297,1297,0,2015_boxofficemojo_rankings.csv,2015,1.0,0.0
17532,The Hours and Times,1273,1273,0,2019_boxofficemojo_rankings.csv,2019,1.0,0.0
17533,Altered Perception,1259,1259,0,2018_boxofficemojo_rankings.csv,2018,1.0,0.0
17534,The Wolf Hour,1255,0,1255,2019_boxofficemojo_rankings.csv,2019,0.0,1.0
17535,Proteus: A Nineteenth Century Vision,1246,1246,0,2005_boxofficemojo_rankings.csv,2005,1.0,0.0
17536,A Fish in the Bathtub 2019 re-release,1237,1237,0,2019_boxofficemojo_rankings.csv,2019,1.0,0.0
17537,Two Men Went to War 2018 Re-release,1227,1227,0,2018_boxofficemojo_rankings.csv,2018,1.0,0.0
17538,The Trials of Darryl Hunt,1217,1217,0,2007_boxofficemojo_rankings.csv,2007,1.0,0.0
17539,A Small Good Thing,1196,1196,0,2016_boxofficemojo_rankings.csv,2016,1.0,0.0
17540,Under the Turban,1190,1190,0,2018_boxofficemojo_rankings.csv,2018,1.0,0.0
17541,Snowman's Land,1190,1190,0,2012_boxofficemojo_rankings.csv,2012,1.0,0.0
17542,Above and Below,1189,0,1189,2016_boxofficemojo_rankings.csv,2016,0.0,1.0
17543,A Different American Dream,1172,1172,0,2017_boxofficemojo_rankings.csv,2017,1.0,0.0
17544,A Zombie Invasion,1170,1170,0,2013_boxofficemojo_rankings.csv,2013,1.0,0.0
17545,The Colour of Olives,1169,1169,0,2006_boxofficemojo_rankings.csv,2006,1.0,0.0
17546,Fear Pharm,1157,1157,0,2020_boxofficemojo_rankings.csv,2020,1.0,0.0
17547,Jack & Diane,1142,1142,0,2012_boxofficemojo_rankings.csv,2012,1.0,0.0
17548,Veer!,1132,1132,0,2013_boxofficemojo_rankings.csv,2013,1.0,0.0
17549,The Ister,1124,1124,0,2006_boxofficemojo_rankings.csv,2006,1.0,0.0
17550,Hai Tang Hong,1107,1107,0,2020_boxofficemojo_rankings.csv,2020,1.0,0.0
17551,Half Brothers,1100,1100,0,2018_boxofficemojo_rankings.csv,2018,1.0,0.0
17552,Fall of Hyperion,1093,1093,0,2008_boxofficemojo_rankings.csv,2008,1.0,0.0
17553,The Empire in Africa,1088,1088,0,2006_boxofficemojo_rankings.csv,2006,1.0,0.0
17554,We Are the Giant,1088,1088,0,2014_boxofficemojo_rankings.csv,2014,1.0,0.0
17555,Kiss Me Deadly,1085,1085,0,2008_boxofficemojo_rankings.csv,2008,1.0,0.0
17556,The Butterfly Room,1081,1081,0,2014_boxofficemojo_rankings.csv,2014,1.0,0.0
17557,Childless,1036,1036,0,2015_boxofficemojo_rankings.csv,2015,1.0,0.0
17558,Invisible Hands,1034,1034,0,2018_boxofficemojo_rankings.csv,2018,1.0,0.0
17559,Absence,1031,1031,0,2013_boxofficemojo_rankings.csv,2013,1.0,0.0
17560,Remnants,1022,1022,0,2013_boxofficemojo_rankings.csv,2013,1.0,0.0
17561,Confessionsofa Ex-Doofus-ItchyFooted Mutha,1013,1013,0,2009_boxofficemojo_rankings.csv,2009,1.0,0.0
17562,How to Rob a Bank (and 10 Tips to Actually Get Away with It),1006,1006,0,2008_boxofficemojo_rankings.csv,2008,1.0,0.0
17563,The Jimmy Show,1000,1000,0,2002_boxofficemojo_rankings.csv,2002,1.0,0.0
17564,Summerspell,984,984,0,1999_boxofficemojo_rankings.csv,1999,1.0,0.0
17565,A House on a Hill,984,984,0,2003_boxofficemojo_rankings.csv,2003,1.0,0.0
17566,The Penguin Counters,976,976,0,2017_boxofficemojo_rankings.csv,2017,1.0,0.0
17567,Looking for Cheyenne,973,973,0,2007_boxofficemojo_rankings.csv,2007,1.0,0.0
17568,Strangers Online,968,968,0,2011_boxofficemojo_rankings.csv,2011,1.0,0.0
17569,The Trouble with Men and Women,967,967,0,2006_boxofficemojo_rankings.csv,2006,1.0,0.0
17570,The Last Wave 2001 Re-release,957,957,0,2001_boxofficemojo_rankings.csv,2001,1.0,0.0
17571,The Lonely Affair of the Heart,932,932,0,2002_boxofficemojo_rankings.csv,2002,1.0,0.0
17572,A People Uncounted,930,930,0,2014_boxofficemojo_rankings.csv,2014,1.0,0.0
17573,High Strung,904,904,0,1992_boxofficemojo_rankings.csv,1992,1.0,0.0
17574,They Are We,900,900,0,2015_boxofficemojo_rankings.csv,2015,1.0,0.0
17575,How to Be a Serial Killer,899,899,0,2009_boxofficemojo_rankings.csv,2009,1.0,0.0
17576,Beat the Drum,895,0,895,2008_boxofficemojo_rankings.csv,2008,0.0,1.0
17577,In Her Line of Fire,884,884,0,2006_boxofficemojo_rankings.csv,2006,1.0,0.0
17578,Big Muddy,881,881,0,2015_boxofficemojo_rankings.csv,2015,1.0,0.0
17579,Extraordinary Ordinary People,880,880,0,2017_boxofficemojo_rankings.csv,2017,1.0,0.0
17580,800 Bullets 2004 Re-release,866,866,0,2004_boxofficemojo_rankings.csv,2004,1.0,0.0
17581,The Underground Comedy Movie,856,856,0,1999_boxofficemojo_rankings.csv,1999,1.0,0.0
17582,45365,853,853,0,2010_boxofficemojo_rankings.csv,2010,1.0,0.0
17583,Officer Downe,850,850,0,2016_boxofficemojo_rankings.csv,2016,1.0,0.0
17584,PTU,849,0,849,2007_boxofficemojo_rankings.csv,2007,0.0,1.0
17585,Abandoned,832,832,0,2011_boxofficemojo_rankings.csv,2011,1.0,0.0
17586,Doing Time for Patsy Cline,831,831,0,2006_boxofficemojo_rankings.csv,2006,1.0,0.0
17587,Disfigured,829,829,0,2008_boxofficemojo_rankings.csv,2008,1.0,0.0
17588,TVTV: Video Revolutionaries,812,812,0,2018_boxofficemojo_rankings.csv,2018,1.0,0.0
17589,Jackpot 2014 Re-release,806,806,0,2014_boxofficemojo_rankings.csv,2014,1.0,0.0
17590,The Untold Story,790,790,0,2019_boxofficemojo_rankings.csv,2019,1.0,0.0
17591,Port Djema,783,783,0,1999_boxofficemojo_rankings.csv,1999,1.0,0.0
17592,Issues,783,783,0,2006_boxofficemojo_rankings.csv,2006,1.0,0.0
17593,Flakes,778,778,0,2007_boxofficemojo_rankings.csv,2007,1.0,0.0
17594,Uncut,762,762,0,2006_boxofficemojo_rankings.csv,2006,1.0,0.0
17595,A New Day in Old Sana'a,737,737,0,2006_boxofficemojo_rankings.csv,2006,1.0,0.0
17596,It's All So Quiet 2015 Re-release,724,724,0,2015_boxofficemojo_rankings.csv,2015,1.0,0.0
17597,A Girl Like Grace,713,713,0,2016_boxofficemojo_rankings.csv,2016,1.0,0.0
17598,Redneck Carnage,706,706,0,2011_boxofficemojo_rankings.csv,2011,1.0,0.0
17599,The Loving Story,700,700,0,2012_boxofficemojo_rankings.csv,2012,1.0,0.0
17600,It's Hard Being Loved by Jerks 2015 Re-release,697,697,0,2015_boxofficemojo_rankings.csv,2015,1.0,0.0
17601,The Portal,685,0,685,2019_boxofficemojo_rankings.csv,2019,0.0,1.0
17602,Syrup,663,663,0,2013_boxofficemojo_rankings.csv,2013,1.0,0.0
17603,Nature Calls,646,646,0,2012_boxofficemojo_rankings.csv,2012,1.0,0.0
17604,Spooky House 2005 Re-release,637,637,0,2005_boxofficemojo_rankings.csv,2005,1.0,0.0
17605,Citizen Gangster,625,625,0,2012_boxofficemojo_rankings.csv,2012,1.0,0.0
17606,Steve + Sky,624,624,0,2005_boxofficemojo_rankings.csv,2005,1.0,0.0
17607,Anatomy 2 2004 Re-release,623,623,0,2004_boxofficemojo_rankings.csv,2004,1.0,0.0
17608,"Jesus, You Know",604,604,0,2004_boxofficemojo_rankings.csv,2004,1.0,0.0
17609,Gottfried Helnwein and the Dreaming Child,601,601,0,2012_boxofficemojo_rankings.csv,2012,1.0,0.0
17610,Shake Hands with the Devil,594,594,0,2010_boxofficemojo_rankings.csv,2010,1.0,0.0
17611,Sorority Girls' Revenge,582,582,0,2001_boxofficemojo_rankings.csv,2001,1.0,0.0
17612,The Rise and Fall of Miss Thang,581,581,0,2008_boxofficemojo_rankings.csv,2008,1.0,0.0
17613,Notes on Marie Menken,577,577,0,2007_boxofficemojo_rankings.csv,2007,1.0,0.0
17614,A Good Day to Die,573,573,0,2011_boxofficemojo_rankings.csv,2011,1.0,0.0
17615,The Pit,560,560,0,2016_boxofficemojo_rankings.csv,2016,1.0,0.0
17616,The Comedians of Comedy,549,549,0,2005_boxofficemojo_rankings.csv,2005,1.0,0.0
17617,Obscene,549,0,549,2007_boxofficemojo_rankings.csv,2007,0.0,1.0
17618,Higher Power,528,528,0,2018_boxofficemojo_rankings.csv,2018,1.0,0.0
17619,Greater 2020 Re-release,527,527,0,2020_boxofficemojo_rankings.csv,2020,1.0,0.0
17620,Meeting Evil,525,525,0,2012_boxofficemojo_rankings.csv,2012,1.0,0.0
17621,The 11th Hour,510,0,510,2015_boxofficemojo_rankings.csv,2015,0.0,1.0
17622,Canary,504,504,0,2008_boxofficemojo_rankings.csv,2008,1.0,0.0
17623,Nobody,488,488,0,1999_boxofficemojo_rankings.csv,1999,1.0,0.0
17624,The Last Door,488,488,0,2007_boxofficemojo_rankings.csv,2007,1.0,0.0
17625,Tasuma,479,479,0,2004_boxofficemojo_rankings.csv,2004,1.0,0.0
17626,Triumph of the Wall,476,476,0,2013_boxofficemojo_rankings.csv,2013,1.0,0.0
17627,Rome & Jewel,470,470,0,2008_boxofficemojo_rankings.csv,2008,1.0,0.0
17628,Green is Gold,455,455,0,2016_boxofficemojo_rankings.csv,2016,1.0,0.0
17629,Serum,440,440,0,2006_boxofficemojo_rankings.csv,2006,1.0,0.0
17630,The Dark Hours,423,423,0,2005_boxofficemojo_rankings.csv,2005,1.0,0.0
17631,State Park,421,421,0,1988_boxofficemojo_rankings.csv,1988,1.0,0.0
17632,The Magician 2010 Re-release,406,406,0,2010_boxofficemojo_rankings.csv,2010,1.0,0.0
17633,Skinless,400,400,0,2014_boxofficemojo_rankings.csv,2014,1.0,0.0
17634,Cinemanovels,398,398,0,2014_boxofficemojo_rankings.csv,2014,1.0,0.0
17635,Spaceship Earth,362,0,362,2020_boxofficemojo_rankings.csv,2020,0.0,1.0
17636,Trojan War,309,309,0,1997_boxofficemojo_rankings.csv,1997,1.0,0.0
17637,Antiporno,294,0,294,2017_boxofficemojo_rankings.csv,2017,0.0,1.0
17638,Wet Woman in the Wind,268,0,268,2017_boxofficemojo_rankings.csv,2017,0.0,1.0
17639,"Pretty Village, Pretty Flame",211,211,0,1998_boxofficemojo_rankings.csv,1998,1.0,0.0
17640,All That Heaven Allows,170,0,170,2009_boxofficemojo_rankings.csv,2009,0.0,1.0
17641,"Mummy, I'm A Zombie",120,120,0,2014_boxofficemojo_rankings.csv,2014,1.0,0.0
17642,The Objective,95,95,0,2009_boxofficemojo_rankings.csv,2009,1.0,0.0
17643,Dog Eat Dog,80,80,0,2009_boxofficemojo_rankings.csv,2009,1.0,0.0
17644,Paranoid Girls,78,78,0,2015_boxofficemojo_rankings.csv,2015,1.0,0.0
17645,Confession of a Child of the Century 2015 Re-release,74,74,0,2015_boxofficemojo_rankings.csv,2015,1.0,0.0
17646,Zyzzyx Rd,30,30,0,2006_boxofficemojo_rankings.csv,2006,1.0,0.0
17647,Confidence,1,0,1,1981_boxofficemojo_rankings.csv,1981,0.0,1.0
