Rank,Release Group,Worldwide,Domestic,Foreign,filename,year,Domestic %,Foreign %
1,Avengers: Endgame,2797800564,858373000,1939427564,2019_boxofficemojo_rankings.csv,2019,0.306802783245132,0.693197216754868
2,Star Wars: Episode VII - The Force Awakens,2068223624,936662225,1131561399,2015_boxofficemojo_rankings.csv,2015,0.4528824707980417,0.5471175292019583
3,Avengers: Infinity War,2048359754,678815482,1369544272,2018_boxofficemojo_rankings.csv,2018,0.3313946589091205,0.6686053410908794
4,Jurassic World,1670400637,652270625,1018130012,2015_boxofficemojo_rankings.csv,2015,0.39048753368022093,0.6095124663197791
5,The Lion King,1656943394,543638043,1113305351,2019_boxofficemojo_rankings.csv,2019,0.32809693135479556,0.6719030686452044
6,The Avengers,1518812988,623357910,895455078,2012_boxofficemojo_rankings.csv,2012,0.41042440045291473,0.5895755995470853
7,Furious 7,1515047671,353007020,1162040651,2015_boxofficemojo_rankings.csv,2015,0.23300060239490641,0.7669993976050936
8,Frozen II,1450026933,477373578,972653355,2019_boxofficemojo_rankings.csv,2019,0.329217042205105,0.6707829577948949
9,Avengers: Age of Ultron,1402805868,459005868,943800000,2015_boxofficemojo_rankings.csv,2015,0.3272055517235689,0.6727944482764311
10,Black Panther,1346913161,700059566,646853595,2018_boxofficemojo_rankings.csv,2018,0.5197510769589992,0.4802489230410007
11,Harry Potter and the Deathly Hallows: Part 2,1341511219,381011219,960500000,2011_boxofficemojo_rankings.csv,2011,0.2840164238686102,0.7159835761313897
12,Star Wars: Episode VIII - The Last Jedi,1332539889,620181382,712358507,2017_boxofficemojo_rankings.csv,2017,0.465412995978239,0.5345870040217611
13,Jurassic World: Fallen Kingdom,1308467944,417719760,890748184,2018_boxofficemojo_rankings.csv,2018,0.3192434036427567,0.6807565963572433
14,Frozen,1280802282,400738009,880064273,2013_boxofficemojo_rankings.csv,2013,0.31288046143565507,0.6871195385643449
15,Beauty and the Beast,1263521126,504014165,759506961,2017_boxofficemojo_rankings.csv,2017,0.3988965080430321,0.6011034919569679
16,Incredibles 2,1242805359,608581744,634223615,2018_boxofficemojo_rankings.csv,2018,0.48968387494698595,0.510316125053014
17,The Fate of the Furious,1236005118,226008385,1009996733,2017_boxofficemojo_rankings.csv,2017,0.1828539232634472,0.8171460767365528
18,Iron Man 3,1214811252,409013994,805797258,2013_boxofficemojo_rankings.csv,2013,0.33668933616363966,0.6633106638363603
19,Minions,1159398397,336045770,823352627,2015_boxofficemojo_rankings.csv,2015,0.28984494964762314,0.7101550503523768
20,Captain America: Civil War,1153296293,408084349,745211944,2016_boxofficemojo_rankings.csv,2016,0.35384172434862754,0.6461582756513724
21,Aquaman,1148461807,335061807,813400000,2018_boxofficemojo_rankings.csv,2018,0.2917483236776023,0.7082516763223977
22,Spider-Man: Far from Home,1131927996,390532085,741395911,2019_boxofficemojo_rankings.csv,2019,0.345014953583673,0.654985046416327
23,Captain Marvel,1128274794,426829839,701444955,2019_boxofficemojo_rankings.csv,2019,0.3783030882811692,0.6216969117188308
24,Transformers: Dark of the Moon,1123794079,352390543,771403536,2011_boxofficemojo_rankings.csv,2011,0.3135721655639725,0.6864278344360275
25,Skyfall,1108561013,304360277,804200736,2012_boxofficemojo_rankings.csv,2012,0.2745543758356943,0.7254456241643057
26,Transformers: Age of Extinction,1104054072,245439076,858614996,2014_boxofficemojo_rankings.csv,2014,0.22230711540729683,0.7776928845927031
27,The Dark Knight Rises,1081041287,448139099,632902188,2012_boxofficemojo_rankings.csv,2012,0.4145439257399981,0.5854560742600019
28,Joker,1074251311,335451311,738800000,2019_boxofficemojo_rankings.csv,2019,0.3122652097931673,0.6877347902068327
29,Star Wars: Episode IX - The Rise of Skywalker,1074144248,515202542,558941706,2019_boxofficemojo_rankings.csv,2019,0.4796399952420543,0.5203600047579457
30,Toy Story 4,1073394593,434038008,639356585,2019_boxofficemojo_rankings.csv,2019,0.4043601587249657,0.5956398412750342
31,Toy Story 3,1066969703,415004880,651964823,2010_boxofficemojo_rankings.csv,2010,0.3889565737744289,0.6110434262255711
32,Rogue One: A Star Wars Story,1056057273,532177324,523879949,2016_boxofficemojo_rankings.csv,2016,0.5039284682810948,0.49607153171890517
33,Aladdin,1050693953,355559216,695134737,2019_boxofficemojo_rankings.csv,2019,0.3384041708670612,0.6615958291329388
34,Pirates of the Caribbean: On Stranger Tides,1045713802,241071802,804642000,2011_boxofficemojo_rankings.csv,2011,0.23053325062644625,0.7694667493735537
35,Despicable Me 3,1034799409,264624300,770175109,2017_boxofficemojo_rankings.csv,2017,0.2557252136969475,0.7442747863030524
36,Finding Dory,1028570889,486295561,542275328,2016_boxofficemojo_rankings.csv,2016,0.47278759898871686,0.5272124010112832
37,Alice in Wonderland,1025467110,334191110,691276000,2010_boxofficemojo_rankings.csv,2010,0.32589159295416115,0.6741084070458389
38,Zootopia,1023784195,341268248,682515947,2016_boxofficemojo_rankings.csv,2016,0.3333400238709487,0.6666599761290513
39,The Hobbit: An Unexpected Journey,1017003568,303003568,714000000,2012_boxofficemojo_rankings.csv,2012,0.29793756633113405,0.7020624336688659
40,Harry Potter and the Deathly Hallows: Part 1,976536918,295983305,680553613,2010_boxofficemojo_rankings.csv,2010,0.30309484418283916,0.6969051558171608
41,Despicable Me 2,970766005,368065385,602700620,2013_boxofficemojo_rankings.csv,2013,0.3791494377679614,0.6208505622320386
42,The Jungle Book,966550600,364001123,602549477,2016_boxofficemojo_rankings.csv,2016,0.3765981036067848,0.6234018963932152
43,Jumanji: Welcome to the Jungle,962077546,404515480,557562066,2017_boxofficemojo_rankings.csv,2017,0.42046036900231326,0.5795396309976868
44,The Hobbit: The Desolation of Smaug,958366855,258366855,700000000,2013_boxofficemojo_rankings.csv,2013,0.2695907664711547,0.7304092335288452
45,The Hobbit: The Battle of the Five Armies,956019788,255119788,700900000,2014_boxofficemojo_rankings.csv,2014,0.26685617934092387,0.7331438206590761
46,Bohemian Rhapsody,903655259,216428042,687227217,2018_boxofficemojo_rankings.csv,2018,0.23950288546929155,0.7604971145307085
47,Spectre,880674609,200074609,680600000,2015_boxofficemojo_rankings.csv,2015,0.22718335121207064,0.7728166487879293
48,Spider-Man: Homecoming,880166924,334201140,545965784,2017_boxofficemojo_rankings.csv,2017,0.37970199843592395,0.620298001564076
49,Ice Age: Continental Drift,877244782,161321843,715922939,2012_boxofficemojo_rankings.csv,2012,0.18389604168657225,0.8161039583134277
50,The Secret Life of Pets,875457937,368384330,507073607,2016_boxofficemojo_rankings.csv,2016,0.42079043941548044,0.5792095605845196
51,Batman v Superman: Dawn of Justice,873634919,330360194,543274725,2016_boxofficemojo_rankings.csv,2016,0.3781444477724682,0.6218555522275317
52,Wolf Warrior 2,870325439,2721100,867604339,2017_boxofficemojo_rankings.csv,2017,0.003126531614572282,0.9968734683854277
53,The Hunger Games: Catching Fire,865011746,424668047,440343699,2013_boxofficemojo_rankings.csv,2013,0.490939052520103,0.5090609474798969
54,Guardians of the Galaxy Vol. 2,863756051,389813101,473942950,2017_boxofficemojo_rankings.csv,2017,0.4512999944240043,0.5487000055759956
55,Inside Out,857611174,356461711,501149463,2015_boxofficemojo_rankings.csv,2015,0.4156449004009829,0.5843550995990171
56,Venom,856085151,213515506,642569645,2018_boxofficemojo_rankings.csv,2018,0.24940919224050412,0.7505908077594958
57,Thor: Ragnarok,853977126,315058289,538918837,2017_boxofficemojo_rankings.csv,2017,0.36893059475225337,0.6310694052477467
58,The Twilight Saga: Breaking Dawn - Part 2,829746820,292324737,537422083,2012_boxofficemojo_rankings.csv,2012,0.35230594436023266,0.6476940556397673
59,Inception,826137188,292576195,533560993,2010_boxofficemojo_rankings.csv,2010,0.3541496488111125,0.6458503511888876
60,Wonder Woman,821847012,412563408,409283604,2017_boxofficemojo_rankings.csv,2017,0.501995385973369,0.49800461402663104
61,Fantastic Beasts and Where to Find Them,814037575,234037575,580000000,2016_boxofficemojo_rankings.csv,2016,0.287502177034027,0.7124978229659731
62,Coco,807292196,209936015,597356181,2017_boxofficemojo_rankings.csv,2017,0.2600496029073468,0.7399503970926532
63,Jumanji: The Next Level,800059707,320314960,479744747,2019_boxofficemojo_rankings.csv,2019,0.4003638193467978,0.5996361806532021
64,Pirates of the Caribbean: Dead Men Tell No Tales,794861794,172558876,622302918,2017_boxofficemojo_rankings.csv,2017,0.21709293024593404,0.782907069754066
65,Mission: Impossible - Fallout,791115104,220159104,570956000,2018_boxofficemojo_rankings.csv,2018,0.27828959766643513,0.7217104023335649
66,Fast & Furious 6,788679850,238679850,550000000,2013_boxofficemojo_rankings.csv,2013,0.30263211365169274,0.6973678863483073
67,Deadpool,782612155,363070709,419541446,2016_boxofficemojo_rankings.csv,2016,0.463921633059737,0.536078366940263
68,Guardians of the Galaxy,772776600,333176600,439600000,2014_boxofficemojo_rankings.csv,2014,0.4311421955581988,0.5688578044418011
69,Fast & Furious Presents: Hobbs & Shaw,759056935,173956935,585100000,2019_boxofficemojo_rankings.csv,2019,0.22917508157671992,0.77082491842328
70,Maleficent,758410378,241410378,517000000,2014_boxofficemojo_rankings.csv,2014,0.31831101604466705,0.681688983955333
71,The Amazing Spider-Man,757930663,262030663,495900000,2012_boxofficemojo_rankings.csv,2012,0.34571851462354675,0.6542814853764533
72,The Hunger Games: Mockingjay - Part 1,755356711,337135885,418220826,2014_boxofficemojo_rankings.csv,2014,0.44632672231596815,0.5536732776840319
73,Shrek Forever After,752600867,238736787,513864080,2010_boxofficemojo_rankings.csv,2010,0.31721566831519477,0.6827843316848052
74,Madagascar 3: Europe's Most Wanted,746921274,216391482,530529792,2012_boxofficemojo_rankings.csv,2012,0.2897112313338661,0.7102887686661339
75,Suicide Squad,746846894,325100054,421746840,2016_boxofficemojo_rankings.csv,2016,0.43529678788488074,0.5647032121151193
76,X-Men: Days of Future Past,746045700,233921534,512124166,2014_boxofficemojo_rankings.csv,2014,0.3135485319465014,0.6864514680534985
77,Monsters University,743559607,268492764,475066843,2013_boxofficemojo_rankings.csv,2013,0.3610911102114238,0.6389088897885762
78,Deadpool 2,734546611,318491426,416055185,2018_boxofficemojo_rankings.csv,2018,0.43358912998919275,0.5664108700108073
79,Ne Zha,726063471,3695533,722367938,2019_boxofficemojo_rankings.csv,2019,0.005089820859476899,0.9949101791405232
80,Gravity,723192705,274092705,449100000,2013_boxofficemojo_rankings.csv,2013,0.37900369169238235,0.6209963083076177
81,Captain America: The Winter Soldier,714421503,259766572,454654931,2014_boxofficemojo_rankings.csv,2014,0.3636040781376089,0.6363959218623911
82,The Twilight Saga: Breaking Dawn - Part 1,712205856,281287133,430918723,2011_boxofficemojo_rankings.csv,2011,0.394952008089077,0.6050479919109231
83,Dawn of the Planet of the Apes,710644566,208545589,502098977,2014_boxofficemojo_rankings.csv,2014,0.29345976734028806,0.7065402326597119
84,The Amazing Spider-Man 2,708982323,202853933,506128390,2014_boxofficemojo_rankings.csv,2014,0.28611987410580336,0.7138801258941967
85,It,700381748,327481748,372900000,2017_boxofficemojo_rankings.csv,2017,0.4675760739555994,0.5324239260444006
86,The Wandering Earth,699856699,5971413,693885286,2019_boxofficemojo_rankings.csv,2019,0.008532336703402763,0.9914676632965972
87,The Twilight Saga: Eclipse,698491347,300531751,397959596,2010_boxofficemojo_rankings.csv,2010,0.4302583736946422,0.5697416263053579
88,Mission: Impossible - Ghost Protocol,694713380,209397903,485315477,2011_boxofficemojo_rankings.csv,2011,0.3014162516921727,0.6985837483078273
89,The Hunger Games,694394724,408010692,286384032,2012_boxofficemojo_rankings.csv,2012,0.5875774655223331,0.4124225344776669
90,Mission: Impossible - Rogue Nation,682714267,195042377,487671890,2015_boxofficemojo_rankings.csv,2015,0.2856866868434727,0.7143133131565274
91,Interstellar,677896797,188020017,489876780,2014_boxofficemojo_rankings.csv,2014,0.2773578778245798,0.7226421221754201
92,Doctor Strange,677718395,232641920,445076475,2016_boxofficemojo_rankings.csv,2016,0.3432722524817996,0.6567277475182004
93,Man of Steel,668045518,291045518,377000000,2013_boxofficemojo_rankings.csv,2013,0.4356671965577052,0.5643328034422948
94,Kung Fu Panda 2,665692281,165249063,500443218,2011_boxofficemojo_rankings.csv,2011,0.24823641150196843,0.7517635884980316
95,The Hunger Games: Mockingjay - Part 2,658344137,281723902,376620235,2015_boxofficemojo_rankings.csv,2015,0.4279280184430351,0.5720719815569649
96,Justice League,657924295,229024295,428900000,2017_boxofficemojo_rankings.csv,2017,0.3481012887660578,0.6518987112339422
97,Big Hero 6,657827828,222527828,435300000,2014_boxofficemojo_rankings.csv,2014,0.33827670178769026,0.6617232982123098
98,Fantastic Beasts: The Crimes of Grindelwald,654855901,159555901,495300000,2018_boxofficemojo_rankings.csv,2018,0.24365039813545178,0.7563496018645482
99,Thor: The Dark World,644783140,206362140,438421000,2013_boxofficemojo_rankings.csv,2013,0.32004890822672566,0.6799510917732744
100,Moana,643331111,248757044,394574067,2016_boxofficemojo_rankings.csv,2016,0.38667031602642327,0.6133296839735767
101,Sing,634151679,270395425,363756254,2016_boxofficemojo_rankings.csv,2016,0.42638919670825315,0.5736108032917469
102,The Martian,630161890,228433663,401728227,2015_boxofficemojo_rankings.csv,2015,0.36249996488997455,0.6375000351100255
103,Fast Five,626137675,209837675,416300000,2011_boxofficemojo_rankings.csv,2011,0.33513024911014977,0.6648697508898502
104,Men in Black 3,624026776,179020854,445005922,2012_boxofficemojo_rankings.csv,2012,0.2868800841328001,0.7131199158671999
105,Iron Man 2,623933331,312433331,311500000,2010_boxofficemojo_rankings.csv,2010,0.5007479412892594,0.4992520587107407
106,Ant-Man and the Wasp,622674139,216648740,406025399,2018_boxofficemojo_rankings.csv,2018,0.3479327732285988,0.6520672267714012
107,How to Train Your Dragon 2,621537519,177002924,444534595,2014_boxofficemojo_rankings.csv,2014,0.2847823640393944,0.7152176359606056
108,Logan,619021436,226277068,392744368,2017_boxofficemojo_rankings.csv,2017,0.36553995522701094,0.6344600447729891
109,Life of Pi,609016565,124987023,484029542,2012_boxofficemojo_rankings.csv,2012,0.20522762463776334,0.7947723753622367
110,Transformers: The Last Knight,605425157,130168683,475256474,2017_boxofficemojo_rankings.csv,2017,0.21500375644284633,0.7849962435571537
111,Tangled,592461732,200821936,391639796,2010_boxofficemojo_rankings.csv,2010,0.33896186901738995,0.66103813098261
112,The Croods,587204668,187168425,400036243,2013_boxofficemojo_rankings.csv,2013,0.3187447838885368,0.6812552161114632
113,The Hangover Part II,586764305,254464305,332300000,2011_boxofficemojo_rankings.csv,2011,0.43367379854505633,0.5663262014549436
114,Ready Player One,582890172,137690172,445200000,2018_boxofficemojo_rankings.csv,2018,0.23621975221774713,0.7637802477822528
115,Operation Red Sea,579330426,1543547,577786879,2018_boxofficemojo_rankings.csv,2018,0.0026643637736368433,0.9973356362263631
116,Fifty Shades of Grey,569651467,166167230,403484237,2015_boxofficemojo_rankings.csv,2015,0.2916998193212763,0.7083001806787237
117,Kong: Skull Island,566652812,168052812,398600000,2017_boxofficemojo_rankings.csv,2017,0.29657103686975084,0.7034289631302492
118,The Smurfs,563749323,142614158,421135165,2011_boxofficemojo_rankings.csv,2011,0.2529744199799243,0.7470255800200757
119,Cars 2,559852396,191452396,368400000,2011_boxofficemojo_rankings.csv,2011,0.3419694143811434,0.6580305856188566
120,Puss in Boots,554987477,149260504,405726973,2011_boxofficemojo_rankings.csv,2011,0.26894391348581725,0.7310560865141827
121,The Mermaid,553810228,3232685,550577543,2016_boxofficemojo_rankings.csv,2016,0.005837170995693492,0.9941628290043065
122,Ted,549368315,218815487,330552828,2012_boxofficemojo_rankings.csv,2012,0.398303799155217,0.6016962008447829
123,American Sniper,547426372,350126372,197300000,2014_boxofficemojo_rankings.csv,2014,0.639586234621521,0.3604137653784791
124,Detective Chinatown 2,544185156,1983984,542201172,2018_boxofficemojo_rankings.csv,2018,0.0036457885301083076,0.9963542114698917
125,X-Men: Apocalypse,543934105,155442489,388491616,2016_boxofficemojo_rankings.csv,2016,0.285774485495812,0.7142255145041879
126,Sherlock Holmes: A Game of Shadows,543848418,186848418,357000000,2011_boxofficemojo_rankings.csv,2011,0.3435670893134785,0.6564329106865214
127,Despicable Me,543113985,251513985,291600000,2010_boxofficemojo_rankings.csv,2010,0.4630961307321151,0.5369038692678849
128,Cinderella,542351353,201151353,341200000,2015_boxofficemojo_rankings.csv,2015,0.3708875286976559,0.6291124713023442
129,World War Z,540007876,202359711,337648165,2013_boxofficemojo_rankings.csv,2013,0.37473473997997764,0.6252652600200224
130,Brave,538983207,237283207,301700000,2012_boxofficemojo_rankings.csv,2012,0.4402423005360907,0.5597576994639093
131,The Revenant,532950503,183637894,349312609,2015_boxofficemojo_rankings.csv,2015,0.34456838480552104,0.6554316151944789
132,The Meg,530243742,145443742,384800000,2016_boxofficemojo_rankings.csv,2016,0.2742960085703378,0.7257039914296621
133,Ralph Breaks the Internet,529323962,201091711,328232251,2018_boxofficemojo_rankings.csv,2018,0.3799029052835511,0.6200970947164489
134,Hotel Transylvania 3: Summer Vacation,528583774,167510016,361073758,2018_boxofficemojo_rankings.csv,2018,0.31690343941583043,0.6830965605841696
135,The Boss Baby,527965936,175003033,352962903,2017_boxofficemojo_rankings.csv,2017,0.331466522870521,0.6685334771294791
136,Dunkirk,525245546,188045546,337200000,2017_boxofficemojo_rankings.csv,2017,0.3580145465907482,0.6419854534092517
137,Godzilla,524976069,200676069,324300000,2014_boxofficemojo_rankings.csv,2014,0.38225755582013016,0.6177424441798699
138,How to Train Your Dragon: The Hidden World,521799505,160799505,361000000,2019_boxofficemojo_rankings.csv,2019,0.3081633912243746,0.6918366087756255
139,Kung Fu Panda 3,521170825,143528619,377642206,2016_boxofficemojo_rankings.csv,2016,0.2753964959569638,0.7246035040430362
140,Ant-Man,519311965,180202163,339109802,2015_boxofficemojo_rankings.csv,2015,0.3470017545234106,0.6529982454765894
141,Dr. Seuss' the Grinch,511595957,270620950,240975007,2018_boxofficemojo_rankings.csv,2018,0.5289739809261237,0.4710260190738763
142,Rio 2,498781117,131538435,367242682,2014_boxofficemojo_rankings.csv,2014,0.2637197570572825,0.7362802429427175
143,How to Train Your Dragon,494878759,217581231,277297528,2010_boxofficemojo_rankings.csv,2010,0.4396657303289107,0.5603342696710892
144,Oz the Great and Powerful,493311825,234911825,258400000,2013_boxofficemojo_rankings.csv,2013,0.47619337930932426,0.5238066206906757
145,Clash of the Titans,493214993,163214888,330000105,2010_boxofficemojo_rankings.csv,2010,0.33092037005452507,0.6690796299454749
146,Maleficent: Mistress of Evil,491730089,113929605,377800484,2019_boxofficemojo_rankings.csv,2019,0.23169134358178353,0.7683086564182164
147,War for the Planet of the Apes,490719763,146880162,343839601,2017_boxofficemojo_rankings.csv,2017,0.2993157665019495,0.7006842334980505
148,Teenage Mutant Ninja Turtles,485004754,191204754,293800000,2014_boxofficemojo_rankings.csv,2014,0.39423274189184543,0.6057672581081546
149,Rio,483866518,143619809,340246709,2011_boxofficemojo_rankings.csv,2011,0.29681700150205476,0.7031829984979453
150,Rise of the Planet of the Apes,481800873,176760185,305040688,2011_boxofficemojo_rankings.csv,2011,0.3668739408863628,0.6331260591136372
151,Hotel Transylvania 2,474800000,169700110,305099890,2015_boxofficemojo_rankings.csv,2015,0.3574138795282224,0.6425861204717775
152,San Andreas,473990832,155190832,318800000,2015_boxofficemojo_rankings.csv,2015,0.32741315131597315,0.6725868486840269
153,It Chapter Two,473093228,211593228,261500000,2019_boxofficemojo_rankings.csv,2019,0.44725482310222375,0.5527451768977762
154,Wreck-It Ralph,471222889,189422889,281800000,2012_boxofficemojo_rankings.csv,2012,0.40198151113156133,0.5980184888684387
155,The Lego Movie,468060692,257760692,210300000,2014_boxofficemojo_rankings.csv,2014,0.5506992926464331,0.44930070735356686
156,Bumblebee,467989645,127195589,340794056,2018_boxofficemojo_rankings.csv,2018,0.2717914602576303,0.7282085397423698
157,Star Trek Into Darkness,467365246,228778661,238586585,2013_boxofficemojo_rankings.csv,2013,0.4895072172311246,0.5104927827688753
158,Lucy,458863600,126663600,332200000,2014_boxofficemojo_rankings.csv,2014,0.27603758502526676,0.7239624149747332
159,"My People, My Country",450064993,2356683,447708310,2019_boxofficemojo_rankings.csv,2019,0.005236317057878794,0.9947636829421213
160,Thor,449326618,181030624,268295994,2011_boxofficemojo_rankings.csv,2011,0.40289316668081304,0.597106833319187
161,La La Land,447403498,151101803,296301695,2016_boxofficemojo_rankings.csv,2016,0.33773049087783397,0.6622695091221661
162,Les Misérables,441809770,148809770,293000000,2012_boxofficemojo_rankings.csv,2012,0.33681864934765926,0.6631813506523407
163,The Eight Hundred,441656664,331279,441325385,2020_boxofficemojo_rankings.csv,2020,0.0007500826479095083,0.9992499173520905
164,Terminator Genisys,440603537,89760956,350842581,2015_boxofficemojo_rankings.csv,2015,0.20372273134974855,0.7962772686502514
165,Warcraft,439048914,47365290,391683624,2016_boxofficemojo_rankings.csv,2016,0.10788157877097038,0.8921184212290296
166,A Star Is Born,436188866,215288866,220900000,2018_boxofficemojo_rankings.csv,2018,0.4935679995096436,0.5064320004903564
167,The Greatest Showman,434993183,174340174,260653009,2017_boxofficemojo_rankings.csv,2017,0.4007882900546513,0.5992117099453488
168,Pokémon Detective Pikachu,433005346,144105346,288900000,2019_boxofficemojo_rankings.csv,2019,0.3328026947731957,0.6671973052268043
169,The Secret Life of Pets 2,430051293,158874395,271176898,2019_boxofficemojo_rankings.csv,2019,0.36943126921374003,0.63056873078626
170,Rampage,428028233,101028233,327000000,2018_boxofficemojo_rankings.csv,2018,0.2360317035441912,0.7639682964558088
171,The Intouchables,426588510,10198820,416389690,2011_boxofficemojo_rankings.csv,2011,0.023907863810021513,0.9760921361899785
172,Bad Boys for Life,426505244,206305244,220200000,2020_boxofficemojo_rankings.csv,2020,0.4837109200936343,0.5162890799063657
173,Django Unchained,425368238,162805434,262562804,2012_boxofficemojo_rankings.csv,2012,0.38273998727662406,0.6172600127233759
174,The King's Speech,423999102,135453143,288545959,2010_boxofficemojo_rankings.csv,2010,0.3194656365097679,0.6805343634902321
175,The Captain,416953262,706572,416246690,2019_boxofficemojo_rankings.csv,2019,0.001694607200362903,0.9983053927996371
176,The Chronicles of Narnia: The Voyage of the Dawn Treader,415686217,104386950,311299267,2010_boxofficemojo_rankings.csv,2010,0.25111958427045944,0.7488804157295406
177,Jason Bourne,415484914,162434410,253050504,2016_boxofficemojo_rankings.csv,2016,0.39095140287091146,0.6090485971290885
178,The Wolverine,414828246,132556852,282271394,2013_boxofficemojo_rankings.csv,2013,0.3195463502743253,0.6804536497256747
179,Kingsman: The Secret Service,414351546,128261724,286089822,2015_boxofficemojo_rankings.csv,2015,0.3095480763573644,0.6904519236426355
180,Pacific Rim,411002906,101802906,309200000,2013_boxofficemojo_rankings.csv,2013,0.24769388370212642,0.7523061162978736
181,Kingsman: The Golden Circle,410902662,100234838,310667824,2017_boxofficemojo_rankings.csv,2017,0.24393815681826855,0.7560618431817314
182,The Mummy,409231607,80227895,329003712,2017_boxofficemojo_rankings.csv,2017,0.196045206742792,0.803954793257208
183,Ice Age: Collision Course,408579038,64063008,344516030,2016_boxofficemojo_rankings.csv,2016,0.15679465180981703,0.843205348190183
184,Alita: Battle Angel,404852543,85710210,319142333,2019_boxofficemojo_rankings.csv,2019,0.21170722892062951,0.7882927710793705
185,Prometheus,403354469,126477084,276877385,2012_boxofficemojo_rankings.csv,2012,0.3135631156227502,0.6864368843772498
186,TRON: Legacy,400062763,172062763,228000000,2010_boxofficemojo_rankings.csv,2010,0.4300894232438224,0.5699105767561776
187,Snow White and the Huntsman,396592829,155332381,241260448,2012_boxofficemojo_rankings.csv,2012,0.39166714484391246,0.6083328551560876
188,Mamma Mia! Here We Go Again,395044706,120634935,274409771,2018_boxofficemojo_rankings.csv,2018,0.3053703369967449,0.6946296630032551
189,Solo: A Star Wars Story,392924807,213767512,179157295,2018_boxofficemojo_rankings.csv,2018,0.5440417815106289,0.4559582184893712
190,The Wolf of Wall Street,392000694,116900694,275100000,2013_boxofficemojo_rankings.csv,2013,0.2982155281592435,0.7017844718407565
191,Independence Day: Resurgence,389681935,103144286,286537649,2016_boxofficemojo_rankings.csv,2016,0.26468839516514925,0.7353116048348508
192,Monster Hunt,387053506,32766,387020740,2015_boxofficemojo_rankings.csv,2015,8.465496240718718e-05,0.9999153450375928
193,Godzilla: King of the Monsters,386600138,110500138,276100000,2019_boxofficemojo_rankings.csv,2019,0.2858253971963145,0.7141746028036855
194,Home,386041607,177397510,208644097,2015_boxofficemojo_rankings.csv,2015,0.45952950869360565,0.5404704913063944
195,1917,384792488,159227644,225564844,2019_boxofficemojo_rankings.csv,2019,0.4138013317973089,0.5861986682026911
196,Cars 3,383930656,152901115,231029541,2017_boxofficemojo_rankings.csv,2017,0.3982519046356121,0.6017480953643879
197,Fifty Shades Darker,381545846,114581250,266964596,2017_boxofficemojo_rankings.csv,2017,0.3003079477898444,0.6996920522101556
198,Taken 2,376141306,139854287,236287019,2012_boxofficemojo_rankings.csv,2012,0.3718131584304118,0.6281868415695883
199,G.I. Joe: Retaliation,375740705,122523060,253217645,2013_boxofficemojo_rankings.csv,2013,0.3260840743884802,0.6739159256115198
200,Spider-Man: Into the Spider-Verse,375540831,190241310,185299521,2018_boxofficemojo_rankings.csv,2018,0.5065795628491859,0.49342043715081413
201,Mad Max: Fury Road,374736354,153636354,221100000,2015_boxofficemojo_rankings.csv,2015,0.4099851865453118,0.5900148134546882
202,Once Upon a Time... In Hollywood,374343626,142502728,231840898,2019_boxofficemojo_rankings.csv,2019,0.38067357930651663,0.6193264206934834
203,The Adventures of Tintin,373993951,77591831,296402120,2011_boxofficemojo_rankings.csv,2011,0.20746814431766036,0.7925318556823396
204,Penguins of Madagascar,373515621,83850911,289664710,2014_boxofficemojo_rankings.csv,2014,0.22449104210289508,0.775508957897105
205,Fifty Shades Freed,371985018,100407760,271577258,2018_boxofficemojo_rankings.csv,2018,0.26992420431298125,0.7300757956870187
206,Captain America: The First Avenger,370569774,176654505,193915269,2011_boxofficemojo_rankings.csv,2011,0.4767105074252494,0.5232894925747505
207,Edge of Tomorrow,370541256,100206256,270335000,2014_boxofficemojo_rankings.csv,2014,0.2704321162013873,0.7295678837986127
208,Gone Girl,369330363,167767189,201563174,2014_boxofficemojo_rankings.csv,2014,0.4542469447604014,0.5457530552395986
209,Shazam!,365971656,140371656,225600000,2019_boxofficemojo_rankings.csv,2019,0.3835588185550632,0.6164411814449369
210,The Nun,365550119,117450119,248100000,2018_boxofficemojo_rankings.csv,2018,0.32129689718415877,0.6787031028158412
211,Night at the Museum: Secret of the Tomb,363204635,113746621,249458014,2014_boxofficemojo_rankings.csv,2014,0.313175025973994,0.6868249740260061
212,The Hangover Part III,362000072,112200072,249800000,2013_boxofficemojo_rankings.csv,2013,0.3099448886297459,0.6900551113702541
213,Monster Hunt 2,361682618,706153,360976465,2018_boxofficemojo_rankings.csv,2018,0.0019524106629862981,0.9980475893370137
214,Noah,359200044,101200044,258000000,2014_boxofficemojo_rankings.csv,2014,0.28173728174710355,0.7182627182528964
215,The Karate Kid,359126022,176591618,182534404,2010_boxofficemojo_rankings.csv,2010,0.4917260437340294,0.5082739562659706
216,Hotel Transylvania,358375603,148313048,210062555,2012_boxofficemojo_rankings.csv,2012,0.4138480598524448,0.5861519401475552
217,Your Name.,357986087,5017246,352968841,2016_boxofficemojo_rankings.csv,2016,0.014015198305737508,0.9859848016942625
218,The Legend of Tarzan,356700357,126643061,230057296,2016_boxofficemojo_rankings.csv,2016,0.3550404660794887,0.6449595339205113
219,The Great Gatsby,353641895,144840419,208801476,2013_boxofficemojo_rankings.csv,2013,0.40956804340164504,0.5904319565983549
220,Dumbo,353284621,114766307,238518314,2019_boxofficemojo_rankings.csv,2019,0.32485508900768145,0.6751449109923185
221,Murder on the Orient Express,352789811,102826543,249963268,2017_boxofficemojo_rankings.csv,2017,0.29146687289106543,0.7085331271089346
222,X-Men: First Class,352616690,146408305,206208385,2011_boxofficemojo_rankings.csv,2011,0.41520526155469273,0.5847947384453073
223,The Angry Birds Movie,352333929,107509366,244824563,2016_boxofficemojo_rankings.csv,2016,0.3051348653964007,0.6948651346035993
224,Now You See Me,351723989,117723989,234000000,2013_boxofficemojo_rankings.csv,2013,0.3347056006464205,0.6652943993535795
225,Peter Rabbit,351266433,115253424,236013009,2018_boxofficemojo_rankings.csv,2018,0.3281082767165515,0.6718917232834485
226,Mary Poppins Returns,349537494,171958438,177579056,2018_boxofficemojo_rankings.csv,2018,0.4919599211865952,0.5080400788134047
227,The Lorax,348840316,214030500,134809816,2012_boxofficemojo_rankings.csv,2012,0.6135486358176558,0.3864513641823441
228,The Maze Runner,348319861,102427862,245891999,2014_boxofficemojo_rankings.csv,2014,0.2940626517992323,0.7059373482007677
229,The Smurfs 2,347545360,71017784,276527576,2013_boxofficemojo_rankings.csv,2013,0.2043410506185437,0.7956589493814563
230,Trolls,346864462,153707064,193157398,2016_boxofficemojo_rankings.csv,2016,0.44313292608223437,0.5568670739177656
231,xXx: Return of Xander Cage,346118277,44898413,301219864,2017_boxofficemojo_rankings.csv,2017,0.12971985585147242,0.8702801441485276
232,Titanic 2012 3D Release,343550770,57884114,285666656,2012_boxofficemojo_rankings.csv,2012,0.1684878016719334,0.8315121983280667
233,Star Trek Beyond,343471816,158848340,184623476,2016_boxofficemojo_rankings.csv,2016,0.462478528369268,0.537521471630732
234,Alvin and the Chipmunks: Chipwrecked,342695435,133110742,209584693,2011_boxofficemojo_rankings.csv,2011,0.3884228630007867,0.6115771369992133
235,A Quiet Place,340939361,188024361,152915000,2018_boxofficemojo_rankings.csv,2018,0.5514891576276522,0.44851084237234784
236,300: Rise of an Empire,337580051,106580051,231000000,2014_boxofficemojo_rankings.csv,2014,0.31571785916935,0.68428214083065
237,Journey 2: The Mysterious Island,335260290,103860290,231400000,2012_boxofficemojo_rankings.csv,2012,0.30979001420060814,0.6902099857993919
238,The Great Wall,334933831,45540830,289393001,2016_boxofficemojo_rankings.csv,2016,0.13596963276008986,0.8640303672399101
239,Now You See Me 2,334897606,65075540,269822066,2016_boxofficemojo_rankings.csv,2016,0.19431473630778956,0.8056852636922105
240,The Good Dinosaur,332207671,123087120,209120551,2015_boxofficemojo_rankings.csv,2015,0.3705125761530052,0.6294874238469947
241,22 Jump Street,331333876,191719337,139614539,2014_boxofficemojo_rankings.csv,2014,0.5786288420445123,0.4213711579554878
242,Black Swan,329398046,106954678,222443368,2010_boxofficemojo_rankings.csv,2010,0.32469736629828094,0.6753026337017191
243,John Wick: Chapter 3 - Parabellum,326709727,171015687,155694040,2019_boxofficemojo_rankings.csv,2019,0.5234484096030603,0.47655159039693973
244,Taken 3,326479141,89256424,237222717,2015_boxofficemojo_rankings.csv,2015,0.27339089329446625,0.7266091067055338
245,The SpongeBob Movie: Sponge Out of Water,325186032,162994032,162192000,2015_boxofficemojo_rankings.csv,2015,0.5012331894993571,0.4987668105006429
246,Tenet,323300000,48300000,275000000,2020_boxofficemojo_rankings.csv,2020,0.14939684503557069,0.8506031549644293
247,Megamind,321885765,148415853,173469912,2010_boxofficemojo_rankings.csv,2010,0.4610823749848024,0.5389176250151976
248,Green Book,321752656,85080171,236672485,2018_boxofficemojo_rankings.csv,2018,0.26442725308847176,0.7355727469115282
249,Robin Hood,321669741,105269730,216400011,2010_boxofficemojo_rankings.csv,2010,0.327260281532045,0.672739718467955
250,The Conjuring 2,320392818,102470008,217922810,2016_boxofficemojo_rankings.csv,2016,0.31982617038562955,0.6801738296143705
251,The Last Airbender,319713881,131772187,187941694,2010_boxofficemojo_rankings.csv,2010,0.4121566026093187,0.5878433973906814
252,The Conjuring,319494638,137400141,182094497,2013_boxofficemojo_rankings.csv,2013,0.4300546070510266,0.5699453929489734
253,The Expendables 2,314975955,85028192,229947763,2012_boxofficemojo_rankings.csv,2012,0.26995137454222495,0.730048625457775
254,Maze Runner: The Scorch Trials,312296056,81697192,230598864,2015_boxofficemojo_rankings.csv,2015,0.2616017411375826,0.7383982588624174
255,Resident Evil: The Final Chapter,312242626,26830068,285412558,2016_boxofficemojo_rankings.csv,2016,0.085926986791355,0.914073013208645
256,The Lego Batman Movie,311950384,175750384,136200000,2017_boxofficemojo_rankings.csv,2017,0.5633921066114155,0.4366078933885845
257,Knives Out,311390805,165363234,146027571,2019_boxofficemojo_rankings.csv,2019,0.5310472606922353,0.4689527393077647
258,Little Fockers,310650585,148438600,162211985,2010_boxofficemojo_rankings.csv,2010,0.47783138731253316,0.5221686126874668
259,The Ex-File 3: The Return of The Exes,307592427,838959,306753468,2017_boxofficemojo_rankings.csv,2017,0.002727502130603495,0.9972724978693965
260,The Fault in Our Stars,307166834,124872350,182294484,2014_boxofficemojo_rankings.csv,2014,0.40652940414784494,0.593470595852155
261,Rise of the Guardians,306941670,103412758,203528912,2012_boxofficemojo_rankings.csv,2012,0.33691338813657984,0.6630866118634202
262,Sonic the Hedgehog,306766470,146066470,160700000,2020_boxofficemojo_rankings.csv,2020,0.47614874598257106,0.5238512540174289
263,Annabelle: Creation,306515884,102092201,204423683,2017_boxofficemojo_rankings.csv,2017,0.33307311734617967,0.6669268826538203
264,Wonder,305937718,132422809,173514909,2017_boxofficemojo_rankings.csv,2017,0.43284237676114196,0.5671576232388581
265,Skyscraper,304868961,68420120,236448841,2018_boxofficemojo_rankings.csv,2018,0.22442468323300382,0.7755753167669962
266,A Good Day to Die Hard,304654182,67349198,237304984,2013_boxofficemojo_rankings.csv,2013,0.22106769569964413,0.7789323043003559
267,Dangal,303723636,12391761,291331875,2016_boxofficemojo_rankings.csv,2016,0.04079946217949267,0.9592005378205073
268,Passengers,303144152,100014699,203129453,2016_boxofficemojo_rankings.csv,2016,0.3299245535173642,0.6700754464826357
269,Battleship,303025485,65422625,237602860,2012_boxofficemojo_rankings.csv,2012,0.21589809517176417,0.7841019048282358
270,Wrath of the Titans,301970083,83670083,218300000,2012_boxofficemojo_rankings.csv,2012,0.27708070338875257,0.7229192966112474
271,Resident Evil: Afterlife,300228084,60128566,240099518,2010_boxofficemojo_rankings.csv,2010,0.20027628727764188,0.7997237127223581
272,Alice Through the Looking Glass,299457024,77041381,222415643,2016_boxofficemojo_rankings.csv,2016,0.257270241889534,0.7427297581104659
273,Real Steel,299268508,85468508,213800000,2011_boxofficemojo_rankings.csv,2011,0.28559138604720813,0.7144086139527919
274,Ocean's 8,297718711,140218711,157500000,2018_boxofficemojo_rankings.csv,2018,0.47097715333048046,0.5290228466695195
275,The Divergent Series: Insurgent,297002527,130179072,166823455,2015_boxofficemojo_rankings.csv,2015,0.4383096444159211,0.5616903555840789
276,Miss Peregrine's Home for Peculiar Children,296482446,87242834,209239612,2016_boxofficemojo_rankings.csv,2016,0.29425969455203427,0.7057403054479657
277,Ferdinand,296069199,84410380,211658819,2017_boxofficemojo_rankings.csv,2017,0.28510355107894897,0.7148964489210511
278,Shutter Island,294804195,128012934,166791261,2010_boxofficemojo_rankings.csv,2010,0.4342303677191568,0.5657696322808432
279,Salt,293503354,118311368,175191986,2010_boxofficemojo_rankings.csv,2010,0.4031005655901295,0.5968994344098705
280,Pacific Rim: Uprising,290930148,59874525,231055623,2018_boxofficemojo_rankings.csv,2018,0.20580378283793402,0.794196217162066
281,Sex and the City 2,290745055,95347692,195397363,2010_boxofficemojo_rankings.csv,2010,0.3279426093764518,0.6720573906235482
282,Divergent,288885818,150947895,137937923,2014_boxofficemojo_rankings.csv,2014,0.5225174985917792,0.47748250140822074
283,Bridesmaids,288383523,169106725,119276798,2011_boxofficemojo_rankings.csv,2011,0.5863952393701772,0.4136047606298228
284,Maze Runner: The Death Cure,288175335,58032443,230142892,2018_boxofficemojo_rankings.csv,2018,0.2013789382772818,0.7986210617227182
285,Pitch Perfect 2,287144079,184296230,102847849,2015_boxofficemojo_rankings.csv,2015,0.6418249355578737,0.35817506444212627
286,Oblivion,286168572,89107235,197061337,2013_boxofficemojo_rankings.csv,2013,0.3113802273158074,0.6886197726841926
287,Elysium,286140700,93050117,193090583,2013_boxofficemojo_rankings.csv,2013,0.3251900795657521,0.6748099204342479
288,John Carter,284139100,73078100,211061000,2012_boxofficemojo_rankings.csv,2012,0.2571912841280908,0.7428087158719092
289,Turbo,282570682,83028128,199542554,2013_boxofficemojo_rankings.csv,2013,0.29383136074959115,0.7061686392504088
290,Paddington,282370135,76271832,206098303,2014_boxofficemojo_rankings.csv,2014,0.2701129565277858,0.7298870434722142
291,The Tourist,278780441,67631157,211149284,2010_boxofficemojo_rankings.csv,2010,0.24259649191099458,0.7574035080890055
292,Split,278454358,138291365,140162993,2017_boxofficemojo_rankings.csv,2017,0.4966392553281569,0.5033607446718431
293,The Bourne Legacy,276144750,113203870,162940880,2012_boxofficemojo_rankings.csv,2012,0.4099439514964525,0.5900560485035475
294,Mr. Peabody & Sherman,275698039,111506430,164191609,2014_boxofficemojo_rankings.csv,2014,0.4044512989807664,0.5955487010192336
295,Lincoln,275293450,182207973,93085477,2012_boxofficemojo_rankings.csv,2012,0.6618681737614898,0.33813182623851024
296,Tomb Raider,274650803,58250803,216400000,2018_boxofficemojo_rankings.csv,2018,0.21209041577060309,0.7879095842293969
297,The Expendables,274470394,103068524,171401870,2010_boxofficemojo_rankings.csv,2010,0.3755178199656754,0.6244821800343245
298,Cloudy With a Chance of Meatballs 2,274325949,119793567,154532382,2013_boxofficemojo_rankings.csv,2013,0.43668332302023677,0.5633166769797632
299,Grown Ups,271430189,162001186,109429003,2010_boxofficemojo_rankings.csv,2010,0.5968429178671795,0.40315708213282053
300,Neighbors,270665134,150157400,120507734,2014_boxofficemojo_rankings.csv,2014,0.5547718606416444,0.44522813935835565
301,We're the Millers,269994119,150394119,119600000,2012_boxofficemojo_rankings.csv,2012,0.5570273884373015,0.4429726115626985
302,Epic,268426634,107518682,160907952,2013_boxofficemojo_rankings.csv,2013,0.4005514668861064,0.5994485331138936
303,Exodus: Gods and Kings,268175631,65014513,203161118,2014_boxofficemojo_rankings.csv,2014,0.24243259075243864,0.7575674092475614
304,Knight and Day 2010 Re-release,261930436,76423035,185507401,2010_boxofficemojo_rankings.csv,2010,0.2917684411444266,0.7082315588555734
305,Terminator: Dark Fate,261119292,62253077,198866215,2019_boxofficemojo_rankings.csv,2019,0.23840856998034446,0.7615914300196556
306,The Lone Ranger,260502115,89302115,171200000,2013_boxofficemojo_rankings.csv,2013,0.34280763900899613,0.6571923609910039
307,Super 8,260095986,127004179,133091807,2011_boxofficemojo_rankings.csv,2011,0.4882973434276683,0.5117026565723317
308,Mojin: The Lost Legend,259368448,1243810,258124638,2015_boxofficemojo_rankings.csv,2015,0.004795533186827721,0.9952044668131723
309,Blade Runner 2049,259239658,92054159,167185499,2017_boxofficemojo_rankings.csv,2017,0.35509288860425825,0.6449071113957418
310,Kung Fu Yoga,257743016,362657,257380359,2017_boxofficemojo_rankings.csv,2017,0.0014070487946800467,0.99859295120532
311,Parasite,257500210,53369749,204130461,2019_boxofficemojo_rankings.csv,2019,0.2072609921366666,0.7927390078633334
312,Annabelle,257047661,84273813,172773848,2014_boxofficemojo_rankings.csv,2014,0.3278528684997449,0.6721471315002551
313,Lost in Hong Kong,256283912,1302281,254981631,2015_boxofficemojo_rankings.csv,2015,0.005081399725161055,0.9949186002748389
314,Halloween,255485178,159342015,96143163,2018_boxofficemojo_rankings.csv,2018,0.6236839892136522,0.37631601078634785
315,Get Out,255407969,176040665,79367304,2017_boxofficemojo_rankings.csv,2017,0.6892528282858708,0.31074717171412924
316,Us,255184580,175084580,80100000,2019_boxofficemojo_rankings.csv,2019,0.6861095603817441,0.3138904396182559
317,Baahubali 2: The Conclusion,254158390,20186659,233971731,2017_boxofficemojo_rankings.csv,2017,0.07942550706274147,0.9205744929372586
318,Men in Black: International,253890701,80001807,173888894,2019_boxofficemojo_rankings.csv,2019,0.31510333653377876,0.6848966634662212
319,X-Men: Dark Phoenix,252442974,65845974,186597000,2019_boxofficemojo_rankings.csv,2019,0.26083504308580996,0.73916495691419
320,True Grit,252276927,171243005,81033922,2010_boxofficemojo_rankings.csv,2010,0.6787898007018296,0.32121019929817046
321,American Hustle,251171807,150117807,101054000,2013_boxofficemojo_rankings.csv,2013,0.5976698133162692,0.4023301866837308
322,Journey to the West: The Demons Strike Back,247585244,880346,246704898,2017_boxofficemojo_rankings.csv,2017,0.0035557288704976295,0.9964442711295024
323,Glass,246999039,111048468,135950571,2019_boxofficemojo_rankings.csv,2019,0.44959068848846817,0.5504093115115318
324,Grown Ups 2,246984278,133668525,113315753,2013_boxofficemojo_rankings.csv,2013,0.5412025659382255,0.4587974340617746
325,The Peanuts Movie,246233113,130178411,116054702,2015_boxofficemojo_rankings.csv,2015,0.5286795484732388,0.47132045152676116
326,Rango,245724603,123477607,122246996,2011_boxofficemojo_rankings.csv,2011,0.5025040451484624,0.4974959548515376
327,Teenage Mutant Ninja Turtles: Out of the Shadows,245623848,82051601,163572247,2016_boxofficemojo_rankings.csv,2016,0.3340538863311025,0.6659461136688974
328,Dark Shadows,245527149,79727149,165800000,2012_boxofficemojo_rankings.csv,2012,0.3247182616045446,0.6752817383954554
329,Dolittle,245516662,77047065,168469597,2020_boxofficemojo_rankings.csv,2020,0.3138160333900271,0.6861839666099729
330,The Bravest,245179562,290217,244889345,2019_boxofficemojo_rankings.csv,2019,0.0011836916488169597,0.9988163083511831
331,Pixels,244874809,78747585,166127224,2015_boxofficemojo_rankings.csv,2015,0.3215830379677805,0.6784169620322195
332,Hercules,244819862,72688614,172131248,2014_boxofficemojo_rankings.csv,2014,0.29690652304999665,0.7030934769500033
333,After Earth,243611982,60522097,183089885,2013_boxofficemojo_rankings.csv,2013,0.24843645416422908,0.7515635458357709
334,Daddy's Home,242786137,150357137,92429000,2015_boxofficemojo_rankings.csv,2015,0.6192986916711806,0.38070130832881943
335,RoboCop,242688965,58607007,184081958,2014_boxofficemojo_rankings.csv,2014,0.24149020125410317,0.7585097987458969
336,Alien: Covenant,240891763,74262031,166629732,2017_boxofficemojo_rankings.csv,2017,0.3082796608533269,0.6917203391466731
337,Sully,240797623,125070033,115727590,2016_boxofficemojo_rankings.csv,2016,0.5193989518742052,0.48060104812579485
338,Assassin's Creed,240697856,54647948,186049908,2016_boxofficemojo_rankings.csv,2016,0.2270396126835463,0.7729603873164537
339,Resident Evil: Retribution,240159255,42345531,197813724,2012_boxofficemojo_rankings.csv,2012,0.17632271136084263,0.8236772886391573
340,Planes,239258712,90288712,148970000,2013_boxofficemojo_rankings.csv,2013,0.37736854489127236,0.6226314551087276
341,Crazy Rich Asians,238532921,174532921,64000000,2018_boxofficemojo_rankings.csv,2018,0.7316932198218459,0.2683067801781541
342,Gulliver's Travels,237382724,42779261,194603463,2010_boxofficemojo_rankings.csv,2010,0.1802121918526809,0.8197878081473191
343,Silver Linings Playbook,236412453,132092958,104319495,2012_boxofficemojo_rankings.csv,2012,0.5587394247797937,0.44126057522020634
344,Hidden Figures,235956898,169607287,66349611,2016_boxofficemojo_rankings.csv,2016,0.7188062245164792,0.2811937754835207
345,Spy,235666219,110825712,124840507,2015_boxofficemojo_rankings.csv,2015,0.47026558354551445,0.5297344164544856
346,American Reunion,234989584,57011521,177978063,2012_boxofficemojo_rankings.csv,2012,0.24261297045404362,0.7573870295459564
347,Alvin and the Chipmunks: The Road Chip,234798636,85886987,148911649,2015_boxofficemojo_rankings.csv,2015,0.3657899741802589,0.6342100258197412
348,The Imitation Game,233555708,91125683,142430025,2014_boxofficemojo_rankings.csv,2014,0.39016679909188945,0.6098332009081106
349,The Girl with the Dragon Tattoo,232617430,102515793,130101637,2011_boxofficemojo_rankings.csv,2011,0.44070555246010584,0.5592944475398941
350,Argo,232325503,136025503,96300000,2012_boxofficemojo_rankings.csv,2012,0.5854953556261105,0.4145046443738895
351,Annabelle Comes Home,231252591,74152591,157100000,2019_boxofficemojo_rankings.csv,2019,0.32065626023623667,0.6793437397637634
352,Ghostbusters,229147509,128350574,100796935,2016_boxofficemojo_rankings.csv,2016,0.5601220565744837,0.43987794342551634
353,Goodbye Mr. Loser,228122928,1293626,226829302,2015_boxofficemojo_rankings.csv,2015,0.005670740820931423,0.9943292591790686
354,Paddington 2,227978523,40891591,187086932,2017_boxofficemojo_rankings.csv,2017,0.17936597913655225,0.8206340208634477
355,The Green Hornet,227817248,98780042,129037206,2011_boxofficemojo_rankings.csv,2011,0.4335933423267408,0.5664066576732593
356,Youth,227091290,1891956,225199334,2017_boxofficemojo_rankings.csv,2017,0.00833125744276674,0.9916687425572333
357,Baby Driver,226945087,107825862,119119225,2017_boxofficemojo_rankings.csv,2017,0.47511873213628986,0.5248812678637101
358,Immortals,226904017,83504017,143400000,2011_boxofficemojo_rankings.csv,2011,0.3680147143450528,0.6319852856549473
359,Percy Jackson & the Olympians: The Lightning Thief,226497209,88768303,137728906,2010_boxofficemojo_rankings.csv,2010,0.39191786685548075,0.6080821331445192
360,Hansel & Gretel: Witch Hunters,226349749,55703475,170646274,2013_boxofficemojo_rankings.csv,2013,0.2460947062945495,0.7539052937054505
361,Valerian and the City of a Thousand Planets,225874228,41189488,184684740,2017_boxofficemojo_rankings.csv,2017,0.18235585513545174,0.8176441448645483
362,Better Days,225820914,1921657,223899257,2019_boxofficemojo_rankings.csv,2019,0.00850965026206563,0.9914903497379344
363,Ford v Ferrari,225508210,117624357,107883853,2019_boxofficemojo_rankings.csv,2019,0.521596783549477,0.47840321645052303
364,The Social Network,224920315,96962694,127957621,2010_boxofficemojo_rankings.csv,2010,0.4310979824121267,0.5689020175878733
365,Non-Stop,222809600,92168600,130641000,2014_boxofficemojo_rankings.csv,2014,0.4136652998793589,0.5863347001206412
366,Geostorm,221600160,33700160,187900000,2017_boxofficemojo_rankings.csv,2017,0.15207642449355632,0.8479235755064437
367,Inferno,220021259,34343574,185677685,2016_boxofficemojo_rankings.csv,2016,0.15609207108482184,0.8439079289151782
368,Green Lantern,219851172,116601172,103250000,2011_boxofficemojo_rankings.csv,2011,0.5303641137742036,0.46963588622579644
369,Captain Phillips,218791811,107100855,111690956,2013_boxofficemojo_rankings.csv,2013,0.4895103455220269,0.5104896544779731
370,Jack Reacher,218340595,80070736,138269859,2012_boxofficemojo_rankings.csv,2012,0.3667239983476275,0.6332760016523725
371,The Emoji Movie,217776646,86089513,131687133,2017_boxofficemojo_rankings.csv,2017,0.39531104267259215,0.6046889573274078
372,Dracula Untold,217124280,56280355,160843925,2014_boxofficemojo_rankings.csv,2014,0.2592080213230874,0.7407919786769126
373,Central Intelligence,216972543,127440871,89531672,2016_boxofficemojo_rankings.csv,2016,0.5873594383783389,0.412640561621661
374,The Help,216639112,169708112,46931000,2011_boxofficemojo_rankings.csv,2011,0.7833678343363962,0.21663216566360372
375,Little Women,216601214,108101214,108500000,2019_boxofficemojo_rankings.csv,2019,0.4990794465260938,0.5009205534739062
376,Valentine's Day,216485654,110485654,106000000,2010_boxofficemojo_rankings.csv,2010,0.5103601645585254,0.48963983544147455
377,Bad Teacher,216197492,100292856,115904636,2011_boxofficemojo_rankings.csv,2011,0.46389463204318765,0.5361053679568124
378,Ted 2,215863606,81476385,134387221,2015_boxofficemojo_rankings.csv,2015,0.37744382441197616,0.6225561755880239
379,The Sorcerer's Apprentice,215283742,63150991,152132751,2010_boxofficemojo_rankings.csv,2010,0.29333841196424393,0.7066615880357561
380,Just Go with It,214945591,103028109,111917482,2011_boxofficemojo_rankings.csv,2011,0.4793218066054679,0.5206781933945321
381,The Expendables 3,214657577,39322544,175335033,2014_boxofficemojo_rankings.csv,2014,0.18318730952599918,0.8168126904740008
382,Creed II,214215889,115715889,98500000,2018_boxofficemojo_rankings.csv,2018,0.5401835015142131,0.45981649848578693
383,Smallfoot,214040103,83240103,130800000,2018_boxofficemojo_rankings.csv,2018,0.3888995652370808,0.6111004347629192
384,Into the Woods,212902372,128002372,84900000,2014_boxofficemojo_rankings.csv,2014,0.6012256735213829,0.39877432647861716
385,Bridget Jones's Baby,211952420,24252420,187700000,2016_boxofficemojo_rankings.csv,2016,0.11442388815376583,0.8855761118462342
386,Battle Los Angeles,211819354,83552429,128266925,2011_boxofficemojo_rankings.csv,2011,0.3944513446113144,0.6055486553886856
387,Fury,211817906,85817906,126000000,2014_boxofficemojo_rankings.csv,2014,0.4051494400100433,0.5948505599899566
388,Due Date,211780824,100539043,111241781,2010_boxofficemojo_rankings.csv,2010,0.47473156965335067,0.5252684303466493
389,Horrible Bosses,209838559,117538559,92300000,2011_boxofficemojo_rankings.csv,2011,0.5601380392628411,0.4398619607371589
390,Tomorrowland,209035668,93436322,115599346,2015_boxofficemojo_rankings.csv,2015,0.44698745861878464,0.5530125413812154
391,Me Before You,208314186,56245075,152069111,2016_boxofficemojo_rankings.csv,2016,0.2700011750519957,0.7299988249480043
392,Safe House,208076205,126373434,81702771,2012_boxofficemojo_rankings.csv,2012,0.6073420745058283,0.3926579254941717
393,Paranormal Activity 3,207039844,104028807,103011037,2011_boxofficemojo_rankings.csv,2011,0.5024579085366776,0.4975420914633224
394,London Has Fallen,205754447,62524260,143230187,2016_boxofficemojo_rankings.csv,2016,0.30387804935268303,0.696121950647317
395,Journey to the West,205637183,18058,205619125,2013_boxofficemojo_rankings.csv,2013,8.781485788005567e-05,0.99991218514212
396,White House Down,205366737,73103784,132262953,2013_boxofficemojo_rankings.csv,2013,0.35596701329485503,0.644032986705145
397,A Dog's Purpose,205035819,64508620,140527199,2017_boxofficemojo_rankings.csv,2017,0.3146212223533489,0.6853787776466511
398,Eat Pray Love,204594016,80574010,124020006,2010_boxofficemojo_rankings.csv,2010,0.39382388388133505,0.606176116118665
399,Yogi Bear,203509374,100246011,103263363,2010_boxofficemojo_rankings.csv,2010,0.49258670020772605,0.5074132997922739
400,Everest,203427584,43482270,159945314,2015_boxofficemojo_rankings.csv,2015,0.2137481512831613,0.7862518487168387
401,Arrival,203388186,100546139,102842047,2016_boxofficemojo_rankings.csv,2016,0.49435584719753584,0.5056441528024641
402,Need for Speed,203277636,43577636,159700000,2014_boxofficemojo_rankings.csv,2014,0.2143749644943726,0.7856250355056273
403,The Addams Family,203044905,100044905,103000000,2019_boxofficemojo_rankings.csv,2019,0.49272305059809307,0.5072769494019069
404,Harley Quinn: Birds of Prey,201858461,84158461,117700000,2020_boxofficemojo_rankings.csv,2020,0.41691817416561006,0.5830818258343899
405,Straight Outta Compton,201634991,161197785,40437206,2015_boxofficemojo_rankings.csv,2015,0.7994534291917617,0.20054657080823834
406,21 Jump Street,201585328,138447667,63137661,2012_boxofficemojo_rankings.csv,2012,0.6867943633278708,0.31320563667212925
407,Percy Jackson: Sea of Monsters,199850315,68559554,131290761,2013_boxofficemojo_rankings.csv,2013,0.34305452057956476,0.6569454794204352
408,RED,199006387,90380162,108626225,2010_boxofficemojo_rankings.csv,2010,0.45415709195303366,0.5458429080469663
409,Total Recall,198467168,58877969,139589199,2012_boxofficemojo_rankings.csv,2012,0.296663521696445,0.703336478303555
410,The Island,198326350,670883,197655467,2018_boxofficemojo_rankings.csv,2018,0.0033827224672868736,0.9966172775327131
411,The Impossible,198087212,19019882,179067330,2012_boxofficemojo_rankings.csv,2012,0.09601771769093302,0.903982282309067
412,Lost in Thailand,197757387,57387,197700000,2012_boxofficemojo_rankings.csv,2012,0.00029018890707733716,0.9997098110929227
413,Christopher Robin,197744377,99215042,98529335,2018_boxofficemojo_rankings.csv,2018,0.5017338217409844,0.4982661782590157
414,Jack the Giant Slayer,197687603,65187603,132500000,2013_boxofficemojo_rankings.csv,2013,0.3297505863329225,0.6702494136670776
415,Smurfs: The Lost Village,197183546,45020282,152163264,2017_boxofficemojo_rankings.csv,2017,0.22831662637814618,0.7716833736218538
416,The Other Woman,196710396,83911193,112799203,2014_boxofficemojo_rankings.csv,2014,0.4265722336301941,0.5734277663698059
417,The Vow,196114570,125014030,71100540,2012_boxofficemojo_rankings.csv,2012,0.6374540657535032,0.36254593424649684
418,The Shape of Water,195333312,63859435,131473877,2017_boxofficemojo_rankings.csv,2017,0.3269254708587545,0.6730745291412455
419,The BFG,195243411,55483770,139759641,2016_boxofficemojo_rankings.csv,2016,0.28417742609506036,0.7158225739049396
420,Rocketman,195179299,96368160,98811139,2019_boxofficemojo_rankings.csv,2019,0.4937417056713581,0.5062582943286419
421,The Intern,194564672,75764672,118800000,2015_boxofficemojo_rankings.csv,2015,0.38940610965591943,0.6105938903440805
422,Gnomeo & Juliet,193967670,99967670,94000000,2011_boxofficemojo_rankings.csv,2011,0.5153831563785862,0.48461684362141383
423,Downton Abbey,193820755,96854135,96966620,2019_boxofficemojo_rankings.csv,2019,0.49970982209825776,0.5002901779017422
424,The Monkey King 2,193678298,709982,192968316,2016_boxofficemojo_rankings.csv,2016,0.003665779838689,0.996334220161311
425,Weathering with You,193186879,7798743,185388136,2019_boxofficemojo_rankings.csv,2019,0.040368906213345886,0.9596310937866541
426,The Equalizer,192330738,101530738,90800000,2014_boxofficemojo_rankings.csv,2014,0.527896575741315,0.47210342425868507
427,The LEGO Movie 2: The Second Part,192306508,105806508,86500000,2019_boxofficemojo_rankings.csv,2019,0.5501972299346208,0.44980277006537916
428,The Equalizer 2,190400157,102084362,88315795,2018_boxofficemojo_rankings.csv,2018,0.5361569213411941,0.4638430786588059
429,The White Storm 2: Drug Lords,189396380,609461,188786919,2019_boxofficemojo_rankings.csv,2019,0.003217912612690908,0.9967820873873091
430,Breakup Buddies,189017596,777896,188239700,2014_boxofficemojo_rankings.csv,2014,0.004115468699538428,0.9958845313004616
431,The Secret Life of Walter Mitty,188133322,58236838,129896484,2013_boxofficemojo_rankings.csv,2013,0.30955089391341317,0.6904491060865868
432,12 Years a Slave,187733202,56671993,131061209,2013_boxofficemojo_rankings.csv,2013,0.30187517389704993,0.6981248261029501
433,Mr. Popper's Penguins,187361754,68224452,119137302,2011_boxofficemojo_rankings.csv,2011,0.3641322230576471,0.635867776942353
434,Hugo,185770160,73864507,111905653,2011_boxofficemojo_rankings.csv,2011,0.39761233451055866,0.6023876654894413
435,The Lion King 2011 3D Release,185542001,94242001,91300000,2011_boxofficemojo_rankings.csv,2011,0.5079281267425805,0.49207187325741947
436,Pitch Perfect 3,185400345,104897530,80502815,2017_boxofficemojo_rankings.csv,2017,0.5657892923554161,0.4342107076445839
437,Hop,183953723,108085305,75868418,2011_boxofficemojo_rankings.csv,2011,0.5875679123928359,0.4124320876071641
438,Bad Moms,183936074,113257297,70678777,2016_boxofficemojo_rankings.csv,2016,0.615742711785835,0.3842572882141651
439,Jupiter Ascending,183887723,47387723,136500000,2015_boxofficemojo_rankings.csv,2015,0.25769922117095334,0.7423007788290467
440,Storks,183388953,72679278,110709675,2016_boxofficemojo_rankings.csv,2016,0.3963121922616571,0.6036878077383429
441,Mirror Mirror,183018522,64935167,118083355,2012_boxofficemojo_rankings.csv,2012,0.3548010676209045,0.6451989323790955
442,Daddy's Home 2,180613180,104029443,76583737,2017_boxofficemojo_rankings.csv,2017,0.5759792447040687,0.42402075529593136
443,Hacksaw Ridge,180450918,67209615,113241303,2016_boxofficemojo_rankings.csv,2016,0.3724537161955585,0.6275462838044414
444,The Post,179769457,81903458,97865999,2017_boxofficemojo_rankings.csv,2017,0.4556027445752367,0.5443972554247632
445,The Dictator,179379533,59650222,119729311,2012_boxofficemojo_rankings.csv,2012,0.3325363880839181,0.6674636119160818
446,Allegiant,179246868,66184051,113062817,2016_boxofficemojo_rankings.csv,2016,0.36923407219589466,0.6307659278041053
447,Abominable,179057149,60716390,118340759,2019_boxofficemojo_rankings.csv,2019,0.3390894490339506,0.6609105509660493
448,Baywatch,177856751,58060186,119796565,2017_boxofficemojo_rankings.csv,2017,0.32644353207599075,0.6735564679240093
449,War Horse,177584879,79884879,97700000,2011_boxofficemojo_rankings.csv,2011,0.44984054639021376,0.5501594536097862
450,Paranormal Activity 2,177512032,84752907,92759125,2010_boxofficemojo_rankings.csv,2010,0.4774488018930458,0.5225511981069543
451,Lee Daniels' The Butler,177313795,116632095,60681700,2013_boxofficemojo_rankings.csv,2013,0.6577722562421046,0.34222774375789544
452,The Descendants,177243185,82584160,94659025,2011_boxofficemojo_rankings.csv,2011,0.4659370119082435,0.5340629880917566
453,The A-Team,177238796,77222099,100016697,2010_boxofficemojo_rankings.csv,2010,0.4356952357090036,0.5643047642909964
454,The Hitman's Bodyguard,176586701,75468583,101118118,2017_boxofficemojo_rankings.csv,2017,0.4273741033306919,0.5726258966693081
455,Looper,176506819,66486205,110020614,2012_boxofficemojo_rankings.csv,2012,0.37667782682095696,0.623322173179043
456,Ip Man 4: The Finale,176345966,3956031,172389935,2019_boxofficemojo_rankings.csv,2019,0.02243335126815433,0.9775666487318456
457,Cowboys & Aliens,174822325,100240551,74581774,2011_boxofficemojo_rankings.csv,2011,0.5733852984737504,0.4266147015262496
458,The Mule,174804407,103804407,71000000,2018_boxofficemojo_rankings.csv,2018,0.5938317504775494,0.40616824952245056
459,Identity Thief,173965010,134506920,39458090,2013_boxofficemojo_rankings.csv,2013,0.7731837568945618,0.22681624310543827
460,The Nutcracker and the Four Realms,173961069,54858851,119102218,2018_boxofficemojo_rankings.csv,2018,0.3153513100106323,0.6846486899893677
461,In Time,173930596,37520095,136410501,2011_boxofficemojo_rankings.csv,2011,0.215718774401256,0.784281225598744
462,Operation Mekong,173839072,800012,173039060,2016_boxofficemojo_rankings.csv,2016,0.004602026407504062,0.9953979735924959
463,Creed,173567581,109767581,63800000,2015_boxofficemojo_rankings.csv,2015,0.6324198353608442,0.3675801646391557
464,Gemini Man,173469516,48546770,124922746,2019_boxofficemojo_rankings.csv,2019,0.27985764369112553,0.7201423563088745
465,The Girl on the Train,173185859,75395035,97790824,2016_boxofficemojo_rankings.csv,2016,0.435341750390833,0.564658249609167
466,The Grand Budapest Hotel,172936941,59301324,113635617,2014_boxofficemojo_rankings.csv,2014,0.342907210322403,0.657092789677597
467,Jackass 3D,171685792,117229692,54456100,2010_boxofficemojo_rankings.csv,2010,0.6828153374508708,0.3171846625491293
468,Spies in Disguise,171616764,66757013,104859751,2019_boxofficemojo_rankings.csv,2019,0.3889888810629246,0.6110111189370754
469,John Wick: Chapter 2,171539887,92029184,79510703,2017_boxofficemojo_rankings.csv,2017,0.5364885427492441,0.46351145725075593
470,Anchorman 2: The Legend Continues,171464676,125168368,46296308,2013_boxofficemojo_rankings.csv,2013,0.7299950690718361,0.2700049309281639
471,The Other Guys,170458922,119219978,51238944,2010_boxofficemojo_rankings.csv,2010,0.6994059131736149,0.30059408682638505
472,Olympus Has Fallen,170270201,98925640,71344561,2013_boxofficemojo_rankings.csv,2013,0.5809920903305916,0.4190079096694083
473,Zookeeper,169852759,80360843,89491916,2011_boxofficemojo_rankings.csv,2011,0.47312062207950356,0.5268793779204964
474,Dumb and Dumber To,169837010,86208010,83629000,2014_boxofficemojo_rankings.csv,2014,0.5075926030492411,0.49240739695075886
475,Ghost in the Shell,169801921,40563557,129238364,2017_boxofficemojo_rankings.csv,2017,0.23888750351652382,0.7611124964834762
476,Insidious: The Last Key,167885588,67745330,100140258,2018_boxofficemojo_rankings.csv,2018,0.40352081919026905,0.596479180809731
477,Fantastic Four,167882881,56117548,111765333,2015_boxofficemojo_rankings.csv,2015,0.3342660530110869,0.6657339469889131
478,Unstoppable,167805466,81562942,86242524,2010_boxofficemojo_rankings.csv,2010,0.48605652690717477,0.5139434730928253
479,Magic Mike,167739368,113721571,54017797,2012_boxofficemojo_rankings.csv,2012,0.6779658964733908,0.3220341035266092
480,Bridge of Spies,165478348,72313754,93164594,2015_boxofficemojo_rankings.csv,2015,0.4369982833041094,0.5630017166958906
481,The Muppets,165184237,88631237,76553000,2011_boxofficemojo_rankings.csv,2011,0.5365598958452676,0.4634401041547324
482,The Huntsman: Winter's War,164989338,48390190,116599148,2016_boxofficemojo_rankings.csv,2016,0.2932928308373478,0.7067071691626522
483,Legend of Deification,163422610,143937,163278673,2020_boxofficemojo_rankings.csv,2020,0.0008807655195324564,0.9991192344804676
484,The Magnificent Seven,162360636,93432655,68927981,2016_boxofficemojo_rankings.csv,2016,0.5754637164638847,0.4245362835361152
485,Jack Reacher: Never Go Back,162146076,58697076,103449000,2016_boxofficemojo_rankings.csv,2016,0.36200121179620776,0.6379987882037922
486,Insidious: Chapter 2,161919318,83586447,78332871,2013_boxofficemojo_rankings.csv,2013,0.5162228203060983,0.4837771796939016
487,Limitless,161849455,79249455,82600000,2011_boxofficemojo_rankings.csv,2011,0.489649192825518,0.510350807174482
488,Flight,161772375,93772375,68000000,2012_boxofficemojo_rankings.csv,2012,0.5796562917494411,0.42034370825055883
489,Into the Storm,161502194,47602194,113900000,2014_boxofficemojo_rankings.csv,2014,0.29474642307336085,0.7052535769266391
490,Unbroken,161459297,115637895,45821402,2014_boxofficemojo_rankings.csv,2014,0.7162046233856698,0.28379537661433024
491,The Predator,160542134,51024708,109517426,2018_boxofficemojo_rankings.csv,2018,0.3178275181018835,0.6821724818981165
492,"Three Billboards Outside Ebbing, Missouri",160192031,54513740,105678291,2017_boxofficemojo_rankings.csv,2017,0.3403024461310438,0.6596975538689562
493,Underworld Awakening,160112671,62321039,97791632,2012_boxofficemojo_rankings.csv,2012,0.3892323987275186,0.6107676012724814
494,Johnny English Reborn,160078586,8305970,151772616,2011_boxofficemojo_rankings.csv,2011,0.051886827636021225,0.9481131723639787
495,Step Up 3D,159291809,42400223,116891586,2010_boxofficemojo_rankings.csv,2010,0.26617955603731014,0.7338204439626899
496,Happy Feet Two,159196259,64006466,95189793,2011_boxofficemojo_rankings.csv,2011,0.4020601137367179,0.5979398862632821
497,Johnny English Strikes Again,158970776,4412170,154558606,2018_boxofficemojo_rankings.csv,2018,0.02775459811556811,0.9722454018844319
498,Focus,158762963,53862963,104900000,2015_boxofficemojo_rankings.csv,2015,0.3392665517334795,0.6607334482665205
499,Goosebumps,158260952,80080379,78180573,2015_boxofficemojo_rankings.csv,2015,0.5060021312142745,0.4939978687857255
500,Final Destination 5,157887643,42587643,115300000,2011_boxofficemojo_rankings.csv,2011,0.26973385751283907,0.7302661424871609
501,Don't Breathe,157830487,89217875,68612612,2016_boxofficemojo_rankings.csv,2016,0.565276561555563,0.4347234384444369
502,Hustlers,157563598,104963598,52600000,2019_boxofficemojo_rankings.csv,2019,0.6661665469203109,0.33383345307968915
503,The Book of Eli,157107755,94835059,62272696,2010_boxofficemojo_rankings.csv,2010,0.6036306673722122,0.39636933262778784
504,Ip Man 3,156954938,2679437,154275501,2015_boxofficemojo_rankings.csv,2015,0.01707137751855886,0.9829286224814411
505,The Climbers,156892866,487157,156405709,2019_boxofficemojo_rankings.csv,2019,0.0031050296448788183,0.9968949703551212
506,This Means War,156491279,54760791,101730488,2012_boxofficemojo_rankings.csv,2012,0.3499287075288074,0.6500712924711926
507,The Hateful Eight,155760117,54117416,101642701,2015_boxofficemojo_rankings.csv,2015,0.3474407765114866,0.6525592234885135
508,Escape Room,155712077,57005601,98706476,2019_boxofficemojo_rankings.csv,2019,0.36609620845273294,0.6339037915472671
509,The Monuments Men,155641650,78031620,77610030,2014_boxofficemojo_rankings.csv,2014,0.5013543611237737,0.49864563887622626
510,The Accountant,155160045,86260045,68900000,2016_boxofficemojo_rankings.csv,2016,0.5559423819450426,0.44405761805495736
511,Lone Survivor,154802912,125095601,29707311,2013_boxofficemojo_rankings.csv,2013,0.8080959161801814,0.19190408381981858
512,Ride Along,154468902,134938200,19530702,2014_boxofficemojo_rankings.csv,2014,0.8735622397315933,0.12643776026840664
513,The Town,154026136,92186262,61839874,2010_boxofficemojo_rankings.csv,2010,0.598510515124524,0.4014894848754759
514,Midnight in Paris,153959590,56817045,97142545,2011_boxofficemojo_rankings.csv,2011,0.36903868735945583,0.6309613126405442
515,Yesterday,153178301,73286650,79891651,2019_boxofficemojo_rankings.csv,2019,0.47844015452293076,0.5215598454770692
516,Tower Heist,152930623,78046570,74884053,2011_boxofficemojo_rankings.csv,2011,0.5103397113604906,0.48966028863950944
517,Duckweed,152894264,471575,152422689,2017_boxofficemojo_rankings.csv,2017,0.0030843210704098096,0.9969156789295902
518,Date Night,152263880,98711404,53552476,2010_boxofficemojo_rankings.csv,2010,0.6482916631311378,0.35170833686886216
519,Jackass Presents: Bad Grandpa,151826547,102003019,49823528,2013_boxofficemojo_rankings.csv,2013,0.6718391547164674,0.3281608452835327
520,47 Ronin,151783839,38362475,113421364,2013_boxofficemojo_rankings.csv,2013,0.25274413437388416,0.7472558656261158
521,Red Sparrow,151572634,46874505,104698129,2018_boxofficemojo_rankings.csv,2018,0.30925440670246584,0.6907455932975342
522,Darkest Hour,150847207,56468410,94378797,2017_boxofficemojo_rankings.csv,2017,0.37434176689794463,0.6256582331020554
523,Gods of Egypt,150680864,31153464,119527400,2015_boxofficemojo_rankings.csv,2015,0.20675129656808977,0.7932487034319102
524,I Am Number Four,149878437,55100437,94778000,2011_boxofficemojo_rankings.csv,2011,0.36763418476268206,0.6323658152373179
525,Jack and Jill,149673788,74158157,75515631,2011_boxofficemojo_rankings.csv,2011,0.49546522467915355,0.5045347753208465
526,Friends with Benefits,149542245,55802754,93739491,2011_boxofficemojo_rankings.csv,2011,0.37315712359407205,0.626842876405928
527,No Strings Attached,149228077,70662220,78565857,2011_boxofficemojo_rankings.csv,2011,0.473518264260686,0.526481735739314
528,Lights Out,148868835,67268835,81600000,2016_boxofficemojo_rankings.csv,2016,0.4518664702387172,0.5481335297612828
529,The Secret World of Arrietty,148800274,19202743,129597531,2010_boxofficemojo_rankings.csv,2010,0.12905045457107156,0.8709495454289284
530,King Arthur: Legend of the Sword,148675066,39175066,109500000,2017_boxofficemojo_rankings.csv,2017,0.2634945257061463,0.7365054742938537
531,RED 2,148075565,53262560,94813005,2013_boxofficemojo_rankings.csv,2013,0.35969850933879605,0.640301490661204
532,The Angry Birds Movie 2,147792047,41667116,106124931,2019_boxofficemojo_rankings.csv,2019,0.2819307049722371,0.7180692950277628
533,Arthur Christmas,147419472,46462469,100957003,2011_boxofficemojo_rankings.csv,2011,0.31517185870805453,0.6848281412919455
534,Source Code,147332697,54712227,92620470,2011_boxofficemojo_rankings.csv,2011,0.3713515608826464,0.6286484391173536
535,Planes: Fire & Rescue,146965787,59165787,87800000,2014_boxofficemojo_rankings.csv,2014,0.402582044486313,0.597417955513687
536,The Last Witch Hunter,146936910,27367660,119569250,2015_boxofficemojo_rankings.csv,2015,0.18625449521158435,0.8137455047884157
537,Angel Has Fallen,146661977,69030436,77631541,2019_boxofficemojo_rankings.csv,2019,0.470677113537069,0.529322886462931
538,Mama,146428180,71628180,74800000,2013_boxofficemojo_rankings.csv,2013,0.4891693661698179,0.5108306338301821
539,The Foreigner,145374099,34393507,110980592,2017_boxofficemojo_rankings.csv,2017,0.23658620921186244,0.7634137907881375
540,"Crazy, Stupid, Love",145051197,84351197,60700000,2011_boxofficemojo_rankings.csv,2011,0.5815270659227997,0.4184729340772003
541,Pete's Dragon,143695338,76233151,67462187,2016_boxofficemojo_rankings.csv,2016,0.5305193060612725,0.4694806939387275
542,More Than Blue,142958164,722669,142235495,2018_boxofficemojo_rankings.csv,2018,0.005055108290282743,0.9949448917097172
543,Paranormal Activity 4,142802657,53885000,88917657,2012_boxofficemojo_rankings.csv,2012,0.3773389174404507,0.6226610825595493
544,Power Rangers,142337240,85364450,56972790,2017_boxofficemojo_rankings.csv,2017,0.5997337731151735,0.4002662268848265
545,New Year's Eve,142044638,54544638,87500000,2011_boxofficemojo_rankings.csv,2011,0.3839964589159641,0.6160035410840359
546,The Taking of Tiger Mountain,141654055,228984,141425071,2014_boxofficemojo_rankings.csv,2014,0.0016165015537324364,0.9983834984462676
547,Trainwreck,140795793,110212700,30583093,2015_boxofficemojo_rankings.csv,2015,0.7827840424180856,0.2172159575819144
548,Sausage Party,140705322,97685686,43019636,2016_boxofficemojo_rankings.csv,2016,0.6942572221966131,0.3057427778033869
549,Girls Trip,140552359,115171585,25380774,2017_boxofficemojo_rankings.csv,2017,0.8194212165446473,0.18057878345535275
550,Step Up Revolution,140470746,35074677,105396069,2012_boxofficemojo_rankings.csv,2012,0.24969381881121355,0.7503061811887864
551,Lion,140312928,51738905,88574023,2016_boxofficemojo_rankings.csv,2016,0.3687394008341127,0.6312605991658873
552,Onward,140245673,61555145,78690528,2020_boxofficemojo_rankings.csv,2020,0.4389094057825228,0.5610905942174772
553,Legend of the Guardians: The Owls of Ga'Hoole,140073390,55675313,84398077,2010_boxofficemojo_rankings.csv,2010,0.3974724464082721,0.6025275535917278
554,The Wolfman,139789765,61979680,77810085,2010_boxofficemojo_rankings.csv,2010,0.4433778109577622,0.5566221890422378
555,Mr. Six,139191345,1415450,137775895,2015_boxofficemojo_rankings.csv,2015,0.010169094924688026,0.989830905075312
556,The Admiral: Roaring Currents,138342258,2589811,135752447,2014_boxofficemojo_rankings.csv,2014,0.018720317547513212,0.9812796824524868
557,Let's Be Cops,138224951,82390774,55834177,2014_boxofficemojo_rankings.csv,2014,0.5960629640592168,0.40393703594078323
558,Escape Plan,137328301,25135965,112192336,2013_boxofficemojo_rankings.csv,2013,0.18303557836923942,0.8169644216307606
559,The First Purge,137056262,69488745,67567517,2018_boxofficemojo_rankings.csv,2018,0.5070089026650968,0.49299109733490326
560,Annie,136853506,85911262,50942244,2014_boxofficemojo_rankings.csv,2014,0.6277607677804031,0.3722392322195969
561,The Best Exotic Marigold Hotel,136836156,46412041,90424115,2012_boxofficemojo_rankings.csv,2012,0.3391796609662142,0.6608203390337858
562,How Long Will I Love U,136796719,746933,136049786,2018_boxofficemojo_rankings.csv,2018,0.005460167505918033,0.994539832494082
563,Contagion,136515867,75658097,60857770,2011_boxofficemojo_rankings.csv,2011,0.5542073508568788,0.4457926491431212
564,The Wind Rises,136454220,5209580,131244640,2012_boxofficemojo_rankings.csv,2012,0.03817822563494189,0.9618217743650581
565,The Bounty Hunter,136333522,67061228,69272294,2010_boxofficemojo_rankings.csv,2010,0.49189096721201114,0.5081090327879888
566,Saw: The Final Chapter,136150434,45710178,90440256,2010_boxofficemojo_rankings.csv,2010,0.3357328849939619,0.6642671150060381
567,Unknown,135710029,63686397,72023632,2011_boxofficemojo_rankings.csv,2011,0.4692829076029451,0.5307170923970549
568,Jack Ryan: Shadow Recruit,135503748,50577412,84926336,2014_boxofficemojo_rankings.csv,2014,0.3732547087922616,0.6267452912077384
569,American Made,134866593,51342000,83524593,2017_boxofficemojo_rankings.csv,2017,0.3806873063072039,0.6193126936927961
570,Wall Street: Money Never Sleeps,134748021,52474616,82273405,2010_boxofficemojo_rankings.csv,2010,0.38942773044510987,0.6105722695548902
571,Last Vegas,134402450,63914167,70488283,2012_boxofficemojo_rankings.csv,2012,0.4755431690419334,0.5244568309580666
572,Point Break,133718711,28782481,104936230,2015_boxofficemojo_rankings.csv,2015,0.21524647362178057,0.7847535263782194
573,The Big Short,133440870,70259870,63181000,2015_boxofficemojo_rankings.csv,2015,0.5265243699325401,0.47347563006745985
574,The Artist,133432856,44671682,88761174,2011_boxofficemojo_rankings.csv,2011,0.33478772274798646,0.6652122772520136
575,Zero Dark Thirty,132820716,95720716,37100000,2012_boxofficemojo_rankings.csv,2012,0.7206761029657452,0.2793238970342548
576,A Wrinkle in Time,132675864,100478608,32197256,2018_boxofficemojo_rankings.csv,2018,0.7573239394921144,0.2426760605078856
577,Ghost Rider: Spirit of Vengeance,132563930,51774002,80789928,2012_boxofficemojo_rankings.csv,2012,0.39055874399619867,0.6094412560038014
578,The Three Musketeers,132274484,20374484,111900000,2011_boxofficemojo_rankings.csv,2011,0.1540318539439549,0.8459681460560451
579,2 Guns,131940411,75612460,56327951,2013_boxofficemojo_rankings.csv,2013,0.5730803733815867,0.4269196266184134
580,The House with a Clock in Its Walls,131457147,68549695,62907452,2018_boxofficemojo_rankings.csv,2018,0.521460388912898,0.478539611087102
581,The Invisible Man,130749733,64914050,65835683,2020_boxofficemojo_rankings.csv,2020,0.49647558362509236,0.5035244163749076
582,A Bad Moms Christmas,130560428,72110659,58449769,2017_boxofficemojo_rankings.csv,2017,0.5523163496369665,0.4476836503630334
583,Cloud Atlas,130482868,27108272,103374596,2012_boxofficemojo_rankings.csv,2012,0.2077534960375028,0.7922465039624972
584,The Woman in Black,128955898,54333290,74622608,2012_boxofficemojo_rankings.csv,2012,0.4213323379749564,0.5786676620250436
585,Pan,128388320,35088320,93300000,2015_boxofficemojo_rankings.csv,2015,0.2732983810365304,0.7267016189634695
586,Blended,127994610,46294610,81700000,2014_boxofficemojo_rankings.csv,2014,0.36169187124364066,0.6383081287563593
587,The Adjustment Bureau,127869379,62495645,65373734,2010_boxofficemojo_rankings.csv,2010,0.4887459803804944,0.5112540196195057
588,Ad Astra,127461872,50188370,77273502,2019_boxofficemojo_rankings.csv,2019,0.393752023350167,0.606247976649833
589,Predators,127233108,52000688,75232420,2010_boxofficemojo_rankings.csv,2010,0.40870406152461514,0.5912959384753849
590,Midway,126696475,56846802,69849673,2019_boxofficemojo_rankings.csv,2019,0.4486849535474448,0.5513150464525552
591,Chronicle,126636097,64575175,62060922,2012_boxofficemojo_rankings.csv,2012,0.5099270786906833,0.49007292130931673
592,Walking with Dinosaurs 3D,126546518,36076121,90470397,2012_boxofficemojo_rankings.csv,2012,0.2850818937586256,0.7149181062413744
593,Sex Tape,126069509,38543473,87526036,2014_boxofficemojo_rankings.csv,2014,0.30573191968249835,0.6942680803175016
594,This Is the End,126041322,101470202,24571120,2013_boxofficemojo_rankings.csv,2013,0.8050550437736602,0.1949449562263398
595,The Upside,125852517,108252517,17600000,2019_boxofficemojo_rankings.csv,2019,0.860153770305603,0.13984622969439697
596,Detective Chinatown,125842935,474252,125368683,2015_boxofficemojo_rankings.csv,2015,0.003768602504383738,0.9962313974956163
597,Wolf Totem,125837070,210591,125626479,2015_boxofficemojo_rankings.csv,2015,0.0016735211651065938,0.9983264788348934
598,Mechanic: Resurrection,125729635,21218403,104511232,2016_boxofficemojo_rankings.csv,2016,0.1687621458536804,0.8312378541463196
599,Ender's Game,125544024,61737191,63806833,2013_boxofficemojo_rankings.csv,2013,0.49175730578780874,0.5082426942121913
600,Happy Death Day,125479266,55683845,69795421,2017_boxofficemojo_rankings.csv,2017,0.44376929173302626,0.5562307082669737
601,Captain Underpants: The First Epic Movie,125427681,73921000,51506681,2017_boxofficemojo_rankings.csv,2017,0.5893515642691345,0.4106484357308655
602,Ride Along 2,124605297,91221830,33383467,2015_boxofficemojo_rankings.csv,2015,0.7320862932496361,0.2679137067503639
603,The Theory of Everything,123726688,35893537,87833151,2014_boxofficemojo_rankings.csv,2014,0.2901034334645731,0.7098965665354269
604,The Curse of La Llorona,123133739,54733739,68400000,2019_boxofficemojo_rankings.csv,2019,0.4445064321485438,0.5554935678514562
605,The Lego Ninjago Movie,123081555,59281555,63800000,2017_boxofficemojo_rankings.csv,2017,0.4816445079849698,0.5183554920150302
606,The Pirates! Band of Misfits,123054041,31051126,92002915,2012_boxofficemojo_rankings.csv,2012,0.25233731251458863,0.7476626874854114
607,Looking Up,122994583,84267,122910316,2019_boxofficemojo_rankings.csv,2019,0.0006851277344466463,0.9993148722655534
608,Zombieland: Double Tap,122810399,73123082,49687317,2019_boxofficemojo_rankings.csv,2019,0.5954144160056023,0.40458558399439776
609,Dragon Blade,122593849,74068,122519781,2015_boxofficemojo_rankings.csv,2015,0.0006041738684621934,0.9993958261315378
610,Prisoners,122126687,61002302,61124385,2013_boxofficemojo_rankings.csv,2013,0.4995001788593512,0.5004998211406488
611,Secret Superstar,122026260,0,122026260,2017_boxofficemojo_rankings.csv,2017,0.0,1.0
612,Deepwater Horizon,121790373,61433527,60356846,2016_boxofficemojo_rankings.csv,2016,0.5044202221139433,0.4955797778860567
613,Last Christmas,121550750,35150750,86400000,2019_boxofficemojo_rankings.csv,2019,0.2891857927655732,0.7108142072344268
614,The Nut Job,120885527,64251541,56633986,2014_boxofficemojo_rankings.csv,2014,0.531507307735855,0.4684926922641451
615,Instant Family,120556201,67363237,53192964,2018_boxofficemojo_rankings.csv,2018,0.5587704028596588,0.4412295971403412
616,We Bought a Zoo,120081841,75624550,44457291,2011_boxofficemojo_rankings.csv,2011,0.629775071486454,0.37022492851354605
617,The Commuter,119942387,36343858,83598529,2017_boxofficemojo_rankings.csv,2017,0.3030109614210029,0.6969890385789971
618,Extreme Job,119932733,1565885,118366848,2019_boxofficemojo_rankings.csv,2019,0.013056360518358236,0.9869436394816418
619,Parental Guidance,119772232,77267296,42504936,2012_boxofficemojo_rankings.csv,2012,0.6451186114658028,0.35488138853419715
620,Dora and the Lost City of Gold,119682635,60477943,59204692,2019_boxofficemojo_rankings.csv,2019,0.505319280445321,0.4946807195546789
621,Wonder Park,119559110,45216793,74342317,2019_boxofficemojo_rankings.csv,2019,0.37819613244026323,0.6218038675597368
622,Allied,119520023,40098064,79421959,2016_boxofficemojo_rankings.csv,2016,0.33549243878575896,0.664507561214241
623,I Belonged to You,119107580,744541,118363039,2016_boxofficemojo_rankings.csv,2016,0.006250995948368693,0.9937490040516314
624,The Shallows,119100758,55124043,63976715,2016_boxofficemojo_rankings.csv,2016,0.46283536667331704,0.537164633326683
625,The Purge: Election Year,118587880,79213375,39374505,2016_boxofficemojo_rankings.csv,2016,0.6679719293405025,0.3320280706594974
626,Jurassic Park 2013 Re-release,118192315,45385935,72806380,2013_boxofficemojo_rankings.csv,2013,0.38400072796611184,0.6159992720338882
627,A Cool Fish,118153135,551876,117601259,2018_boxofficemojo_rankings.csv,2018,0.004670853634141828,0.9953291463658581
628,Why Him?,118102725,60323786,57778939,2016_boxofficemojo_rankings.csv,2016,0.5107738707976467,0.4892261292023533
629,P Storm,117991727,326711,117665016,2019_boxofficemojo_rankings.csv,2019,0.0027689314183866466,0.9972310685816134
630,Saving Mr. Banks,117867984,83301580,34566404,2013_boxofficemojo_rankings.csv,2013,0.7067362753909493,0.29326372460905076
631,Pompeii,117831631,23219748,94611883,2014_boxofficemojo_rankings.csv,2014,0.19705869979852864,0.8029413002014714
632,Magic Mike XXL,117813057,66013057,51800000,2015_boxofficemojo_rankings.csv,2015,0.5603203811271954,0.43967961887280455
633,Game Night,117679066,69179066,48500000,2018_boxofficemojo_rankings.csv,2018,0.5878621266419637,0.41213787335803637
634,Water for Elephants,117094902,58709717,58385185,2011_boxofficemojo_rankings.csv,2011,0.5013857648559286,0.49861423514407144
635,Warm Bodies,116980662,66380662,50600000,2013_boxofficemojo_rankings.csv,2013,0.5674498747493838,0.4325501252506162
636,Abraham Lincoln: Vampire Hunter,116471580,37519139,78952441,2012_boxofficemojo_rankings.csv,2012,0.32213127872052566,0.6778687212794744
637,Personal Tailor,116126458,375892,115750566,2013_boxofficemojo_rankings.csv,2013,0.0032369195312923434,0.9967630804687077
638,The Iron Lady,115890699,30017992,85872707,2011_boxofficemojo_rankings.csv,2011,0.25901985456140875,0.7409801454385913
639,A Nightmare on Elm Street,115694863,63075011,52619852,2010_boxofficemojo_rankings.csv,2010,0.5451841971583474,0.4548158028416525
640,Dragon Ball Super: Broly,115560610,30712119,84848491,2018_boxofficemojo_rankings.csv,2018,0.2657663281632037,0.7342336718367963
641,Pitch Perfect,115350426,65001093,50349333,2012_boxofficemojo_rankings.csv,2012,0.5635097784554346,0.4364902215445654
642,The Gentlemen,115171795,36471795,78700000,2019_boxofficemojo_rankings.csv,2019,0.31667297535824634,0.6833270246417537
643,The Monkey King 3,115084576,187074,114897502,2018_boxofficemojo_rankings.csv,2018,0.0016255349457081026,0.998374465054292
644,Dear John,114984666,80014842,34969824,2010_boxofficemojo_rankings.csv,2010,0.6958740220195969,0.3041259779804031
645,So Young,114926694,11186,114915508,2013_boxofficemojo_rankings.csv,2013,9.733160861653256e-05,0.9999026683913834
646,Finding Mr Right 2,114679097,0,114679097,2016_boxofficemojo_rankings.csv,2016,0.0,1.0
647,Office Christmas Party,114501299,54767494,59733805,2016_boxofficemojo_rankings.csv,2016,0.47831329843690246,0.5216867015630976
648,Hope Springs,114281051,63536011,50745040,2012_boxofficemojo_rankings.csv,2012,0.5559627816163504,0.4440372183836496
649,Seventh Son,114178613,17223265,96955348,2014_boxofficemojo_rankings.csv,2014,0.15084493100297164,0.8491550689970284
650,The Dark Tower,113231078,50701325,62529753,2017_boxofficemojo_rankings.csv,2017,0.44776863291895885,0.5522313670810411
651,Pet Sematary,113118226,54724696,58393530,2019_boxofficemojo_rankings.csv,2019,0.4837831880425706,0.5162168119574294
652,Insidious: Chapter 3,112983889,52218558,60765331,2015_boxofficemojo_rankings.csv,2015,0.46217702773534375,0.5378229722646563
653,Deliver Us from Evil,112781920,30577122,82204798,2014_boxofficemojo_rankings.csv,2014,0.2711172322655972,0.7288827677344029
654,Cats & Dogs: The Revenge of Kitty Galore,112483764,43585753,68898011,2010_boxofficemojo_rankings.csv,2010,0.3874848373672844,0.6125151626327155
655,Tooth Fairy,112462508,60022256,52440252,2010_boxofficemojo_rankings.csv,2010,0.5337090295016362,0.46629097049836377
656,How to Be Single,112343513,46843513,65500000,2016_boxofficemojo_rankings.csv,2016,0.4169667811616324,0.5830332188383677
657,The Purge: Anarchy,111928365,71962800,39965565,2014_boxofficemojo_rankings.csv,2014,0.6429362208587609,0.35706377914123916
658,Get Hard,111711453,90411453,21300000,2015_boxofficemojo_rankings.csv,2015,0.809330203591569,0.19066979640843093
659,Good Boys,111037232,83140306,27896926,2019_boxofficemojo_rankings.csv,2019,0.748760613917321,0.251239386082679
660,Free Birds,110387072,55750480,54636592,2013_boxofficemojo_rankings.csv,2013,0.5050453734292364,0.49495462657076367
661,10 Cloverfield Lane,110216998,72082998,38134000,2016_boxofficemojo_rankings.csv,2016,0.6540098107190326,0.34599018928096736
662,Moneyball,110206216,75605492,34600724,2011_boxofficemojo_rankings.csv,2011,0.6860365480654921,0.3139634519345079
663,Buddies in India,110155128,293194,109861934,2017_boxofficemojo_rankings.csv,2017,0.002661646401064506,0.9973383535989355
664,The 5th Wave,109906372,34916787,74989585,2015_boxofficemojo_rankings.csv,2015,0.3176957474312772,0.6823042525687227
665,Along With the Gods: The Two Worlds,109383972,1908823,107475149,2017_boxofficemojo_rankings.csv,2017,0.017450664526974757,0.9825493354730253
666,Sanctum,108609310,23209310,85400000,2010_boxofficemojo_rankings.csv,2010,0.2136954005140075,0.7863045994859925
667,The Boxtrolls,108255770,50837305,57418465,2014_boxofficemojo_rankings.csv,2014,0.4696036525351027,0.5303963474648973
668,Neighbors 2: Sorority Rising,108007109,55455765,52551344,2016_boxofficemojo_rankings.csv,2016,0.5134455084803723,0.48655449151962765
669,Horrible Bosses 2,107645357,54445357,53200000,2014_boxofficemojo_rankings.csv,2014,0.5057845365313806,0.49421546346861944
670,The Call of the Wild,107604626,62342368,45262258,2020_boxofficemojo_rankings.csv,2020,0.579365128781731,0.420634871218269
671,Paul Blart: Mall Cop 2,107588225,71038190,36550035,2015_boxofficemojo_rankings.csv,2015,0.6602784830774929,0.33972151692250707
672,Vacation,107228221,58884188,48344033,2015_boxofficemojo_rankings.csv,2015,0.5491482321617552,0.45085176783824477
673,ParaNorman,107139399,56003051,51136348,2012_boxofficemojo_rankings.csv,2012,0.5227120137196215,0.4772879862803785
674,The Man from U.N.C.L.E.,107045109,45445109,61600000,2015_boxofficemojo_rankings.csv,2015,0.42454166682197503,0.575458333178025
675,The Breakup Guru,106980263,208959,106771304,2014_boxofficemojo_rankings.csv,2014,0.00195324814260365,0.9980467518573963
676,Hereafter,106956330,32746941,74209389,2010_boxofficemojo_rankings.csv,2010,0.30617113545313307,0.693828864546867
677,Shaun the Sheep Movie,106209378,19375982,86833396,2015_boxofficemojo_rankings.csv,2015,0.18243193176406702,0.817568068235933
678,Life as We Know It,105734416,53374681,52359735,2010_boxofficemojo_rankings.csv,2010,0.50479950634049,0.4952004936595101
679,First Man,105697415,44936545,60760870,2018_boxofficemojo_rankings.csv,2018,0.4251432733714443,0.5748567266285557
680,Gangster Squad,105200903,46000903,59200000,2013_boxofficemojo_rankings.csv,2013,0.4372671877160598,0.5627328122839402
681,Sisters,105011053,87044645,17966408,2015_boxofficemojo_rankings.csv,2015,0.8289093625220576,0.17109063747794245
682,The Campaign,104907746,86907746,18000000,2012_boxofficemojo_rankings.csv,2012,0.8284206773444546,0.17157932265554537
683,Let the Bullets Fly,104723314,63012,104660302,2010_boxofficemojo_rankings.csv,2010,0.0006016998277957476,0.9993983001722042
684,Scary Stories to Tell in the Dark,104545505,68947075,35598430,2019_boxofficemojo_rankings.csv,2019,0.6594934425922951,0.3405065574077049
685,Book Club,104438188,68566296,35871892,2018_boxofficemojo_rankings.csv,2018,0.6565251400187065,0.34347485998129346
686,Ouija,103590271,50856010,52734261,2014_boxofficemojo_rankings.csv,2014,0.49093423068658637,0.5090657693134136
687,Birdman or (The Unexpected Virtue of Ignorance),103215094,42340598,60874496,2014_boxofficemojo_rankings.csv,2014,0.41021711417518064,0.5897828858248194
688,Cold War II,103197501,560824,102636677,2016_boxofficemojo_rankings.csv,2016,0.00543447268165922,0.9945655273183408
689,Night School,103105878,77339130,25766748,2018_boxofficemojo_rankings.csv,2018,0.75009428657404,0.24990571342596005
690,Transcendence,103039258,23022309,80016949,2014_boxofficemojo_rankings.csv,2014,0.22343240282262125,0.7765675971773788
691,Jigsaw,102952888,38052832,64900056,2017_boxofficemojo_rankings.csv,2017,0.3696140316141496,0.6303859683858505
692,Love & Other Drugs,102820008,32367005,70453003,2010_boxofficemojo_rankings.csv,2010,0.31479286599549766,0.6852071340045023
693,Chappie,102811889,31569268,71242621,2015_boxofficemojo_rankings.csv,2015,0.3070585348354022,0.6929414651645979
694,Star Wars: Episode I - The Phantom Menace 2012 3D Release,102739593,43456382,59283211,2012_boxofficemojo_rankings.csv,2012,0.4229759991359903,0.5770240008640096
695,Project X,102731865,54731865,48000000,2012_boxofficemojo_rankings.csv,2012,0.5327642499238187,0.46723575007618134
696,Railroad Tigers,102205175,218044,101987131,2016_boxofficemojo_rankings.csv,2016,0.002133394908819441,0.9978666050911805
697,Heaven Is for Real,101888019,91443253,10444766,2014_boxofficemojo_rankings.csv,2014,0.8974877900020806,0.10251220999791938
698,The Devil Inside,101758490,53261944,48496546,2012_boxofficemojo_rankings.csv,2012,0.5234152354265477,0.4765847645734523
699,Joy,101134059,56451232,44682827,2015_boxofficemojo_rankings.csv,2015,0.5581822044737669,0.4418177955262332
700,"Alexander and the Terrible, Horrible, No Good, Very Bad Day",100654149,66954149,33700000,2014_boxofficemojo_rankings.csv,2014,0.665190155251325,0.334809844748675
701,Life,100541806,30234022,70307784,2017_boxofficemojo_rankings.csv,2017,0.30071095003008,0.69928904996992
702,Instructions Not Included,100486616,44467206,56019410,2013_boxofficemojo_rankings.csv,2013,0.44251869323572407,0.557481306764276
703,Tammy,100375432,84525432,15850000,2014_boxofficemojo_rankings.csv,2014,0.8420928340313395,0.15790716596866053
704,PK,100370104,10616104,89754000,2014_boxofficemojo_rankings.csv,2014,0.10576958254422054,0.8942304174557795
705,Aftershock,100293273,62962,100230311,2010_boxofficemojo_rankings.csv,2010,0.0006277788940041871,0.9993722211059958
706,Philomena,100129872,37709979,62419893,2013_boxofficemojo_rankings.csv,2013,0.376610678180034,0.623389321819966
707,Atomic Blonde,100014025,51687870,48326155,2017_boxofficemojo_rankings.csv,2017,0.5168062179279356,0.48319378207206437
708,The Book of Life,99783556,50151543,49632013,2014_boxofficemojo_rankings.csv,2014,0.5026032846534353,0.4973967153465647
709,Black Mass,99775678,62575678,37200000,2015_boxofficemojo_rankings.csv,2015,0.6271636460340565,0.3728363539659435
710,Insidious,99557032,54009150,45547882,2011_boxofficemojo_rankings.csv,2011,0.5424945773795266,0.45750542262047345
711,Line Walker 2: Invisible Spy,99482027,296751,99185276,2019_boxofficemojo_rankings.csv,2019,0.002982960932229497,0.9970170390677705
712,The Lucky One,99357138,60457138,38900000,2012_boxofficemojo_rankings.csv,2012,0.6084830865397914,0.39151691346020856
713,Blue Jasmine,99104804,33405481,65699323,2013_boxofficemojo_rankings.csv,2013,0.3370722674553698,0.6629277325446302
714,Ode To My Father,99085291,2300121,96785170,2014_boxofficemojo_rankings.csv,2014,0.023213546398122804,0.9767864536018772
715,Justin Bieber: Never Say Never,99036827,73013910,26022917,2011_boxofficemojo_rankings.csv,2011,0.7372399965923787,0.2627600034076213
716,Young Detective Dee: Rise of the Sea Dragon,98774891,87783,98687108,2013_boxofficemojo_rankings.csv,2013,0.0008887177612780155,0.999111282238722
717,Spotlight,98690254,45055776,53634478,2015_boxofficemojo_rankings.csv,2015,0.45653723821604514,0.5434627617839549
718,Devil and Angel,98599942,131058,98468884,2015_boxofficemojo_rankings.csv,2015,0.0013291894228497619,0.9986708105771502
719,The Visit,98450062,65206105,33243957,2015_boxofficemojo_rankings.csv,2015,0.6623267032579421,0.3376732967420579
720,Riddick,98337295,42025135,56312160,2013_boxofficemojo_rankings.csv,2013,0.4273570368190421,0.572642963180958
721,Alpha,98203196,35857181,62346015,2018_boxofficemojo_rankings.csv,2018,0.36513252582940375,0.6348674741705962
722,Killers,98159963,47059963,51100000,2010_boxofficemojo_rankings.csv,2010,0.4794211566685289,0.5205788433314711
723,Paul,97984015,37412945,60571070,2011_boxofficemojo_rankings.csv,2011,0.3818270255612612,0.6181729744387388
724,Along With the Gods: The Last 49 Days,97962238,1200246,96761992,2018_boxofficemojo_rankings.csv,2018,0.012252129233715547,0.9877478707662845
725,A Simple Favor,97644617,53548586,44096031,2018_boxofficemojo_rankings.csv,2018,0.5484028474401206,0.4515971525598795
726,Safe Haven,97594140,71349120,26245020,2013_boxofficemojo_rankings.csv,2013,0.7310799603336839,0.26892003966631606
727,The Little Prince,97571250,1339152,96232098,2015_boxofficemojo_rankings.csv,2015,0.013724862600407395,0.9862751373995926
728,Evil Dead,97542952,54239856,43303096,2013_boxofficemojo_rankings.csv,2013,0.5560612518677925,0.44393874813220746
729,42,97470701,95020213,2450488,2013_boxofficemojo_rankings.csv,2013,0.9748592348792074,0.025140765120792555
730,Scream 4,97138686,38180928,58957758,2011_boxofficemojo_rankings.csv,2011,0.39305584183010256,0.6069441581698974
731,The Shack,96942115,57386418,39555697,2017_boxofficemojo_rankings.csv,2017,0.5919658138261168,0.40803418617388326
732,The Rite,96560591,33047633,63512958,2011_boxofficemojo_rankings.csv,2011,0.34224762563849676,0.6577523743615032
733,Contraband,96262212,66528000,29734212,2012_boxofficemojo_rankings.csv,2012,0.6911123131057907,0.3088876868942093
734,Kick-Ass,96188903,48071303,48117600,2010_boxofficemojo_rankings.csv,2010,0.4997593433413,0.5002406566587
735,Assassination,96119773,1904682,94215091,2015_boxofficemojo_rankings.csv,2015,0.019815714712518098,0.9801842852874819
736,Think Like a Man,96070507,91547205,4523302,2012_boxofficemojo_rankings.csv,2012,0.9529168509540602,0.04708314904593977
737,Dolphin Tale,95932565,72286779,23645786,2011_boxofficemojo_rankings.csv,2011,0.7535165874069978,0.2464834125930022
738,The Favourite,95918706,34366783,61551923,2018_boxofficemojo_rankings.csv,2018,0.35829072798375744,0.6417092720162426
739,Some Like It Hot,95721320,100026,95621294,2016_boxofficemojo_rankings.csv,2016,0.001044970963626494,0.9989550290363735
740,Poltergeist,95437994,47425125,48012869,2015_boxofficemojo_rankings.csv,2015,0.49692080703205055,0.5030791929679495
741,The Mortal Instruments: City of Bones,95396573,31165421,64231152,2013_boxofficemojo_rankings.csv,2013,0.32669329746258285,0.6733067025374172
742,Truth or Dare,95330493,41411015,53919478,2018_boxofficemojo_rankings.csv,2018,0.43439421843753606,0.565605781562464
743,Rush,95224595,26947624,68276971,2013_boxofficemojo_rankings.csv,2013,0.28299016656358583,0.7170098334364142
744,The Hustle,95017038,35417038,59600000,2019_boxofficemojo_rankings.csv,2019,0.3727440756467277,0.6272559243532723
745,I Feel Pretty,94539426,48795601,45743825,2018_boxofficemojo_rankings.csv,2018,0.5161402291568811,0.48385977084311893
746,Veteran,94393020,1200627,93192393,2015_boxofficemojo_rankings.csv,2015,0.01271944684045494,0.9872805531595451
747,Masquerade,94268432,922921,93345511,2012_boxofficemojo_rankings.csv,2012,0.009790350602203715,0.9902096493977963
748,Police Story: Lockdown,94249025,0,94249025,2013_boxofficemojo_rankings.csv,2013,0.0,1.0
749,Fleet of Time,94244191,569280,93674911,2014_boxofficemojo_rankings.csv,2014,0.006040478399353017,0.9939595216006469
750,Dirty Grandpa,94073028,35593113,58479915,2016_boxofficemojo_rankings.csv,2016,0.378356195784407,0.6216438042155931
751,Ben-Hur,94061311,26410477,67650834,2016_boxofficemojo_rankings.csv,2016,0.2807793844166174,0.7192206155833827
752,Blockers,94017294,60311495,33705799,2018_boxofficemojo_rankings.csv,2018,0.6414936277574634,0.35850637224253656
753,In the Heart of the Sea,93920758,25020758,68900000,2015_boxofficemojo_rankings.csv,2015,0.26640285420183685,0.7335971457981632
754,Nothing to Declare,93811164,0,93811164,2011_boxofficemojo_rankings.csv,2011,0.0,1.0
755,Kill Zone 2,93638358,11998,93626360,2015_boxofficemojo_rankings.csv,2015,0.00012813125151126635,0.9998718687484888
756,The Internship,93492844,44672764,48820080,2013_boxofficemojo_rankings.csv,2013,0.4778201420421011,0.5221798579578989
757,BlacKkKlansman,93400823,49275340,44125483,2018_boxofficemojo_rankings.csv,2018,0.5275685847008008,0.47243141529919924
758,Goosebumps 2: Haunted Halloween,93320380,46700633,46619747,2018_boxofficemojo_rankings.csv,2018,0.5004333780038187,0.49956662199618135
759,Money Monster,93282604,41012075,52270529,2016_boxofficemojo_rankings.csv,2016,0.43965405382551287,0.5603459461744872
760,Nanny McPhee Returns,93251121,29011215,64239906,2010_boxofficemojo_rankings.csv,2010,0.3111084852266816,0.6888915147733183
761,Train to Busan,92742323,2129768,90612555,2016_boxofficemojo_rankings.csv,2016,0.022964359001445327,0.9770356409985547
762,Southpaw,91970827,52421953,39548874,2015_boxofficemojo_rankings.csv,2015,0.5699845778270538,0.4300154221729462
763,Get Him to the Greek,91720255,60974475,30745780,2010_boxofficemojo_rankings.csv,2010,0.6647874561622185,0.33521254383778154
764,Shadow,91708374,521396,91186978,2018_boxofficemojo_rankings.csv,2018,0.005685369582498541,0.9943146304175015
765,Season of the Witch,91627228,24827228,66800000,2011_boxofficemojo_rankings.csv,2011,0.2709590647007241,0.7290409352992759
766,Crawl,91542097,39014193,52527904,2019_boxofficemojo_rankings.csv,2019,0.4261885436161682,0.5738114563838318
767,Five Feet Apart,91522094,45729221,45792873,2019_boxofficemojo_rankings.csv,2019,0.49965225883052894,0.500347741169471
768,Rambo: Last Blood,91490353,44819352,46671001,2019_boxofficemojo_rankings.csv,2019,0.4898806325514997,0.5101193674485003
769,Overboard,91244913,50316123,40928790,2018_boxofficemojo_rankings.csv,2018,0.551440308787406,0.448559691212594
770,Paranormal Activity: The Marked Ones,90894962,32462372,58432590,2014_boxofficemojo_rankings.csv,2014,0.35714159823291414,0.6428584017670859
771,My Big Fat Greek Wedding 2,90632641,59689605,30943036,2016_boxofficemojo_rankings.csv,2016,0.6585883887020351,0.34141161129796493
772,Sherlock Gnomes,90497778,43242871,47254907,2018_boxofficemojo_rankings.csv,2018,0.4778335110062039,0.522166488993796
773,Jojo Rabbit,90335025,33370906,56964119,2019_boxofficemojo_rankings.csv,2019,0.369412705647671,0.630587294352329
774,Red Riding Hood,90260376,37662162,52598214,2011_boxofficemojo_rankings.csv,2011,0.4172613019028416,0.5827386980971584
775,Detective Dee: The Four Heavenly Kings,90040771,262963,89777808,2018_boxofficemojo_rankings.csv,2018,0.0029204880975530517,0.9970795119024469
776,Sucker Punch,89792502,36392502,53400000,2011_boxofficemojo_rankings.csv,2011,0.4052955557469598,0.5947044442530401
777,Burlesque,89519773,39440655,50079118,2010_boxofficemojo_rankings.csv,2010,0.4405803732321797,0.5594196267678203
778,The Hundred-Foot Journey,89514453,54240821,35273632,2014_boxofficemojo_rankings.csv,2014,0.6059448411085079,0.39405515889149206
779,The Purge,89328627,64473115,24855512,2013_boxofficemojo_rankings.csv,2013,0.7217519978226017,0.2782480021773983
780,The Last Song,89137047,62950384,26186663,2010_boxofficemojo_rankings.csv,2010,0.7062202094265025,0.29377979057349746
781,The Inbetweeners,88823111,36000,88787111,2011_boxofficemojo_rankings.csv,2011,0.00040529992244923735,0.9995947000775508
782,Collateral Beauty,88528280,31016021,57512259,2016_boxofficemojo_rankings.csv,2016,0.350351559976089,0.649648440023911
783,This Is 40,88215156,67544505,20670651,2012_boxofficemojo_rankings.csv,2012,0.7656791424820469,0.23432085751795304
784,Dhoom 3,88031955,8031955,80000000,2013_boxofficemojo_rankings.csv,2013,0.09123908471645324,0.9087609152835467
785,Chasing the Dragon,87965942,456854,87509088,2017_boxofficemojo_rankings.csv,2017,0.005193532742478902,0.9948064672575211
786,Tiger Zinda Hai,87320000,5560921,81759079,2017_boxofficemojo_rankings.csv,2017,0.06368439074667888,0.9363156092533211
787,Pain & Gain,87305549,49875291,37430258,2013_boxofficemojo_rankings.csv,2013,0.5712728637672274,0.42872713623277253
788,Sultan,87280000,6200000,81080000,2016_boxofficemojo_rankings.csv,2016,0.07103574702108158,0.9289642529789184
789,A Million Ways to Die in the West,87189756,43139300,44050456,2014_boxofficemojo_rankings.csv,2014,0.49477486781818725,0.5052251321818128
790,The Thieves,87126367,685839,86440528,2012_boxofficemojo_rankings.csv,2012,0.007871773191231536,0.9921282268087684
791,About Time,87100449,15322921,71777528,2013_boxofficemojo_rankings.csv,2013,0.17592241114623874,0.8240775888537613
792,Dinner for Schmucks,86855739,73026337,13829402,2010_boxofficemojo_rankings.csv,2010,0.8407773376955552,0.15922266230444485
793,Snowpiercer,86758912,4563650,82195262,2013_boxofficemojo_rankings.csv,2013,0.052601512568530136,0.9473984874314698
794,The Lincoln Lawyer,86752352,58009200,28743152,2011_boxofficemojo_rankings.csv,2011,0.6686758187259292,0.3313241812740708
795,Robin Hood,86489031,30824628,55664403,2018_boxofficemojo_rankings.csv,2018,0.35639927564918605,0.643600724350814
796,A Taxi Driver,86252940,1527829,84725111,2017_boxofficemojo_rankings.csv,2017,0.01771335562590678,0.9822866443740932
797,War Dogs,86234523,43034523,43200000,2016_boxofficemojo_rankings.csv,2016,0.4990405408747956,0.5009594591252045
798,Step Up All In,86165646,14904384,71261262,2014_boxofficemojo_rankings.csv,2014,0.1729736233858213,0.8270263766141787
799,Hall Pass,86157237,45060734,41096503,2011_boxofficemojo_rankings.csv,2011,0.523005792305062,0.47699420769493805
800,I Can Only Imagine,86086881,83482352,2604529,2018_boxofficemojo_rankings.csv,2018,0.9697453436604353,0.030254656339564676
801,John Wick,86013056,43037835,42975221,2014_boxofficemojo_rankings.csv,2014,0.5003639796265348,0.49963602037346516
802,The Second Best Exotic Marigold Hotel,85978266,33078266,52900000,2015_boxofficemojo_rankings.csv,2015,0.38472822887588826,0.6152717711241118
803,Spy Kids 4-D: All the Time in the World,85564310,38538188,47026122,2011_boxofficemojo_rankings.csv,2011,0.45040026618574963,0.5495997338142503
804,Paper Towns,85512300,32000304,53511996,2015_boxofficemojo_rankings.csv,2015,0.37421872642882953,0.6257812735711704
805,The Possession,85446075,49130154,36315921,2012_boxofficemojo_rankings.csv,2012,0.5749843278348362,0.42501567216516384
806,Nerve,85251425,38583626,46667799,2016_boxofficemojo_rankings.csv,2016,0.4525862881470896,0.5474137118529103
807,J. Edgar,84920539,37306030,47614509,2011_boxofficemojo_rankings.csv,2011,0.4393051485459837,0.5606948514540163
808,Going in Style,84918541,45018541,39900000,2017_boxofficemojo_rankings.csv,2017,0.5301379471416025,0.46986205285839755
809,Sicario,84872444,46889293,37983151,2015_boxofficemojo_rankings.csv,2015,0.5524678068655593,0.44753219313444065
810,Carrie,84790678,35266619,49524059,2013_boxofficemojo_rankings.csv,2013,0.41592566343201076,0.5840743365679892
811,The Judge,84419388,47119388,37300000,2014_boxofficemojo_rankings.csv,2014,0.5581583699706517,0.44184163002934823
812,What to Expect When You're Expecting,84384002,41152203,43231799,2012_boxofficemojo_rankings.csv,2012,0.4876777828100639,0.5123222171899361
813,Leap!,84197417,2844490,81352927,2016_boxofficemojo_rankings.csv,2016,0.0337835779451524,0.9662164220548476
814,Finding Mr. Right,84112033,6945,84105088,2013_boxofficemojo_rankings.csv,2013,8.256844772733052e-05,0.9999174315522726
815,Marmaduke,83761844,33644788,50117056,2010_boxofficemojo_rankings.csv,2010,0.40167200712534457,0.5983279928746554
816,Mortal Engines,83672673,15951040,67721633,2018_boxofficemojo_rankings.csv,2018,0.19063619492591088,0.8093638050740891
817,Piranha 3D,83188165,25003155,58185010,2010_boxofficemojo_rankings.csv,2010,0.30056144404675833,0.6994385559532417
818,Oceans,83090556,19422319,63668237,2010_boxofficemojo_rankings.csv,2010,0.23374881496761196,0.766251185032388
819,Rings,83080890,27793018,55287872,2017_boxofficemojo_rankings.csv,2017,0.33452961324800445,0.6654703867519955
820,Savages,82966152,47382068,35584084,2012_boxofficemojo_rankings.csv,2012,0.5711011883496778,0.4288988116503222
821,Once Upon A Time,82886178,485728,82400450,2017_boxofficemojo_rankings.csv,2017,0.005860180933906736,0.9941398190660933
822,"Big Mommas: Like Father, Like Son",82686066,37915414,44770652,2011_boxofficemojo_rankings.csv,2011,0.4585465947793429,0.5414534052206571
823,Sinister,82515113,48086903,34428210,2012_boxofficemojo_rankings.csv,2012,0.5827647960683275,0.4172352039316725
824,Act of Valor,82497035,70012847,12484188,2012_boxofficemojo_rankings.csv,2012,0.8486710704208945,0.1513289295791055
825,Hitman: Agent 47,82347656,22467450,59880206,2015_boxofficemojo_rankings.csv,2015,0.2728365455842483,0.7271634544157517
826,Abduction,82087155,28087155,54000000,2011_boxofficemojo_rankings.csv,2011,0.34216260753585626,0.6578373924641437
827,Ouija: Origin of Evil,81705746,35144505,46561241,2016_boxofficemojo_rankings.csv,2016,0.43013504827432825,0.5698649517256718
828,One Piece: Stampede,81562741,1298528,80264213,2019_boxofficemojo_rankings.csv,2019,0.01592060276640286,0.9840793972335972
829,Frankenweenie,81491068,35291068,46200000,2012_boxofficemojo_rankings.csv,2012,0.43306670124877983,0.5669332987512202
830,Tinker Tailor Soldier Spy,81244605,24149393,57095212,2011_boxofficemojo_rankings.csv,2011,0.297243035399089,0.7027569646009111
831,Edge of Darkness,81126522,43313890,37812632,2010_boxofficemojo_rankings.csv,2010,0.5339054224461884,0.46609457755381156
832,Underworld: Blood Wars,81093313,30353973,50739340,2016_boxofficemojo_rankings.csv,2016,0.37430919858953104,0.625690801410469
833,A Dog's Way Home,80708134,42004346,38703788,2019_boxofficemojo_rankings.csv,2019,0.5204474929379485,0.4795525070620515
834,Go Away Mr. Tumor,80606893,286639,80320254,2015_boxofficemojo_rankings.csv,2015,0.0035560110225312867,0.9964439889774687
835,Vampires Suck,80547866,36661504,43886362,2010_boxofficemojo_rankings.csv,2010,0.4551517727359779,0.5448482272640222
836,Den of Thieves,80509622,44947622,35562000,2018_boxofficemojo_rankings.csv,2018,0.5582888216764947,0.44171117832350526
837,Muppets Most Wanted,80383113,51183113,29200000,2014_boxofficemojo_rankings.csv,2014,0.6367396221641727,0.36326037783582726
838,Hereditary,80200936,44069456,36131480,2018_boxofficemojo_rankings.csv,2018,0.5494880508626483,0.4505119491373517
839,The Wedding Ringer,79799880,64460211,15339669,2015_boxofficemojo_rankings.csv,2015,0.8077732823658381,0.19222671763416185
840,The Grey,79781695,51580236,28201459,2012_boxofficemojo_rankings.csv,2012,0.6465171741462751,0.353482825853725
841,Letters to Juliet,79293444,53032453,26260991,2010_boxofficemojo_rankings.csv,2010,0.6688125817816666,0.3311874182183334
842,Manchester by the Sea,78988148,47695371,31292777,2016_boxofficemojo_rankings.csv,2016,0.603829463124012,0.396170536875988
843,Lady Bird,78965611,48958273,30007338,2017_boxofficemojo_rankings.csv,2017,0.6199948608008617,0.3800051391991382
844,Paranormal Activity: The Ghost Dimension,78903124,18300124,60603000,2015_boxofficemojo_rankings.csv,2015,0.2319315519116835,0.7680684480883165
845,The Boss,78844582,63285885,15558697,2016_boxofficemojo_rankings.csv,2016,0.8026662504216207,0.1973337495783794
846,The Attorney,78547586,557236,77990350,2013_boxofficemojo_rankings.csv,2013,0.007094247301247424,0.9929057526987526
847,The Family,78418811,36918811,41500000,2013_boxofficemojo_rankings.csv,2013,0.47079024189744473,0.5292097581025552
848,Scary Movie V,78378744,32015787,46362957,2013_boxofficemojo_rankings.csv,2013,0.4084753769465864,0.5915246230534136
849,R.I.P.D.,78324220,33618855,44705365,2013_boxofficemojo_rankings.csv,2013,0.4292268087700075,0.5707731912299925
850,Priest,78309505,29137000,49172505,2011_boxofficemojo_rankings.csv,2011,0.37207488414082046,0.6279251158591795
851,If I Stay,78274843,50474843,27800000,2014_boxofficemojo_rankings.csv,2014,0.6448411911857811,0.3551588088142189
852,Tag,78130625,54730625,23400000,2018_boxofficemojo_rankings.csv,2018,0.7005015638874001,0.2994984361125999
853,Shin Godzilla,77947607,1918403,76029204,2016_boxofficemojo_rankings.csv,2016,0.024611441888139043,0.975388558111861
854,Tiny Times,77717014,23462,77693552,2013_boxofficemojo_rankings.csv,2013,0.0003018901369525082,0.9996981098630475
855,The Back-up Plan,77477008,37490007,39987001,2010_boxofficemojo_rankings.csv,2010,0.48388558060992753,0.5161144193900725
856,Diary of a Wimpy Kid: Dog Days,77229695,49008662,28221033,2012_boxofficemojo_rankings.csv,2012,0.6345831354118386,0.3654168645881613
857,Mike and Dave Need Wedding Dates,77068246,46009673,31058573,2016_boxofficemojo_rankings.csv,2016,0.596999093504736,0.40300090649526393
858,Drive,76976666,35061555,41915111,2011_boxofficemojo_rankings.csv,2011,0.45548289919441304,0.544517100805587
859,"I, Frankenstein",76801179,19075290,57725889,2014_boxofficemojo_rankings.csv,2014,0.248372358971208,0.751627641028792
860,Sanju,76693052,7909317,68783735,2018_boxofficemojo_rankings.csv,2018,0.10312951165380665,0.8968704883461933
861,The Book Thief,76586316,21488481,55097835,2013_boxofficemojo_rankings.csv,2013,0.28057859578987976,0.7194214042101202
862,Cold Pursuit,76419755,32138862,44280893,2019_boxofficemojo_rankings.csv,2019,0.42055698817668286,0.5794430118233171
863,The Ides of March,76338111,40962534,35375577,2011_boxofficemojo_rankings.csv,2011,0.5365934978401549,0.4634065021598452
864,Kubo and the Two Strings,76249438,48023088,28226350,2016_boxofficemojo_rankings.csv,2016,0.6298156322148892,0.37018436778511077
865,Diary of a Wimpy Kid,76196538,64003625,12192913,2010_boxofficemojo_rankings.csv,2010,0.8399807482066968,0.16001925179330326
866,The Mechanic,76130093,29121498,47008595,2011_boxofficemojo_rankings.csv,2011,0.38252282182290254,0.6174771781770975
867,If You Are the One 2,76085443,426894,75658549,2010_boxofficemojo_rankings.csv,2010,0.005610718465554574,0.9943892815344454
868,Vice,76073488,47836282,28237206,2018_boxofficemojo_rankings.csv,2018,0.6288167304751426,0.3711832695248573
869,Widows,75984700,42402632,33582068,2018_boxofficemojo_rankings.csv,2018,0.5580417110286676,0.4419582889713324
870,Sicario: Day of the Soldado,75837743,50072235,25765508,2018_boxofficemojo_rankings.csv,2018,0.6602548153364743,0.33974518466352566
871,A Dog's Journey,75727748,22782371,52945377,2019_boxofficemojo_rankings.csv,2019,0.30084574811335996,0.69915425188664
872,Bajrangi Bhaijaan,75547184,8178001,67369183,2015_boxofficemojo_rankings.csv,2015,0.10825024265629808,0.8917497573437019
873,Searching,75462037,26020957,49441080,2018_boxofficemojo_rankings.csv,2018,0.3448218208050758,0.6551781791949242
874,The Change-Up,75450437,37081475,38368962,2011_boxofficemojo_rankings.csv,2011,0.49146799507602584,0.5085320049239741
875,The Spy Who Dumped Me,75320680,33562069,41758611,2018_boxofficemojo_rankings.csv,2018,0.4455890334500432,0.5544109665499568
876,Larry Crowne,75055070,35608245,39446825,2011_boxofficemojo_rankings.csv,2011,0.47442824315532584,0.5255717568446742
877,Easy A,75026216,58401464,16624752,2010_boxofficemojo_rankings.csv,2010,0.7784140946146078,0.22158590538539222
878,Tyler Perry's Boo! A Madea Halloween,74827344,73206343,1621001,2016_boxofficemojo_rankings.csv,2016,0.9783367828744529,0.021663217125547047
879,Tyler Perry's a Madea Family Funeral,74747725,73257045,1490680,2019_boxofficemojo_rankings.csv,2019,0.9800571856869222,0.019942814313077754
880,Crimson Peak,74679822,31090320,43589502,2014_boxofficemojo_rankings.csv,2014,0.4163148648104705,0.5836851351895295
881,Escape from Planet Earth,74597643,57012977,17584666,2013_boxofficemojo_rankings.csv,2013,0.7642731687916735,0.23572683120832652
882,Hubble 3D,74249729,52522904,21726825,2010_boxofficemojo_rankings.csv,2010,0.7073817602755156,0.29261823972448436
883,August: Osage County,74188937,37738810,36450127,2013_boxofficemojo_rankings.csv,2013,0.5086851426379111,0.4913148573620889
884,Miracles from Heaven,73983003,61705123,12277880,2016_boxofficemojo_rankings.csv,2016,0.8340445845378837,0.16595541546211634
885,Cats,73834284,27166770,46667514,2019_boxofficemojo_rankings.csv,2019,0.3679424859053282,0.6320575140946718
886,Charlie's Angels,73279888,17803077,55476811,2019_boxofficemojo_rankings.csv,2019,0.24294629107511737,0.7570537089248827
887,War Room,73267874,67790117,5477757,2015_boxofficemojo_rankings.csv,2015,0.9252365777666758,0.07476342223332426
888,To Rome With Love,73244881,16685867,56559014,2012_boxofficemojo_rankings.csv,2012,0.22780932636097806,0.7721906736390219
889,Here Comes the Boom,73100172,45290318,27809854,2012_boxofficemojo_rankings.csv,2012,0.6195651359069305,0.3804348640930694
890,The Best Man Holiday,72835710,70525195,2310515,2013_boxofficemojo_rankings.csv,2013,0.9682777170703766,0.0317222829296234
891,The Transporter Refueled,72629670,16029670,56600000,2015_boxofficemojo_rankings.csv,2015,0.22070415575342694,0.779295844246573
892,Diary of a Wimpy Kid: Rodrick Rules,72526996,52698535,19828461,2011_boxofficemojo_rankings.csv,2011,0.7266057868989914,0.27339421310100864
893,Doctor Sleep,72381712,31581712,40800000,2019_boxofficemojo_rankings.csv,2019,0.4363217051290525,0.5636782948709476
894,Second Act,72282227,39282227,33000000,2018_boxofficemojo_rankings.csv,2018,0.5434562357908536,0.45654376420914644
895,What Men Want,72216294,54611903,17604391,2019_boxofficemojo_rankings.csv,2019,0.7562268841987377,0.24377311580126224
896,Run All Night,71561644,26461644,45100000,2015_boxofficemojo_rankings.csv,2015,0.3697741208963841,0.6302258791036159
897,Brick Mansions,71416730,20396829,51019901,2014_boxofficemojo_rankings.csv,2014,0.28560295325759105,0.714397046742409
898,The Counselor,71009334,16973715,54035619,2013_boxofficemojo_rankings.csv,2013,0.23903498376706364,0.7609650162329363
899,Son of God,70829270,59700064,11129206,2014_boxofficemojo_rankings.csv,2014,0.842872784090532,0.15712721590946793
900,I Am Not Madame Bovary,70826207,436798,70389409,2016_boxofficemojo_rankings.csv,2016,0.006167180461887504,0.9938328195381125
901,Spirited Away 2018 Re-release,70186029,1175067,69010962,2018_boxofficemojo_rankings.csv,2018,0.016742178133485795,0.9832578218665142
902,Think Like a Man Too,70181428,65182182,4999246,2014_boxofficemojo_rankings.csv,2014,0.9287668241803231,0.07123317581967696
903,The Cabin in the Woods,69935600,42073277,27862323,2012_boxofficemojo_rankings.csv,2012,0.6016002865493397,0.39839971345066033
904,After,69746452,12138565,57607887,2019_boxofficemojo_rankings.csv,2019,0.17403845861578737,0.8259615413842126
905,The Dilemma,69721966,48475290,21246676,2011_boxofficemojo_rankings.csv,2011,0.6952656785380952,0.3047343214619048
906,Exit,69501772,470699,69031073,2019_boxofficemojo_rankings.csv,2019,0.006772474808268198,0.9932275251917319
907,The Last Exorcism,69432527,41034350,28398177,2010_boxofficemojo_rankings.csv,2010,0.5909960615433167,0.40900393845668326
908,13 Hours,69411370,52853219,16558151,2015_boxofficemojo_rankings.csv,2015,0.7614490104431018,0.23855098955689824
909,Finding Nemo 2012 3D Release,69328283,41128283,28200000,2012_boxofficemojo_rankings.csv,2012,0.5932396017942634,0.4067603982057366
910,Takers,69055695,57744720,11310975,2010_boxofficemojo_rankings.csv,2010,0.8362050371080908,0.1637949628919092
911,Anna Karenina,68929150,12816367,56112783,2012_boxofficemojo_rankings.csv,2012,0.18593536986891612,0.8140646301310839
912,Running Man,68782475,310978,68471497,2015_boxofficemojo_rankings.csv,2015,0.004521180722269735,0.9954788192777303
913,The Nut Job 2: Nutty by Nature,68743485,28370522,40372963,2017_boxofficemojo_rankings.csv,2017,0.41270124725273966,0.5872987527472603
914,Playing with Fire,68631669,44451847,24179822,2019_boxofficemojo_rankings.csv,2019,0.6476871049136224,0.3523128950863777
915,The Call,68572631,51872378,16700253,2013_boxofficemojo_rankings.csv,2013,0.7564589143444124,0.24354108565558757
916,One Direction: This Is Us,68532898,28873374,39659524,2013_boxofficemojo_rankings.csv,2013,0.4213067715303678,0.5786932284696322
917,Stalingrad,68316452,1013945,67302507,2013_boxofficemojo_rankings.csv,2013,0.014841886109659207,0.9851581138903408
918,The Watch,68267862,35353000,32914862,2012_boxofficemojo_rankings.csv,2012,0.5178571433802922,0.4821428566197078
919,Moonrise Kingdom,68263166,45512466,22750700,2012_boxofficemojo_rankings.csv,2012,0.6667207026407185,0.3332792973592816
920,Shoplifters,67999335,3313513,64685822,2018_boxofficemojo_rankings.csv,2018,0.04872860889007223,0.9512713911099278
921,Legion,67918658,40168080,27750578,2010_boxofficemojo_rankings.csv,2010,0.591414512342102,0.4085854876578981
922,The American,67876281,35606376,32269905,2010_boxofficemojo_rankings.csv,2010,0.5245775913975016,0.4754224086024984
923,A Beautiful Day in the Neighborhood,67760877,61704055,6056822,2019_boxofficemojo_rankings.csv,2019,0.9106147637374882,0.08938523626251177
924,Jersey Boys,67647013,47047013,20600000,2014_boxofficemojo_rankings.csv,2014,0.6954780545890474,0.30452194541095257
925,12 Strong,67450815,45819713,21631102,2018_boxofficemojo_rankings.csv,2018,0.6793055502739292,0.32069444972607075
926,The Next Three Days,67448651,21148651,46300000,2010_boxofficemojo_rankings.csv,2010,0.3135518751887269,0.6864481248112732
927,American Assassin,67234188,36249674,30984514,2017_boxofficemojo_rankings.csv,2017,0.5391553773208356,0.4608446226791644
928,War,67179155,4654000,62525155,2019_boxofficemojo_rankings.csv,2019,0.06927744178979328,0.9307225582102068
929,Skyline,66984887,21393620,45591267,2010_boxofficemojo_rankings.csv,2010,0.31937980279044137,0.6806201972095586
930,The Giver,66980456,45090374,21890082,2014_boxofficemojo_rankings.csv,2014,0.6731870263767687,0.32681297362323125
931,Madea's Witness Protection,66899242,65653242,1246000,2012_boxofficemojo_rankings.csv,2012,0.9813749758181116,0.018625024181888338
932,Mulan,66800000,0,66800000,2020_boxofficemojo_rankings.csv,2020,0.0,1.0
933,Selma,66787908,52076908,14711000,2014_boxofficemojo_rankings.csv,2014,0.779735577284439,0.22026442271556101
934,Victoria & Abdul,66558465,22245070,44313395,2017_boxofficemojo_rankings.csv,2017,0.33421849497280326,0.6657815050271968
935,"Love, Simon",66316289,40826341,25489948,2018_boxofficemojo_rankings.csv,2018,0.615630663531248,0.38436933646875204
936,Mile 22,66308758,36108758,30200000,2018_boxofficemojo_rankings.csv,2018,0.5445548836851989,0.4554451163148011
937,One Piece Film: Gold,66207073,423593,65783480,2016_boxofficemojo_rankings.csv,2016,0.00639800221949096,0.9936019977805091
938,Life of the Party,65859911,53059911,12800000,2018_boxofficemojo_rankings.csv,2018,0.8056480823364611,0.1943519176635389
939,Beijing Love Story,65842375,428318,65414057,2014_boxofficemojo_rankings.csv,2014,0.0065052027664554936,0.9934947972335445
940,The Age of Adaline,65663276,42629776,23033500,2015_boxofficemojo_rankings.csv,2015,0.6492179281460158,0.35078207185398425
941,Moonlight,65336603,27854932,37481671,2016_boxofficemojo_rankings.csv,2016,0.42632966394044086,0.5736703360595592
942,Something Borrowed,65100369,39046489,26053880,2011_boxofficemojo_rankings.csv,2011,0.5997890580312993,0.40021094196870066
943,The Pirates,64858224,415775,64442449,2014_boxofficemojo_rankings.csv,2014,0.006410520892462304,0.9935894791075377
944,Hot Tub Time Machine,64735752,50287556,14448196,2010_boxofficemojo_rankings.csv,2010,0.7768127262969,0.22318727370309996
945,God's Not Dead,64667874,60755732,3912142,2014_boxofficemojo_rankings.csv,2014,0.9395040882277961,0.060495911772203925
946,The Darkest Hour,64626786,21443494,43183292,2011_boxofficemojo_rankings.csv,2011,0.3318050506178661,0.6681949493821339
947,Happy Death Day 2U,64600152,28148130,36452022,2019_boxofficemojo_rankings.csv,2019,0.43572854131984085,0.5642714586801592
948,Monster Trucks,64493915,33370166,31123749,2016_boxofficemojo_rankings.csv,2016,0.5174157282900255,0.4825842717099745
949,Capernaum,64417003,1661096,62755907,2018_boxofficemojo_rankings.csv,2018,0.025786607923997954,0.974213392076002
950,Fences,64414761,57682904,6731857,2016_boxofficemojo_rankings.csv,2016,0.8954920130806664,0.10450798691933359
951,Zhongkui: Snow Girl and the Dark Crystal,64325947,165428,64160519,2015_boxofficemojo_rankings.csv,2015,0.002571714956641058,0.9974282850433589
952,Isle of Dogs,64241499,32015231,32226268,2018_boxofficemojo_rankings.csv,2018,0.49835747139088393,0.5016425286091161
953,Thunder and the House of Magic,64197205,4091,64193114,2013_boxofficemojo_rankings.csv,2013,6.372551577595941e-05,0.9999362744842241
954,The Danish Girl,64191523,11114018,53077505,2015_boxofficemojo_rankings.csv,2015,0.1731384064528271,0.8268615935471729
955,The Boy,64188367,35819556,28368811,2015_boxofficemojo_rankings.csv,2015,0.5580381255064488,0.4419618744935511
956,The Grandmaster,64076736,6594959,57481777,2013_boxofficemojo_rankings.csv,2013,0.10292282990194757,0.8970771700980524
957,Hanna,63782078,40259119,23522959,2011_boxofficemojo_rankings.csv,2011,0.6311979832328448,0.3688020167671552
958,"Hail, Caesar!",63647656,30498085,33149571,2016_boxofficemojo_rankings.csv,2016,0.4791705919225054,0.5208294080774947
959,Elite Squad 2: The Enemy Within,63618850,100119,63518731,2010_boxofficemojo_rankings.csv,2010,0.0015737316848701288,0.9984262683151298
960,Footloose 2011 Re-release,63543328,51802742,11740586,2011_boxofficemojo_rankings.csv,2011,0.815234952755386,0.18476504724461396
961,Conan the Barbarian,63523283,21295021,42228262,2011_boxofficemojo_rankings.csv,2011,0.33523174487061697,0.664768255129383
962,Begin Again,63464861,16170632,47294229,2014_boxofficemojo_rankings.csv,2014,0.25479661887229216,0.7452033811277078
963,Colombiana,63458440,36665854,26792586,2011_boxofficemojo_rankings.csv,2011,0.5777931824356224,0.42220681756437756
964,Side Effects,63414135,32172757,31241378,2013_boxofficemojo_rankings.csv,2013,0.5073436229950941,0.49265637700490594
965,The Host,63365859,26627201,36738658,2013_boxofficemojo_rankings.csv,2013,0.42021368320754554,0.5797863167924544
966,The Longest Ride,62944815,37446117,25498698,2015_boxofficemojo_rankings.csv,2015,0.5949039170263667,0.4050960829736333
967,Unfriended,62882090,32482090,30400000,2015_boxofficemojo_rankings.csv,2015,0.5165555088897331,0.4834444911102668
968,The Mountain Between Us,62832209,30348555,32483654,2017_boxofficemojo_rankings.csv,2017,0.48300951825519933,0.5169904817448007
969,The Star,62812974,40852824,21960150,2017_boxofficemojo_rankings.csv,2017,0.65038830990553,0.34961169009446996
970,The Nice Guys,62788218,36261763,26526455,2016_boxofficemojo_rankings.csv,2016,0.5775249585837904,0.4224750414162097
971,Beauty and the Beast 2012 3D Release,62767829,47617067,15150762,2012_boxofficemojo_rankings.csv,2012,0.7586221757008674,0.2413778242991326
972,Devil,62695489,33601190,29094299,2010_boxofficemojo_rankings.csv,2010,0.5359427055429777,0.46405729445702226
973,Runner Runner,62675095,19316646,43358449,2013_boxofficemojo_rankings.csv,2013,0.3082028994132358,0.6917971005867641
974,How to Be a Latin Lover,62547032,32149404,30397628,2017_boxofficemojo_rankings.csv,2017,0.5140036700702281,0.4859963299297719
975,Andhadhun,62475342,1193046,61282296,2018_boxofficemojo_rankings.csv,2018,0.019096270013215774,0.9809037299867842
976,47 Meters Down,62187529,44307191,17880338,2017_boxofficemojo_rankings.csv,2017,0.7124771109654477,0.28752288903455225
977,Brooklyn,62076141,38322743,23753398,2015_boxofficemojo_rankings.csv,2015,0.6173506017392415,0.3826493982607585
978,"Dragon Ball Z: Resurrection ""F""",61768190,8008363,53759827,2015_boxofficemojo_rankings.csv,2015,0.1296518968744268,0.8703481031255732
979,White Snake,61631776,34730,61597046,2019_boxofficemojo_rankings.csv,2019,0.000563508018980339,0.9994364919810197
980,"Everything, Everything",61621140,34121140,27500000,2017_boxofficemojo_rankings.csv,2017,0.5537245821807256,0.4462754178192744
981,Woman in Gold,61619773,33307793,28311980,2015_boxofficemojo_rankings.csv,2015,0.540537418078447,0.459462581921553
982,The Face Reader,61559184,515876,61043308,2013_boxofficemojo_rankings.csv,2013,0.008380163063889865,0.9916198369361101
983,Krampus,61548707,42725475,18823232,2015_boxofficemojo_rankings.csv,2015,0.694173396688902,0.305826603311098
984,From Up on Poppy Hill,61459425,1002895,60456530,2011_boxofficemojo_rankings.csv,2011,0.0163180016734618,0.9836819983265382
985,The Legend of Hercules,61279452,18848538,42430914,2013_boxofficemojo_rankings.csv,2013,0.30758333152195944,0.6924166684780406
986,Ashfall,61255955,372562,60883393,2019_boxofficemojo_rankings.csv,2019,0.0060820535734035985,0.9939179464265964
987,The Walk,61181942,10137502,51044440,2014_boxofficemojo_rankings.csv,2014,0.16569434817874856,0.8343056518212515
988,Ma,61105672,45896028,15209644,2019_boxofficemojo_rankings.csv,2019,0.7510927627144007,0.24890723728559927
989,Snatched,60845711,45852178,14993533,2017_boxofficemojo_rankings.csv,2017,0.7535811028652455,0.24641889713475448
990,Kick-Ass 2,60795985,28795985,32000000,2013_boxofficemojo_rankings.csv,2013,0.4736494523445915,0.5263505476554085
991,127 Hours,60738797,18335230,42403567,2010_boxofficemojo_rankings.csv,2010,0.301870153931432,0.698129846068568
992,Why Did I Get Married Too?,60673972,60095852,578120,2010_boxofficemojo_rankings.csv,2010,0.9904716968257822,0.009528303174217769
993,Evangelion: 3.0 You Can (Not) Redo,60488344,174945,60313399,2012_boxofficemojo_rankings.csv,2012,0.002892210109107963,0.997107789890892
994,The Ghost Writer,60331447,15541549,44789898,2010_boxofficemojo_rankings.csv,2010,0.2576027888076346,0.7423972111923653
995,My Little Pony: The Movie,60330833,21885107,38445726,2017_boxofficemojo_rankings.csv,2017,0.3627516132588456,0.6372483867411544
996,Secretariat,60321861,59713955,607906,2010_boxofficemojo_rankings.csv,2010,0.9899222936772458,0.0100777063227542
997,The Perfect Guy,60273173,57027435,3245738,2015_boxofficemojo_rankings.csv,2015,0.9461495415215655,0.05385045847843451
998,A Haunted House,60159584,40041683,20117901,2013_boxofficemojo_rankings.csv,2013,0.6655910885288037,0.33440891147119634
999,Beautiful Creatures,60052138,19452138,40600000,2013_boxofficemojo_rankings.csv,2013,0.323920823601651,0.676079176398349
1000,Morning Glory,60040976,31011732,29029244,2010_boxofficemojo_rankings.csv,2010,0.5165094584738262,0.4834905415261737
1001,Forever Young,59981902,149761,59832141,2015_boxofficemojo_rankings.csv,2015,0.0024967697756566637,0.9975032302243433
1002,Adrift,59945012,31445012,28500000,2018_boxofficemojo_rankings.csv,2018,0.5245642790095696,0.47543572099043035
1003,Bombshell,59636523,31762808,27873715,2019_boxofficemojo_rankings.csv,2019,0.5326066377142745,0.4673933622857255
1004,Quartet,59520298,18390117,41130181,2012_boxofficemojo_rankings.csv,2012,0.3089721929819639,0.6910278070180361
1005,Rock of Ages,59418613,38518613,20900000,2012_boxofficemojo_rankings.csv,2012,0.6482583664482373,0.35174163355176263
1006,Miss Granny,59396311,234573,59161738,2015_boxofficemojo_rankings.csv,2015,0.003949285671967069,0.9960507143280329
1007,One Day,59389433,13843771,45545662,2011_boxofficemojo_rankings.csv,2011,0.23310158559688557,0.7668984144031145
1008,Molly's Game,59284015,28780744,30503271,2017_boxofficemojo_rankings.csv,2017,0.48547224745152634,0.5145277525484736
1009,The Devotion of Suspect X,59035664,686435,58349229,2017_boxofficemojo_rankings.csv,2017,0.011627463019641822,0.9883725369803582
1010,The Gift,58978653,43787265,15191388,2015_boxofficemojo_rankings.csv,2015,0.742425653566554,0.257574346433446
1011,A Walk Among the Tombstones,58834384,26307600,32526784,2014_boxofficemojo_rankings.csv,2014,0.44714668891578774,0.5528533110842122
1012,Shock Wave,58815633,0,58815633,2017_boxofficemojo_rankings.csv,2017,0.0,1.0
1013,The Tree of Life,58409247,13303319,45105928,2011_boxofficemojo_rankings.csv,2011,0.22776049484082547,0.7722395051591745
1014,Beginning of the Great Revival,58309289,151000,58158289,2011_boxofficemojo_rankings.csv,2011,0.0025896388481087464,0.9974103611518913
1015,Huo guo ying xiong,58106427,779818,57326609,2016_boxofficemojo_rankings.csv,2016,0.013420511985705126,0.9865794880142948
1016,L.O.R.D: Legend of Ravaging Dynasties,58089494,350456,57739038,2016_boxofficemojo_rankings.csv,2016,0.0060330358532646195,0.9939669641467354
1017,Snitch,57824674,42930462,14894212,2013_boxofficemojo_rankings.csv,2013,0.7424246265530179,0.25757537344698217
1018,Dolphin Tale 2,57824533,42024533,15800000,2014_boxofficemojo_rankings.csv,2014,0.7267595745217692,0.27324042547823085
1019,Nine Lives,57814445,19700032,38114413,2016_boxofficemojo_rankings.csv,2016,0.3407458464748732,0.6592541535251268
1020,That's My Boy,57719093,36931089,20788004,2012_boxofficemojo_rankings.csv,2012,0.6398418110970663,0.3601581889029337
1021,Goldbuster,57628292,186135,57442157,2017_boxofficemojo_rankings.csv,2017,0.0032299239408310073,0.996770076059169
1022,Ready or Not,57615777,28714231,28901546,2019_boxofficemojo_rankings.csv,2019,0.4983744469852416,0.5016255530147584
1023,Killer Elite,57084522,25124966,31959556,2011_boxofficemojo_rankings.csv,2011,0.44013622466699465,0.5598637753330054
1024,The 15:17 to Paris,57076286,36276286,20800000,2018_boxofficemojo_rankings.csv,2018,0.6355754472181319,0.36442455278186814
1025,All the Money in the World,56996304,25113707,31882597,2017_boxofficemojo_rankings.csv,2017,0.44061992160053043,0.5593800783994696
1026,Zoolander 2,56722693,28848693,27874000,2016_boxofficemojo_rankings.csv,2016,0.5085917377018754,0.4914082622981247
1027,The Big Sick,56411585,42873127,13538458,2017_boxofficemojo_rankings.csv,2017,0.7600057151381228,0.2399942848618772
1028,Remember Me,56032889,19068240,36964649,2010_boxofficemojo_rankings.csv,2010,0.3403044237108674,0.6596955762891327
1029,The Odd Life of Timothy Green,56012642,51854875,4157767,2012_boxofficemojo_rankings.csv,2012,0.9257709179295631,0.07422908207043688
1030,Confidential Assignment,55972241,475618,55496623,2017_boxofficemojo_rankings.csv,2017,0.008497390697649572,0.9915026093023505
1031,Dallas Buyers Club,55736588,27298285,28438303,2013_boxofficemojo_rankings.csv,2013,0.4897731630073947,0.5102268369926053
1032,All Eyez on Me,55668698,44922302,10746396,2017_boxofficemojo_rankings.csv,2017,0.806958014358446,0.1930419856415539
1033,Cop Out,55611001,44875481,10735520,2010_boxofficemojo_rankings.csv,2010,0.8069533040773713,0.19304669592262869
1034,Lawless,55404159,37400127,18004032,2012_boxofficemojo_rankings.csv,2012,0.6750418682467502,0.3249581317532498
1035,Silent Hill: Revelation,55362705,17529157,37833548,2011_boxofficemojo_rankings.csv,2011,0.31662392579986837,0.6833760742001317
1036,Extremely Loud & Incredibly Close,55247881,31847881,23400000,2011_boxofficemojo_rankings.csv,2011,0.5764543440136646,0.4235456559863355
1037,End of Watch,55078146,41003371,14074775,2012_boxofficemojo_rankings.csv,2012,0.744458083247755,0.2555419167522451
1038,Barbershop: The Next Cut,55030051,54030051,1000000,2016_boxofficemojo_rankings.csv,2016,0.9818281106081476,0.018171889391852464
1039,Downsizing,55003890,24449754,30554136,2017_boxofficemojo_rankings.csv,2017,0.44450954287051336,0.5554904571294866
1040,St. Vincent,54837234,44137712,10699522,2014_boxofficemojo_rankings.csv,2014,0.8048858190039272,0.19511418099607286
1041,The Three Stooges,54819301,44338224,10481077,2012_boxofficemojo_rankings.csv,2012,0.8088068105793614,0.19119318942063854
1042,The Crazies,54806823,39123589,15683234,2010_boxofficemojo_rankings.csv,2010,0.7138452268981181,0.28615477310188187
1043,Early Man,54622814,8267544,46355270,2018_boxofficemojo_rankings.csv,2018,0.15135697695838227,0.8486430230416178
1044,The Age of Shadows,54491162,541719,53949443,2016_boxofficemojo_rankings.csv,2016,0.009941410315309481,0.9900585896846905
1045,No Escape,54418872,27288872,27130000,2015_boxofficemojo_rankings.csv,2015,0.5014597141962075,0.4985402858037925
1046,No Good Deed,54323210,52543632,1779578,2014_boxofficemojo_rankings.csv,2014,0.9672409270365282,0.03275907296347178
1047,The Five-Year Engagement,54169363,28835528,25333835,2012_boxofficemojo_rankings.csv,2012,0.5323217110749484,0.4676782889250516
1048,Tyler Perry's Madea's Big Happy Family,54161287,53345287,816000,2011_boxofficemojo_rankings.csv,2011,0.9849338882955274,0.015066111704472605
1049,"I, Tonya",53939297,30014539,23924758,2017_boxofficemojo_rankings.csv,2017,0.5564503185868366,0.4435496814131634
1050,Peppermint,53918723,35418723,18500000,2018_boxofficemojo_rankings.csv,2018,0.6568909838610235,0.34310901613897643
1051,Long Shot,53873809,30316271,23557538,2019_boxofficemojo_rankings.csv,2019,0.5627274470234692,0.4372725529765308
1052,Tyler Perry's A Madea Christmas,53396635,52543354,853281,2013_boxofficemojo_rankings.csv,2013,0.9840199480735069,0.01598005192649312
1053,Sinister 2,53329150,27740955,25588195,2015_boxofficemojo_rankings.csv,2015,0.5201837081596088,0.4798162918403912
1054,Little White Lies,53319615,206088,53113527,2010_boxofficemojo_rankings.csv,2010,0.003865144187556493,0.9961348558124435
1055,3 Days to Kill,53260230,30697999,22562231,2014_boxofficemojo_rankings.csv,2014,0.5763775147046868,0.4236224852953132
1056,Temptation: Confessions of a Marriage Counselor,53143144,51975354,1167790,2013_boxofficemojo_rankings.csv,2013,0.9780255756038823,0.021974424396117777
1057,Delivery Man,53120346,30664106,22456240,2013_boxofficemojo_rankings.csv,2013,0.5772572716299702,0.4227427283700298
1058,From Paris with Love,52830951,24077427,28753524,2010_boxofficemojo_rankings.csv,2010,0.4557447205521627,0.5442552794478374
1059,Found a Treasure Called Love,52715771,4364639,48351132,2015_boxofficemojo_rankings.csv,2015,0.08279569694617575,0.9172043030538243
1060,Wild,52501541,37880356,14621185,2014_boxofficemojo_rankings.csv,2014,0.7215094124570554,0.2784905875429447
1061,Teo-neol,52444295,568876,51875419,2016_boxofficemojo_rankings.csv,2016,0.010847242774452398,0.9891527572255476
1062,The Boy Next Door,52425855,35423380,17002475,2015_boxofficemojo_rankings.csv,2015,0.6756853083273511,0.3243146916726489
1063,The Night Before,52395996,43047372,9348624,2015_boxofficemojo_rankings.csv,2015,0.8215775113808315,0.17842248861916854
1064,Patriots Day,52185751,31886361,20299390,2016_boxofficemojo_rankings.csv,2016,0.6110166163940038,0.3889833836059962
1065,The Finest Hours,52099090,27569558,24529532,2016_boxofficemojo_rankings.csv,2016,0.5291754232175648,0.47082457678243517
1066,Teen Titans GO! To the Movies,52090236,29790236,22300000,2018_boxofficemojo_rankings.csv,2018,0.5718967370391641,0.4281032629608359
1067,Detective Dee: Mystery of the Phantom Flame,51899269,459836,51439433,2010_boxofficemojo_rankings.csv,2010,0.008860163329082727,0.9911398366709173
1068,"Yo-kai Watch Movie: It's the Secret of Birth, Meow!",51838845,257343,51581502,2015_boxofficemojo_rankings.csv,2015,0.004964288845555876,0.9950357111544441
1069,Slender Man,51738549,30569484,21169065,2018_boxofficemojo_rankings.csv,2018,0.5908454061979975,0.4091545938020025
1070,Master,51636415,597251,51039164,2016_boxofficemojo_rankings.csv,2016,0.011566469128424194,0.9884335308715758
1071,Daybreakers,51416464,30101577,21314887,2010_boxofficemojo_rankings.csv,2010,0.5854462687282423,0.4145537312717576
1072,Breaking In,51411620,46840590,4571030,2018_boxofficemojo_rankings.csv,2018,0.9110895552406246,0.08891044475937541
1073,Hot Pursuit,51380201,34580201,16800000,2015_boxofficemojo_rankings.csv,2015,0.6730258022929883,0.3269741977070117
1074,Simmba,51329025,5102129,46226896,2018_boxofficemojo_rankings.csv,2018,0.09940046591572702,0.900599534084273
1075,Once Upon a Deadpool 2018 Re-release,51247568,6100309,45147259,2018_boxofficemojo_rankings.csv,2018,0.11903606820912946,0.8809639317908705
1076,The 100 Year-Old Man Who Climbed Out the Window and Disappeared,51167572,944193,50223379,2013_boxofficemojo_rankings.csv,2013,0.018452956884489263,0.9815470431155108
1077,Magic in the Moonlight,51029361,10539326,40490035,2014_boxofficemojo_rankings.csv,2014,0.20653454782629946,0.7934654521737006
1078,Red Dawn,50950296,44806783,6143513,2012_boxofficemojo_rankings.csv,2012,0.8794214463444923,0.12057855365550771
1079,War of the Arrows,50587661,251200,50336461,2011_boxofficemojo_rankings.csv,2011,0.004965637766885486,0.9950343622331145
1080,The Himalayas,50544493,696717,49847776,2015_boxofficemojo_rankings.csv,2015,0.013784231647154914,0.9862157683528451
1081,Alpha and Omega,50507267,25107267,25400000,2010_boxofficemojo_rankings.csv,2010,0.49710207048027366,0.5028979295197263
1082,Dragon Ball Z: Battle of Gods,50461371,2553002,47908369,2013_boxofficemojo_rankings.csv,2013,0.05059319533747904,0.9494068046625209
1083,About Last Night,50445860,48637684,1808176,2014_boxofficemojo_rankings.csv,2014,0.9641561071612219,0.03584389283877805
1084,Breakthrough,50444358,40713082,9731276,2019_boxofficemojo_rankings.csv,2019,0.8070889117074302,0.1929110882925698
1085,Just Mercy,50401502,36001502,14400000,2019_boxofficemojo_rankings.csv,2019,0.7142942287711981,0.28570577122880186
1086,Red Tails,50365498,49876377,489121,2012_boxofficemojo_rankings.csv,2012,0.9902885701636466,0.009711429836353449
1087,"Monsters, Inc. 2012 3D Release",50207820,34043006,16164814,2012_boxofficemojo_rankings.csv,2012,0.6780419066193274,0.32195809338067255
1088,Uncut Gems,50023780,50023780,0,2019_boxofficemojo_rankings.csv,2019,1.0,0.0
1089,21 Bridges,49939757,28539757,21400000,2019_boxofficemojo_rankings.csv,2019,0.5714836978481894,0.42851630215181064
1090,Winnie the Pooh,49871429,26692846,23178583,2011_boxofficemojo_rankings.csv,2011,0.535233229430823,0.464766770569177
1091,The Wailing,49851770,786633,49065137,2016_boxofficemojo_rankings.csv,2016,0.015779439727014708,0.9842205602729853
1092,The Switch,49830607,27779426,22051181,2010_boxofficemojo_rankings.csv,2010,0.5574771746208108,0.44252282537918913
1093,She's Out of My League,49779728,32010860,17768868,2010_boxofficemojo_rankings.csv,2010,0.6430501187149917,0.3569498812850082
1094,The Boy and the Beast,49714378,490643,49223735,2015_boxofficemojo_rankings.csv,2015,0.009869237426645467,0.9901307625733545
1095,Surprise,49567466,0,49567466,2015_boxofficemojo_rankings.csv,2015,0.0,1.0
1096,Death Wish,49562710,34017028,15545682,2018_boxofficemojo_rankings.csv,2018,0.6863431801852643,0.3136568198147357
1097,The Grudge,49511319,21221803,28289516,2019_boxofficemojo_rankings.csv,2019,0.4286252806151256,0.5713747193848744
1098,Entourage,49263404,32363404,16900000,2015_boxofficemojo_rankings.csv,2015,0.6569461582476112,0.34305384175238884
1099,Death at a Funeral,49050886,42739347,6311539,2010_boxofficemojo_rankings.csv,2010,0.8713267075338863,0.12867329246611367
1100,Little,48987096,40860481,8126615,2019_boxofficemojo_rankings.csv,2019,0.8341070268790786,0.16589297312092147
1101,Whiplash,48982041,13092000,35890041,2014_boxofficemojo_rankings.csv,2014,0.2672816349159481,0.732718365084052
1102,Zhi qing chun 2: Yuan lai ni hai zai zhe li,48980792,96421,48884371,2016_boxofficemojo_rankings.csv,2016,0.0019685471806989156,0.9980314528193011
1103,The Berlin File,48972848,665210,48307638,2013_boxofficemojo_rankings.csv,2013,0.013583241064518036,0.986416758935482
1104,Trouble with the Curve,48963137,35763137,13200000,2012_boxofficemojo_rankings.csv,2012,0.7304094302617906,0.2695905697382094
1105,Luck-Key,48913975,466505,48447470,2016_boxofficemojo_rankings.csv,2016,0.00953725392385305,0.9904627460761469
1106,Florence Foster Jenkins,48902953,27383770,21519183,2016_boxofficemojo_rankings.csv,2016,0.559961481262696,0.44003851873730404
1107,The Woman in Black 2: Angel of Death,48854305,26501323,22352982,2015_boxofficemojo_rankings.csv,2015,0.5424562482262311,0.457543751773769
1108,Isn't It Romantic,48791187,48791187,0,2019_boxofficemojo_rankings.csv,2019,1.0,0.0
1109,Mother's Day,48782670,32492859,16289811,2016_boxofficemojo_rankings.csv,2016,0.6660738126879894,0.33392618731201057
1110,How Do You Know,48668907,30212620,18456287,2010_boxofficemojo_rankings.csv,2010,0.6207786831950017,0.3792213168049983
1111,Concussion,48623572,34542474,14081098,2015_boxofficemojo_rankings.csv,2015,0.7104059323325732,0.28959406766742685
1112,Her,48517427,25568251,22949176,2013_boxofficemojo_rankings.csv,2013,0.5269910747740189,0.47300892522598115
1113,Fantasy Island,48505021,27309289,21195732,2020_boxofficemojo_rankings.csv,2020,0.5630198366474267,0.43698016335257334
1114,Logan Lucky,48453605,27780977,20672628,2017_boxofficemojo_rankings.csv,2017,0.5733521169374292,0.4266478830625709
1115,Homefront,48449416,20158898,28290518,2013_boxofficemojo_rankings.csv,2013,0.4160813414138986,0.5839186585861015
1116,Chef,48428048,31424003,17004045,2014_boxofficemojo_rankings.csv,2014,0.6488802315550691,0.3511197684449309
1117,Boo 2! A Madea Halloween,48333932,47319572,1014360,2017_boxofficemojo_rankings.csv,2017,0.979013501322425,0.020986498677575
1118,The Last Stand,48330757,12050299,36280458,2013_boxofficemojo_rankings.csv,2013,0.24932982117370933,0.7506701788262907
1119,Charlie St. Cloud,48190704,31162545,17028159,2010_boxofficemojo_rankings.csv,2010,0.6466505448851713,0.3533494551148288
1120,Arthur,48147945,33035397,15112548,2011_boxofficemojo_rankings.csv,2011,0.6861226787560715,0.3138773212439285
1121,Boyhood,48137666,25352281,22785385,2014_boxofficemojo_rankings.csv,2014,0.5266620321807874,0.4733379678192125
1122,21 & Over,48065672,25682380,22383292,2013_boxofficemojo_rankings.csv,2013,0.5343185465086184,0.4656814534913815
1123,Heartbreaker,48023509,504030,47519479,2010_boxofficemojo_rankings.csv,2010,0.010495484617752526,0.9895045153822475
1124,Countdown,48021766,25621766,22400000,2019_boxofficemojo_rankings.csv,2019,0.5335448513076341,0.4664551486923659
1125,Midsommar: The Directors Cut,47863365,27426361,20437004,2019_boxofficemojo_rankings.csv,2019,0.5730136399728686,0.4269863600271314
1126,Queen & Slim,47802566,43808310,3994256,2019_boxofficemojo_rankings.csv,2019,0.9164426445224718,0.08355735547752813
1127,Phantom Thread,47756590,21198205,26558385,2017_boxofficemojo_rankings.csv,2017,0.4438802058522185,0.5561197941477815
1128,Scott Pilgrim vs. the World,47664559,31524275,16140284,2010_boxofficemojo_rankings.csv,2010,0.6613776705665104,0.3386223294334896
1129,Man on a Ledge,47636031,18620000,29016031,2012_boxofficemojo_rankings.csv,2012,0.3908805920459662,0.6091194079540337
1130,Coming Home,47587984,377607,47210377,2014_boxofficemojo_rankings.csv,2014,0.007934923236084135,0.9920650767639159
1131,47 Meters Down: Uncaged,47582563,22260900,25321663,2019_boxofficemojo_rankings.csv,2019,0.46783734621441053,0.5321626537855895
1132,Beauty and the Beast,47430624,0,47430624,2014_boxofficemojo_rankings.csv,2014,0.0,1.0
1133,Nightcrawler,47398992,32381217,15017775,2014_boxofficemojo_rankings.csv,2014,0.683162565988745,0.3168374340112549
1134,Rough Night,47347283,22105643,25241640,2017_boxofficemojo_rankings.csv,2017,0.466883031070653,0.533116968929347
1135,Texas Chainsaw,47340586,34341945,12998641,2013_boxofficemojo_rankings.csv,2013,0.7254228961170865,0.2745771038829135
1136,A Monster Calls,47309313,3740823,43568490,2016_boxofficemojo_rankings.csv,2016,0.07907159843982516,0.9209284015601749
1137,Tiny Times 2.0,47289937,43788,47246149,2013_boxofficemojo_rankings.csv,2013,0.0009259475224084143,0.9990740524775916
1138,Golden Job,47287851,285795,47002056,2018_boxofficemojo_rankings.csv,2018,0.006043729921243407,0.9939562700787566
1139,Mortdecai,47275695,7696134,39579561,2015_boxofficemojo_rankings.csv,2015,0.16279261468287246,0.8372073853171276
1140,Soul Surfer,47120948,43853424,3267524,2011_boxofficemojo_rankings.csv,2011,0.9306566582658736,0.0693433417341264
1141,The Place Beyond the Pines,47052899,21403519,25649380,2013_boxofficemojo_rankings.csv,2013,0.45488204669387106,0.5451179533061289
1142,Son of Bigfoot,47046281,289308,46756973,2017_boxofficemojo_rankings.csv,2017,0.006149434000957483,0.9938505659990425
1143,Parker,46922566,17616641,29305925,2013_boxofficemojo_rankings.csv,2013,0.3754406994706982,0.6245593005293019
1144,Mary Queen of Scots,46712809,16468499,30244310,2018_boxofficemojo_rankings.csv,2018,0.35254782044899075,0.6474521795510092
1145,Uncle Drew,46664414,42469946,4194468,2018_boxofficemojo_rankings.csv,2018,0.9101142039413588,0.08988579605864118
1146,The Big Wedding,46522137,21819348,24702789,2013_boxofficemojo_rankings.csv,2013,0.4690100112984922,0.5309899887015078
1147,Risen,46432579,36880033,9552546,2016_boxofficemojo_rankings.csv,2016,0.7942706133122608,0.20572938668773924
1148,Tyler Perry's Acrimony,46403669,43549096,2854573,2018_boxofficemojo_rankings.csv,2018,0.9384838944523978,0.061516105547602284
1149,A Werewolf Boy,46282588,342922,45939666,2012_boxofficemojo_rankings.csv,2012,0.007409309090494248,0.9925906909095058
1150,The Thousand Faces of Dunjia,46263237,124187,46139050,2017_boxofficemojo_rankings.csv,2017,0.002684356047113608,0.9973156439528864
1151,Asterix: The Secret of the Magic Potion,46221204,1271953,44949251,2018_boxofficemojo_rankings.csv,2018,0.027518820150163114,0.9724811798498368
1152,The Battleship Island,46183383,1104957,45078426,2017_boxofficemojo_rankings.csv,2017,0.023925423566307388,0.9760745764336927
1153,Eddie the Eagle,46152800,15789389,30363411,2016_boxofficemojo_rankings.csv,2016,0.342111182853478,0.657888817146522
1154,The World's End,46089287,26004851,20084436,2013_boxofficemojo_rankings.csv,2013,0.5642276696534707,0.43577233034652935
1155,Let's Get Married,45972724,462918,45509806,2015_boxofficemojo_rankings.csv,2015,0.010069405502271303,0.9899305944977287
1156,Avatar 2010 Special Edition,45823494,10741486,35082008,2010_boxofficemojo_rankings.csv,2010,0.23441001683546872,0.7655899831645313
1157,Somewhere Only We Know,45737711,482341,45255370,2015_boxofficemojo_rankings.csv,2015,0.010545805407708313,0.9894541945922917
1158,Chasing the Dragon II: Wild Wild Bunch,45733356,196634,45536722,2019_boxofficemojo_rankings.csv,2019,0.004299575128490461,0.9957004248715096
1159,"McFarland, USA",45710059,44482410,1227649,2015_boxofficemojo_rankings.csv,2015,0.9731426949153577,0.026857305084642312
1160,Earth to Echo,45681062,38934842,6746220,2014_boxofficemojo_rankings.csv,2014,0.8523191076424624,0.14768089235753756
1161,That Awkward Moment,45640143,26068955,19571188,2014_boxofficemojo_rankings.csv,2014,0.5711847791537376,0.42881522084626245
1162,The Debt,45636368,31177548,14458820,2011_boxofficemojo_rankings.csv,2011,0.6831732972264576,0.31682670277354236
1163,Hero,45565534,88675,45476859,2015_boxofficemojo_rankings.csv,2015,0.0019460981188105905,0.9980539018811894
1164,Machete,45491656,26593646,18898010,2010_boxofficemojo_rankings.csv,2010,0.5845829397813085,0.4154170602186915
1165,Wei ai zhi jian ru jia jing,45386560,271734,45114826,2014_boxofficemojo_rankings.csv,2014,0.005987102789900799,0.9940128972100992
1166,Blair Witch,45173154,20777061,24396093,2016_boxofficemojo_rankings.csv,2016,0.4599426686035693,0.5400573313964308
1167,Flatliners,45158254,16883115,28275139,2017_boxofficemojo_rankings.csv,2017,0.3738655396198445,0.6261344603801555
1168,Grudge Match,44907260,29807260,15100000,2013_boxofficemojo_rankings.csv,2013,0.6637514735924659,0.3362485264075341
1169,Child's Play,44902237,29208403,15693834,2019_boxofficemojo_rankings.csv,2019,0.6504888164035124,0.34951118359648764
1170,Still Alice,44779195,18754371,26024824,2015_boxofficemojo_rankings.csv,2015,0.41881885103115407,0.5811811489688459
1171,The Man from Nowhere,44723232,528175,44195057,2010_boxofficemojo_rankings.csv,2010,0.011809857570222116,0.9881901424297779
1172,Hellboy,44664690,21903748,22760942,2019_boxofficemojo_rankings.csv,2019,0.4904041201226293,0.5095958798773706
1173,Mother!,44516999,17800004,26716995,2017_boxofficemojo_rankings.csv,2017,0.3998473482006278,0.6001526517993722
1174,Oculus,44446287,27695246,16751041,2014_boxofficemojo_rankings.csv,2014,0.6231172021185931,0.37688279788140683
1175,House at the End of the Street,44287131,31611916,12675215,2012_boxofficemojo_rankings.csv,2012,0.7137946235442526,0.2862053764557474
1176,Winchester,44019588,25091816,18927772,2018_boxofficemojo_rankings.csv,2018,0.5700147852360635,0.4299852147639365
1177,Kick,43996483,2472695,41523788,2014_boxofficemojo_rankings.csv,2014,0.056202105972879696,0.9437978940271203
1178,Wind River,43980821,33800859,10179962,2017_boxofficemojo_rankings.csv,2017,0.7685363354176585,0.23146366458234147
1179,Max,43967255,42656255,1311000,2015_boxofficemojo_rankings.csv,2015,0.9701823550276223,0.029817644972377738
1180,Battle of Memories,43892362,594552,43297810,2017_boxofficemojo_rankings.csv,2017,0.01354568250393998,0.98645431749606
1181,Of Gods and Men,43803417,3951596,39851821,2010_boxofficemojo_rankings.csv,2010,0.09021204898238874,0.9097879510176112
1182,Café Society,43763247,11103205,32660042,2016_boxofficemojo_rankings.csv,2016,0.25371072215002693,0.746289277849973
1183,Richard Jewell,43745542,22345542,21400000,2019_boxofficemojo_rankings.csv,2019,0.5108072955182497,0.4891927044817504
1184,The DUFF,43709744,34030343,9679401,2015_boxofficemojo_rankings.csv,2015,0.7785527867653491,0.22144721323465083
1185,Judy,43660268,24313888,19346380,2019_boxofficemojo_rankings.csv,2019,0.5568881986706998,0.4431118013293001
1186,Boy,43551154,256211,43294943,2010_boxofficemojo_rankings.csv,2010,0.005882989920313018,0.994117010079687
1187,League of Gods,43498766,181633,43317133,2016_boxofficemojo_rankings.csv,2016,0.004175589716728976,0.9958244102832711
1188,Harriet,43347017,43082155,264862,2019_boxofficemojo_rankings.csv,2019,0.9938897294824232,0.006110270517576792
1189,Beastly,43202283,27865571,15336712,2011_boxofficemojo_rankings.csv,2011,0.6450022791619601,0.35499772083804
1190,The Snowman,43155261,6700035,36455226,2017_boxofficemojo_rankings.csv,2017,0.1552541878961177,0.8447458121038823
1191,Annihilation,43070915,32732301,10338614,2018_boxofficemojo_rankings.csv,2018,0.7599629819798349,0.2400370180201651
1192,When in Rome,43053376,32680633,10372743,2010_boxofficemojo_rankings.csv,2010,0.7590724824924299,0.24092751750757013
1193,Gifted,43046590,24801212,18245378,2017_boxofficemojo_rankings.csv,2017,0.5761481223019059,0.42385187769809407
1194,The Possession of Hannah Grace,43016528,14837422,28179106,2018_boxofficemojo_rankings.csv,2018,0.3449237465190124,0.6550762534809876
1195,The New Mutants,42991061,21991061,21000000,2020_boxofficemojo_rankings.csv,2020,0.5115263612591464,0.4884736387408536
1196,Legend,42972994,1872994,41100000,2015_boxofficemojo_rankings.csv,2015,0.04358537364187378,0.9564146263581262
1197,The Gallows,42964410,22764410,20200000,2015_boxofficemojo_rankings.csv,2015,0.5298434215668271,0.47015657843317293
1198,Xin Shao Lin si,42741494,66099,42675395,2011_boxofficemojo_rankings.csv,2011,0.001546483143523247,0.9984535168564768
1199,Almost Christmas,42580920,42158780,422140,2016_boxofficemojo_rankings.csv,2016,0.9900861700498721,0.009913829950127897
1200,Love the Coopers,42426912,26302731,16124181,2015_boxofficemojo_rankings.csv,2015,0.6199539339558816,0.3800460660441184
1201,My Name Is Khan,42345360,4018771,38326589,2010_boxofficemojo_rankings.csv,2010,0.09490463654105195,0.905095363458948
1202,After We Collided,42332008,0,42332008,2020_boxofficemojo_rankings.csv,2020,0.0,1.0
1203,Loving Vincent,42187665,6735118,35452547,2017_boxofficemojo_rankings.csv,2017,0.15964661708582353,0.8403533829141765
1204,Long Day's Journey Into Night,42140994,521365,41619629,2018_boxofficemojo_rankings.csv,2018,0.01237191984602926,0.9876280801539707
1205,Jobs,42128352,16131410,25996942,2013_boxofficemojo_rankings.csv,2013,0.3829110144161348,0.6170889855838653
1206,Going the Distance,42059111,17804299,24254812,2010_boxofficemojo_rankings.csv,2010,0.4233161038520286,0.5766838961479713
1207,Bang Bang,42045981,2546172,39499809,2014_boxofficemojo_rankings.csv,2014,0.060556846087144456,0.9394431539128556
1208,Mary and the Witch's Flower,41978431,2418404,39560027,2017_boxofficemojo_rankings.csv,2017,0.05761063342267366,0.9423893665773263
1209,"As Above, So Below",41898409,21321100,20577309,2014_boxofficemojo_rankings.csv,2014,0.5088761246280259,0.49112387537197416
1210,Call Me by Your Name,41887595,18095701,23791894,2017_boxofficemojo_rankings.csv,2017,0.4320062061333433,0.5679937938666567
1211,The Guilt Trip,41863726,37134215,4729511,2012_boxofficemojo_rankings.csv,2012,0.8870260377683534,0.11297396223164656
1212,T2 Trainspotting,41681746,2402004,39279742,2017_boxofficemojo_rankings.csv,2017,0.05762724047116452,0.9423727595288355
1213,Overlord,41657844,21704844,19953000,2018_boxofficemojo_rankings.csv,2018,0.5210265802522089,0.47897341974779106
1214,Born to Be Wild,41644475,25978556,15665919,2011_boxofficemojo_rankings.csv,2011,0.6238175892480335,0.3761824107519665
1215,Safe,41564670,17142080,24422590,2012_boxofficemojo_rankings.csv,2012,0.4124194899177595,0.5875805100822405
1216,The Great Battle,41509280,472166,41037114,2018_boxofficemojo_rankings.csv,2018,0.0113749503725432,0.9886250496274568
1217,The Lady in the Van,41387687,10021175,31366512,2015_boxofficemojo_rankings.csv,2015,0.24212938017048405,0.757870619829516
1218,Shark Night 3D,41363927,18877153,22486774,2011_boxofficemojo_rankings.csv,2011,0.45636752525938845,0.5436324747406115
1219,Ricki and the Flash,41325328,26822144,14503184,2015_boxofficemojo_rankings.csv,2015,0.6490485447568619,0.35095145524313803
1220,This Is Where I Leave You,41296320,34296320,7000000,2014_boxofficemojo_rankings.csv,2014,0.8304933708378858,0.1695066291621142
1221,The Darkest Minds,41142379,12695691,28446688,2018_boxofficemojo_rankings.csv,2018,0.30857940908084097,0.6914205909191591
1222,50/50,41097853,35014192,6083661,2011_boxofficemojo_rankings.csv,2011,0.8519713183070659,0.14802868169293418
1223,Fist Fight,41087017,32187017,8900000,2017_boxofficemojo_rankings.csv,2017,0.7833865622320549,0.21661343776794503
1224,Dredd,41037742,13414714,27623028,2012_boxofficemojo_rankings.csv,2012,0.32688723468264896,0.6731127653173511
1225,Fright Night,41002607,18302607,22700000,2011_boxofficemojo_rankings.csv,2011,0.4463766657568871,0.5536233342431128
1226,Drive Angry,40909909,10721033,30188876,2011_boxofficemojo_rankings.csv,2011,0.262064454848824,0.737935545151176
1227,Underwater,40882928,17291078,23591850,2020_boxofficemojo_rankings.csv,2020,0.4229412824834855,0.5770587175165145
1228,Fighting with My Family,40811919,22958886,17853033,2019_boxofficemojo_rankings.csv,2019,0.5625534540534592,0.43744654594654075
1229,30 Minutes or Less,40662632,37053924,3608708,2011_boxofficemojo_rankings.csv,2011,0.9112524737700206,0.0887475262299794
1230,The Circle,40656399,20497844,20158555,2017_boxofficemojo_rankings.csv,2017,0.504172639588666,0.495827360411334
1231,The Roommate,40492652,37300000,3192652,2011_boxofficemojo_rankings.csv,2011,0.9211547813662587,0.07884521863374125
1232,Holmes & Watson,40466970,30573626,9893344,2018_boxofficemojo_rankings.csv,2018,0.7555205146320567,0.24447948536794328
1233,The Witch,40423945,25138705,15285240,2016_boxofficemojo_rankings.csv,2016,0.6218765882449128,0.37812341175508724
1234,Carol,40272135,12711491,27560644,2015_boxofficemojo_rankings.csv,2015,0.3156398586764769,0.6843601413235231
1235,Diary of a Wimpy Kid: The Long Haul,40140972,20738724,19402248,2017_boxofficemojo_rankings.csv,2017,0.5166472799911273,0.48335272000887275
1236,The Wild Life,40075446,8005586,32069860,2016_boxofficemojo_rankings.csv,2016,0.19976286726790266,0.8002371327320974
1237,Northern Limit Line,40034677,337907,39696770,2015_boxofficemojo_rankings.csv,2015,0.008440357842777151,0.9915596421572228
1238,Dream House,39984400,21302340,18682060,2011_boxofficemojo_rankings.csv,2011,0.532766278848751,0.467233721151249
1239,Brotherhood of Blades 2,39966092,14204,39951888,2017_boxofficemojo_rankings.csv,2017,0.0003554012736596813,0.9996445987263404
1240,Monte Carlo,39782683,23186769,16595914,2011_boxofficemojo_rankings.csv,2011,0.5828357277964384,0.41716427220356156
1241,The Forest,39712000,26594261,13117739,2016_boxofficemojo_rankings.csv,2016,0.6696782080983078,0.3303217919016922
1242,The November Man,39661919,25018119,14643800,2014_boxofficemojo_rankings.csv,2014,0.6307843803523475,0.3692156196476524
1243,Thugs of Hindostan,39570044,1449848,38120196,2018_boxofficemojo_rankings.csv,2018,0.0366400401273246,0.9633599598726754
1244,Don Jon,39439355,24477704,14961651,2013_boxofficemojo_rankings.csv,2013,0.6206415901071405,0.37935840989285957
1245,Frank Miller's Sin City: A Dame to Kill For,39407616,13757804,25649812,2014_boxofficemojo_rankings.csv,2014,0.3491153588179503,0.6508846411820497
1246,Uri: The Surgical Strike,39346577,4186168,35160409,2019_boxofficemojo_rankings.csv,2019,0.10639217739322025,0.8936078226067797
1247,The Gambler,39280992,33680992,5600000,2014_boxofficemojo_rankings.csv,2014,0.8574374089126874,0.14256259108731267
1248,Mars Needs Moms,39233678,21392758,17840920,2011_boxofficemojo_rankings.csv,2011,0.5452651673391417,0.45473483266085835
1249,Absolutely Fabulous: The Movie,39219109,4772155,34446954,2016_boxofficemojo_rankings.csv,2016,0.12167933238870877,0.8783206676112912
1250,Samba,39178695,151530,39027165,2014_boxofficemojo_rankings.csv,2014,0.0038676632797493638,0.9961323367202506
1251,Show Dogs,39156854,17857020,21299834,2018_boxofficemojo_rankings.csv,2018,0.4560381689499366,0.5439618310500635
1252,Women Who Flirt,39156132,375495,38780637,2014_boxofficemojo_rankings.csv,2014,0.009589685722787941,0.990410314277212
1253,Believer,39047153,365639,38681514,2018_boxofficemojo_rankings.csv,2018,0.009364037372968011,0.990635962627032
1254,The Spy Gone North,38844509,500803,38343706,2018_boxofficemojo_rankings.csv,2018,0.012892504317663018,0.987107495682337
1255,Criminal,38803993,14708696,24095297,2015_boxofficemojo_rankings.csv,2015,0.3790510940459143,0.6209489059540857
1256,On the Basis of Sex,38673750,24622687,14051063,2018_boxofficemojo_rankings.csv,2018,0.6366769966708685,0.36332300332913153
1257,"Crouching Tiger, Hidden Dragon: Sword of Destiny",38659039,0,38659039,2016_boxofficemojo_rankings.csv,2016,0.0,1.0
1258,The Best of Me,38609668,26766213,11843455,2014_boxofficemojo_rankings.csv,2014,0.6932515710831805,0.30674842891681947
1259,Million Dollar Arm,38483455,36457627,2025828,2014_boxofficemojo_rankings.csv,2014,0.9473584687237672,0.05264153127623286
1260,Chernobyl Diaries,38390020,18119640,20270380,2012_boxofficemojo_rankings.csv,2012,0.4719882927906784,0.5280117072093216
1261,Boruto: Naruto The Movie,38362448,919651,37442797,2015_boxofficemojo_rankings.csv,2015,0.023972688082887723,0.9760273119171122
1262,The Lazarus Effect,38356892,25801570,12555322,2015_boxofficemojo_rankings.csv,2015,0.6726710287162996,0.3273289712837005
1263,Don't Be Afraid of the Dark,38269529,24046682,14222847,2011_boxofficemojo_rankings.csv,2011,0.6283506128335157,0.3716493871664843
1264,The Water Diviner,38176317,4196641,33979676,2014_boxofficemojo_rankings.csv,2014,0.10992786444014492,0.8900721355598551
1265,Jumping the Broom,38158601,37295394,863207,2011_boxofficemojo_rankings.csv,2011,0.9773784421499101,0.022621557850089943
1266,One for the Money,38080789,26414527,11666262,2011_boxofficemojo_rankings.csv,2011,0.6936444252770078,0.30635557472299224
1267,But Always,38039248,430760,37608488,2014_boxofficemojo_rankings.csv,2014,0.011324093473141214,0.9886759065268588
1268,Overcomer,38026103,34746945,3279158,2019_boxofficemojo_rankings.csv,2019,0.9137656046426845,0.08623439535731547
1269,The Eagle,37989684,19490041,18499643,2011_boxofficemojo_rankings.csv,2011,0.5130350913158425,0.48696490868415754
1270,For Colored Girls,37981984,37729698,252286,2010_boxofficemojo_rankings.csv,2010,0.9933577456090761,0.0066422543909238655
1271,Killing Them Softly,37930465,15026056,22904409,2012_boxofficemojo_rankings.csv,2012,0.39614742397700636,0.6038525760229937
1272,Hell or High Water,37879877,27007844,10872033,2016_boxofficemojo_rankings.csv,2016,0.7129865812394269,0.28701341876057307
1273,The Handmaiden,37692886,2006788,35686098,2016_boxofficemojo_rankings.csv,2016,0.05324049742436809,0.9467595025756319
1274,Pokémon the Movie: I Choose You!,37552144,2401722,35150422,2017_boxofficemojo_rankings.csv,2017,0.06395698738266449,0.9360430126173355
1275,A Walk in the Woods,37461274,29504281,7956993,2015_boxofficemojo_rankings.csv,2015,0.7875941699153104,0.21240583008468958
1276,Pain and Glory,37359689,4567338,32792351,2019_boxofficemojo_rankings.csv,2019,0.12225310547954508,0.877746894520455
1277,Snowden,37357216,21587519,15769697,2016_boxofficemojo_rankings.csv,2016,0.5778674460109662,0.4221325539890339
1278,Unhinged,37353385,19353385,18000000,2020_boxofficemojo_rankings.csv,2020,0.518115961913492,0.4818840380865081
1279,Home Again,37270721,27020284,10250437,2017_boxofficemojo_rankings.csv,2017,0.7249734718037786,0.27502652819622136
1280,"Like Father, Like Son",37170163,334616,36835547,2013_boxofficemojo_rankings.csv,2013,0.009002274216553745,0.9909977257834462
1281,Till The End Of The World,37013733,118660,36895073,2018_boxofficemojo_rankings.csv,2018,0.003205837141582018,0.9967941628584179
1282,Train to Busan Presents: Peninsula,36995513,1169697,35825816,2020_boxofficemojo_rankings.csv,2020,0.031617266666906334,0.9683827333330937
1283,2.0,36945969,4152000,32793969,2018_boxofficemojo_rankings.csv,2018,0.11238032490093845,0.8876196750990616
1284,Devil's Due,36921560,15821461,21100099,2014_boxofficemojo_rankings.csv,2014,0.42851550692874296,0.571484493071257
1285,Ex Machina,36869414,25442958,11426456,2015_boxofficemojo_rankings.csv,2015,0.6900830590906598,0.3099169409093402
1286,The Adventurers,36796816,216556,36580260,2017_boxofficemojo_rankings.csv,2017,0.0058851831093211975,0.9941148168906788
1287,Burnt,36606743,13651946,22954797,2015_boxofficemojo_rankings.csv,2015,0.3729352813496683,0.6270647186503318
1288,The Intruder,36599361,35419122,1180239,2019_boxofficemojo_rankings.csv,2019,0.9677524697767265,0.03224753022327357
1289,The Priests,36577134,185093,36392041,2015_boxofficemojo_rankings.csv,2015,0.005060347265042691,0.9949396527349573
1290,Furry Vengeance,36288132,17630465,18657667,2010_boxofficemojo_rankings.csv,2010,0.48584658477322556,0.5141534152267744
1291,A Most Wanted Man,36233517,17237855,18995662,2014_boxofficemojo_rankings.csv,2014,0.4757433566275115,0.5242566433724886
1292,A Very Harold & Kumar Christmas,36192775,35061031,1131744,2011_boxofficemojo_rankings.csv,2011,0.9687301125708101,0.031269887429189944
1293,Nothing to Lose,36075317,1016188,35059129,2018_boxofficemojo_rankings.csv,2018,0.028168512005036575,0.9718314879949634
1294,Kundo: Age of the Rampant,35941291,280958,35660333,2014_boxofficemojo_rankings.csv,2014,0.00781713711953196,0.9921828628804681
1295,Ra.One,35911689,2511689,33400000,2011_boxofficemojo_rankings.csv,2011,0.06994070927713815,0.9300592907228619
1296,You Will Meet a Tall Dark Stranger,35867322,3248246,32619076,2010_boxofficemojo_rankings.csv,2010,0.09056282484652743,0.9094371751534726
1297,Conquest 1453,35797045,35730,35761315,2012_boxofficemojo_rankings.csv,2012,0.0009981270800425008,0.9990018729199575
1298,Tad the Lost Explorer and the Secret of King Midas,35704046,5874,35698172,2017_boxofficemojo_rankings.csv,2017,0.00016451916962016014,0.9998354808303799
1299,Hostiles,35669017,29819114,5849903,2017_boxofficemojo_rankings.csv,2017,0.835994835517895,0.164005164482105
1300,Faster,35626958,23240020,12386938,2010_boxofficemojo_rankings.csv,2010,0.6523155864163311,0.34768441358366886
1301,Tyler Perry's Good Deeds,35579177,35025791,553386,2012_boxofficemojo_rankings.csv,2012,0.9844463518647438,0.015553648135256191
1302,Mia and the White Lion,35487190,399471,35087719,2018_boxofficemojo_rankings.csv,2018,0.011256766173934877,0.9887432338260651
1303,Arbitrage,35485056,7919574,27565482,2012_boxofficemojo_rankings.csv,2012,0.22318054112694652,0.7768194588730535
1304,Room,35401758,14677654,20724104,2015_boxofficemojo_rankings.csv,2015,0.4146024047732319,0.5853975952267682
1305,Namiya,35351623,70814,35280809,2017_boxofficemojo_rankings.csv,2017,0.0020031329254670996,0.997996867074533
1306,Eye in the Sky,35259653,18704595,16555058,2016_boxofficemojo_rankings.csv,2016,0.5304815393390286,0.46951846066097136
1307,Courageous,35185884,34522221,663663,2011_boxofficemojo_rankings.csv,2011,0.9811383735591239,0.01886162644087612
1308,The Girl in the Spider's Web,35164920,14841338,20323582,2018_boxofficemojo_rankings.csv,2018,0.42204953118050603,0.577950468819494
1309,My Week with Marilyn,35057696,14600347,20457349,2011_boxofficemojo_rankings.csv,2011,0.4164662446727817,0.5835337553272183
1310,When Marnie Was There,34949567,561085,34388482,2014_boxofficemojo_rankings.csv,2014,0.016054133088401354,0.9839458669115987
1311,The Sitter,34942188,30441326,4500862,2011_boxofficemojo_rankings.csv,2011,0.8711911801287315,0.12880881987126852
1312,The Hate U Give,34934009,29719483,5214526,2018_boxofficemojo_rankings.csv,2018,0.8507321046376326,0.14926789536236737
1313,Lost and Love,34930177,188817,34741360,2015_boxofficemojo_rankings.csv,2015,0.005405555202311171,0.9945944447976889
1314,Secret in Their Eyes,34854990,20180155,14674835,2015_boxofficemojo_rankings.csv,2015,0.578974631752871,0.42102536824712905
1315,Chimpanzee,34823764,28972764,5851000,2012_boxofficemojo_rankings.csv,2012,0.8319825507661952,0.16801744923380482
1316,Kidnap,34814102,30971040,3843062,2017_boxofficemojo_rankings.csv,2017,0.8896119164584513,0.11038808354154876
1317,Broken City,34737199,19701164,15036035,2013_boxofficemojo_rankings.csv,2013,0.5671488941868917,0.4328511058131083
1318,Endless Love,34718173,23438250,11279923,2014_boxofficemojo_rankings.csv,2014,0.6751003285800782,0.32489967141992177
1319,Jane Eyre,34710627,11242660,23467967,2011_boxofficemojo_rankings.csv,2011,0.3238967708650149,0.6761032291349851
1320,The Kids Are All Right,34705850,20811365,13894485,2010_boxofficemojo_rankings.csv,2010,0.5996500589958177,0.4003499410041823
1321,The Man Standing Next,34664900,113527,34551373,2020_boxofficemojo_rankings.csv,2020,0.003274984205925879,0.9967250157940741
1322,Alex Cross,34618867,25888412,8730455,2012_boxofficemojo_rankings.csv,2012,0.7478122262060165,0.2521877737939835
1323,Salmon Fishing in the Yemen,34564651,9047981,25516670,2012_boxofficemojo_rankings.csv,2012,0.2617697774526929,0.7382302225473071
1324,Haywire,34513760,18942396,15571364,2012_boxofficemojo_rankings.csv,2012,0.548836058430029,0.4511639415699709
1325,Steve Jobs,34441873,17766658,16675215,2015_boxofficemojo_rankings.csv,2015,0.515844710303647,0.484155289696353
1326,Victor Frankenstein,34227298,5775076,28452222,2015_boxofficemojo_rankings.csv,2015,0.16872719546836562,0.8312728045316343
1327,The House,34184504,25584504,8600000,2017_boxofficemojo_rankings.csv,2017,0.748424022767743,0.25157597723225705
1328,Cirque du Soleil: Worlds Away,34153101,12512862,21640239,2012_boxofficemojo_rankings.csv,2012,0.36637557450493297,0.633624425495067
1329,The Bad Guys: The Movie,34024386,166972,33857414,2019_boxofficemojo_rankings.csv,2019,0.004907421400638942,0.9950925785993611
1330,The Witness,33963557,418063,33545494,2015_boxofficemojo_rankings.csv,2015,0.012309164202088727,0.9876908357979113
1331,The Good Liar,33856058,17156058,16700000,2019_boxofficemojo_rankings.csv,2019,0.5067352495674482,0.49326475043255186
1332,The Art of Racing in the Rain,33766787,26395642,7371145,2019_boxofficemojo_rankings.csv,2019,0.7817042823766442,0.21829571762335576
1333,I Want to Eat Your Pancreas,33748006,277019,33470987,2017_boxofficemojo_rankings.csv,2017,0.008208455338072419,0.9917915446619275
1334,Nobody's Fool,33705333,31713110,1992223,2018_boxofficemojo_rankings.csv,2018,0.9408929441521909,0.05910705584780901
1335,The Skin I Live In,33678406,3185812,30492594,2011_boxofficemojo_rankings.csv,2011,0.09459509455405936,0.9054049054459407
1336,Bloodshot,33477953,12561824,20916129,2020_boxofficemojo_rankings.csv,2020,0.375226764910029,0.624773235089971
1337,2016: Obama's America,33449086,33449086,0,2012_boxofficemojo_rankings.csv,2012,1.0,0.0
1338,Get on Up,33448971,30703100,2745871,2014_boxofficemojo_rankings.csv,2014,0.9179086555457865,0.08209134445421355
1339,The Perks of Being a Wallflower,33384127,17742948,15641179,2012_boxofficemojo_rankings.csv,2012,0.5314785676438386,0.46852143235616134
1340,Perfect Strangers,33262366,1014507,32247859,2017_boxofficemojo_rankings.csv,2017,0.03050014541960124,0.9694998545803988
1341,Project Almanac,33213241,22348241,10865000,2015_boxofficemojo_rankings.csv,2015,0.6728714310054836,0.32712856899451637
1342,Bharat,33185983,2971549,30214434,2019_boxofficemojo_rankings.csv,2019,0.08954229259986062,0.9104577074001394
1343,Baaghi 2,33139063,1319579,31819484,2018_boxofficemojo_rankings.csv,2018,0.039819442088631175,0.9601805579113688
1344,Lockout,32948113,14326864,18621249,2012_boxofficemojo_rankings.csv,2012,0.43483109336185655,0.5651689066381435
1345,Inside Llewyn Davis,32935319,13235319,19700000,2013_boxofficemojo_rankings.csv,2013,0.40185792644060925,0.5981420735593908
1346,Sleepless,32917353,20783704,12133649,2017_boxofficemojo_rankings.csv,2017,0.6313905009312262,0.3686094990687738
1347,Brightburn,32893421,17300439,15592982,2019_boxofficemojo_rankings.csv,2019,0.5259543846169117,0.4740456153830883
1348,Katy Perry: Part of Me,32726956,25326071,7400885,2012_boxofficemojo_rankings.csv,2012,0.7738596586862524,0.2261403413137476
1349,Leap Year,32686500,25918920,6767580,2010_boxofficemojo_rankings.csv,2010,0.7929548896333348,0.20704511036666515
1350,Mud,32613173,21590086,11023087,2013_boxofficemojo_rankings.csv,2013,0.6620050738393348,0.3379949261606652
1351,The Hurricane Heist,32517248,6115825,26401423,2018_boxofficemojo_rankings.csv,2018,0.18807941557661953,0.8119205844233804
1352,UglyDolls,32450241,20150241,12300000,2019_boxofficemojo_rankings.csv,2019,0.6209581309426947,0.3790418690573053
1353,Movie 43,32438988,8840453,23598535,2012_boxofficemojo_rankings.csv,2012,0.2725255485775327,0.7274744514224674
1354,Stuber,32390945,22370452,10020493,2019_boxofficemojo_rankings.csv,2019,0.6906390659488323,0.3093609340511677
1355,Kevin Hart: Let Me Explain,32318051,32244051,74000,2013_boxofficemojo_rankings.csv,2013,0.997710257960791,0.002289742039208986
1356,Potiche,32309881,1618844,30691037,2010_boxofficemojo_rankings.csv,2010,0.050103681904616115,0.9498963180953839
1357,Seven Psychopaths,32226382,15024049,17202333,2012_boxofficemojo_rankings.csv,2012,0.4662034044032619,0.5337965955967381
1358,The Kid Who Would Be King,32140970,16790790,15350180,2019_boxofficemojo_rankings.csv,2019,0.5224108046521309,0.4775891953478691
1359,You Again,32054369,25702053,6352316,2010_boxofficemojo_rankings.csv,2010,0.8018268274131367,0.1981731725868633
1360,Dilwale,31994323,4871263,27123060,2015_boxofficemojo_rankings.csv,2015,0.15225397955756087,0.8477460204424391
1361,Suffragette,31972096,4702420,27269676,2015_boxofficemojo_rankings.csv,2015,0.1470788777814254,0.8529211222185746
1362,Bad Times at the El Royale,31882724,17839115,14043609,2018_boxofficemojo_rankings.csv,2018,0.5595229253309724,0.44047707466902764
1363,Self/less,31807156,12279691,19527465,2015_boxofficemojo_rankings.csv,2015,0.38606692783221486,0.6139330721677851
1364,Spring Breakers,31724284,14124284,17600000,2013_boxofficemojo_rankings.csv,2013,0.44521994570468476,0.5547800542953152
1365,Hunter Killer,31672678,15767460,15905218,2018_boxofficemojo_rankings.csv,2018,0.49782528651350544,0.5021747134864946
1366,New World,31670607,457806,31212801,2013_boxofficemojo_rankings.csv,2013,0.014455232891494628,0.9855447671085054
1367,Ae Dil Hai Mushkil,31668920,4264983,27403937,2016_boxofficemojo_rankings.csv,2016,0.1346740905594507,0.8653259094405493
1368,Anna,31626978,7743794,23883184,2019_boxofficemojo_rankings.csv,2019,0.2448477372703772,0.7551522627296228
1369,Super Troopers 2,31626386,30617396,1008990,2018_boxofficemojo_rankings.csv,2018,0.9680965760678442,0.03190342393215589
1370,Bodyguard,31516209,1834384,29681825,2011_boxofficemojo_rankings.csv,2011,0.058204462345074565,0.9417955376549254
1371,The Thing,31505287,16928670,14576617,2011_boxofficemojo_rankings.csv,2011,0.5373279094394537,0.46267209056054626
1372,I Don't Know How She Does It,31410151,9662284,21747867,2011_boxofficemojo_rankings.csv,2011,0.3076166045811114,0.6923833954188886
1373,What's in a Name?,31303580,8111,31295469,2012_boxofficemojo_rankings.csv,2012,0.00025910774422605975,0.9997408922557739
1374,Tazza: The Hidden Card,31278476,251555,31026921,2014_boxofficemojo_rankings.csv,2014,0.008042431479078457,0.9919575685209215
1375,Saving Mr. Wu,31222161,92696,31129465,2015_boxofficemojo_rankings.csv,2015,0.0029689168536412326,0.9970310831463588
1376,My Dear Liar,31177968,90545,31087423,2019_boxofficemojo_rankings.csv,2019,0.0029041340987969455,0.997095865901203
1377,Joyful Noise,31158113,30932113,226000,2012_boxofficemojo_rankings.csv,2012,0.9927466724316714,0.007253327568328673
1378,Premium Rush,31083599,20275446,10808153,2012_boxofficemojo_rankings.csv,2012,0.6522875938529512,0.3477124061470488
1379,The Wild Goose Lake,31042413,12573,31029840,2019_boxofficemojo_rankings.csv,2019,0.00040502650357754084,0.9995949734964225
1380,The Strangers: Prey at Night,31039126,24586708,6452418,2018_boxofficemojo_rankings.csv,2018,0.7921198554366512,0.20788014456334886
1381,This Is Not What I Expected,30996615,337670,30658945,2017_boxofficemojo_rankings.csv,2017,0.010893770174581966,0.9891062298254181
1382,Playing for Keeps,30962335,13103272,17859063,2012_boxofficemojo_rankings.csv,2012,0.42320038201253235,0.5767996179874677
1383,Billy Lynn's Long Halftime Walk,30930984,1738477,29192507,2016_boxofficemojo_rankings.csv,2016,0.05620503376161586,0.9437949662383841
1384,African Cats,30857747,15428747,15429000,2011_boxofficemojo_rankings.csv,2011,0.499995900543225,0.500004099456775
1385,Attack on Titan Part 1,30810658,449523,30361135,2015_boxofficemojo_rankings.csv,2015,0.014589853939503662,0.9854101460604964
1386,Winter's Tale,30800231,12600231,18200000,2014_boxofficemojo_rankings.csv,2014,0.40909534087585253,0.5909046591241475
1387,Norm of the North,30734502,17062499,13672003,2016_boxofficemojo_rankings.csv,2016,0.5551578157993254,0.44484218420067456
1388,Carnage,30722632,2547047,28175585,2011_boxofficemojo_rankings.csv,2011,0.08290458317503527,0.9170954168249648
1389,A Man Called Ove,30691696,3479315,27212381,2015_boxofficemojo_rankings.csv,2015,0.11336339966354417,0.8866366003364559
1390,A Wedding Invitation,30665036,14350,30650686,2013_boxofficemojo_rankings.csv,2013,0.0004679596658552757,0.9995320403341448
1391,When the Bough Breaks,30658387,29747603,910784,2016_boxofficemojo_rankings.csv,2016,0.9702925010373181,0.02970749896268189
1392,Wild Tales,30642704,3106530,27536174,2014_boxofficemojo_rankings.csv,2014,0.10137910805782675,0.8986208919421732
1393,A Dangerous Method,30519436,5704709,24814727,2011_boxofficemojo_rankings.csv,2011,0.18692052500577008,0.81307947499423
1394,What's Your Number?,30426096,14011084,16415012,2011_boxofficemojo_rankings.csv,2011,0.4604956219161341,0.5395043780838659
1395,Nocturnal Animals,30311857,10663357,19648500,2016_boxofficemojo_rankings.csv,2016,0.3517883117487655,0.6482116882512345
1396,Far from the Madding Crowd,30229977,12236500,17993477,2015_boxofficemojo_rankings.csv,2015,0.40478032781831097,0.595219672181689
1397,A Silent Voice: The Movie,30156463,310407,29846056,2016_boxofficemojo_rankings.csv,2016,0.010293216415996797,0.9897067835840032
1398,When the Game Stands Tall,30138754,30127963,10791,2014_boxofficemojo_rankings.csv,2014,0.9996419560012335,0.0003580439987665051
1399,The Rum Diary,30134958,13109815,17025143,2011_boxofficemojo_rankings.csv,2011,0.4350367768888213,0.5649632231111787
1400,Reset 2017 Re-release,29949252,108970,29840282,2017_boxofficemojo_rankings.csv,2017,0.0036384881999724067,0.9963615118000276
1401,Keeping Up with the Joneses,29918745,14904426,15014319,2016_boxofficemojo_rankings.csv,2016,0.4981634757741342,0.5018365242258658
1402,The Bye Bye Man,29874280,22395806,7478474,2017_boxofficemojo_rankings.csv,2017,0.7496684773658143,0.2503315226341857
1403,Draft Day,29824199,28842237,981962,2014_boxofficemojo_rankings.csv,2014,0.9670749916871195,0.03292500831288042
1404,The Disaster Artist,29820616,21120616,8700000,2017_boxofficemojo_rankings.csv,2017,0.7082555236283516,0.2917444763716484
1405,Like a Boss,29753143,22169514,7583629,2020_boxofficemojo_rankings.csv,2020,0.7451150286878936,0.2548849713121064
1406,The Swindlers,29721916,241916,29480000,2017_boxofficemojo_rankings.csv,2017,0.008139313764294335,0.9918606862357057
1407,The Raven,29699345,16008272,13691073,2012_boxofficemojo_rankings.csv,2012,0.5390109445174632,0.4609890554825367
1408,Masterminds,29674699,17368022,12306677,2016_boxofficemojo_rankings.csv,2016,0.5852804774868988,0.4147195225131011
1409,Amour,29652180,6739492,22912688,2012_boxofficemojo_rankings.csv,2012,0.22728487416439533,0.7727151258356046
1410,Politics,29459596,1514558,27945038,2010_boxofficemojo_rankings.csv,2010,0.051411363550267285,0.9485886364497327
1411,The Losers,29397654,23591432,5806222,2010_boxofficemojo_rankings.csv,2010,0.8024936955853689,0.19750630441463118
1412,Mr. Holmes,29355203,17737646,11617557,2015_boxofficemojo_rankings.csv,2015,0.6042419805443008,0.3957580194556992
1413,Rowdy Rathore,29342463,777373,28565090,2012_boxofficemojo_rankings.csv,2012,0.02649310659435781,0.9735068934056422
1414,Sword Art Online The Movie: Ordinal Scale,29322339,1522976,27799363,2017_boxofficemojo_rankings.csv,2017,0.05193910349375607,0.9480608965062439
1415,Free Solo,29318861,17541090,11777771,2018_boxofficemojo_rankings.csv,2018,0.5982868843370143,0.4017131156629857
1416,Big Eyes,29253166,14482031,14771135,2014_boxofficemojo_rankings.csv,2014,0.495058586137309,0.504941413862691
1417,My Hero Academia: Heroes Rising,29187012,13304000,15883012,2019_boxofficemojo_rankings.csv,2019,0.4558191842316713,0.5441808157683288
1418,Special ID,29139936,12666,29127270,2013_boxofficemojo_rankings.csv,2013,0.0004346612154535961,0.9995653387845465
1419,Sacrifice,29093560,29792,29063768,2010_boxofficemojo_rankings.csv,2010,0.0010240066873906115,0.9989759933126093
1420,Pad Man,29045020,1670192,27374828,2018_boxofficemojo_rankings.csv,2018,0.057503558269197265,0.9424964417308027
1421,M.S. Dhoni: The Untold Story,28903047,1801550,27101497,2016_boxofficemojo_rankings.csv,2016,0.06233079854867897,0.937669201451321
1422,Speak Bachchan,28775262,1216258,27559004,2012_boxofficemojo_rankings.csv,2012,0.04226748656536993,0.9577325134346301
1423,Twins 2,28733523,1431255,27302268,2017_boxofficemojo_rankings.csv,2017,0.04981133013170713,0.9501886698682929
1424,The Suspect,28674130,218693,28455437,2013_boxofficemojo_rankings.csv,2013,0.007626839942484741,0.9923731600575153
1425,The Fortress,28645448,252895,28392553,2017_boxofficemojo_rankings.csv,2017,0.008828453302598025,0.9911715466974019
1426,Love & Mercy,28641776,12551031,16090745,2015_boxofficemojo_rankings.csv,2015,0.43820714888629814,0.5617928511137019
1427,I Give It a Year,28328531,34657,28293874,2013_boxofficemojo_rankings.csv,2013,0.0012233955936507969,0.9987766044063492
1428,The Master,28258060,16377274,11880786,2012_boxofficemojo_rankings.csv,2012,0.5795611588339752,0.42043884116602487
1429,Fan,28240000,2300000,25940000,2016_boxofficemojo_rankings.csv,2016,0.08144475920679886,0.9185552407932012
1430,Gully Boy,28141995,5566534,22575461,2019_boxofficemojo_rankings.csv,2019,0.19780168392468267,0.8021983160753173
1431,Your Highness,28013733,21596445,6417288,2011_boxofficemojo_rankings.csv,2011,0.7709234967007075,0.22907650329929252
1432,Mandela: Long Walk to Freedom,27985788,8323085,19662703,2013_boxofficemojo_rankings.csv,2013,0.29740398948208996,0.70259601051791
1433,The Brothers Grimsby,27979040,6874837,21104203,2016_boxofficemojo_rankings.csv,2016,0.24571382720779555,0.7542861727922044
1434,The 33,27972023,12227722,15744301,2015_boxofficemojo_rankings.csv,2015,0.4371411392018375,0.5628588607981625
1435,The Divine Move,27926871,136707,27790164,2014_boxofficemojo_rankings.csv,2014,0.004895177837860891,0.9951048221621391
1436,Greenland,27900000,0,27900000,2020_boxofficemojo_rankings.csv,2020,0.0,1.0
1437,Monster Family,27890108,127259,27762849,2017_boxofficemojo_rankings.csv,2017,0.004562872255639885,0.9954371277443601
1438,The Beguiled,27869129,10709995,17159134,2017_boxofficemojo_rankings.csv,2017,0.3842960072415611,0.6157039927584389
1439,Dark Skies,27858103,17418667,10439436,2013_boxofficemojo_rankings.csv,2013,0.6252639312877837,0.3747360687122163
1440,Default,27694043,203775,27490268,2018_boxofficemojo_rankings.csv,2018,0.007358080580722721,0.9926419194192773
1441,Nebraska,27682872,17654912,10027960,2013_boxofficemojo_rankings.csv,2013,0.6377557935462765,0.36224420645372346
1442,One Cut of the Dead,27590180,52406,27537774,2018_boxofficemojo_rankings.csv,2018,0.0018994439325876091,0.9981005560674124
1443,The Women on the 6th Floor,27533970,719823,26814147,2011_boxofficemojo_rankings.csv,2011,0.026143087974600104,0.9738569120253999
1444,Mirai,27526961,812794,26714167,2018_boxofficemojo_rankings.csv,2018,0.029527196990615855,0.9704728030093841
1445,The Happytime Murders,27506452,20706452,6800000,2018_boxofficemojo_rankings.csv,2018,0.7527852737968532,0.2472147262031468
1446,The Incredible Burt Wonderstone,27437881,22537881,4900000,2013_boxofficemojo_rankings.csv,2013,0.8214147805364416,0.17858521946355843
1447,Left Behind,27405896,14019924,13385972,2014_boxofficemojo_rankings.csv,2014,0.5115659783573578,0.48843402164264216
1448,Irrational Man,27391084,4030360,23360724,2015_boxofficemojo_rankings.csv,2015,0.14714131065422603,0.852858689345774
1449,Jing wu feng yun: Chen Zhen,27390678,50433,27340245,2010_boxofficemojo_rankings.csv,2010,0.0018412468650830767,0.998158753134917
1450,Detective K: Secret of the Lost Island,27387870,185367,27202503,2015_boxofficemojo_rankings.csv,2015,0.006768215271943382,0.9932317847280566
1451,Midnight Sun,27365467,9561064,17804403,2018_boxofficemojo_rankings.csv,2018,0.34938428056060583,0.6506157194393942
1452,Ramona and Beezus,27293743,26167002,1126741,2010_boxofficemojo_rankings.csv,2010,0.9587179742990912,0.04128202570090881
1453,American Ultra,27262374,14440985,12821389,2015_boxofficemojo_rankings.csv,2015,0.5297038695162791,0.4702961304837209
1454,Khumba,27187375,1029,27186346,2013_boxofficemojo_rankings.csv,2013,3.7848449877930475e-05,0.999962151550122
1455,Splice 2010 Re-release,27127620,17010170,10117450,2010_boxofficemojo_rankings.csv,2010,0.627042475528631,0.37295752447136904
1456,Let Me In,27093592,12134935,14958657,2010_boxofficemojo_rankings.csv,2010,0.4478894861928976,0.5521105138071024
1457,My Neighbor Totoro 2018 Re-release,27083857,1144649,25939208,2018_boxofficemojo_rankings.csv,2018,0.042263145902741994,0.9577368540972581
1458,Hitchcock,27039669,6008677,21030992,2012_boxofficemojo_rankings.csv,2012,0.22221710628188532,0.7777828937181147
1459,Total Dhamaal,26911995,2167632,24744363,2019_boxofficemojo_rankings.csv,2019,0.08054519926895051,0.9194548007310495
1460,You're Next,26895481,18494006,8401475,2013_boxofficemojo_rankings.csv,2013,0.6876250326216512,0.3123749673783488
1461,Chips,26800152,18600152,8200000,2017_boxofficemojo_rankings.csv,2017,0.6940315860895118,0.3059684139104883
1462,A Cure for Wellness,26620002,8106986,18513016,2017_boxofficemojo_rankings.csv,2017,0.3045449057441844,0.6954550942558156
1463,Missing Link,26527094,16649539,9877555,2019_boxofficemojo_rankings.csv,2019,0.6276427791148175,0.3723572208851825
1464,No Manches Frida 2,26493648,9270920,17222728,2019_boxofficemojo_rankings.csv,2019,0.3499299152762957,0.6500700847237043
1465,A Hard Day,26488847,19004,26469843,2014_boxofficemojo_rankings.csv,2014,0.0007174340204388662,0.9992825659795611
1466,"The Way, Way Back",26474920,21506546,4968374,2013_boxofficemojo_rankings.csv,2013,0.8123365811870253,0.18766341881297469
1467,Only the Brave,26351322,18343983,8007339,2017_boxofficemojo_rankings.csv,2017,0.6961314123063731,0.3038685876936269
1468,Aloha,26250020,21067116,5182904,2015_boxofficemojo_rankings.csv,2015,0.8025561885286182,0.19744381147138174
1469,Apollo 18,26236153,17687709,8548444,2011_boxofficemojo_rankings.csv,2011,0.6741731152429246,0.3258268847570755
1470,The Zookeeper's Wife,26152835,17571660,8581175,2017_boxofficemojo_rankings.csv,2017,0.6718835644395722,0.32811643556042774
1471,Badrinath Ki Dulhania,26134309,1993259,24141050,2017_boxofficemojo_rankings.csv,2017,0.0762698183449197,0.9237301816550803
1472,Top Five,26117471,25317471,800000,2014_boxofficemojo_rankings.csv,2014,0.9693691628871723,0.030630837112827655
1473,Hichki,26055222,330279,25724943,2018_boxofficemojo_rankings.csv,2018,0.012676115367583512,0.9873238846324165
1474,Iceman,26033917,7679,26026238,2014_boxofficemojo_rankings.csv,2014,0.0002949613767302093,0.9997050386232698
1475,Agneepath,26001696,1986748,24014948,2012_boxofficemojo_rankings.csv,2012,0.07640840043664844,0.9235915995633516
1476,The Light Between Oceans,25975621,12545979,13429642,2016_boxofficemojo_rankings.csv,2016,0.48299053177592943,0.5170094682240706
1477,White Boy Rick,25957482,24011188,1946294,2018_boxofficemojo_rankings.csv,2018,0.925019922964793,0.07498007703520704
1478,"Paul, Apostle of Christ",25915966,17560475,8355491,2018_boxofficemojo_rankings.csv,2018,0.6775929170458087,0.32240708295419124
1479,Huevos: Little Rooster's Egg-cellent Adventure,25892561,9080818,16811743,2015_boxofficemojo_rankings.csv,2015,0.3507114649647827,0.6492885350352172
1480,Rust and Bone,25807712,2062027,23745685,2012_boxofficemojo_rankings.csv,2012,0.07989964395138942,0.9201003560486106
1481,Our Idiot Brother,25804448,24816118,988330,2011_boxofficemojo_rankings.csv,2011,0.9616992388289026,0.038300761171097326
1482,Fair Game,25798915,9540691,16258224,2010_boxofficemojo_rankings.csv,2010,0.3698097768840279,0.6301902231159722
1483,"The Gangster, the Cop, the Devil",25775371,216494,25558877,2019_boxofficemojo_rankings.csv,2019,0.008399258346271718,0.9916007416537282
1484,A Beautiful Planet,25730120,15650615,10079505,2016_boxofficemojo_rankings.csv,2016,0.6082604744944835,0.3917395255055165
1485,Fireworks,25672406,525280,25147126,2017_boxofficemojo_rankings.csv,2017,0.020460879280266915,0.979539120719733
1486,Emma.,25643186,10055355,15587831,2020_boxofficemojo_rankings.csv,2020,0.39212580683227116,0.6078741931677288
1487,Father Figures,25601244,17501244,8100000,2017_boxofficemojo_rankings.csv,2017,0.6836091246191005,0.31639087538089944
1488,"Love, Rosie",25574387,20431,25553956,2014_boxofficemojo_rankings.csv,2014,0.0007988852284123173,0.9992011147715877
1489,Mr. Donkey,25537759,356255,25181504,2016_boxofficemojo_rankings.csv,2016,0.013950127730471574,0.9860498722695284
1490,Keys To The Heart,25375866,75134,25300732,2018_boxofficemojo_rankings.csv,2018,0.0029608447648643795,0.9970391552351356
1491,A Haunted House 2,25358716,17329486,8029230,2014_boxofficemojo_rankings.csv,2014,0.6833739531607199,0.31662604683928003
1492,And So It Goes,25312387,15160801,10151586,2014_boxofficemojo_rankings.csv,2014,0.5989478985130877,0.40105210148691234
1493,Enough Said,25288872,17550872,7738000,2013_boxofficemojo_rankings.csv,2013,0.6940156128751017,0.3059843871248983
1494,Biutiful,25147786,5101237,20046549,2010_boxofficemojo_rankings.csv,2010,0.20285034237208793,0.797149657627912
1495,On the Other Side of the Tracks,25109572,9572,25100000,2012_boxofficemojo_rankings.csv,2012,0.0003812092057961004,0.9996187907942039
1496,Born in China,25081168,13873211,11207957,2016_boxofficemojo_rankings.csv,2016,0.5531325734112542,0.4468674265887458
1497,Race,25070261,19206207,5864054,2016_boxofficemojo_rankings.csv,2016,0.7660952153629353,0.2339047846370646
1498,The Last Exorcism 2,25051865,15179302,9872563,2013_boxofficemojo_rankings.csv,2013,0.6059150486400913,0.39408495135990873
1499,Free State of Jones,25035950,20810036,4225914,2016_boxofficemojo_rankings.csv,2016,0.8312061655339622,0.16879383446603785
1500,Whiskey Tango Foxtrot,24972139,23083334,1888805,2016_boxofficemojo_rankings.csv,2016,0.924363507667485,0.07563649233251504
1501,Housefull 2,24922847,1791780,23131067,2012_boxofficemojo_rankings.csv,2012,0.07189307064317331,0.9281069293568267
1502,Booksmart,24863452,22680962,2182490,2019_boxofficemojo_rankings.csv,2019,0.9122209578943423,0.08777904210565773
1503,Wild City,24817852,34866,24782986,2015_boxofficemojo_rankings.csv,2015,0.0014048758127818636,0.9985951241872182
1504,Elle s'appelait Sarah,24792815,7693187,17099628,2010_boxofficemojo_rankings.csv,2010,0.31029905236658284,0.6897009476334172
1505,Lottery Ticket,24719879,24719879,0,2010_boxofficemojo_rankings.csv,2010,1.0,0.0
1506,Big Miracle,24719215,20157300,4561915,2012_boxofficemojo_rankings.csv,2012,0.815450652458017,0.18454934754198302
1507,Super 30,24701637,2269878,22431759,2019_boxofficemojo_rankings.csv,2019,0.09189180457959123,0.9081081954204088
1508,Drug War,24676341,128195,24548146,2013_boxofficemojo_rankings.csv,2013,0.005195057079167451,0.9948049429208325
1509,Ready,24663361,955148,23708213,2011_boxofficemojo_rankings.csv,2011,0.03872740621199195,0.961272593788008
1510,The Death of Stalin,24646055,8047856,16598199,2017_boxofficemojo_rankings.csv,2017,0.32653728963925466,0.6734627103607453
1511,The Snow Queen 3: Fire and Ice,24644317,0,24644317,2016_boxofficemojo_rankings.csv,2016,0.0,1.0
1512,Sparkle,24637800,24397469,240331,2012_boxofficemojo_rankings.csv,2012,0.9902454358749564,0.009754564125043632
1513,The Players,24629152,10854,24618298,2012_boxofficemojo_rankings.csv,2012,0.00044069726801799754,0.999559302731982
1514,Capture the Flag,24604331,6690,24597641,2015_boxofficemojo_rankings.csv,2015,0.00027190334904858825,0.9997280966509514
1515,God's Not Dead 2,24487848,20774575,3713273,2016_boxofficemojo_rankings.csv,2016,0.8483626245964937,0.15163737540350627
1516,Stan & Ollie,24420923,5470235,18950688,2018_boxofficemojo_rankings.csv,2018,0.22399788083357866,0.7760021191664214
1517,The Tale of The Princess Kaguya,24366656,703232,23663424,2013_boxofficemojo_rankings.csv,2013,0.02886042303055454,0.9711395769694454
1518,The Great Beauty,24271739,2852400,21419339,2013_boxofficemojo_rankings.csv,2013,0.11751939158541545,0.8824806084145845
1519,Jackie,24270399,13960394,10310005,2016_boxofficemojo_rankings.csv,2016,0.5752024925506993,0.42479750744930067
1520,Trance,24261569,2328743,21932826,2013_boxofficemojo_rankings.csv,2013,0.09598484747626998,0.90401515252373
1521,The Accidental Detective 2: In Action,24243825,179045,24064780,2018_boxofficemojo_rankings.csv,2018,0.0073851795250955655,0.9926148204749045
1522,Jolly LLB 2,24214186,1654254,22559932,2017_boxofficemojo_rankings.csv,2017,0.06831755566757437,0.9316824443324256
1523,The Gunman,24177137,10664749,13512388,2015_boxofficemojo_rankings.csv,2015,0.44110884593159233,0.5588911540684077
1524,The Railway Man,24174885,4438438,19736447,2013_boxofficemojo_rankings.csv,2013,0.18359706778336277,0.8164029322166372
1525,The Way Back,24172201,2701859,21470342,2010_boxofficemojo_rankings.csv,2010,0.11177546471668012,0.8882245352833199
1526,The Founder,24121245,12786053,11335192,2016_boxofficemojo_rankings.csv,2016,0.5300743390318369,0.46992566096816313
1527,Bad Santa 2,24079268,17782178,6297090,2016_boxofficemojo_rankings.csv,2016,0.7384849904905747,0.2615150095094253
1528,Kung Fu Jungle,24070765,129784,23940981,2014_boxofficemojo_rankings.csv,2014,0.0053917688116684286,0.9946082311883315
1529,I Can Speak,24024444,63239,23961205,2017_boxofficemojo_rankings.csv,2017,0.0026322773588433514,0.9973677226411567
1530,Spirits' Homecoming,23857217,125616,23731601,2016_boxofficemojo_rankings.csv,2016,0.0052653249538703525,0.9947346750461297
1531,Silence,23834809,7100177,16734632,2016_boxofficemojo_rankings.csv,2016,0.2978910802264033,0.7021089197735967
1532,Wanderlust,23812816,17450535,6362281,2012_boxofficemojo_rankings.csv,2012,0.7328211413551425,0.26717885864485746
1533,The Dressmaker,23762417,2022115,21740302,2015_boxofficemojo_rankings.csv,2015,0.08509719360618913,0.9149028063938108
1534,Pokémon the Movie: The Power of Us,23740788,789170,22951618,2018_boxofficemojo_rankings.csv,2018,0.0332411038757433,0.9667588961242567
1535,The Peanut Butter Falcon,23728475,20457151,3271324,2019_boxofficemojo_rankings.csv,2019,0.8621350929632013,0.1378649070367986
1536,Amy,23706049,8413144,15292905,2015_boxofficemojo_rankings.csv,2015,0.3548943984718837,0.6451056015281164
1537,Trolls World Tour,23705759,0,23705759,2020_boxofficemojo_rankings.csv,2020,0.0,1.0
1538,To the Arctic 3D,23695388,14560838,9134550,2012_boxofficemojo_rankings.csv,2012,0.6145009315736886,0.3854990684263115
1539,What Now?,23591043,23591043,0,2016_boxofficemojo_rankings.csv,2016,1.0,0.0
1540,No manches Frida,23540937,11528613,12012324,2016_boxofficemojo_rankings.csv,2016,0.48972617360133114,0.5102738263986688
1541,Youth,23469540,2703296,20766244,2015_boxofficemojo_rankings.csv,2015,0.11518316933352762,0.8848168306664723
1542,Wish Upon,23468586,14301505,9167081,2017_boxofficemojo_rankings.csv,2017,0.6093892917110558,0.39061070828894423
1543,Only Cloud Knows,23410836,0,23410836,2019_boxofficemojo_rankings.csv,2019,0.0,1.0
1544,Detroit,23355100,16790139,6564961,2017_boxofficemojo_rankings.csv,2017,0.7189067484189748,0.2810932515810251
1545,Middle School: The Worst Years of My Life,23316139,20007149,3308990,2016_boxofficemojo_rankings.csv,2016,0.8580815631610362,0.14191843683896377
1546,Warrior,23308615,13657115,9651500,2011_boxofficemojo_rankings.csv,2011,0.5859256330760108,0.41407436692398925
1547,Triple 9,23177948,12639297,10538651,2016_boxofficemojo_rankings.csv,2016,0.5453156163781194,0.4546843836218806
1548,Hoodwinked Too! Hood vs. Evil,23167844,10143779,13024065,2011_boxofficemojo_rankings.csv,2011,0.4378387130023838,0.5621612869976161
1549,Rock Dog,23157646,9420546,13737100,2016_boxofficemojo_rankings.csv,2016,0.40680067395451164,0.5931993260454884
1550,The Choice,23064015,18730891,4333124,2016_boxofficemojo_rankings.csv,2016,0.8121262061267304,0.1878737938732697
1551,Padmaavat,22991060,11846060,11145000,2018_boxofficemojo_rankings.csv,2018,0.5152463609768319,0.48475363902316815
1552,Young Adult,22939027,16311571,6627456,2011_boxofficemojo_rankings.csv,2011,0.7110838223434673,0.28891617765653266
1553,A Separation,22926076,7099055,15827021,2011_boxofficemojo_rankings.csv,2011,0.30964980662194436,0.6903501933780556
1554,Baggage Claim,22871096,21569509,1301587,2013_boxofficemojo_rankings.csv,2013,0.9430903092707057,0.056909690729294304
1555,Won't You Be My Neighbor?,22844741,22835787,8954,2018_boxofficemojo_rankings.csv,2018,0.9996080498351897,0.0003919501648103605
1556,Kon-Tiki,22842887,1517410,21325477,2012_boxofficemojo_rankings.csv,2012,0.06642811830220935,0.9335718816977907
1557,Hunt for the Wilderpeople,22835917,5205468,17630449,2016_boxofficemojo_rankings.csv,2016,0.22795090733601808,0.7720490926639819
1558,Sweet Sixteen,22819702,34327,22785375,2016_boxofficemojo_rankings.csv,2016,0.001504270301163442,0.9984957296988366
1559,Scoob!,22800000,0,22800000,2020_boxofficemojo_rankings.csv,2020,0.0,1.0
1560,Captain Fantastic,22787526,5879835,16907691,2016_boxofficemojo_rankings.csv,2016,0.2580286688427695,0.7419713311572305
1561,Extraordinary Mission,22757764,54174,22703590,2017_boxofficemojo_rankings.csv,2017,0.0023804623336457836,0.9976195376663543
1562,Black and Blue,22741061,22055313,685748,2019_boxofficemojo_rankings.csv,2019,0.9698453823240701,0.030154617675929897
1563,Fading Gigolo,22706304,3769873,18936431,2014_boxofficemojo_rankings.csv,2014,0.1660275930420028,0.8339724069579972
1564,Live by Night,22678555,10378555,12300000,2016_boxofficemojo_rankings.csv,2016,0.45763740238300016,0.5423625976169999
1565,The Farewell,22671661,17695781,4975880,2019_boxofficemojo_rankings.csv,2019,0.7805242412543131,0.21947575874568695
1566,Julieta,22468044,1490948,20977096,2016_boxofficemojo_rankings.csv,2016,0.06635860246668557,0.9336413975333144
1567,Late Night,22386555,15499454,6887101,2019_boxofficemojo_rankings.csv,2019,0.6923554785450463,0.30764452145495363
1568,2 States,22386518,2238174,20148344,2014_boxofficemojo_rankings.csv,2014,0.09997865679691678,0.9000213432030832
1569,Mojin: The Worm Valley,22381583,101516,22280067,2018_boxofficemojo_rankings.csv,2018,0.004535693476194244,0.9954643065238058
1570,Solace,22354572,0,22354572,2015_boxofficemojo_rankings.csv,2015,0.0,1.0
1571,Twenty,22271862,136125,22135737,2015_boxofficemojo_rankings.csv,2015,0.006111972137758397,0.9938880278622416
1572,Dark Waters,22270399,11136084,11134315,2019_boxofficemojo_rankings.csv,2019,0.5000397163966394,0.4999602836033607
1573,Fei chang xing yun,22259179,64432,22194747,2013_boxofficemojo_rankings.csv,2013,0.0028946260776284696,0.9971053739223715
1574,Fifty Shades of Black,22227514,11686940,10540574,2015_boxofficemojo_rankings.csv,2015,0.5257870943192298,0.47421290568077024
1575,Upside Down,22187813,105095,22082718,2012_boxofficemojo_rankings.csv,2012,0.004736609236791386,0.9952633907632086
1576,Mr. Turner,22179785,3958500,18221285,2014_boxofficemojo_rankings.csv,2014,0.17847332604892246,0.8215266739510775
1577,Sabotage,22126842,10508518,11618324,2014_boxofficemojo_rankings.csv,2014,0.4749217262906293,0.5250782737093708
1578,The Glass Castle,22088533,17273059,4815474,2017_boxofficemojo_rankings.csv,2017,0.7819921313923383,0.21800786860766172
1579,Gretel & Hansel,22051055,15347654,6703401,2020_boxofficemojo_rankings.csv,2020,0.6960054292186927,0.3039945707813073
1580,A Thousand Words,22044277,18450127,3594150,2010_boxofficemojo_rankings.csv,2010,0.8369576829396582,0.16304231706034178
1581,Big Brother,22029250,85624,21943626,2018_boxofficemojo_rankings.csv,2018,0.0038868322798097984,0.9961131677201902
1582,Bullet to the Head,21947209,9489829,12457380,2013_boxofficemojo_rankings.csv,2013,0.4323934309824999,0.5676065690175002
1583,Leap! 2017 Re-release,21929861,21858070,71791,2017_boxofficemojo_rankings.csv,2017,0.9967263358395204,0.003273664160479631
1584,Black or White,21833967,21571189,262778,2015_boxofficemojo_rankings.csv,2015,0.9879647157110754,0.012035284288924683
1585,Master Z: The Ip Man Legacy,21832649,209454,21623195,2018_boxofficemojo_rankings.csv,2018,0.009593613674639298,0.9904063863253607
1586,Welcome Back,21775694,1388365,20387329,2015_boxofficemojo_rankings.csv,2015,0.0637575546386719,0.9362424453613281
1587,Diana,21766271,335359,21430912,2013_boxofficemojo_rankings.csv,2013,0.015407278536594533,0.9845927214634055
1588,Legends of Oz: Dorothy's Return,21755418,8462347,13293071,2014_boxofficemojo_rankings.csv,2014,0.38897652989246173,0.6110234701075383
1589,Proud Mary,21753365,20877013,876352,2018_boxofficemojo_rankings.csv,2018,0.9597141867476595,0.0402858132523405
1590,22 Bullets,21695883,0,21695883,2010_boxofficemojo_rankings.csv,2010,0.0,1.0
1591,Just Wright,21584424,21540363,44061,2010_boxofficemojo_rankings.csv,2010,0.9979586668608807,0.0020413331391192094
1592,It Follows,21528593,14674076,6854517,2015_boxofficemojo_rankings.csv,2015,0.6816086866429218,0.3183913133570782
1593,The Star 2019 Re-release,21502695,43510,21459185,2019_boxofficemojo_rankings.csv,2019,0.002023467290960505,0.9979765327090395
1594,My Soul to Take,21500813,14744435,6756378,2010_boxofficemojo_rankings.csv,2010,0.6857617430559486,0.3142382569440514
1595,Our Family Wedding,21409028,20255281,1153747,2010_boxofficemojo_rankings.csv,2010,0.9461093235993713,0.053890676400628744
1596,Love & Friendship,21401949,14016568,7385381,2016_boxofficemojo_rankings.csv,2016,0.6549201663829776,0.34507983361702244
1597,Shaft,21360215,21360215,0,2019_boxofficemojo_rankings.csv,2019,1.0,0.0
1598,Bears,21316745,17780194,3536551,2014_boxofficemojo_rankings.csv,2014,0.8340951679067324,0.16590483209326753
1599,Hotel Mumbai,21314816,9651611,11663205,2019_boxofficemojo_rankings.csv,2019,0.4528123067072219,0.5471876932927782
1600,Love Live! The School Idol Movie,21292009,115840,21176169,2015_boxofficemojo_rankings.csv,2015,0.005440538748598124,0.9945594612514018
1601,I'm So Excited!,21245677,1368119,19877558,2013_boxofficemojo_rankings.csv,2013,0.06439517083875464,0.9356048291612453
1602,The Prison,21205329,207481,20997848,2017_boxofficemojo_rankings.csv,2017,0.009784380143312088,0.9902156198566879
1603,Unplanned,21171090,19005109,2165981,2019_boxofficemojo_rankings.csv,2019,0.8976915690217179,0.10230843097828218
1604,The Prodigy,21150265,14856291,6293974,2018_boxofficemojo_rankings.csv,2018,0.7024163054221779,0.2975836945778221
1605,Beasts of the Southern Wild,21107746,12795746,8312000,2012_boxofficemojo_rankings.csv,2012,0.6062109142302546,0.39378908576974536
1606,Gonjiam: Haunted Asylum,21041950,115252,20926698,2018_boxofficemojo_rankings.csv,2018,0.005477249019221127,0.9945227509807789
1607,Yves Saint Laurent,21026290,723593,20302697,2014_boxofficemojo_rankings.csv,2014,0.034413726815334514,0.9655862731846655
1608,My Hero Academia: Two Heroes,21022724,5754556,15268168,2018_boxofficemojo_rankings.csv,2018,0.27373027396449673,0.7262697260355033
1609,The Infiltrator,21011110,15436808,5574302,2016_boxofficemojo_rankings.csv,2016,0.7346974053250875,0.26530259467491246
1610,Before Midnight,20994648,8114627,12880021,2013_boxofficemojo_rankings.csv,2013,0.38650931418330997,0.6134906858166901
1611,71: Into the Fire,20967660,176638,20791022,2010_boxofficemojo_rankings.csv,2010,0.008424306765752593,0.9915756932342474
1612,El nino,20918976,1237,20917739,2014_boxofficemojo_rankings.csv,2014,5.9132913580473535e-05,0.9999408670864195
1613,SuperFly,20780685,20545116,235569,2018_boxofficemojo_rankings.csv,2018,0.9886640406704591,0.01133595932954087
1614,The Photograph,20690779,20578185,112594,2020_boxofficemojo_rankings.csv,2020,0.9945582522533347,0.005441747746665314
1615,Keanu,20651333,20591853,59480,2016_boxofficemojo_rankings.csv,2016,0.9971197985137328,0.0028802014862672545
1616,The Front Line,20629645,11018,20618627,2011_boxofficemojo_rankings.csv,2011,0.0005340857780150847,0.9994659142219849
1617,If Beale Street Could Talk,20596567,14915773,5680794,2018_boxofficemojo_rankings.csv,2018,0.7241873366566379,0.275812663343362
1618,The Best Offer,20596350,100035,20496315,2013_boxofficemojo_rankings.csv,2013,0.004856928533453743,0.9951430714665462
1619,Polisse,20590872,211440,20379432,2011_boxofficemojo_rankings.csv,2011,0.010268627768653994,0.989731372231346
1620,The Man with the Iron Fists,20546518,15634090,4912428,2012_boxofficemojo_rankings.csv,2012,0.7609118975779741,0.23908810242202597
1621,Race 2,20531909,1579940,18951969,2013_boxofficemojo_rankings.csv,2013,0.07695046768422752,0.9230495323157725
1622,Country Strong,20529194,20218921,310273,2010_boxofficemojo_rankings.csv,2010,0.9848862551544888,0.015113744845511227
1623,Cock and Bull,20490872,82778,20408094,2016_boxofficemojo_rankings.csv,2016,0.004039749992094041,0.995960250007906
1624,The Sapphires,20423628,2450867,17972761,2012_boxofficemojo_rankings.csv,2012,0.12000154918607017,0.8799984508139298
1625,That Demon Within,20415934,172343,20243591,2014_boxofficemojo_rankings.csv,2014,0.00844159272850314,0.9915584072714969
1626,The Clan,20381995,201227,20180768,2015_boxofficemojo_rankings.csv,2015,0.009872782325773311,0.9901272176742267
1627,Burn the Stage: The Movie,20347513,4201819,16145694,2018_boxofficemojo_rankings.csv,2018,0.20650282911724888,0.7934971708827512
1628,Brahms: The Boy II,20311536,12611536,7700000,2020_boxofficemojo_rankings.csv,2020,0.6209050856616654,0.37909491433833464
1629,Cold War 2018 Re-release,20296042,4580048,15715994,2018_boxofficemojo_rankings.csv,2018,0.22566212663533117,0.7743378733646689
1630,Labor Day,20275812,13371528,6904284,2014_boxofficemojo_rankings.csv,2014,0.6594817509651402,0.3405182490348599
1631,Singh Is Bliing,20224851,919095,19305756,2015_boxofficemojo_rankings.csv,2015,0.045443845297055585,0.9545561547029444
1632,The Bling Ring,20045576,5845732,14199844,2013_boxofficemojo_rankings.csv,2013,0.29162205166865746,0.7083779483313425
1633,The Company You Keep,20014680,5133027,14881653,2012_boxofficemojo_rankings.csv,2012,0.25646310608013717,0.7435368939198628
1634,The Wife,19978189,9601092,10377097,2018_boxofficemojo_rankings.csv,2018,0.48057869509593687,0.5194213049040631
1635,They Shall Not Grow Old,19866389,17956913,1909476,2018_boxofficemojo_rankings.csv,2018,0.9038840928766673,0.09611590712333277
1636,The Rooftop,19833152,85755,19747397,2013_boxofficemojo_rankings.csv,2013,0.0043238210446831645,0.9956761789553168
1637,Gone,19767535,11682205,8085330,2012_boxofficemojo_rankings.csv,2012,0.590979350738471,0.4090206492615291
1638,It Comes at Night,19735344,13985117,5750227,2017_boxofficemojo_rankings.csv,2017,0.7086330494163162,0.2913669505836838
1639,Another Year,19722766,3205706,16517060,2010_boxofficemojo_rankings.csv,2010,0.1625383579564854,0.8374616420435146
1640,Brothers,19694450,613775,19080675,2015_boxofficemojo_rankings.csv,2015,0.031164871321615988,0.9688351286783841
1641,Blackhat,19652057,8005980,11646077,2015_boxofficemojo_rankings.csv,2015,0.4073863616414302,0.5926136383585698
1642,Youth in Revolt,19651093,15281286,4369807,2010_boxofficemojo_rankings.csv,2010,0.7776303333356572,0.2223696666643428
1643,The Guard,19561904,5360274,14201630,2011_boxofficemojo_rankings.csv,2011,0.27401596490811936,0.7259840350918806
1644,Puella Magi Madoka Magica the Movie Part III: The Rebellion Story,19544634,375627,19169007,2013_boxofficemojo_rankings.csv,2013,0.019218932418995412,0.9807810675810046
1645,Margin Call,19504039,5354039,14150000,2011_boxofficemojo_rankings.csv,2011,0.2745092439571106,0.7254907560428894
1646,In This Corner of the World,19496308,172147,19324161,2016_boxofficemojo_rankings.csv,2016,0.008829723042947414,0.9911702769570526
1647,Blue Is the Warmest Colour,19465835,2199787,17266048,2013_boxofficemojo_rankings.csv,2013,0.11300758482746823,0.8869924151725318
1648,Buried,19439764,1044143,18395621,2010_boxofficemojo_rankings.csv,2010,0.05371171172654154,0.9462882882734585
1649,The Edge of Seventeen,19370020,14431633,4938387,2016_boxofficemojo_rankings.csv,2016,0.7450499792979047,0.2549500207020953
1650,The Lost City of Z,19263938,8580410,10683528,2017_boxofficemojo_rankings.csv,2017,0.44541308220572556,0.5545869177942745
1651,Foxcatcher,19206513,12096300,7110213,2014_boxofficemojo_rankings.csv,2014,0.6298019843581185,0.3701980156418815
1652,Everybody Knows,19176163,2660165,16515998,2018_boxofficemojo_rankings.csv,2018,0.13872248582784782,0.8612775141721521
1653,My Annoying Brother,19162324,51996,19110328,2016_boxofficemojo_rankings.csv,2016,0.0027134495794977685,0.9972865504205022
1654,Oolong Courtyard: KungFu School,19129015,37727,19091288,2018_boxofficemojo_rankings.csv,2018,0.0019722395533695804,0.9980277604466304
1655,Shame,19123767,3909002,15214765,2011_boxofficemojo_rankings.csv,2011,0.20440543957683652,0.7955945604231635
1656,Norwegian Wood,19115721,13000,19102721,2010_boxofficemojo_rankings.csv,2010,0.000680068515333531,0.9993199314846665
1657,Les Misérables,19082469,330181,18752288,2013_boxofficemojo_rankings.csv,2013,0.01730284482579272,0.9826971551742073
1658,Always Miss You,19015465,91884,18923581,2019_boxofficemojo_rankings.csv,2019,0.0048320669518205316,0.9951679330481795
1659,Memoir of a Murderer,19015346,91335,18924011,2017_boxofficemojo_rankings.csv,2017,0.004803225773541013,0.995196774226459
1660,Jo Nesbø's Headhunters,18962444,1200010,17762434,2011_boxofficemojo_rankings.csv,2011,0.0632835092354129,0.9367164907645871
1661,The Turning,18714343,15472775,3241568,2020_boxofficemojo_rankings.csv,2020,0.8267869729650675,0.17321302703493252
1662,Pina,18705853,3524826,15181027,2011_boxofficemojo_rankings.csv,2011,0.18843439002754914,0.8115656099724509
1663,13 Assassins,18689058,802778,17886280,2010_boxofficemojo_rankings.csv,2010,0.042954438902164035,0.957045561097836
1664,Glee: The 3D Concert Movie,18663238,11862398,6800840,2011_boxofficemojo_rankings.csv,2011,0.6356023536751768,0.3643976463248232
1665,The Drop,18658381,10724389,7933992,2014_boxofficemojo_rankings.csv,2014,0.5747759679684963,0.4252240320315037
1666,Greta,18653107,10532219,8120888,2019_boxofficemojo_rankings.csv,2019,0.56463617562479,0.43536382437521
1667,Peppa Celebrates Chinese New Year,18653040,131225,18521815,2019_boxofficemojo_rankings.csv,2019,0.0070350462980833155,0.9929649537019167
1668,Admission,18637201,18007317,629884,2013_boxofficemojo_rankings.csv,2013,0.9662028649044457,0.03379713509555431
1669,Detective K: Secret of the Living Dead,18603476,104013,18499463,2018_boxofficemojo_rankings.csv,2018,0.005591051908793819,0.9944089480912062
1670,Battle of the Sexes,18598607,12638526,5960081,2017_boxofficemojo_rankings.csv,2017,0.6795415377076358,0.32045846229236413
1671,Black Christmas,18529730,10429730,8100000,2019_boxofficemojo_rankings.csv,2019,0.5628646504833044,0.4371353495166956
1672,Airpocalypse,18491089,105678,18385411,2018_boxofficemojo_rankings.csv,2018,0.005715077137966293,0.9942849228620337
1673,Motherless Brooklyn,18477736,9277736,9200000,2019_boxofficemojo_rankings.csv,2019,0.5021035044553077,0.4978964955446923
1674,Zero,18412196,1035388,17376808,2018_boxofficemojo_rankings.csv,2018,0.05623381371782051,0.9437661862821795
1675,Repo Men,18409891,13794835,4615056,2010_boxofficemojo_rankings.csv,2010,0.7493164951384014,0.25068350486159857
1676,The Wasted Times,18345372,386540,17958832,2016_boxofficemojo_rankings.csv,2016,0.021070164180917127,0.9789298358190829
1677,Fabricated City,18307490,104874,18202616,2017_boxofficemojo_rankings.csv,2017,0.005728475066762292,0.9942715249332377
1678,Asura,18300843,175702,18125141,2016_boxofficemojo_rankings.csv,2016,0.009600759921277943,0.990399240078722
1679,Chappaquiddick,18263470,17395520,867950,2018_boxofficemojo_rankings.csv,2018,0.9524761723812616,0.04752382761873839
1680,The Case for Christ,18175663,14682684,3492979,2017_boxofficemojo_rankings.csv,2017,0.8078210957146378,0.19217890428536225
1681,Sorry to Bother You,18170707,17493096,677611,2018_boxofficemojo_rankings.csv,2018,0.9627086056695537,0.03729139433044625
1682,Hell Fest,18159691,11107431,7052260,2018_boxofficemojo_rankings.csv,2018,0.6116530837446518,0.3883469162553482
1683,The Lighthouse,18113964,10867104,7246860,2019_boxofficemojo_rankings.csv,2019,0.5999296454381824,0.4000703545618176
1684,Blinded by the Light,18096691,11901145,6195546,2019_boxofficemojo_rankings.csv,2019,0.6576420517983095,0.3423579482016906
1685,Dead Man Down,18074539,10895295,7179244,2013_boxofficemojo_rankings.csv,2013,0.6027979468798623,0.3972020531201377
1686,Kalank,17987034,2729336,15257698,2019_boxofficemojo_rankings.csv,2019,0.15173908049542797,0.848260919504572
1687,Dope,17986781,17506470,480311,2015_boxofficemojo_rankings.csv,2015,0.9732964447612944,0.02670355523870558
1688,Cantinflas,17966873,6382924,11583949,2014_boxofficemojo_rankings.csv,2014,0.3552607067462435,0.6447392932537566
1689,We Have a Pope,17877523,548115,17329408,2011_boxofficemojo_rankings.csv,2011,0.030659448739067487,0.9693405512609325
1690,Dil Dhadakne Do,17870077,3066100,14803977,2015_boxofficemojo_rankings.csv,2015,0.17157732448494767,0.8284226755150523
1691,The Old Man & the Gun,17860397,11277120,6583277,2018_boxofficemojo_rankings.csv,2018,0.6314036580485864,0.3685963419514135
1692,Gekijouban Fate/Stay Night: Heaven's Feel - III. Spring Song,17850900,0,17850900,2020_boxofficemojo_rankings.csv,2020,0.0,1.0
1693,The Quiet Ones,17835162,8509867,9325295,2014_boxofficemojo_rankings.csv,2014,0.4771398768343119,0.5228601231656881
1694,Unforgettable,17768012,11368012,6400000,2017_boxofficemojo_rankings.csv,2017,0.6398021343074284,0.36019786569257156
1695,The Children Act,17696794,547750,17149044,2018_boxofficemojo_rankings.csv,2018,0.03095193400567357,0.9690480659943265
1696,Regression,17671101,55039,17616062,2015_boxofficemojo_rankings.csv,2015,0.0031146333213759574,0.996885366678624
1697,Before I Go to Sleep,17669776,3242457,14427319,2014_boxofficemojo_rankings.csv,2014,0.18350300535784947,0.8164969946421505
1698,Neerja,17618280,1585687,16032593,2015_boxofficemojo_rankings.csv,2015,0.09000237253579804,0.909997627464202
1699,Operation Finale,17612099,17612099,0,2018_boxofficemojo_rankings.csv,2018,1.0,0.0
1700,Little Boy,17572289,6485961,11086328,2015_boxofficemojo_rankings.csv,2015,0.3691016577293943,0.6308983422706057
1701,Toilet: A Love Story,17567417,1830715,15736702,2017_boxofficemojo_rankings.csv,2017,0.10421082393615408,0.8957891760638459
1702,Loving Pablo,17535962,22017,17513945,2018_boxofficemojo_rankings.csv,2018,0.0012555341988081407,0.9987444658011918
1703,Addicted,17534314,17390770,143544,2014_boxofficemojo_rankings.csv,2014,0.9918135377295056,0.0081864622704943
1704,Machete Kills,17496820,8008161,9488659,2013_boxofficemojo_rankings.csv,2013,0.45769236924195367,0.5423076307580463
1705,Fate/Stay Night: Heaven's Feel - I. Presage Flower,17422935,193833,17229102,2017_boxofficemojo_rankings.csv,2017,0.011125163469874622,0.9888748365301254
1706,Stolen,17415418,304318,17111100,2012_boxofficemojo_rankings.csv,2012,0.017474056608919753,0.9825259433910802
1707,Kapoor & Sons,17412627,2607036,14805591,2016_boxofficemojo_rankings.csv,2016,0.14972100418851217,0.8502789958114878
1708,Billy and Buddy,17400053,894,17399159,2013_boxofficemojo_rankings.csv,2013,5.1379153845106106e-05,0.9999486208461549
1709,Fruitvale Station,17385830,16101339,1284491,2013_boxofficemojo_rankings.csv,2013,0.9261185114544431,0.07388148854555693
1710,Fate/stay night [Heaven's Feel] II. lost butterfly,17295864,420595,16875269,2019_boxofficemojo_rankings.csv,2019,0.024317663459888447,0.9756823365401116
1711,While We're Young,17287309,7587485,9699824,2015_boxofficemojo_rankings.csv,2015,0.4389049215236449,0.5610950784763551
1712,Legend of the Naga Pearls,17274695,13588,17261107,2017_boxofficemojo_rankings.csv,2017,0.0007865840757246365,0.9992134159242754
1713,My Afternoons with Margueritte,17107143,666557,16440586,2010_boxofficemojo_rankings.csv,2010,0.03896366564539736,0.9610363343546027
1714,Melancholia,17039814,3030848,14008966,2011_boxofficemojo_rankings.csv,2011,0.17786860819020678,0.8221313918097932
1715,Beyond Outrage,17027515,3878,17023637,2012_boxofficemojo_rankings.csv,2012,0.0002277490285576022,0.9997722509714424
1716,Chinese Puzzle,16968297,338523,16629774,2013_boxofficemojo_rankings.csv,2013,0.019950322651707476,0.9800496773482925
1717,The Nutcracker in 3D,16918946,195459,16723487,2010_boxofficemojo_rankings.csv,2010,0.011552670006748648,0.9884473299932514
1718,Calvary,16887741,3600006,13287735,2014_boxofficemojo_rankings.csv,2014,0.21317273873397277,0.7868272612660272
1719,The Last Godfather,16863629,164247,16699382,2010_boxofficemojo_rankings.csv,2010,0.009739718538637206,0.9902602814613628
1720,The Cold Light of Day,16863583,3763583,13100000,2012_boxofficemojo_rankings.csv,2012,0.2231781348008902,0.7768218651991098
1721,The Pyramid,16861137,2756333,14104804,2014_boxofficemojo_rankings.csv,2014,0.16347254636505237,0.8365274536349476
1722,Monkey Kingdom,16839663,16432322,407341,2015_boxofficemojo_rankings.csv,2015,0.9758106204381881,0.024189379561811896
1723,Hit and Run,16816647,13749300,3067347,2012_boxofficemojo_rankings.csv,2012,0.8176005597310807,0.18239944026891924
1724,Hardcore Henry,16810562,9252038,7558524,2016_boxofficemojo_rankings.csv,2016,0.5503705349053768,0.44962946509462326
1725,The Birth of a Nation,16779212,15861566,917646,2016_boxofficemojo_rankings.csv,2016,0.9453105425928225,0.05468945740717741
1726,102 Not Out,16758596,1343797,15414799,2018_boxofficemojo_rankings.csv,2018,0.08018553582889641,0.9198144641711036
1727,Baaghi 3,16726319,721439,16004880,2020_boxofficemojo_rankings.csv,2020,0.04313196466000678,0.9568680353399932
1728,Love Is All You Need,16722143,1631709,15090434,2012_boxofficemojo_rankings.csv,2012,0.09757774467064419,0.9024222553293558
1729,Delhi Belly,16706074,1532594,15173480,2011_boxofficemojo_rankings.csv,2011,0.09173872927894369,0.9082612707210563
1730,Pride,16699029,1446634,15252395,2014_boxofficemojo_rankings.csv,2014,0.08662982739894637,0.9133701726010536
1731,Mai wei,16653488,70177,16583311,2011_boxofficemojo_rankings.csv,2011,0.004213952056169854,0.9957860479438302
1732,Beautiful Boy,16636604,7649973,8986631,2018_boxofficemojo_rankings.csv,2018,0.45982779899070747,0.5401722010092925
1733,Nothing to Lose 2,16610713,1150551,15460162,2019_boxofficemojo_rankings.csv,2019,0.06926559985715243,0.9307344001428476
1734,Belle,16607575,10726630,5880945,2014_boxofficemojo_rankings.csv,2014,0.6458877951778029,0.3541122048221971
1735,Upgrade,16593554,11977130,4616424,2018_boxofficemojo_rankings.csv,2018,0.7217941376512832,0.27820586234871686
1736,Tazza: One-Eyed Jack,16572611,97655,16474956,2019_boxofficemojo_rankings.csv,2019,0.005892553683906537,0.9941074463160935
1737,Battle of the Year,16549477,8888355,7661122,2013_boxofficemojo_rankings.csv,2013,0.5370776973798024,0.4629223026201976
1738,"Tomorrow, When the War Began",16533595,4936,16528659,2010_boxofficemojo_rankings.csv,2010,0.00029854366216179845,0.9997014563378382
1739,Silent House,16527747,12754783,3772964,2012_boxofficemojo_rankings.csv,2012,0.7717194001094039,0.2282805998905961
1740,Pride and Prejudice and Zombies,16457494,10938134,5519360,2016_boxofficemojo_rankings.csv,2016,0.6646293779599738,0.33537062204002627
1741,Poms,16418218,13631124,2787094,2019_boxofficemojo_rankings.csv,2019,0.8302438181780751,0.1697561818219249
1742,Forever My Girl,16376066,16376066,0,2018_boxofficemojo_rankings.csv,2018,1.0,0.0
1743,Before I Fall,16373843,12241122,4132721,2017_boxofficemojo_rankings.csv,2017,0.7476022580648904,0.25239774193510955
1744,The Single Moms Club,16365451,15973881,391570,2014_boxofficemojo_rankings.csv,2014,0.9760733755519478,0.02392662444805218
1745,Little Q,16360233,1652,16358581,2019_boxofficemojo_rankings.csv,2019,0.0001009765569964682,0.9998990234430035
1746,Playmobil: The Movie,16349303,1115008,15234295,2019_boxofficemojo_rankings.csv,2019,0.068199115277269,0.931800884722731
1747,Macbeth,16322067,1110707,15211360,2015_boxofficemojo_rankings.csv,2015,0.06804940820301743,0.9319505917969826
1748,Gangnam 1970,16191434,18022,16173412,2015_boxofficemojo_rankings.csv,2015,0.0011130576822287637,0.9988869423177712
1749,In the House,16190771,389757,15801014,2012_boxofficemojo_rankings.csv,2012,0.024072788133437252,0.9759272118665627
1750,Scouts Guide to the Zombie Apocalypse,16137046,3703046,12434000,2015_boxofficemojo_rankings.csv,2015,0.22947483696830262,0.7705251630316974
1751,The Space Between Us,16080475,7885294,8195181,2017_boxofficemojo_rankings.csv,2017,0.4903644948299102,0.5096355051700898
1752,Unfriended: Dark Web,16024987,8866745,7158242,2018_boxofficemojo_rankings.csv,2018,0.5533074691417846,0.44669253085821536
1753,Sea Rex 3D: Journey to a Prehistoric World,16004150,6096582,9907568,2010_boxofficemojo_rankings.csv,2010,0.38093756931795814,0.6190624306820418
1754,The Kitchen,15980032,12180032,3800000,2019_boxofficemojo_rankings.csv,2019,0.762203229630579,0.23779677036942104
1755,The Words,15950164,11494838,4455326,2012_boxofficemojo_rankings.csv,2012,0.7206720883873043,0.27932791161269566
1756,Wonder Wheel,15889124,1404061,14485063,2017_boxofficemojo_rankings.csv,2017,0.08836616795236792,0.911633832047632
1757,The Hunt,15843274,613308,15229966,2012_boxofficemojo_rankings.csv,2012,0.038710938155838245,0.9612890618441617
1758,"I, Daniel Blake",15793051,260354,15532697,2016_boxofficemojo_rankings.csv,2016,0.01648535169043651,0.9835146483095635
1759,Finding Your Feet,15775555,1418682,14356873,2018_boxofficemojo_rankings.csv,2018,0.08992913403046676,0.9100708659695332
1760,I Hate Luv Storys,15719212,847993,14871219,2010_boxofficemojo_rankings.csv,2010,0.053946279240969584,0.9460537207590304
1761,The Brand New Testament,15709652,127910,15581742,2015_boxofficemojo_rankings.csv,2015,0.008142128164264873,0.9918578718357351
1762,Feng Shui,15702302,64147,15638155,2018_boxofficemojo_rankings.csv,2018,0.004085197189558576,0.9959148028104414
1763,Judy Moody and the Not Bummer Summer,15691640,15013650,677990,2011_boxofficemojo_rankings.csv,2011,0.956792916482917,0.04320708351708298
1764,Out of the Furnace,15660668,11330849,4329819,2013_boxofficemojo_rankings.csv,2013,0.723522713079672,0.276477286920328
1765,I Still Believe,15647958,9868521,5779437,2020_boxofficemojo_rankings.csv,2020,0.6306587095900947,0.36934129040990527
1766,The Divine Move 2: The Wrathful,15642991,67578,15575413,2019_boxofficemojo_rankings.csv,2019,0.004320017827792652,0.9956799821722073
1767,Vampire Academy,15642346,7791979,7850367,2014_boxofficemojo_rankings.csv,2014,0.4981336559106927,0.5018663440893073
1768,Tully,15636462,9369755,6266707,2018_boxofficemojo_rankings.csv,2018,0.5992247479001324,0.4007752520998676
1769,The Conspirator,15623183,11538204,4084979,2011_boxofficemojo_rankings.csv,2011,0.7385309382857513,0.2614690617142486
1770,Paranoia,15500644,7388654,8111990,2013_boxofficemojo_rankings.csv,2013,0.47666755007082284,0.5233324499291772
1771,Chronicles of Evil,15460494,105057,15355437,2015_boxofficemojo_rankings.csv,2015,0.006795190373606432,0.9932048096263936
1772,Our Little Sister,15407615,64441,15343174,2015_boxofficemojo_rankings.csv,2015,0.004182412398025262,0.9958175876019747
1773,Anonymous,15395087,4463292,10931795,2011_boxofficemojo_rankings.csv,2011,0.2899166467847827,0.7100833532152173
1774,Miss Bala,15383580,15006824,376756,2019_boxofficemojo_rankings.csv,2019,0.9755092117699521,0.024490788230047883
1775,When Harry Met Sejal,15360368,1664648,13695720,2017_boxofficemojo_rankings.csv,2017,0.10837292439868629,0.8916270756013137
1776,Apollo 11,15342353,9039891,6302462,2019_boxofficemojo_rankings.csv,2019,0.5892115114285273,0.4107884885714727
1777,The Dead Don't Die,15322395,6563605,8758790,2019_boxofficemojo_rankings.csv,2019,0.42836677947540186,0.5716332205245982
1778,The Negotiation,15229193,110986,15118207,2018_boxofficemojo_rankings.csv,2018,0.0072877138007247004,0.9927122861992753
1779,Attack on Titan Part 2,15186410,305934,14880476,2015_boxofficemojo_rankings.csv,2015,0.020145248284485932,0.9798547517155141
1780,Spectacle,15159762,2065487,13094275,2015_boxofficemojo_rankings.csv,2015,0.13624798331266677,0.8637520166873333
1781,Extraordinary Measures,15134293,12068313,3065980,2010_boxofficemojo_rankings.csv,2010,0.7974150493848638,0.2025849506151361
1782,Irreplaceable,15130912,8494,15122418,2016_boxofficemojo_rankings.csv,2016,0.0005613673518159382,0.9994386326481841
1783,Three,15121228,119550,15001678,2016_boxofficemojo_rankings.csv,2016,0.007906103922247585,0.9920938960777524
1784,War of the Buttons,15082409,47771,15034638,2011_boxofficemojo_rankings.csv,2011,0.003167332221265184,0.9968326677787348
1785,Ip Man 2,15061802,205675,14856127,2010_boxofficemojo_rankings.csv,2010,0.013655404579080245,0.9863445954209198
1786,Hanyo,15038301,157961,14880340,2010_boxofficemojo_rankings.csv,2010,0.01050391264279123,0.9894960873572087
1787,Journey to the South Pacific,14994876,7653913,7340963,2013_boxofficemojo_rankings.csv,2013,0.510435231341693,0.489564768658307
1788,Blue Valentine,14892418,9706328,5186090,2010_boxofficemojo_rankings.csv,2010,0.651763064936802,0.3482369350631979
1789,Gold,14880939,7227038,7653901,2017_boxofficemojo_rankings.csv,2017,0.4856573903031254,0.5143426096968746
1790,School of Life,14880497,6300,14874197,2017_boxofficemojo_rankings.csv,2017,0.00042337295588984697,0.9995766270441101
1791,Emperor,14858240,3346265,11511975,2013_boxofficemojo_rankings.csv,2013,0.22521274390506546,0.7747872560949345
1792,The Take,14857808,50269,14807539,2016_boxofficemojo_rankings.csv,2016,0.0033833389151347224,0.9966166610848652
1793,Somewhere,14788642,1785645,13002997,2010_boxofficemojo_rankings.csv,2010,0.12074435232119352,0.8792556476788065
1794,Dabangg 3,14784628,202000,14582628,2019_boxofficemojo_rankings.csv,2019,0.013662839538471985,0.986337160461528
1795,Seondal: The Man Who Sells the River,14777982,97477,14680505,2016_boxofficemojo_rankings.csv,2016,0.006596096814842514,0.9934039031851575
1796,A Royal Affair,14758997,1546761,13212236,2012_boxofficemojo_rankings.csv,2012,0.10480122734627563,0.8951987726537244
1797,Made in India,14751915,790628,13961287,2018_boxofficemojo_rankings.csv,2018,0.053594940046766806,0.9464050599532332
1798,Sword Master,14714624,75526,14639098,2016_boxofficemojo_rankings.csv,2016,0.005132716948798691,0.9948672830512013
1799,Inherent Vice,14710975,8110975,6600000,2014_boxofficemojo_rankings.csv,2014,0.5513553656368799,0.4486446343631201
1800,The Way Back,14690514,13590514,1100000,2020_boxofficemojo_rankings.csv,2020,0.9251217486331655,0.0748782513668344
1801,"Hello, My Name Is Doris",14659448,14444999,214449,2016_boxofficemojo_rankings.csv,2016,0.985371277281382,0.014628722718618054
1802,Beyond the Lights,14618727,14618727,0,2014_boxofficemojo_rankings.csv,2014,1.0,0.0
1803,Megan Leavey,14510490,13406883,1103607,2017_boxofficemojo_rankings.csv,2017,0.9239441948548947,0.07605580514510536
1804,A United Kingdom,14459330,3902185,10557145,2016_boxofficemojo_rankings.csv,2016,0.269873154565253,0.7301268454347469
1805,Serenity,14454622,8547045,5907577,2019_boxofficemojo_rankings.csv,2019,0.5913018687033117,0.40869813129668836
1806,America: Imagine the World Without Her,14444502,14444502,0,2014_boxofficemojo_rankings.csv,2014,1.0,0.0
1807,RBG,14441292,14017361,423931,2018_boxofficemojo_rankings.csv,2018,0.9706445240495103,0.02935547595048975
1808,Unfinished Business,14431253,10219501,4211752,2015_boxofficemojo_rankings.csv,2015,0.7081506366772171,0.29184936332278283
1809,45 Years,14430249,4247285,10182964,2015_boxofficemojo_rankings.csv,2015,0.2943320659262359,0.705667934073764
1810,Do You Believe?,14410698,12985600,1425098,2015_boxofficemojo_rankings.csv,2015,0.9011083293814082,0.09889167061859183
1811,Woodlawn,14401617,14394097,7520,2015_boxofficemojo_rankings.csv,2015,0.9994778364123973,0.0005221635876026977
1812,Eighth Grade,14347433,13539709,807724,2018_boxofficemojo_rankings.csv,2018,0.9437025424687469,0.056297457531253155
1813,The Other Side of the Door,14332467,3000342,11332125,2016_boxofficemojo_rankings.csv,2016,0.20933883887540086,0.7906611611245992
1814,Beginners,14311701,5790894,8520807,2011_boxofficemojo_rankings.csv,2011,0.4046265360071455,0.5953734639928545
1815,The Beauty Inside,14301869,108083,14193786,2015_boxofficemojo_rankings.csv,2015,0.007557264019129248,0.9924427359808707
1816,Unsane,14293601,7732899,6560702,2018_boxofficemojo_rankings.csv,2018,0.5410042577794077,0.45899574222059225
1817,Colette,14273033,5137622,9135411,2018_boxofficemojo_rankings.csv,2018,0.35995306673781247,0.6400469332621875
1818,La Belle Époque,14223716,0,14223716,2019_boxofficemojo_rankings.csv,2019,0.0,1.0
1819,Ya veremos,14134723,4165949,9968774,2018_boxofficemojo_rankings.csv,2018,0.2947315628328903,0.7052684371671096
1820,Shaandaar,14120808,521794,13599014,2015_boxofficemojo_rankings.csv,2015,0.03695213475036273,0.9630478652496373
1821,Red Lights,14107313,52624,14054689,2012_boxofficemojo_rankings.csv,2012,0.0037302638709440982,0.9962697361290559
1822,Seeking Justice,14089528,411746,13677782,2011_boxofficemojo_rankings.csv,2011,0.02922354815576505,0.970776451844235
1823,Island of Lemurs: Madagascar,14066534,11272213,2794321,2014_boxofficemojo_rankings.csv,2014,0.8013497141513325,0.19865028584866748
1824,Kedarnath,13999297,901131,13098166,2018_boxofficemojo_rankings.csv,2018,0.06436973228012807,0.9356302677198719
1825,The Quake,13837294,6235,13831059,2018_boxofficemojo_rankings.csv,2018,0.0004505938805665327,0.9995494061194334
1826,Winter's Bone,13796834,6531503,7265331,2010_boxofficemojo_rankings.csv,2010,0.47340592776574686,0.5265940722342531
1827,Pulling Strings,13725819,5842961,7882858,2013_boxofficemojo_rankings.csv,2013,0.4256912465478381,0.5743087534521619
1828,Tees Maar Khan,13681934,1076443,12605491,2010_boxofficemojo_rankings.csv,2010,0.0786762310065229,0.9213237689934771
1829,Phantom,13676590,489984,13186606,2015_boxofficemojo_rankings.csv,2015,0.03582647428927825,0.9641735257107218
1830,The Bride of Humpty Sharma,13669988,380011,13289977,2014_boxofficemojo_rankings.csv,2014,0.027798927109519044,0.972201072890481
1831,Chloe,13657649,3075255,10582394,2010_boxofficemojo_rankings.csv,2010,0.2251672304655069,0.7748327695344931
1832,All Is Lost,13627519,6263670,7363849,2013_boxofficemojo_rankings.csv,2013,0.45963392162579264,0.5403660783742074
1833,Sing Street,13624522,3237118,10387404,2016_boxofficemojo_rankings.csv,2016,0.23759497764398635,0.7624050223560137
1834,Do It Like An Hombre,13610252,2534252,11076000,2017_boxofficemojo_rankings.csv,2017,0.18620169560416663,0.8137983043958333
1835,Love Forecast,13608637,32211,13576426,2015_boxofficemojo_rankings.csv,2015,0.0023669526933520232,0.9976330473066479
1836,Strange Magic,13603453,12429583,1173870,2015_boxofficemojo_rankings.csv,2015,0.9137079387123255,0.08629206128767454
1837,The Two Faces of January,13551951,507463,13044488,2014_boxofficemojo_rankings.csv,2014,0.03744575227581623,0.9625542477241837
1838,Nymphomaniac: Vol. I,13545832,785896,12759936,2013_boxofficemojo_rankings.csv,2013,0.05801755108139537,0.9419824489186046
1839,Phantom of the Theatre,13526843,43955,13482888,2016_boxofficemojo_rankings.csv,2016,0.0032494647864250363,0.9967505352135749
1840,Three Identical Strangers,13448497,12320845,1127652,2018_boxofficemojo_rankings.csv,2018,0.9161503326356841,0.08384966736431587
1841,The Third Murder,13411936,89315,13322621,2017_boxofficemojo_rankings.csv,2017,0.006659366701421778,0.9933406332985782
1842,Our President,13392049,507268,12884781,2017_boxofficemojo_rankings.csv,2017,0.03787829629356942,0.9621217037064306
1843,Ratchet & Clank,13385737,8821329,4564408,2016_boxofficemojo_rankings.csv,2016,0.6590095860989947,0.3409904139010052
1844,Hotel Artemis,13313581,6708147,6605434,2018_boxofficemojo_rankings.csv,2018,0.5038574520258674,0.4961425479741326
1845,Paris Can Wait,13203541,5617731,7585810,2017_boxofficemojo_rankings.csv,2017,0.42547154585273755,0.5745284541472625
1846,The Well Digger's Daughter,13194167,386368,12807799,2011_boxofficemojo_rankings.csv,2011,0.029283243117962657,0.9707167568820373
1847,Mommy,13156856,3494070,9662786,2014_boxofficemojo_rankings.csv,2014,0.2655702851805933,0.7344297148194067
1848,The Sisters Brothers,13143056,3143056,10000000,2018_boxofficemojo_rankings.csv,2018,0.23914194689576002,0.76085805310424
1849,Hillary's America: The Secret History of the Democratic Party,13099931,13099931,0,2016_boxofficemojo_rankings.csv,2016,1.0,0.0
1850,The Angels' Share,13090471,346669,12743802,2012_boxofficemojo_rankings.csv,2012,0.026482545967979304,0.9735174540320207
1851,Shut In,13082071,6900335,6181736,2016_boxofficemojo_rankings.csv,2016,0.5274650321038619,0.47253496789613814
1852,Hot Tub Time Machine 2,13081651,12314651,767000,2015_boxofficemojo_rankings.csv,2015,0.94136825695778,0.05863174304221998
1853,The Personal History of David Copperfield,13069190,1874133,11195057,2020_boxofficemojo_rankings.csv,2020,0.14340085345763587,0.8565991465423641
1854,Welcome to Marwen,13061491,10763520,2297971,2018_boxofficemojo_rankings.csv,2018,0.8240651852074162,0.1759348147925838
1855,"Roman J. Israel, Esq.",13025860,11962778,1063082,2017_boxofficemojo_rankings.csv,2017,0.9183868090091556,0.08161319099084437
1856,Friends with Kids,13019073,7251073,5768000,2012_boxofficemojo_rankings.csv,2012,0.5569577035169861,0.4430422964830138
1857,The Vatican Tapes,13015764,1784763,11231001,2015_boxofficemojo_rankings.csv,2015,0.13712318385613015,0.8628768161438698
1858,In a Better World,13004504,1008098,11996406,2010_boxofficemojo_rankings.csv,2010,0.07751914259859508,0.922480857401405
1859,Pyaar Ka Punchnama 2,12983721,222856,12760865,2015_boxofficemojo_rankings.csv,2015,0.017164262848839713,0.9828357371511602
1860,The Wave,12975143,177404,12797739,2015_boxofficemojo_rankings.csv,2015,0.013672604610215086,0.9863273953897849
1861,I Saw the Devil,12966357,129210,12837147,2010_boxofficemojo_rankings.csv,2010,0.00996501947308716,0.9900349805269129
1862,Le Havre,12959706,611709,12347997,2011_boxofficemojo_rankings.csv,2011,0.04720083927829844,0.9527991607217016
1863,Loving,12957265,7751969,5205296,2016_boxofficemojo_rankings.csv,2016,0.5982720118790501,0.4017279881209499
1864,Child 44,12951093,1224330,11726763,2015_boxofficemojo_rankings.csv,2015,0.09453487825313277,0.9054651217468672
1865,Take Point,12908032,112386,12795646,2018_boxofficemojo_rankings.csv,2018,0.008706671938836221,0.9912933280611638
1866,Mubarakan,12899968,758868,12141100,2017_boxofficemojo_rankings.csv,2017,0.05882712267193221,0.9411728773280678
1867,Earth: One Amazing Day,12851540,81345,12770195,2017_boxofficemojo_rankings.csv,2017,0.006329591628707532,0.9936704083712925
1868,Suburbicon,12751667,5775178,6976489,2017_boxofficemojo_rankings.csv,2017,0.4528959233330042,0.5471040766669958
1869,Elle,12748594,2341534,10407060,2016_boxofficemojo_rankings.csv,2016,0.18366997960716294,0.8163300203928371
1870,Populaire,12698385,179091,12519294,2012_boxofficemojo_rankings.csv,2012,0.014103447013143797,0.9858965529868562
1871,The Past,12673462,1331747,11341715,2013_boxofficemojo_rankings.csv,2013,0.10508154756766541,0.8949184524323346
1872,Redemption,12671109,36895,12634214,2013_boxofficemojo_rankings.csv,2013,0.0029117419793326695,0.9970882580206674
1873,The Green Inferno,12666449,7192291,5474158,2015_boxofficemojo_rankings.csv,2015,0.5678222049447323,0.43217779505526766
1874,Made in Dagenham,12629471,1095369,11534102,2010_boxofficemojo_rankings.csv,2010,0.08673118612806506,0.9132688138719349
1875,Luis and the Aliens,12627729,169710,12458019,2018_boxofficemojo_rankings.csv,2018,0.013439471182823135,0.9865605288171768
1876,Their Finest,12597262,3603484,8993778,2017_boxofficemojo_rankings.csv,2017,0.2860529534116223,0.7139470465883777
1877,People Like Us,12558931,12434778,124153,2012_boxofficemojo_rankings.csv,2012,0.9901143656255457,0.009885634374454322
1878,The Promise,12448676,8224288,4224388,2017_boxofficemojo_rankings.csv,2017,0.6606556392021128,0.33934436079788727
1879,Can You Ever Forgive Me?,12442161,8803865,3638296,2018_boxofficemojo_rankings.csv,2018,0.707583272712835,0.292416727287165
1880,Rampant,12359573,167937,12191636,2018_boxofficemojo_rankings.csv,2018,0.013587605332320138,0.9864123946676798
1881,Tall Tales from the Magical Garden of Antoon Krings 2018 Re-release,12353849,220,12353629,2018_boxofficemojo_rankings.csv,2018,1.7808215075317822e-05,0.9999821917849246
1882,Marrowbone,12294931,1377,12293554,2017_boxofficemojo_rankings.csv,2017,0.00011199737517843735,0.9998880026248216
1883,The Beatles: Eight Days a Week - The Touring Years,12283800,2930414,9353386,2016_boxofficemojo_rankings.csv,2016,0.23855924062586495,0.761440759374135
1884,The Man Who Knew Infinity,12252684,3866794,8385890,2016_boxofficemojo_rankings.csv,2016,0.3155875071943421,0.684412492805658
1885,Gainsbourg: A Heroic Life,12220456,233007,11987449,2010_boxofficemojo_rankings.csv,2010,0.0190669644406068,0.9809330355593932
1886,The Guillotines,12217440,5290,12212150,2012_boxofficemojo_rankings.csv,2012,0.0004329875980565487,0.9995670124019435
1887,The Current War: Director's Cut,12217160,5979540,6237620,2019_boxofficemojo_rankings.csv,2019,0.48943780714994317,0.5105621928500568
1888,I Married an Anti-Fan,12194083,89408,12104675,2016_boxofficemojo_rankings.csv,2016,0.007332080649278835,0.9926679193507212
1889,Little Women,12165890,1379497,10786393,2018_boxofficemojo_rankings.csv,2018,0.11339055342436928,0.8866094465756307
1890,Miss & Mrs. Cops,12147170,104578,12042592,2019_boxofficemojo_rankings.csv,2019,0.008609248080005466,0.9913907519199945
1891,Bachelorette,12128575,447954,11680621,2012_boxofficemojo_rankings.csv,2012,0.03693377004305947,0.9630662299569406
1892,Barney's Version,12104765,4439201,7665564,2011_boxofficemojo_rankings.csv,2011,0.3667316961543657,0.6332683038456344
1893,Stoker,12077441,1714221,10363220,2012_boxofficemojo_rankings.csv,2012,0.14193577927642123,0.8580642207235788
1894,The Connection,12062441,190980,11871461,2014_boxofficemojo_rankings.csv,2014,0.01583261630046522,0.9841673836995348
1895,The Bookshop,12055868,1588150,10467718,2017_boxofficemojo_rankings.csv,2017,0.13173253058178805,0.868267469418212
1896,Tamara Drewe,12037973,560391,11477582,2010_boxofficemojo_rankings.csv,2010,0.04655194026436178,0.9534480597356382
1897,I Am Love,12014663,5005465,7009198,2010_boxofficemojo_rankings.csv,2010,0.4166130169443787,0.5833869830556213
1898,A Most Violent Year,12007070,5749134,6257936,2014_boxofficemojo_rankings.csv,2014,0.47881239969451334,0.5211876003054867
1899,The Assassin,11991669,632542,11359127,2015_boxofficemojo_rankings.csv,2015,0.052748453947486375,0.9472515460525136
1900,Mere Brother Ki Dulhan,11983381,496172,11487209,2011_boxofficemojo_rankings.csv,2011,0.041405009153927426,0.9585949908460726
1901,This Must Be the Place,11928909,143979,11784930,2011_boxofficemojo_rankings.csv,2011,0.012069754241565594,0.9879302457584344
1902,The Warring States,11868961,68961,11800000,2011_boxofficemojo_rankings.csv,2011,0.005810196865589161,0.9941898031344109
1903,Viceroy's House,11868221,1105717,10762504,2017_boxofficemojo_rankings.csv,2017,0.09316619567498785,0.9068338043250121
1904,Boy Erased,11853081,6788692,5064389,2018_boxofficemojo_rankings.csv,2018,0.5727364893566491,0.4272635106433509
1905,Unstoppable,11845347,101417,11743930,2018_boxofficemojo_rankings.csv,2018,0.008561758469380424,0.9914382415306195
1906,Kites,11844500,1643486,10201014,2010_boxofficemojo_rankings.csv,2010,0.13875520283675968,0.8612447971632403
1907,Wo zhi nv ren xin,11838177,123526,11714651,2011_boxofficemojo_rankings.csv,2011,0.010434545791974559,0.9895654542080254
1908,Last Letter,11834622,180946,11653676,2018_boxofficemojo_rankings.csv,2018,0.015289546214488303,0.9847104537855117
1909,Ash Is Purest White,11813509,422814,11390695,2018_boxofficemojo_rankings.csv,2018,0.03579072060638376,0.9642092793936162
1910,Getaway,11806432,10501938,1304494,2013_boxofficemojo_rankings.csv,2013,0.8895098874918349,0.11049011250816504
1911,Ballon,11799591,34222,11765369,2018_boxofficemojo_rankings.csv,2018,0.002900270017833669,0.9970997299821663
1912,The Divine Fury,11799556,102982,11696574,2019_boxofficemojo_rankings.csv,2019,0.0087276165306559,0.9912723834693441
1913,Win Win,11789613,10179275,1610338,2011_boxofficemojo_rankings.csv,2011,0.8634104444310429,0.1365895555689572
1914,Toni Erdmann,11784207,1479387,10304820,2016_boxofficemojo_rankings.csv,2016,0.12553980085380373,0.8744601991461962
1915,The Interview,11782625,6105175,5677450,2014_boxofficemojo_rankings.csv,2014,0.5181506667656826,0.4818493332343175
1916,C'est Si Bon,11750035,164167,11585868,2015_boxofficemojo_rankings.csv,2015,0.013971617956882681,0.9860283820431173
1917,Seeking a Friend for the End of the World,11681781,7078738,4603043,2012_boxofficemojo_rankings.csv,2012,0.6059639364922181,0.3940360635077819
1918,Bring the Soul: The Movie,11641119,4809800,6831319,2019_boxofficemojo_rankings.csv,2019,0.41317333840501075,0.5868266615949893
1919,Back to Burgundy,11625884,257610,11368274,2017_boxofficemojo_rankings.csv,2017,0.02215831501501305,0.9778416849849869
1920,The Lunchbox 2013 Re-release,11621581,4235151,7386430,2013_boxofficemojo_rankings.csv,2013,0.36442124354681177,0.6355787564531883
1921,Delicacy,11597420,498584,11098836,2011_boxofficemojo_rankings.csv,2011,0.042990941088621434,0.9570090589113786
1922,Haute Cuisine,11509942,217883,11292059,2012_boxofficemojo_rankings.csv,2012,0.01892998244474212,0.9810700175552579
1923,Fists of Legend,11478881,134213,11344668,2013_boxofficemojo_rankings.csv,2013,0.011692167555356658,0.9883078324446434
1924,Double Dhamaal,11445869,543646,10902223,2011_boxofficemojo_rankings.csv,2011,0.0474971363030627,0.9525028636969373
1925,Trumbo,11430025,7857741,3572284,2015_boxofficemojo_rankings.csv,2015,0.6874649005579603,0.3125350994420397
1926,Seasons,11425100,150092,11275008,2016_boxofficemojo_rankings.csv,2016,0.013137040376014214,0.9868629596239857
1927,Fun Size,11417362,9409538,2007824,2012_boxofficemojo_rankings.csv,2012,0.8241429149745799,0.17585708502542005
1928,The King's Case Note,11383493,90959,11292534,2017_boxofficemojo_rankings.csv,2017,0.007990429651074587,0.9920095703489255
1929,King of Thieves,11353515,7518,11345997,2018_boxofficemojo_rankings.csv,2018,0.0006621737849467764,0.9993378262150532
1930,Bajirao Mastani,11350917,6557047,4793870,2015_boxofficemojo_rankings.csv,2015,0.577666720671114,0.4223332793288859
1931,The Apparition,11350665,4936819,6413846,2012_boxofficemojo_rankings.csv,2012,0.4349365433655209,0.5650634566344791
1932,Snow Flower and the Secret Fan,11348205,1348205,10000000,2011_boxofficemojo_rankings.csv,2011,0.11880337022463024,0.8811966297753697
1933,"It's Not You, It's Me",11301956,1339911,9962045,2010_boxofficemojo_rankings.csv,2010,0.11855567301801564,0.8814443269819844
1934,Tomorrow,11277905,62510,11215395,2015_boxofficemojo_rankings.csv,2015,0.00554269609470908,0.994457303905291
1935,At Eternity's Gate,11235662,2294915,8940747,2018_boxofficemojo_rankings.csv,2018,0.20425276232054684,0.7957472376794531
1936,Straw Dogs,11168712,10324441,844271,2010_boxofficemojo_rankings.csv,2010,0.9244074876315191,0.0755925123684808
1937,Ida,11156836,3827060,7329776,2013_boxofficemojo_rankings.csv,2013,0.343023774840824,0.656976225159176
1938,Gloria Bell,11145006,5611123,5533883,2019_boxofficemojo_rankings.csv,2019,0.5034652291797779,0.49653477082022207
1939,Bicycling with Molière,11123929,59874,11064055,2013_boxofficemojo_rankings.csv,2013,0.0053824507509891515,0.9946175492490108
1940,We Are Your Friends,11122090,3591417,7530673,2015_boxofficemojo_rankings.csv,2015,0.32290846414657676,0.6770915358534232
1941,Conviction 2010 Re-release,11104555,6783129,4321426,2010_boxofficemojo_rankings.csv,2010,0.6108420373441349,0.3891579626558651
1942,The Warrior's Way,11103434,5666340,5437094,2010_boxofficemojo_rankings.csv,2010,0.510323202713683,0.489676797286317
1943,The Belko Experiment,11084630,10166820,917810,2017_boxofficemojo_rankings.csv,2017,0.9171997621932352,0.08280023780676486
1944,Action Jackson,11060963,256872,10804091,2014_boxofficemojo_rankings.csv,2014,0.023223294391274973,0.976776705608725
1945,Promised Land,11039031,7597898,3441133,2012_boxofficemojo_rankings.csv,2012,0.6882758097155448,0.3117241902844552
1946,Last Night,11027222,99000,10928222,2010_boxofficemojo_rankings.csv,2010,0.008977782436954657,0.9910222175630453
1947,La boda de Valentina,11021794,2783739,8238055,2018_boxofficemojo_rankings.csv,2018,0.2525667781488204,0.7474332218511796
1948,The Loft,11016443,6002684,5013759,2014_boxofficemojo_rankings.csv,2014,0.5448840428802655,0.45511595711973457
1949,Gringo,11001627,4969853,6031774,2018_boxofficemojo_rankings.csv,2018,0.4517380020246096,0.5482619979753903
1950,[REC] 3: Genesis,10998667,9600,10989067,2012_boxofficemojo_rankings.csv,2012,0.0008728330442225408,0.9991271669557774
1951,Hyde Park on Hudson,10980481,6376145,4604336,2012_boxofficemojo_rankings.csv,2012,0.5806799356057353,0.41932006439426467
1952,Justin Bieber's Believe,10980157,6206566,4773591,2013_boxofficemojo_rankings.csv,2013,0.5652529376401448,0.43474706235985516
1953,Friend Request,10975390,3759078,7216312,2016_boxofficemojo_rankings.csv,2016,0.3425006309570776,0.6574993690429224
1954,The Florida Project,10971298,5904366,5066932,2017_boxofficemojo_rankings.csv,2017,0.538164764096281,0.46183523590371894
1955,Jonah Hex,10903312,10547117,356195,2010_boxofficemojo_rankings.csv,2010,0.9673314860658853,0.0326685139341147
1956,One Chance,10900434,101196,10799238,2013_boxofficemojo_rankings.csv,2013,0.009283667053990695,0.9907163329460094
1957,A Bag of Marbles,10898998,411318,10487680,2017_boxofficemojo_rankings.csv,2017,0.037739065554466565,0.9622609344455334
1958,The Darkness,10898293,10753574,144719,2016_boxofficemojo_rankings.csv,2016,0.9867209479502891,0.013279052049710905
1959,The Hunt,10890815,5812500,5078315,2020_boxofficemojo_rankings.csv,2020,0.5337066142432867,0.46629338575671336
1960,Only You,10857889,61565,10796324,2015_boxofficemojo_rankings.csv,2015,0.005670070858156682,0.9943299291418434
1961,Danny Collins,10835752,5637066,5198686,2015_boxofficemojo_rankings.csv,2015,0.5202284068516887,0.47977159314831125
1962,"Where'd You Go, Bernadette",10834213,9198356,1635857,2019_boxofficemojo_rankings.csv,2019,0.8490100757664631,0.15098992423353685
1963,Flying Monsters 3D with David Attenborough,10813862,5705874,5107988,2011_boxofficemojo_rankings.csv,2011,0.5276444252756324,0.4723555747243677
1964,Golden Slumber,10733326,94450,10638876,2018_boxofficemojo_rankings.csv,2018,0.008799695453208073,0.991200304546792
1965,Our Kind of Traitor,10711027,3153157,7557870,2016_boxofficemojo_rankings.csv,2016,0.2943841893032293,0.7056158106967707
1966,Prom,10702246,10130219,572027,2011_boxofficemojo_rankings.csv,2011,0.9465507520570916,0.05344924794290843
1967,Impractical Jokers: The Movie,10691091,10691091,0,2020_boxofficemojo_rankings.csv,2020,1.0,0.0
1968,The Sessions,10656155,6002451,4653704,2012_boxofficemojo_rankings.csv,2012,0.563284880897472,0.4367151191025281
1969,Red Joan,10647493,1579730,9067763,2018_boxofficemojo_rankings.csv,2018,0.14836638070576802,0.851633619294232
1970,Only God Forgives,10635126,779188,9855938,2013_boxofficemojo_rankings.csv,2013,0.07326551655335348,0.9267344834466466
1971,My Old Lady,10606667,4013786,6592881,2014_boxofficemojo_rankings.csv,2014,0.37842104404710736,0.6215789559528927
1972,The Phone,10551318,40516,10510802,2015_boxofficemojo_rankings.csv,2015,0.0038398994324690054,0.996160100567531
1973,Moms' Night Out,10536956,10429707,107249,2014_boxofficemojo_rankings.csv,2014,0.9898216334964292,0.01017836650357086
1974,Get Low,10522511,9176933,1345578,2010_boxofficemojo_rankings.csv,2010,0.8721238685329006,0.12787613146709945
1975,The Leisure Seeker,10472180,3226443,7245737,2017_boxofficemojo_rankings.csv,2017,0.308096594978314,0.691903405021686
1976,Mood Indigo,10435322,303187,10132135,2013_boxofficemojo_rankings.csv,2013,0.029053918987837653,0.9709460810121624
1977,Furious,10433259,9996,10423263,2017_boxofficemojo_rankings.csv,2017,0.0009580898931005164,0.9990419101068995
1978,Every Day,10421847,6102076,4319771,2018_boxofficemojo_rankings.csv,2018,0.5855081157879213,0.4144918842120787
1979,The Perfect Match,10414738,9669521,745217,2016_boxofficemojo_rankings.csv,2016,0.9284459196189093,0.07155408038109072
1980,Swing Kids,10397408,222001,10175407,2018_boxofficemojo_rankings.csv,2018,0.0213515714685814,0.9786484285314186
1981,Lobster Cop,10373129,85693,10287436,2018_boxofficemojo_rankings.csv,2018,0.008261056042010082,0.9917389439579899
1982,Queen of Katwe,10367161,8874389,1492772,2016_boxofficemojo_rankings.csv,2016,0.8560095671322168,0.14399043286778318
1983,I'm Your Hero,10338463,274579,10063884,2014_boxofficemojo_rankings.csv,2014,0.026558976900144634,0.9734410230998554
1984,Kin,10313019,5718096,4594923,2018_boxofficemojo_rankings.csv,2018,0.5544541321993104,0.4455458678006896
1985,The Babadook,10312540,964413,9348127,2014_boxofficemojo_rankings.csv,2014,0.09351847362531442,0.9064815263746856
1986,3-D Sex and Zen: Extreme Ecstasy,10306807,153215,10153592,2011_boxofficemojo_rankings.csv,2011,0.014865418553000944,0.9851345814469991
1987,Stone,10300416,1810078,8490338,2010_boxofficemojo_rankings.csv,2010,0.17572863076598072,0.8242713692340193
1988,English Vinglish,10299150,1862086,8437064,2012_boxofficemojo_rankings.csv,2012,0.18079996892947475,0.8192000310705252
1989,Girls vs Gangsters,10265819,37115,10228704,2018_boxofficemojo_rankings.csv,2018,0.0036153959075257416,0.9963846040924743
1990,Chennai Express,10234653,5307960,4926693,2013_boxofficemojo_rankings.csv,2013,0.5186262787805312,0.4813737212194688
1991,The Miracle Season,10230620,10230620,0,2018_boxofficemojo_rankings.csv,2018,1.0,0.0
1992,Babies,10219306,7320323,2898983,2010_boxofficemojo_rankings.csv,2010,0.7163229088159215,0.28367709118407847
1993,The Best of Enemies,10209813,10205616,4197,2019_boxofficemojo_rankings.csv,2019,0.9995889248902012,0.0004110751097987789
1994,My Spy,10200000,0,10200000,2020_boxofficemojo_rankings.csv,2020,0.0,1.0
1995,Senna,10197661,1612430,8585231,2010_boxofficemojo_rankings.csv,2010,0.15811763109207103,0.841882368907929
1996,BTS World Tour: Love Yourself in Seoul,10195760,3509917,6685843,2019_boxofficemojo_rankings.csv,2019,0.34425261088923237,0.6557473891107676
1997,For Greater Glory: The True Story of Cristiada,10173682,5672846,4500836,2012_boxofficemojo_rankings.csv,2012,0.557600090114867,0.44239990988513306
1998,Ben Is Back,10134204,3703184,6431020,2018_boxofficemojo_rankings.csv,2018,0.36541439268441805,0.634585607315582
1999,Trespass,10117966,24094,10093872,2011_boxofficemojo_rankings.csv,2011,0.00238130865432835,0.9976186913456716
2000,Marshall,10116816,10051659,65157,2017_boxofficemojo_rankings.csv,2017,0.9935595349366836,0.006440465063316364
2001,Iron Sky,10109659,122082,9987577,2012_boxofficemojo_rankings.csv,2012,0.012075778223578065,0.9879242217764219
2002,Bernie,10090641,9206470,884171,2012_boxofficemojo_rankings.csv,2012,0.9123771225237326,0.08762287747626736
2003,A Little Chaos,10084623,558173,9526450,2015_boxofficemojo_rankings.csv,2015,0.05534892082728328,0.9446510791727167
2004,Gladiators of Rome,10079201,8201,10071000,2012_boxofficemojo_rankings.csv,2012,0.000813655764975815,0.9991863442350242
2005,Papillon,10060903,2335896,7725007,2018_boxofficemojo_rankings.csv,2018,0.23217558105867833,0.7678244189413217
2006,The King's Choice,10017316,113231,9904085,2016_boxofficemojo_rankings.csv,2016,0.01130352681297066,0.9886964731870294
2007,Thank You for Your Service,9995692,9536300,459392,2017_boxofficemojo_rankings.csv,2017,0.9540410008631719,0.045958999136828146
2008,Alan Partridge,9979601,153426,9826175,2013_boxofficemojo_rankings.csv,2013,0.015373961343745106,0.9846260386562549
2009,Cyrus,9933873,7468936,2464937,2010_boxofficemojo_rankings.csv,2010,0.7518654607321837,0.24813453926781628
2010,The Goldfinch,9932621,5332621,4600000,2019_boxofficemojo_rankings.csv,2019,0.5368795406569927,0.4631204593430073
2011,The Collection,9929706,6842058,3087648,2012_boxofficemojo_rankings.csv,2012,0.6890494038796314,0.3109505961203685
2012,Portrait of a Lady on Fire,9919850,3759854,6159996,2019_boxofficemojo_rankings.csv,2019,0.37902327152124277,0.6209767284787573
2013,Never Let Me Go,9904795,2434652,7470143,2010_boxofficemojo_rankings.csv,2010,0.24580539021756634,0.7541946097824337
2014,The Princess and the Matchmaker,9899017,78900,9820117,2018_boxofficemojo_rankings.csv,2018,0.007970488382836398,0.9920295116171636
2015,Arctic Dogs,9877855,5801249,4076606,2019_boxofficemojo_rankings.csv,2019,0.5872984570030639,0.41270154299693607
2016,Young & Beautiful,9757417,61067,9696350,2013_boxofficemojo_rankings.csv,2013,0.0062585210819625725,0.9937414789180374
2017,Tamjung Hong Gil-dong: Sarajin Ma-eul,9754195,67054,9687141,2016_boxofficemojo_rankings.csv,2016,0.006874375589169583,0.9931256244108304
2018,Maudie,9733932,6170998,3562934,2017_boxofficemojo_rankings.csv,2017,0.6339676504828675,0.3660323495171324
2019,Popstar: Never Stop Never Stopping,9680029,9639125,40904,2016_boxofficemojo_rankings.csv,2016,0.9957743928246496,0.0042256071753504045
2020,Tod@s Caen,9667157,2670925,6996232,2019_boxofficemojo_rankings.csv,2019,0.2762885717072765,0.7237114282927235
2021,In Darkness,9661759,1041455,8620304,2012_boxofficemojo_rankings.csv,2012,0.10779144874137307,0.892208551258627
2022,Overdrive,9650552,7793,9642759,2017_boxofficemojo_rankings.csv,2017,0.0008075185751032687,0.9991924814248967
2023,On the Road,9617377,744296,8873081,2012_boxofficemojo_rankings.csv,2012,0.07739074801788472,0.9226092519821153
2024,Paterson,9588282,2152738,7435544,2016_boxofficemojo_rankings.csv,2016,0.22451759345417668,0.7754824065458233
2025,Hysteria,9584256,1804139,7780117,2011_boxofficemojo_rankings.csv,2011,0.1882398592024253,0.8117601407975746
2026,God of War,9559524,53000,9506524,2017_boxofficemojo_rankings.csv,2017,0.005544209104972172,0.9944557908950278
2027,Agent Vinod,9520886,698210,8822676,2012_boxofficemojo_rankings.csv,2012,0.07333456151034683,0.9266654384896532
2028,Traffik,9515914,9186156,329758,2018_boxofficemojo_rankings.csv,2018,0.9653466813592473,0.034653318640752745
2029,The Young and Prodigious T.S. Spivet,9494789,173564,9321225,2013_boxofficemojo_rankings.csv,2013,0.01827992175497528,0.9817200782450247
2030,The Square,9493791,1502347,7991444,2017_boxofficemojo_rankings.csv,2017,0.15824521521487042,0.8417547847851296
2031,Point Blank,9487445,708215,8779230,2010_boxofficemojo_rankings.csv,2010,0.07464760006513872,0.9253523999348613
2032,Our Time Will Come,9484714,114560,9370154,2017_boxofficemojo_rankings.csv,2017,0.012078382120957996,0.987921617879042
2033,The Mayor 2017 Re-release,9476194,96777,9379417,2017_boxofficemojo_rankings.csv,2017,0.010212644443539252,0.9897873555564608
2034,Official Secrets,9473603,1988546,7485057,2019_boxofficemojo_rankings.csv,2019,0.20990387712045777,0.7900961228795422
2035,Promare,9467336,2313596,7153740,2019_boxofficemojo_rankings.csv,2019,0.2443766651991648,0.7556233348008352
2036,Peepli [Live],9460931,757951,8702980,2010_boxofficemojo_rankings.csv,2010,0.08011378584200646,0.9198862141579935
2037,The Big Bad Fox and Other Tales,9399067,35787,9363280,2017_boxofficemojo_rankings.csv,2017,0.0038075055747554517,0.9961924944252446
2038,Bel Ami,9374932,120462,9254470,2012_boxofficemojo_rankings.csv,2012,0.01284937320078695,0.9871506267992131
2039,You Were Never Really Here,9360514,2528078,6832436,2017_boxofficemojo_rankings.csv,2017,0.2700789721590075,0.7299210278409924
2040,Jexi,9341824,6546159,2795665,2019_boxofficemojo_rankings.csv,2019,0.7007367083772933,0.29926329162270665
2041,Saving Private Perez,9330465,1400726,7929739,2011_boxofficemojo_rankings.csv,2011,0.15012392201246133,0.8498760779875387
2042,Replicas,9330075,4046429,5283646,2018_boxofficemojo_rankings.csv,2018,0.4336973711358162,0.5663026288641838
2043,MacGruber,9322895,8525600,797295,2010_boxofficemojo_rankings.csv,2010,0.9144798906348296,0.08552010936517036
2044,Peeples,9307166,9177065,130101,2013_boxofficemojo_rankings.csv,2013,0.9860214161861945,0.013978583813805406
2045,Mid90s,9303022,7362439,1940583,2018_boxofficemojo_rankings.csv,2018,0.7914029441185886,0.20859705588141145
2046,Jerusalem,9279456,8020721,1258735,2013_boxofficemojo_rankings.csv,2013,0.8643525008362559,0.13564749916374408
2047,Le Chef,9245235,342667,8902568,2012_boxofficemojo_rankings.csv,2012,0.03706417413943507,0.9629358258605649
2048,We Need to Talk About Kevin,9232318,1738692,7493626,2011_boxofficemojo_rankings.csv,2011,0.1883267019181965,0.8116732980818036
2049,The Aftermath,9215591,1618497,7597094,2019_boxofficemojo_rankings.csv,2019,0.17562595822666174,0.8243740417733383
2050,Tulip Fever,9204549,2455635,6748914,2017_boxofficemojo_rankings.csv,2017,0.2667849342754327,0.7332150657245673
2051,My Cousin Rachel,9200168,2716368,6483800,2017_boxofficemojo_rankings.csv,2017,0.2952519997460916,0.7047480002539084
2052,A Hologram for the King,9169507,4212494,4957013,2016_boxofficemojo_rankings.csv,2016,0.4594024520620356,0.5405975479379644
2053,Unfinished Song,9166865,1702668,7464197,2013_boxofficemojo_rankings.csv,2013,0.18574158122760617,0.8142584187723938
2054,The Raid: Redemption,9148519,4105187,5043332,2012_boxofficemojo_rankings.csv,2012,0.4487269469517416,0.5512730530482585
2055,Ruby Sparks,9128263,2540106,6588157,2012_boxofficemojo_rankings.csv,2012,0.2782682751362444,0.7217317248637556
2056,My Piece of the Pie,9123187,6850,9116337,2011_boxofficemojo_rankings.csv,2011,0.0007508341109307526,0.9992491658890692
2057,Searching for Sugar Man,9122406,3696196,5426210,2012_boxofficemojo_rankings.csv,2012,0.40517775683301094,0.5948222431669891
2058,City Of Rock,9118873,312537,8806336,2017_boxofficemojo_rankings.csv,2017,0.034273643245168565,0.9657263567548314
2059,Human Capital,9113941,158549,8955392,2014_boxofficemojo_rankings.csv,2014,0.017396316258795178,0.9826036837412048
2060,Miss Sloane,9101546,3500605,5600941,2016_boxofficemojo_rankings.csv,2016,0.3846165255880704,0.6153834744119295
2061,Inception 10th Anniversary re-release,9100000,0,9100000,2020_boxofficemojo_rankings.csv,2020,0.0,1.0
2062,Meet the Blacks,9097072,9097072,0,2016_boxofficemojo_rankings.csv,2016,1.0,0.0
2063,Tolkien,9090040,4535154,4554886,2019_boxofficemojo_rankings.csv,2019,0.4989146362392245,0.5010853637607755
2064,Murder 2,9078349,59000,9019349,2011_boxofficemojo_rankings.csv,2011,0.006498979054451421,0.9935010209455486
2065,Twice Born,9075131,18295,9056836,2012_boxofficemojo_rankings.csv,2012,0.002015948860683113,0.9979840511393169
2066,Me and Earl and the Dying Girl,9074749,6758416,2316333,2015_boxofficemojo_rankings.csv,2015,0.7447496343976016,0.2552503656023985
2067,Monsieur Lazhar,9074711,2009517,7065194,2012_boxofficemojo_rankings.csv,2012,0.22144143212935377,0.7785585678706463
2068,Anjaana Anjaani,9062995,854757,8208238,2010_boxofficemojo_rankings.csv,2010,0.09431286235951802,0.905687137640482
2069,The Fifth Estate,9058564,3255008,5803556,2013_boxofficemojo_rankings.csv,2013,0.3593293594878835,0.6406706405121165
2070,Frances Ha,9058065,4069826,4988239,2013_boxofficemojo_rankings.csv,2013,0.4493041284203635,0.5506958715796365
2071,Incarnate,9037058,4799774,4237284,2016_boxofficemojo_rankings.csv,2016,0.5311213007596056,0.4688786992403944
2072,Like Crazy,9029150,107362,8921788,2016_boxofficemojo_rankings.csv,2016,0.011890598782831163,0.9881094012171688
2073,Truman,9027600,210840,8816760,2015_boxofficemojo_rankings.csv,2015,0.02335504453010767,0.9766449554698924
2074,"Two Days, One Night",9016922,1436243,7580679,2014_boxofficemojo_rankings.csv,2014,0.15928306799149422,0.8407169320085058
2075,Champion,8974547,97472,8877075,2018_boxofficemojo_rankings.csv,2018,0.010860938162115592,0.9891390618378844
2076,The Lobster 2016 Re-release,8952351,8700374,251977,2016_boxofficemojo_rankings.csv,2016,0.9718535388078506,0.028146461192149416
2077,Downhill,8899195,8287061,612134,2020_boxofficemojo_rankings.csv,2020,0.9312146772826081,0.06878532271739185
2078,Hannah Arendt,8880936,717205,8163731,2013_boxofficemojo_rankings.csv,2013,0.08075781651843905,0.919242183481561
2079,Bluebeard,8855737,43144,8812593,2017_boxofficemojo_rankings.csv,2017,0.0048718700656986535,0.9951281299343013
2080,All Together,8835903,43180,8792723,2012_boxofficemojo_rankings.csv,2012,0.004886880265661585,0.9951131197343385
2081,Morgan,8809407,3915251,4894156,2016_boxofficemojo_rankings.csv,2016,0.4444397903286793,0.5555602096713207
2082,Captive State,8808611,5958315,2850296,2019_boxofficemojo_rankings.csv,2019,0.6764193582847511,0.32358064171524886
2083,The Traitor,8780535,296027,8484508,2019_boxofficemojo_rankings.csv,2019,0.03371400489833478,0.9662859951016652
2084,7 Days in Entebbe,8771432,3326885,5444547,2018_boxofficemojo_rankings.csv,2018,0.379286415262639,0.620713584737361
2085,Sorry We Missed You,8766149,28273,8737876,2019_boxofficemojo_rankings.csv,2019,0.0032252474832449233,0.9967747525167551
2086,Marguerite,8754356,506677,8247679,2015_boxofficemojo_rankings.csv,2015,0.0578771299682124,0.9421228700317876
2087,La folle histoire de Max et Léon,8750678,543,8750135,2016_boxofficemojo_rankings.csv,2016,6.205233468766649e-05,0.9999379476653123
2088,The Villainess,8737458,27741,8709717,2017_boxofficemojo_rankings.csv,2017,0.003174950883884077,0.9968250491161159
2089,Reservation,8726551,651096,8075455,2011_boxofficemojo_rankings.csv,2011,0.07461092016765845,0.9253890798323415
2090,Code Geass: Lelouch of the Re;Surrection 2019 Re-release,8715612,522805,8192807,2019_boxofficemojo_rankings.csv,2019,0.05998488689032967,0.9400151131096703
2091,Mardaani 2,8680109,0,8680109,2019_boxofficemojo_rankings.csv,2019,0.0,1.0
2092,Corpus Christi,8669555,127240,8542315,2019_boxofficemojo_rankings.csv,2019,0.014676647186620305,0.9853233528133797
2093,Le Week-end,8652213,2225098,6427115,2013_boxofficemojo_rankings.csv,2013,0.257170968860799,0.7428290311392011
2094,Himmatwala,8644563,270880,8373683,2013_boxofficemojo_rankings.csv,2013,0.03133530289501042,0.9686646971049896
2095,Pope Francis: A Man of His Word,8608385,2008385,6600000,2018_boxofficemojo_rankings.csv,2018,0.23330566651003642,0.7666943334899635
2096,Space Dogs,8530226,14408,8515818,2010_boxofficemojo_rankings.csv,2010,0.0016890525526521807,0.9983109474473478
2097,Our Brand Is Crisis,8527658,7002261,1525397,2015_boxofficemojo_rankings.csv,2015,0.8211235722633342,0.1788764277366658
2098,What If,8526288,3493000,5033288,2014_boxofficemojo_rankings.csv,2014,0.40967417474052015,0.5903258252594799
2099,Stronger,8503658,4211129,4292529,2017_boxofficemojo_rankings.csv,2017,0.495213824450607,0.504786175549393
2100,Piranha 3DD,8493728,376512,8117216,2012_boxofficemojo_rankings.csv,2012,0.044328238436644074,0.9556717615633559
2101,Amityville: The Awakening,8481997,742,8481255,2017_boxofficemojo_rankings.csv,2017,8.747939901417083e-05,0.9999125206009858
2102,A-X-L,8467697,6501381,1966316,2018_boxofficemojo_rankings.csv,2018,0.767786211528353,0.232213788471647
2103,The Outrage,8457741,44745,8412996,2010_boxofficemojo_rankings.csv,2010,0.005290419746833109,0.9947095802531669
2104,Casa de mi Padre,8446952,5909483,2537469,2012_boxofficemojo_rankings.csv,2012,0.6995994531518588,0.3004005468481412
2105,A Street Cat Named Bob,8446262,82703,8363559,2016_boxofficemojo_rankings.csv,2016,0.009791668787920621,0.9902083312120794
2106,The Way 2010 Re-release,8437872,4430765,4007107,2010_boxofficemojo_rankings.csv,2010,0.5251045524274367,0.4748954475725633
2107,Condorito: The Movie,8431194,447719,7983475,2017_boxofficemojo_rankings.csv,2017,0.053102680355830975,0.946897319644169
2108,Raees,8428190,3262954,5165236,2017_boxofficemojo_rankings.csv,2017,0.38714765566509535,0.6128523443349047
2109,Malang,8397569,0,8397569,2020_boxofficemojo_rankings.csv,2020,0.0,1.0
2110,Filth,8377987,34411,8343576,2013_boxofficemojo_rankings.csv,2013,0.004107311219270214,0.9958926887807298
2111,Easy Money,8369756,205741,8164015,2010_boxofficemojo_rankings.csv,2010,0.024581481228365558,0.9754185187716344
2112,The Love Punch,8366493,266588,8099905,2014_boxofficemojo_rankings.csv,2014,0.031863768965084895,0.9681362310349151
2113,Venus in Fur,8350026,373605,7976421,2013_boxofficemojo_rankings.csv,2013,0.04474297445301368,0.9552570255469863
2114,I Am Not Your Negro,8345298,7123919,1221379,2017_boxofficemojo_rankings.csv,2017,0.8536446511556568,0.14635534884434326
2115,Khatta Meetha,8319469,541904,7777565,2010_boxofficemojo_rankings.csv,2010,0.06513684947921557,0.9348631505207844
2116,Time Renegades,8312361,59425,8252936,2016_boxofficemojo_rankings.csv,2016,0.007148991724493198,0.9928510082755068
2117,London Boulevard,8307227,16075,8291152,2010_boxofficemojo_rankings.csv,2010,0.0019350620850977108,0.9980649379149023
2118,The Office,8290521,63675,8226846,2015_boxofficemojo_rankings.csv,2015,0.007680458200395367,0.9923195417996047
2119,My Worst Nightmare,8226544,21952,8204592,2011_boxofficemojo_rankings.csv,2011,0.0026684352505742387,0.9973315647494257
2120,Cave of Forgotten Dreams,8183347,5304920,2878427,2011_boxofficemojo_rankings.csv,2011,0.6482579805060203,0.35174201949397965
2121,The Big Year,8179416,7204138,975278,2011_boxofficemojo_rankings.csv,2011,0.880764347968119,0.11923565203188101
2122,Walk of Shame,8122990,59209,8063781,2014_boxofficemojo_rankings.csv,2014,0.0072890647409389895,0.992710935259061
2123,Ernest & Celestine,8111137,262075,7849062,2012_boxofficemojo_rankings.csv,2012,0.03231051331027943,0.9676894866897205
2124,The New Year's Eve of Old Lee,8099301,25358,8073943,2016_boxofficemojo_rankings.csv,2016,0.0031308874679432212,0.9968691125320568
2125,The Man Who Invented Christmas,8096007,5676486,2419521,2017_boxofficemojo_rankings.csv,2017,0.7011463799376656,0.29885362006233446
2126,The Company Men,8087000,4441272,3645728,2011_boxofficemojo_rankings.csv,2011,0.5491865957709905,0.4508134042290095
2127,Heroine,8036853,598668,7438185,2012_boxofficemojo_rankings.csv,2012,0.07449035088734358,0.9255096491126564
2128,My King,8003331,54114,7949217,2015_boxofficemojo_rankings.csv,2015,0.0067614347076236135,0.9932385652923764
2129,Disobedience,8003180,3498782,4504398,2018_boxofficemojo_rankings.csv,2018,0.4371739733455951,0.5628260266544048
2130,Life Itself,7997774,4102648,3895126,2018_boxofficemojo_rankings.csv,2018,0.5129737349417476,0.48702626505825247
2131,Denial,7994527,4073489,3921038,2016_boxofficemojo_rankings.csv,2016,0.5095347104337755,0.4904652895662245
2132,Metallica Through the Never,7975812,3419967,4555845,2013_boxofficemojo_rankings.csv,2013,0.42879232860553884,0.5712076713944612
2133,Chasing Mavericks,7942116,6002756,1939360,2012_boxofficemojo_rankings.csv,2012,0.7558131863095428,0.2441868136904573
2134,Suspiria,7942093,2483472,5458621,2018_boxofficemojo_rankings.csv,2018,0.3126974211961507,0.6873025788038493
2135,The Ark of Mr Chow,7894075,54075,7840000,2015_boxofficemojo_rankings.csv,2015,0.006850074264559179,0.9931499257354408
2136,Pavarotti,7885016,4600249,3284767,2019_boxofficemojo_rankings.csv,2019,0.5834165713804512,0.4165834286195488
2137,The Battle of Jangsari,7883200,70853,7812347,2019_boxofficemojo_rankings.csv,2019,0.008987847574589,0.991012152425411
2138,Inside Job,7871522,4312735,3558787,2010_boxofficemojo_rankings.csv,2010,0.5478908653243935,0.4521091346756066
2139,For a Few Bullets,7860447,30142,7830305,2016_boxofficemojo_rankings.csv,2016,0.0038346419739233657,0.9961653580260766
2140,Salut d'Amour,7858183,22480,7835703,2015_boxofficemojo_rankings.csv,2015,0.0028607122028082065,0.9971392877971917
2141,Pele: Birth of a Legend,7846608,57046,7789562,2016_boxofficemojo_rankings.csv,2016,0.007270147814189265,0.9927298521858108
2142,The Lady,7832142,355391,7476751,2011_boxofficemojo_rankings.csv,2011,0.04537596483822689,0.9546240351617731
2143,Renoir,7816573,2293798,5522775,2013_boxofficemojo_rankings.csv,2013,0.2934531539589024,0.7065468460410975
2144,Dongju: The Portrait of a Poet,7809531,56550,7752981,2016_boxofficemojo_rankings.csv,2016,0.007241151869427242,0.9927588481305728
2145,Qué León,7807916,2607916,5200000,2018_boxofficemojo_rankings.csv,2018,0.33400922858288945,0.6659907714171105
2146,Bad Words,7804337,7779614,24723,2014_boxofficemojo_rankings.csv,2014,0.9968321460234226,0.0031678539765773828
2147,Amazing Grace,7796112,4450456,3345656,2018_boxofficemojo_rankings.csv,2018,0.5708558317274046,0.4291441682725954
2148,By the Grace of God,7755652,67059,7688593,2019_boxofficemojo_rankings.csv,2019,0.00864646840781407,0.991353531592186
2149,3 idiotas,7738470,1249233,6489237,2017_boxofficemojo_rankings.csv,2017,0.16143152328561072,0.8385684767143893
2150,Certified Copy,7736632,1373975,6362657,2010_boxofficemojo_rankings.csv,2010,0.17759342825146654,0.8224065717485335
2151,Love Live! Sunshine!! The School Idol Movie: Over The Rainbow,7733048,34135,7698913,2019_boxofficemojo_rankings.csv,2019,0.004414171488396296,0.9955858285116037
2152,Explosion,7731410,122700,7608710,2017_boxofficemojo_rankings.csv,2017,0.015870326369963564,0.9841296736300365
2153,Cedar Rapids,7728936,6861102,867834,2011_boxofficemojo_rankings.csv,2011,0.8877162393374716,0.11228376066252845
2154,Spirited Away Studio Ghibli Fest 2020,7724266,0,7724266,2020_boxofficemojo_rankings.csv,2020,0.0,1.0
2155,My Mother,7723656,303002,7420654,2015_boxofficemojo_rankings.csv,2015,0.03923038519581918,0.9607696148041808
2156,The Sweeney,7708312,26650,7681662,2012_boxofficemojo_rankings.csv,2012,0.0034573068656276497,0.9965426931343724
2157,Kevin Hart: Laugh at My Pain,7706436,7706436,0,2011_boxofficemojo_rankings.csv,2011,1.0,0.0
2158,BPM (Beats Per Minute),7704369,125189,7579180,2017_boxofficemojo_rankings.csv,2017,0.01624909191135575,0.9837509080886443
2159,Penguins,7699452,7699452,0,2019_boxofficemojo_rankings.csv,2019,1.0,0.0
2160,No,7699095,2343664,5355431,2012_boxofficemojo_rankings.csv,2012,0.30440772584310233,0.6955922741568976
2161,Declaration of War,7691610,59100,7632510,2011_boxofficemojo_rankings.csv,2011,0.007683696911309856,0.9923163030886901
2162,Finding Fanny,7685784,615691,7070093,2014_boxofficemojo_rankings.csv,2014,0.08010776779571219,0.9198922322042878
2163,Leave No Trace,7682928,6046104,1636824,2018_boxofficemojo_rankings.csv,2018,0.7869530991309563,0.21304690086904368
2164,Princess Mononoke Studio Ghibli Fest 2020,7673132,0,7673132,2020_boxofficemojo_rankings.csv,2020,0.0,1.0
2165,Lolo,7663798,24134,7639664,2015_boxofficemojo_rankings.csv,2015,0.0031490913513117125,0.9968509086486883
2166,Pandas,7635778,7574012,61766,2018_boxofficemojo_rankings.csv,2018,0.9919109748869074,0.008089025113092601
2167,Just Getting Started,7634022,6069605,1564417,2017_boxofficemojo_rankings.csv,2017,0.7950730296559271,0.2049269703440729
2168,The White Crow,7622595,1828784,5793811,2019_boxofficemojo_rankings.csv,2019,0.23991619651837728,0.7600838034816227
2169,Fullmetal Alchemist: The Sacred Star of Milos,7621364,177802,7443562,2011_boxofficemojo_rankings.csv,2011,0.023329419773153465,0.9766705802268465
2170,ABCD (Any Body Can Dance),7610738,222098,7388640,2013_boxofficemojo_rankings.csv,2013,0.029182189690408474,0.9708178103095916
2171,Only Lovers Left Alive,7609187,1879534,5729653,2013_boxofficemojo_rankings.csv,2013,0.24700851746710917,0.7529914825328908
2172,Klovn Forever,7585569,5700,7579869,2015_boxofficemojo_rankings.csv,2015,0.0007514268211125625,0.9992485731788875
2173,Burning,7576345,718991,6857354,2018_boxofficemojo_rankings.csv,2018,0.0948994534963759,0.9051005465036241
2174,Miss You Already,7573997,1162653,6411344,2015_boxofficemojo_rankings.csv,2015,0.15350587015019942,0.8464941298498005
2175,Guzaarish,7564310,1017335,6546975,2010_boxofficemojo_rankings.csv,2010,0.13449144733624085,0.8655085526637591
2176,Hippocrates: Diary of a French Doctor,7555591,23050,7532541,2014_boxofficemojo_rankings.csv,2014,0.003050720982647155,0.9969492790173529
2177,"Kiki, Love to Love",7551282,12450,7538832,2016_boxofficemojo_rankings.csv,2016,0.001648726666544833,0.9983512733334552
2178,The Advocate: A Missing Body,7550177,50162,7500015,2015_boxofficemojo_rankings.csv,2015,0.006643817754206292,0.9933561822457937
2179,Take Me Home Tonight,7550073,6928068,622005,2011_boxofficemojo_rankings.csv,2011,0.9176160283483352,0.08238397165166482
2180,A Bigger Splash,7545758,2024099,5521659,2015_boxofficemojo_rankings.csv,2015,0.2682432964322471,0.7317567035677529
2181,Albert Nobbs,7532259,3014696,4517563,2011_boxofficemojo_rankings.csv,2011,0.4002379631396106,0.5997620368603894
2182,Beirut,7509436,5019226,2490210,2018_boxofficemojo_rankings.csv,2018,0.6683892105878524,0.3316107894121476
2183,Where Do We Go Now?,7507008,531997,6975011,2011_boxofficemojo_rankings.csv,2011,0.07086671547439406,0.929133284525606
2184,The Whistleblower,7505141,280851,7224290,2019_boxofficemojo_rankings.csv,2019,0.037421149049698066,0.9625788509503019
2185,Open Season 3,7487555,0,7487555,2010_boxofficemojo_rankings.csv,2010,0.0,1.0
2186,Frantz,7478354,880883,6597471,2016_boxofficemojo_rankings.csv,2016,0.11779102727685799,0.882208972723142
2187,The Tall Man,7462847,0,7462847,2012_boxofficemojo_rankings.csv,2012,0.0,1.0
2188,Big Game,7455398,24752,7430646,2015_boxofficemojo_rankings.csv,2015,0.0033200105480619547,0.996679989451938
2189,Black Nativity,7454185,7018189,435996,2013_boxofficemojo_rankings.csv,2013,0.941509903497163,0.058490096502837
2190,I'll See You in My Dreams,7452512,7449681,2831,2015_boxofficemojo_rankings.csv,2015,0.999620128085671,0.00037987191432902086
2191,Yu-Gi-Oh!: The Dark Side of Dimensions,7445186,1015339,6429847,2016_boxofficemojo_rankings.csv,2016,0.13637523629362652,0.8636247637063735
2192,Brittany Runs a Marathon,7442106,7189808,252298,2019_boxofficemojo_rankings.csv,2019,0.9660985747851482,0.033901425214851816
2193,Mayday Life,7435496,85912,7349584,2019_boxofficemojo_rankings.csv,2019,0.011554306531803662,0.9884456934681963
2194,Genius,7435006,1361045,6073961,2016_boxofficemojo_rankings.csv,2016,0.1830590318286226,0.8169409681713774
2195,Beatriz at Dinner,7425391,7115854,309537,2017_boxofficemojo_rankings.csv,2017,0.958313710348721,0.04168628965127897
2196,God's Not Dead: A Light in Darkness,7414178,5728940,1685238,2018_boxofficemojo_rankings.csv,2018,0.7727006284445828,0.2272993715554172
2197,Goodbye Christopher Robin,7401949,1735251,5666698,2017_boxofficemojo_rankings.csv,2017,0.23443163415473411,0.7655683658452659
2198,The Innocents,7400324,1065665,6334659,2016_boxofficemojo_rankings.csv,2016,0.14400247881038722,0.8559975211896128
2199,Return of the Hero,7362730,37108,7325622,2018_boxofficemojo_rankings.csv,2018,0.005039978377585488,0.9949600216224145
2200,Compadres,7353544,3127773,4225771,2016_boxofficemojo_rankings.csv,2016,0.4253422567404234,0.5746577432595766
2201,The Young Messiah,7330338,6490401,839937,2016_boxofficemojo_rankings.csv,2016,0.8854163341444828,0.11458366585551717
2202,Even the Rain,7313485,518017,6795468,2011_boxofficemojo_rankings.csv,2011,0.07083039070976423,0.9291696092902357
2203,The Beaver,7294800,970816,6323984,2011_boxofficemojo_rankings.csv,2011,0.13308329220814827,0.8669167077918517
2204,The Midwife,7286136,603582,6682554,2017_boxofficemojo_rankings.csv,2017,0.08283979327314231,0.9171602067268577
2205,A Long Way Down,7257942,13347,7244595,2014_boxofficemojo_rankings.csv,2014,0.0018389510414935804,0.9981610489585064
2206,Let There Be Light,7233471,7233471,0,2017_boxofficemojo_rankings.csv,2017,1.0,0.0
2207,Birth of the Dragon,7215027,6901965,313062,2017_boxofficemojo_rankings.csv,2017,0.95660972578481,0.043390274215190046
2208,20th Century Women,7214806,5664764,1550042,2016_boxofficemojo_rankings.csv,2016,0.785158187205588,0.21484181279441195
2209,Animal Kingdom,7208231,1044039,6164192,2010_boxofficemojo_rankings.csv,2010,0.14483983657016541,0.8551601634298346
2210,Grandma,7205073,6980524,224549,2015_boxofficemojo_rankings.csv,2015,0.9688345975120585,0.03116540248794148
2211,Timbuktu,7179391,1076075,6103316,2014_boxofficemojo_rankings.csv,2014,0.1498838829087314,0.8501161170912686
2212,Blade of the Immortal,7162617,150532,7012085,2017_boxofficemojo_rankings.csv,2017,0.021016340815095937,0.978983659184904
2213,Wild Rose,7123449,1635117,5488332,2019_boxofficemojo_rankings.csv,2019,0.22954007251262695,0.770459927487373
2214,Baar Baar Dekho,7122579,981947,6140632,2016_boxofficemojo_rankings.csv,2016,0.13786396753198527,0.8621360324680147
2215,Postman Pat: The Movie,7102455,1519,7100936,2014_boxofficemojo_rankings.csv,2014,0.00021386971124773055,0.9997861302887523
2216,Incendies,7099598,2071334,5028264,2011_boxofficemojo_rankings.csv,2011,0.2917537021110209,0.7082462978889791
2217,In Safe Hands,7086596,1737,7084859,2018_boxofficemojo_rankings.csv,2018,0.0002451106285725897,0.9997548893714274
2218,The Map Against the World,7035812,34034,7001778,2016_boxofficemojo_rankings.csv,2016,0.004837252615618496,0.9951627473843815
2219,The Joneses,7031729,1475746,5555983,2010_boxofficemojo_rankings.csv,2010,0.2098695783071276,0.7901304216928724
2220,Cosmopolis,7029095,763556,6265539,2012_boxofficemojo_rankings.csv,2012,0.10862792436295142,0.8913720756370486
2221,The Killing of a Sacred Deer,7027336,2291901,4735435,2017_boxofficemojo_rankings.csv,2017,0.3261408021474994,0.6738591978525006
2222,The Kid with a Bike,7011798,1470000,5541798,2011_boxofficemojo_rankings.csv,2011,0.20964665553685374,0.7903533444631463
2223,Jessabelle,6998359,0,6998359,2014_boxofficemojo_rankings.csv,2014,0.0,1.0
2224,Goon,6985158,4168528,2816630,2012_boxofficemojo_rankings.csv,2012,0.5967693214670305,0.40323067853296946
2225,The Princess of Montpensier,6965201,352428,6612773,2010_boxofficemojo_rankings.csv,2010,0.05059839622718713,0.9494016037728129
2226,11-11-11,6963872,32771,6931101,2011_boxofficemojo_rankings.csv,2011,0.004705859039339034,0.9952941409606609
2227,The Salesman,6953604,2402067,4551537,2016_boxofficemojo_rankings.csv,2016,0.3454420182685123,0.6545579817314877
2228,What We Do in the Shadows,6946808,3469224,3477584,2014_boxofficemojo_rankings.csv,2014,0.49939828479497345,0.5006017152050265
2229,The Spectacular Now,6918591,6854611,63980,2013_boxofficemojo_rankings.csv,2013,0.9907524523418135,0.009247547658186472
2230,Hasee Toh Phasee,6914987,646035,6268952,2014_boxofficemojo_rankings.csv,2014,0.09342533832673872,0.9065746616732613
2231,Don 2,6913518,3680306,3233212,2011_boxofficemojo_rankings.csv,2011,0.5323347679141068,0.46766523208589317
2232,Centurion,6890432,123570,6766862,2010_boxofficemojo_rankings.csv,2010,0.01793356352693126,0.9820664364730688
2233,Barbara,6889185,1013902,5875283,2012_boxofficemojo_rankings.csv,2012,0.147172996515553,0.852827003484447
2234,The Awakening,6879667,209696,6669971,2011_boxofficemojo_rankings.csv,2011,0.03048054506126532,0.9695194549387347
2235,Talvar,6879098,342370,6536728,2015_boxofficemojo_rankings.csv,2015,0.049769606422237336,0.9502303935777626
2236,Dog Days,6842356,6809080,33276,2018_boxofficemojo_rankings.csv,2018,0.995136762834322,0.004863237165678021
2237,Commitment,6834802,76543,6758259,2013_boxofficemojo_rankings.csv,2013,0.011199007666937535,0.9888009923330625
2238,Collide,6817535,2280004,4537531,2016_boxofficemojo_rankings.csv,2016,0.3344323131454404,0.6655676868545596
2239,Race 3,6817391,1690861,5126530,2018_boxofficemojo_rankings.csv,2018,0.2480217138785204,0.7519782861214797
2240,Bran Nue Dae,6812530,113568,6698962,2010_boxofficemojo_rankings.csv,2010,0.016670458698897474,0.9833295413011025
2241,The Names of Love,6803887,514237,6289650,2010_boxofficemojo_rankings.csv,2010,0.07557988543901449,0.9244201145609855
2242,Baahubali: The Beginning,6787855,6738000,49855,2015_boxofficemojo_rankings.csv,2015,0.9926552644392079,0.007344735560792032
2243,A Little Bit of Heaven,6778388,15375,6763013,2011_boxofficemojo_rankings.csv,2011,0.002268238407125706,0.9977317615928742
2244,The Sun Is also a Star,6750029,4950029,1800000,2019_boxofficemojo_rankings.csv,2019,0.7333344790074235,0.26666552099257645
2245,A Letter to Momo,6748888,71712,6677176,2012_boxofficemojo_rankings.csv,2012,0.010625750494007309,0.9893742495059927
2246,Midnight Special,6740647,3712282,3028365,2016_boxofficemojo_rankings.csv,2016,0.5507308126356416,0.44926918736435834
2247,Wild Card,6738764,0,6738764,2015_boxofficemojo_rankings.csv,2015,0.0,1.0
2248,Churchill,6724365,1281258,5443107,2017_boxofficemojo_rankings.csv,2017,0.19053962716182124,0.8094603728381787
2249,Cesar Chavez 2014 Re-release,6719925,5571497,1148428,2014_boxofficemojo_rankings.csv,2014,0.8291010688363337,0.17089893116366625
2250,Pati Patni Aur Woh,6712525,874044,5838481,2019_boxofficemojo_rankings.csv,2019,0.13021091169120413,0.8697890883087959
2251,Jab Tak Hai Jaan,6703114,3047539,3655575,2012_boxofficemojo_rankings.csv,2012,0.45464525890504026,0.5453547410949597
2252,Bleed for This,6698679,5083906,1614773,2016_boxofficemojo_rankings.csv,2016,0.7589415763914049,0.24105842360859506
2253,Innocence,6682271,294039,6388232,2014_boxofficemojo_rankings.csv,2014,0.04400285471810407,0.9559971452818959
2254,Fahrenheit 11/9,6674168,6352306,321862,2018_boxofficemojo_rankings.csv,2018,0.9517749628118441,0.048225037188155885
2255,Son of Saul,6659121,1777043,4882078,2015_boxofficemojo_rankings.csv,2015,0.2668584937861919,0.7331415062138081
2256,The Conquest,6637166,74474,6562692,2011_boxofficemojo_rankings.csv,2011,0.011220752953896287,0.9887792470461038
2257,Southside with You,6628603,6304223,324380,2016_boxofficemojo_rankings.csv,2016,0.9510635951496869,0.04893640485031311
2258,Pieta,6616296,22080,6594216,2012_boxofficemojo_rankings.csv,2012,0.003337214659078131,0.9966627853409219
2259,The Red Turtle,6591789,921974,5669815,2016_boxofficemojo_rankings.csv,2016,0.13986703761300612,0.8601329623869939
2260,Soorma,6579645,390077,6189568,2018_boxofficemojo_rankings.csv,2018,0.05928541737434163,0.9407145826256583
2261,The Raid 2,6566916,2627209,3939707,2014_boxofficemojo_rankings.csv,2014,0.4000673984561398,0.5999326015438602
2262,A Melody to Remember,6559996,44263,6515733,2016_boxofficemojo_rankings.csv,2016,0.006747412650861372,0.9932525873491387
2263,From the Land of the Moon,6547983,47748,6500235,2016_boxofficemojo_rankings.csv,2016,0.007292016488130773,0.9927079835118692
2264,Chhapaak,6532100,604334,5927766,2020_boxofficemojo_rankings.csv,2020,0.09251756709174691,0.907482432908253
2265,The Measure of a Man,6518931,112391,6406540,2015_boxofficemojo_rankings.csv,2015,0.017240710171652376,0.9827592898283476
2266,National Theatre Live: Fleabag,6508794,326283,6182511,2019_boxofficemojo_rankings.csv,2019,0.05012956317253242,0.9498704368274675
2267,The Lobster,6504366,376871,6127495,2015_boxofficemojo_rankings.csv,2015,0.057941235164195866,0.9420587648358041
2268,Wadjda,6499169,1347747,5151422,2012_boxofficemojo_rankings.csv,2012,0.20737220404639423,0.7926277959536058
2269,It's Kind of a Funny Story,6491240,6363628,127612,2010_boxofficemojo_rankings.csv,2010,0.9803408901843099,0.01965910981569007
2270,Everybody Loves Somebody,6481798,1915789,4566009,2017_boxofficemojo_rankings.csv,2017,0.2955644406073747,0.7044355593926254
2271,Gloria,6461559,2107925,4353634,2013_boxofficemojo_rankings.csv,2013,0.32622545116433976,0.6737745488356602
2272,Waiting for 'Superman',6433688,6417135,16553,2010_boxofficemojo_rankings.csv,2010,0.9974271366594091,0.002572863340590964
2273,Run the Race,6424420,6424420,0,2019_boxofficemojo_rankings.csv,2019,1.0,0.0
2274,Same Kind of Different as Me,6423605,6423605,0,2017_boxofficemojo_rankings.csv,2017,1.0,0.0
2275,Gotti,6412349,4343227,2069122,2018_boxofficemojo_rankings.csv,2018,0.6773223041977284,0.3226776958022715
2276,The Mustang,6405816,5043620,1362196,2019_boxofficemojo_rankings.csv,2019,0.7873501205779249,0.2126498794220752
2277,A Journey Through Time with Antony,6389648,127381,6262267,2015_boxofficemojo_rankings.csv,2015,0.01993552696486567,0.9800644730351343
2278,"Farewell, My Queen",6366835,1597998,4768837,2012_boxofficemojo_rankings.csv,2012,0.25098781419653565,0.7490121858034644
2279,Greenberg,6344112,4234170,2109942,2010_boxofficemojo_rankings.csv,2010,0.6674172839319357,0.3325827160680644
2280,Hector and the Search for Happiness,6337728,1124445,5213283,2014_boxofficemojo_rankings.csv,2014,0.17742083598412553,0.8225791640158745
2281,Hampstead,6335171,144396,6190775,2017_boxofficemojo_rankings.csv,2017,0.02279275492326884,0.9772072450767312
2282,Closed Circuit,6331939,5750401,581538,2013_boxofficemojo_rankings.csv,2013,0.9081579907829181,0.09184200921708184
2283,Sheng zhe wei wang,6313827,163406,6150421,2015_boxofficemojo_rankings.csv,2015,0.02588065843425865,0.9741193415657413
2284,Lowriders,6312033,6303560,8473,2017_boxofficemojo_rankings.csv,2017,0.9986576432664405,0.0013423567335595363
2285,Absolutely Anything,6303792,20169,6283623,2015_boxofficemojo_rankings.csv,2015,0.003199502775472287,0.9968004972245277
2286,A Late Quartet,6303709,1562548,4741161,2012_boxofficemojo_rankings.csv,2012,0.24787755906879586,0.7521224409312042
2287,My Boyfriend's Meds,6292780,2971116,3321664,2020_boxofficemojo_rankings.csv,2020,0.47214680951820975,0.5278531904817902
2288,Max Steel,6272403,3818664,2453739,2016_boxofficemojo_rankings.csv,2016,0.6088039942586597,0.3911960057413403
2289,Norman,6217567,3814868,2402699,2017_boxofficemojo_rankings.csv,2017,0.6135628293189281,0.38643717068107186
2290,Unbroken: Path to Redemption,6216897,6216897,0,2018_boxofficemojo_rankings.csv,2018,1.0,0.0
2291,Attack the Block,6206022,1024175,5181847,2011_boxofficemojo_rankings.csv,2011,0.16502922484000218,0.8349707751599978
2292,Great Expectations,6202879,258656,5944223,2012_boxofficemojo_rankings.csv,2012,0.041699346384154845,0.9583006536158452
2293,The Snitch Cartel,6197324,0,6197324,2012_boxofficemojo_rankings.csv,2012,0.0,1.0
2294,Yeh Jawaani Hai Deewani,6189998,3827466,2362532,2013_boxofficemojo_rankings.csv,2013,0.6183307329016907,0.38166926709830923
2295,Immortal Hero,6180032,43007,6137025,2019_boxofficemojo_rankings.csv,2019,0.006959025454884376,0.9930409745451156
2296,The Autopsy of Jane Doe,6170043,10474,6159569,2016_boxofficemojo_rankings.csv,2016,0.0016975570510610704,0.9983024429489389
2297,Tiger & Bunny: The Rising,6168617,34471,6134146,2014_boxofficemojo_rankings.csv,2014,0.005588124534235146,0.9944118754657648
2298,Darker Than Night,6160114,870063,5290051,2014_boxofficemojo_rankings.csv,2014,0.14124137962381866,0.8587586203761813
2299,The Patriarch,6156936,2156047,4000889,2016_boxofficemojo_rankings.csv,2016,0.3501818112125902,0.6498181887874098
2300,Four Lions,6148687,304616,5844071,2010_boxofficemojo_rankings.csv,2010,0.0495416338480069,0.9504583661519931
2301,Ploey,6146292,77815,6068477,2018_boxofficemojo_rankings.csv,2018,0.012660478870837898,0.9873395211291621
2302,Mobile Suit Gundam Narrative,6126259,259224,5867035,2018_boxofficemojo_rankings.csv,2018,0.04231358811307194,0.957686411886928
2303,The Duelist,6101904,13450,6088454,2016_boxofficemojo_rankings.csv,2016,0.0022042300239400684,0.9977957699760599
2304,The Trip to Italy,6089109,2880537,3208572,2014_boxofficemojo_rankings.csv,2014,0.4730637930771152,0.5269362069228848
2305,Meet the Mormons,6047363,6047363,0,2014_boxofficemojo_rankings.csv,2014,1.0,0.0
2306,She's Funny That Way,6034851,111996,5922855,2015_boxofficemojo_rankings.csv,2015,0.01855820466818485,0.9814417953318152
2307,Matru's Bijlee's Mandola,6009116,0,6009116,2013_boxofficemojo_rankings.csv,2013,0.0,1.0
2308,The Illusionist,6007194,2231474,3775720,2010_boxofficemojo_rankings.csv,2010,0.3714669444669175,0.6285330555330825
2309,Blue Exorcist: The Movie,5994921,21796,5973125,2012_boxofficemojo_rankings.csv,2012,0.0036357443242371335,0.9963642556757629
2310,The Broken Circle Breakdown,5990754,175058,5815696,2012_boxofficemojo_rankings.csv,2012,0.029221363454416588,0.9707786365455834
2311,The Rhythm Section,5989583,5437971,551612,2020_boxofficemojo_rankings.csv,2020,0.9079047740051353,0.09209522599486475
2312,"Cyrano, My Love",5985822,351019,5634803,2019_boxofficemojo_rankings.csv,2019,0.058641737091413675,0.9413582629085864
2313,Learning to Drive,5967516,3447633,2519883,2015_boxofficemojo_rankings.csv,2015,0.5777333483479559,0.4222666516520442
2314,The Immigrant,5952884,2025328,3927556,2013_boxofficemojo_rankings.csv,2013,0.340226350790642,0.659773649209358
2315,All Saints,5942565,5802208,140357,2017_boxofficemojo_rankings.csv,2017,0.9763810745023404,0.02361892549765968
2316,Death of a Nation,5885881,5885881,0,2018_boxofficemojo_rankings.csv,2018,1.0,0.0
2317,Maggie's Plan,5883891,3351735,2532156,2016_boxofficemojo_rankings.csv,2016,0.5696460046591618,0.43035399534083824
2318,Blue Story,5881391,0,5881391,2019_boxofficemojo_rankings.csv,2019,0.0,1.0
2319,Testament of Youth,5874883,1822250,4052633,2015_boxofficemojo_rankings.csv,2015,0.31017638989576474,0.6898236101042353
2320,My Life as a Zucchini,5872598,309766,5562832,2016_boxofficemojo_rankings.csv,2016,0.05274769361022157,0.9472523063897784
2321,Tracks,5853509,510007,5343502,2014_boxofficemojo_rankings.csv,2014,0.08712842160147016,0.9128715783985298
2322,20 Feet from Stardom,5839368,4946445,892923,2013_boxofficemojo_rankings.csv,2013,0.847085677765128,0.152914322234872
2323,Young Goethe in Love,5826565,162138,5664427,2010_boxofficemojo_rankings.csv,2010,0.027827373418128864,0.9721726265818711
2324,Puella Magi Madoka Magica the Movie Part 1: Beginnings,5816330,180440,5635890,2012_boxofficemojo_rankings.csv,2012,0.031022999038912855,0.9689770009610872
2325,Phillauri,5805030,467596,5337434,2017_boxofficemojo_rankings.csv,2017,0.08055014358237597,0.919449856417624
2326,Phoenix,5793245,3184472,2608773,2014_boxofficemojo_rankings.csv,2014,0.5496870924671752,0.4503129075328249
2327,The Wizard of Oz 2013 3D/IMAX Release,5787802,5633202,154600,2013_boxofficemojo_rankings.csv,2013,0.9732886508557135,0.026711349144286554
2328,Dylan Dog: Dead of Night,5782515,1186538,4595977,2011_boxofficemojo_rankings.csv,2011,0.20519410671654115,0.7948058932834589
2329,The Skeleton Twins,5776640,5284309,492331,2014_boxofficemojo_rankings.csv,2014,0.9147720820407711,0.08522791795922889
2330,Furie,5756185,594788,5161397,2019_boxofficemojo_rankings.csv,2019,0.10333024390286275,0.8966697560971373
2331,The Disappointments Room,5745040,2423468,3321572,2016_boxofficemojo_rankings.csv,2016,0.42183657555038784,0.5781634244496122
2332,Under the Skin,5735963,2614251,3121712,2014_boxofficemojo_rankings.csv,2014,0.4557649691952336,0.5442350308047663
2333,The Devil's Double,5728213,1361512,4366701,2011_boxofficemojo_rankings.csv,2011,0.2376852955712366,0.7623147044287634
2334,Kingsglaive: Final Fantasy XV,5725482,269980,5455502,2016_boxofficemojo_rankings.csv,2016,0.04715410859731984,0.9528458914026802
2335,Like for Likes,5715555,50839,5664716,2016_boxofficemojo_rankings.csv,2016,0.008894849231614427,0.9911051507683856
2336,Saaho,5708522,2872057,2836465,2019_boxofficemojo_rankings.csv,2019,0.5031174444103045,0.4968825555896956
2337,My Best Friend's Wedding,5707770,78578,5629192,2016_boxofficemojo_rankings.csv,2016,0.013766847648030668,0.9862331523519693
2338,Bill & Ted Face the Music,5698881,3353535,2345346,2020_boxofficemojo_rankings.csv,2020,0.5884549966914557,0.41154500330854427
2339,The Viral Factor,5687319,220496,5466823,2012_boxofficemojo_rankings.csv,2012,0.03876976128822737,0.9612302387117726
2340,Wish I Was Here,5670776,3591299,2079477,2014_boxofficemojo_rankings.csv,2014,0.6332993932400081,0.36670060675999194
2341,Mission Mangal,5667057,3659413,2007644,2019_boxofficemojo_rankings.csv,2019,0.6457342850089561,0.35426571499104387
2342,Anomalisa,5659286,3759286,1900000,2015_boxofficemojo_rankings.csv,2015,0.6642686020816053,0.3357313979183946
2343,Incident in a Ghostland,5643957,0,5643957,2018_boxofficemojo_rankings.csv,2018,0.0,1.0
2344,Things to Come,5638693,388140,5250553,2016_boxofficemojo_rankings.csv,2016,0.0688351006164017,0.9311648993835983
2345,Pagalpanti,5633633,423340,5210293,2019_boxofficemojo_rankings.csv,2019,0.07514511506163074,0.9248548849383692
2346,Wazir,5633588,1124045,4509543,2016_boxofficemojo_rankings.csv,2016,0.19952559541095302,0.800474404589047
2347,Dalida,5623134,3465,5619669,2017_boxofficemojo_rankings.csv,2017,0.0006162044155447833,0.9993837955844552
2348,Mother and Child,5621971,1110509,4511462,2010_boxofficemojo_rankings.csv,2010,0.19753019003477607,0.802469809965224
2349,Solitary Man,5615390,4360548,1254842,2010_boxofficemojo_rankings.csv,2010,0.7765352005826843,0.22346479941731562
2350,El Angel,5604680,109608,5495072,2018_boxofficemojo_rankings.csv,2018,0.01955651348515883,0.9804434865148411
2351,The Party,5597950,749827,4848123,2017_boxofficemojo_rankings.csv,2017,0.13394671263587563,0.8660532873641243
2352,Fathers & Daughters,5587709,0,5587709,2015_boxofficemojo_rankings.csv,2015,0.0,1.0
2353,The French Minister,5586646,12027,5574619,2013_boxofficemojo_rankings.csv,2013,0.0021528122598066892,0.9978471877401933
2354,Destroyer,5580940,1533324,4047616,2018_boxofficemojo_rankings.csv,2018,0.2747429644468495,0.7252570355531506
2355,Pawn Sacrifice,5578519,2436633,3141886,2014_boxofficemojo_rankings.csv,2014,0.4367885096384901,0.56321149036151
2356,Knock Knock,5567103,36336,5530767,2015_boxofficemojo_rankings.csv,2015,0.00652691354911163,0.9934730864508884
2357,Dheepan,5562575,261819,5300756,2014_boxofficemojo_rankings.csv,2014,0.047067949645622754,0.9529320503543772
2358,Escobar: Paradise Lost,5552496,195792,5356704,2014_boxofficemojo_rankings.csv,2014,0.03526197947733776,0.9647380205226622
2359,Ek Tha Tiger,5543117,2347774,3195343,2012_boxofficemojo_rankings.csv,2012,0.42354761770318033,0.5764523822968196
2360,Last Cab to Darwin,5543036,34193,5508843,2015_boxofficemojo_rankings.csv,2015,0.006168641156218361,0.9938313588437816
2361,On My Way,5505705,317324,5188381,2013_boxofficemojo_rankings.csv,2013,0.057635489006403355,0.9423645109935966
2362,Warriors of the Dawn,5497176,84532,5412644,2017_boxofficemojo_rankings.csv,2017,0.015377350115768533,0.9846226498842314
2363,Tale of Tales,5497104,118925,5378179,2015_boxofficemojo_rankings.csv,2015,0.021634118619549492,0.9783658813804506
2364,A Wizard's Tale,5487261,2150,5485111,2018_boxofficemojo_rankings.csv,2018,0.0003918166094158816,0.9996081833905841
2365,Chalet Girl,5468650,1710,5466940,2011_boxofficemojo_rankings.csv,2011,0.00031269143207190075,0.9996873085679281
2366,Man of Tai Chi,5464885,100144,5364741,2013_boxofficemojo_rankings.csv,2013,0.018324996774863513,0.9816750032251365
2367,Thank You,5452347,463540,4988807,2011_boxofficemojo_rankings.csv,2011,0.08501659927367058,0.9149834007263294
2368,OK Jaanu,5445281,355922,5089359,2017_boxofficemojo_rankings.csv,2017,0.0653633852871872,0.9346366147128128
2369,Hara-Kiri: Death of a Samurai,5435358,75688,5359670,2011_boxofficemojo_rankings.csv,2011,0.013925117719936755,0.9860748822800632
2370,An Inconvenient Sequel: Truth to Power,5433926,3496795,1937131,2017_boxofficemojo_rankings.csv,2017,0.6435117077413274,0.3564882922586726
2371,The Salt of the Earth,5412189,1343349,4068840,2014_boxofficemojo_rankings.csv,2014,0.24820807255622448,0.7517919274437755
2372,The Student and Mister Henri,5411932,761,5411171,2015_boxofficemojo_rankings.csv,2015,0.00014061521837303203,0.999859384781627
2373,Lady Macbeth,5401447,1129408,4272039,2017_boxofficemojo_rankings.csv,2017,0.2090936002889596,0.7909063997110404
2374,Exit Through the Gift Shop,5386242,3291250,2094992,2010_boxofficemojo_rankings.csv,2010,0.6110475541202939,0.3889524458797061
2375,Truth,5383097,2541854,2841243,2015_boxofficemojo_rankings.csv,2015,0.4721917513282781,0.5278082486717218
2376,After the Storm,5382886,272132,5110754,2016_boxofficemojo_rankings.csv,2016,0.05055503683340126,0.9494449631665988
2377,Madame,5381950,90979,5290971,2017_boxofficemojo_rankings.csv,2017,0.016904467711517202,0.9830955322884828
2378,Won't Back Down,5378228,5310554,67674,2012_boxofficemojo_rankings.csv,2012,0.9874170451680367,0.012582954831963242
2379,Intruders,5348049,69136,5278913,2011_boxofficemojo_rankings.csv,2011,0.01292733106970411,0.9870726689302959
2380,Much Ado About Nothing,5341221,4328849,1012372,2013_boxofficemojo_rankings.csv,2013,0.8104605669752291,0.18953943302477091
2381,Trollhunter,5341098,253444,5087654,2010_boxofficemojo_rankings.csv,2010,0.04745166630531775,0.9525483336946823
2382,Sky on fire,5335450,78366,5257084,2016_boxofficemojo_rankings.csv,2016,0.014687795781049395,0.9853122042189506
2383,Force,5310437,0,5310437,2011_boxofficemojo_rankings.csv,2011,0.0,1.0
2384,The Meddler 2016 Re-release,5294643,4267218,1027425,2016_boxofficemojo_rankings.csv,2016,0.80595008955278,0.19404991044721995
2385,Don't Let Go,5288011,5215062,72949,2019_boxofficemojo_rankings.csv,2019,0.9862048320247443,0.013795167975255724
2386,Talaash,5277766,2871956,2405810,2012_boxofficemojo_rankings.csv,2012,0.5441612985494241,0.45583870145057587
2387,Mustang,5274664,845464,4429200,2015_boxofficemojo_rankings.csv,2015,0.16028774534264173,0.8397122546573582
2388,True Story,5261595,4719695,541900,2015_boxofficemojo_rankings.csv,2015,0.8970084166493241,0.10299158335067599
2389,The War with Grandpa,5259376,3608000,1651376,2020_boxofficemojo_rankings.csv,2020,0.686012941459215,0.31398705854078507
2390,Les Misérables: The Staged Concert,5257431,459478,4797953,2019_boxofficemojo_rankings.csv,2019,0.08739591637056197,0.912604083629438
2391,The Truth,5252668,9619,5243049,2019_boxofficemojo_rankings.csv,2019,0.0018312598473766094,0.9981687401526234
2392,The Biggest Little Farm,5248412,4366949,881463,2019_boxofficemojo_rankings.csv,2019,0.8320514852873593,0.1679485147126407
2393,Tucker and Dale vs Evil,5224938,223838,5001100,2010_boxofficemojo_rankings.csv,2010,0.042840316956871065,0.9571596830431289
2394,Kill the Messenger,5218973,2450846,2768127,2014_boxofficemojo_rankings.csv,2014,0.4696031192343781,0.5303968807656219
2395,The New Girlfriend,5215796,146754,5069042,2014_boxofficemojo_rankings.csv,2014,0.028136453189503578,0.9718635468104965
2396,Mountains May Depart,5210160,82913,5127247,2015_boxofficemojo_rankings.csv,2015,0.015913714741965696,0.9840862852580343
2397,Zindagi Na Milegi Dobara,5192743,3108485,2084258,2011_boxofficemojo_rankings.csv,2011,0.5986209985743566,0.4013790014256434
2398,Oldboy,5186767,2193658,2993109,2013_boxofficemojo_rankings.csv,2013,0.422933592351459,0.577066407648541
2399,MI-5,5161464,0,5161464,2015_boxofficemojo_rankings.csv,2015,0.0,1.0
2400,October Baby 2012 Re-release,5157886,5157886,0,2012_boxofficemojo_rankings.csv,2012,1.0,0.0
2401,Rabbit Hole,5140925,2229058,2911867,2010_boxofficemojo_rankings.csv,2010,0.43359084211498905,0.566409157885011
2402,The Legend of Chupacabras,5138140,0,5138140,2016_boxofficemojo_rankings.csv,2016,0.0,1.0
2403,Never Look Away,5105444,1304042,3801402,2018_boxofficemojo_rankings.csv,2018,0.25542185948959584,0.7445781405104042
2404,In the Fade,5104991,321011,4783980,2017_boxofficemojo_rankings.csv,2017,0.06288179548210761,0.9371182045178924
2405,"Good Day, Ramon",5104868,154356,4950512,2014_boxofficemojo_rankings.csv,2014,0.030237020820126984,0.969762979179873
2406,Action Point,5103663,5059608,44055,2018_boxofficemojo_rankings.csv,2018,0.9913679645384109,0.008632035461589058
2407,Serena,5092129,176391,4915738,2014_boxofficemojo_rankings.csv,2014,0.03463993154925965,0.9653600684507403
2408,Dark Places,5090852,208588,4882264,2014_boxofficemojo_rankings.csv,2014,0.04097310234121911,0.9590268976587809
2409,Locke,5090608,1375769,3714839,2014_boxofficemojo_rankings.csv,2014,0.2702563230168184,0.7297436769831815
2410,The Liberator,5082098,113067,4969031,2014_boxofficemojo_rankings.csv,2014,0.02224809517644091,0.9777519048235591
2411,The Sense of an Ending,5081495,1274420,3807075,2017_boxofficemojo_rankings.csv,2017,0.2507962715696857,0.7492037284303144
2412,Dogman,5080147,148225,4931922,2018_boxofficemojo_rankings.csv,2018,0.029177305302385936,0.9708226946976141
2413,Anthropoid,5079219,2964845,2114374,2016_boxofficemojo_rankings.csv,2016,0.583720646815977,0.416279353184023
2414,Konosuba!: God's Blessing on This Wonderful World! - Legend of Crimson,5078942,1134786,3944156,2019_boxofficemojo_rankings.csv,2019,0.22342960403958148,0.7765703959604185
2415,Doctor Who: The Day of the Doctor,5074950,0,5074950,2013_boxofficemojo_rankings.csv,2013,0.0,1.0
2416,Stand Up Guys,5072654,3310031,1762623,2013_boxofficemojo_rankings.csv,2013,0.652524497038434,0.3474755029615661
2417,Mr. X,5061387,44995,5016392,2015_boxofficemojo_rankings.csv,2015,0.008889855685803121,0.9911101443141969
2418,Monsters,5060438,237301,4823137,2010_boxofficemojo_rankings.csv,2010,0.04689337168047509,0.9531066283195249
2419,Table 19,5042014,3614896,1427118,2017_boxofficemojo_rankings.csv,2017,0.7169547724381566,0.28304522756184336
2420,Kedi,5037923,2835047,2202876,2017_boxofficemojo_rankings.csv,2017,0.562741232845361,0.4372587671546389
2421,The Real Exorcist,5035830,0,5035830,2020_boxofficemojo_rankings.csv,2020,0.0,1.0
2422,Breathe,5026154,490131,4536023,2017_boxofficemojo_rankings.csv,2017,0.09751611271759679,0.9024838872824033
2423,Oranges and Sunshine,5017653,143480,4874173,2011_boxofficemojo_rankings.csv,2011,0.028595042343502033,0.9714049576564979
2424,Double Lover,5012423,167581,4844842,2017_boxofficemojo_rankings.csv,2017,0.03343313204013309,0.9665668679598669
2425,Worlds Apart,5011560,60298,4951262,2015_boxofficemojo_rankings.csv,2015,0.012031782518816496,0.9879682174811835
2426,Blindspotting,5006989,4333394,673595,2018_boxofficemojo_rankings.csv,2018,0.8654690473655924,0.13453095263440762
2427,Hands of Stone,4978353,4712792,265561,2016_boxofficemojo_rankings.csv,2016,0.9466568561932028,0.053343143806797146
2428,Take This Waltz,4965950,1239692,3726258,2012_boxofficemojo_rankings.csv,2012,0.24963843776115346,0.7503615622388465
2429,The Professor and the Madman,4957273,0,4957273,2019_boxofficemojo_rankings.csv,2019,0.0,1.0
2430,Swiss Army Man,4935501,4210454,725047,2016_boxofficemojo_rankings.csv,2016,0.8530955621323955,0.14690443786760451
2431,Nymphomaniac: Vol. II,4934725,327167,4607558,2014_boxofficemojo_rankings.csv,2014,0.06629893256463126,0.9337010674353687
2432,Sgt. Stubby: An American Hero,4932694,4015935,916759,2018_boxofficemojo_rankings.csv,2018,0.8141463873493876,0.18585361265061243
2433,Desierto,4924990,2002036,2922954,2016_boxofficemojo_rankings.csv,2016,0.4065055969656791,0.5934944030343209
2434,[REC] 4: Apocalypse,4915757,837,4914920,2014_boxofficemojo_rankings.csv,2014,0.00017026879074779326,0.9998297312092522
2435,Panga,4886124,582720,4303404,2020_boxofficemojo_rankings.csv,2020,0.11926017432222351,0.8807398256777765
2436,Samson,4873825,4719928,153897,2018_boxofficemojo_rankings.csv,2018,0.9684237739352561,0.03157622606474381
2437,The Young Karl Marx,4870373,125659,4744714,2017_boxofficemojo_rankings.csv,2017,0.02580069329392225,0.9741993067060778
2438,Back To The Future Day,4850000,1650000,3200000,2015_boxofficemojo_rankings.csv,2015,0.3402061855670103,0.6597938144329897
2439,90 Minutes in Heaven,4842699,4842699,0,2015_boxofficemojo_rankings.csv,2015,1.0,0.0
2440,RamLeela,4840059,2738863,2101196,2013_boxofficemojo_rankings.csv,2013,0.565873887074517,0.4341261129254829
2441,Antebellum,4831009,0,4831009,2020_boxofficemojo_rankings.csv,2020,0.0,1.0
2442,Jimmy's Hall,4825184,560592,4264592,2014_boxofficemojo_rankings.csv,2014,0.11618043995835185,0.8838195600416482
2443,Predestination,4824499,68372,4756127,2014_boxofficemojo_rankings.csv,2014,0.014171834215324742,0.9858281657846752
2444,Capital,4822849,101700,4721149,2012_boxofficemojo_rankings.csv,2012,0.021087120911311964,0.9789128790886881
2445,Mazinger Z: INFINITY,4812371,220682,4591689,2017_boxofficemojo_rankings.csv,2017,0.04585722921196225,0.9541427707880378
2446,Trash,4809022,17484,4791538,2014_boxofficemojo_rankings.csv,2014,0.00363566646191263,0.9963643335380874
2447,Robot & Frank,4806423,3325038,1481385,2012_boxofficemojo_rankings.csv,2012,0.6917905477732609,0.3082094522267391
2448,Burke and Hare,4791599,4833,4786766,2010_boxofficemojo_rankings.csv,2010,0.0010086403307121485,0.9989913596692879
2449,A Royal Night Out,4779170,228136,4551034,2015_boxofficemojo_rankings.csv,2015,0.04773548545040247,0.9522645145495975
2450,Martha Marcy May Marlene,4778439,2990625,1787814,2011_boxofficemojo_rankings.csv,2011,0.6258581515846493,0.3741418484153507
2451,Gladiator 20th Anniversary,4777216,0,4777216,2020_boxofficemojo_rankings.csv,2020,0.0,1.0
2452,Men & Chicken,4765472,30207,4735265,2015_boxofficemojo_rankings.csv,2015,0.00633872153692226,0.9936612784630777
2453,Slack Bay,4734494,112621,4621873,2016_boxofficemojo_rankings.csv,2016,0.023787336091248612,0.9762126639087514
2454,The Double,4729855,137921,4591934,2011_boxofficemojo_rankings.csv,2011,0.02915966768537302,0.970840332314627
2455,Clouds of Sils Maria,4728401,1851517,2876884,2014_boxofficemojo_rankings.csv,2014,0.3915735996164454,0.6084264003835546
2456,Sweet Bean,4720010,124800,4595210,2015_boxofficemojo_rankings.csv,2015,0.026440621947834857,0.9735593780521652
2457,Girl in Progress,4709246,2609412,2099834,2012_boxofficemojo_rankings.csv,2012,0.5541039903203188,0.4458960096796812
2458,"Jeff, Who Lives at Home",4704757,4269426,435331,2012_boxofficemojo_rankings.csv,2012,0.9074700351155225,0.09252996488447757
2459,Unlocked,4699125,0,4699125,2017_boxofficemojo_rankings.csv,2017,0.0,1.0
2460,Menteur,4697364,4697364,0,2019_boxofficemojo_rankings.csv,2019,1.0,0.0
2461,Jay and Silent Bob Reboot,4691248,4589490,101758,2019_boxofficemojo_rankings.csv,2019,0.9783089702356388,0.02169102976436121
2462,Keith Lemon: The Film,4682943,0,4682943,2012_boxofficemojo_rankings.csv,2012,0.0,1.0
2463,The Runaways,4681651,3573673,1107978,2010_boxofficemojo_rankings.csv,2010,0.7633360538835552,0.2366639461164448
2464,Warriors of the Rainbow: Seediq Bale I,4670432,136166,4534266,2011_boxofficemojo_rankings.csv,2011,0.029154904728299225,0.9708450952717008
2465,Where to Invade Next,4664756,3827261,837495,2016_boxofficemojo_rankings.csv,2016,0.8204632782507809,0.17953672174921903
2466,A Simple Life,4663094,191826,4471268,2012_boxofficemojo_rankings.csv,2012,0.041137064790029966,0.95886293520997
2467,Tubelight,4650456,930058,3720398,2017_boxofficemojo_rankings.csv,2017,0.19999286091514468,0.8000071390848553
2468,The SpongeBob Movie: Sponge on the Run,4649790,4649790,0,2020_boxofficemojo_rankings.csv,2020,1.0,0.0
2469,Gemma Bovery,4644525,191533,4452992,2014_boxofficemojo_rankings.csv,2014,0.04123844741927323,0.9587615525807268
2470,Everybody Wants Some!!,4644472,3400278,1244194,2016_boxofficemojo_rankings.csv,2016,0.7321129290907556,0.26788707090924435
2471,Housefull 4,4634173,2109160,2525013,2019_boxofficemojo_rankings.csv,2019,0.4551319081096023,0.5448680918903978
2472,Dear White People,4633961,4404154,229807,2014_boxofficemojo_rankings.csv,2014,0.9504080850054629,0.04959191499453707
2473,Killer Joe,4633668,1987762,2645906,2012_boxofficemojo_rankings.csv,2012,0.428982395803929,0.5710176041960711
2474,Hamlet 2018 Re-release,4630718,235229,4395489,2018_boxofficemojo_rankings.csv,2018,0.050797522112121705,0.9492024778878783
2475,Atlas Shrugged: Part I,4627375,4627375,0,2011_boxofficemojo_rankings.csv,2011,1.0,0.0
2476,Heneral Luna,4625639,206040,4419599,2015_boxofficemojo_rankings.csv,2015,0.044543035027160574,0.9554569649728394
2477,Bad Samaritan,4623836,3435047,1188789,2018_boxofficemojo_rankings.csv,2018,0.742899834682718,0.257100165317282
2478,The Last Black Man in San Francisco,4607017,4515719,91298,2019_boxofficemojo_rankings.csv,2019,0.9801828384831226,0.019817161516877405
2479,Whitney,4605123,3026351,1578772,2018_boxofficemojo_rankings.csv,2018,0.6571705033720054,0.3428294966279945
2480,A Hidden Life,4604834,1730597,2874237,2019_boxofficemojo_rankings.csv,2019,0.37582179943945865,0.6241782005605414
2481,The Guilty,4598051,207140,4390911,2018_boxofficemojo_rankings.csv,2018,0.04504952206924195,0.954950477930758
2482,The Book of Henry,4596705,4504974,91731,2017_boxofficemojo_rankings.csv,2017,0.9800441838229775,0.019955816177022453
2483,Labyrinth of Lies,4574756,794452,3780304,2014_boxofficemojo_rankings.csv,2014,0.17365997224770022,0.8263400277522998
2484,The Broken Hearts Gallery,4573894,3947336,626558,2020_boxofficemojo_rankings.csv,2020,0.8630143155919223,0.13698568440807768
2485,Find a Boyfriend for My Wife... PLEASE!,4570757,1741889,2828868,2016_boxofficemojo_rankings.csv,2016,0.38109420387038734,0.6189057961296127
2486,The Beach Bum,4554416,3502600,1051816,2019_boxofficemojo_rankings.csv,2019,0.7690557911266779,0.23094420887332207
2487,The Iceman,4552970,1969193,2583777,2013_boxofficemojo_rankings.csv,2013,0.432507352343635,0.567492647656365
2488,Colossal,4531320,3029287,1502033,2017_boxofficemojo_rankings.csv,2017,0.6685219759363717,0.33147802406362825
2489,Cezanne et Moi,4529583,257597,4271986,2016_boxofficemojo_rankings.csv,2016,0.05686991495685144,0.9431300850431485
2490,"Juliet, Naked",4511157,3444895,1066262,2018_boxofficemojo_rankings.csv,2018,0.7636389068258985,0.23636109317410145
2491,Maps to the Stars,4510934,350741,4160193,2014_boxofficemojo_rankings.csv,2014,0.07775352066778188,0.9222464793322181
2492,Simon and the Oaks,4505573,150664,4354909,2011_boxofficemojo_rankings.csv,2011,0.03343947595566646,0.9665605240443336
2493,Barfi!,4490134,2804874,1685260,2012_boxofficemojo_rankings.csv,2012,0.6246748983437911,0.3753251016562089
2494,Rundskop,4483147,151840,4331307,2011_boxofficemojo_rankings.csv,2011,0.03386906563625953,0.9661309343637404
2495,Woman at War,4481653,847495,3634158,2018_boxofficemojo_rankings.csv,2018,0.189103217049602,0.810896782950398
2496,The Wall,4476705,1803064,2673641,2017_boxofficemojo_rankings.csv,2017,0.4027658735610231,0.5972341264389769
2497,Batman: The Killing Joke,4462034,3775000,687034,2016_boxofficemojo_rankings.csv,2016,0.8460267223423219,0.1539732776576781
2498,Flypaper,4453634,5043,4448591,2011_boxofficemojo_rankings.csv,2011,0.0011323337301628288,0.9988676662698371
2499,Buck,4448728,4038912,409816,2011_boxofficemojo_rankings.csv,2011,0.9078801850776221,0.09211981492237781
2500,In Harm's Way,4447734,0,4447734,2017_boxofficemojo_rankings.csv,2017,0.0,1.0
2501,Mental,4446852,17669,4429183,2012_boxofficemojo_rankings.csv,2012,0.003973372624049553,0.9960266273759505
2502,Leviathan,4439481,1092800,3346681,2014_boxofficemojo_rankings.csv,2014,0.24615489963804327,0.7538451003619567
2503,Swift,4428275,0,4428275,2019_boxofficemojo_rankings.csv,2019,0.0,1.0
2504,Samsara,4426444,2672413,1754031,2012_boxofficemojo_rankings.csv,2012,0.6037381247791681,0.3962618752208319
2505,Safety Not Guaranteed,4424699,4010957,413742,2012_boxofficemojo_rankings.csv,2012,0.906492622436012,0.09350737756398797
2506,Don't Think Twice,4417667,4417667,0,2016_boxofficemojo_rankings.csv,2016,1.0,0.0
2507,The Commune,4410339,38737,4371602,2016_boxofficemojo_rankings.csv,2016,0.008783225053675013,0.991216774946325
2508,Thérèse,4408087,101944,4306143,2012_boxofficemojo_rankings.csv,2012,0.02312658529652432,0.9768734147034757
2509,The Eagle Huntress,4400140,3169351,1230789,2016_boxofficemojo_rankings.csv,2016,0.7202841273232216,0.27971587267677844
2510,360,4396975,100343,4296632,2012_boxofficemojo_rankings.csv,2012,0.02282091665292616,0.9771790833470738
2511,Kabali,4388789,3903095,485694,2016_boxofficemojo_rankings.csv,2016,0.8893330255794936,0.11066697442050644
2512,White Elephant,4387907,8884,4379023,2012_boxofficemojo_rankings.csv,2012,0.0020246554906473632,0.9979753445093527
2513,Clown,4381603,55007,4326596,2014_boxofficemojo_rankings.csv,2014,0.012554081234653163,0.9874459187653468
2514,Brian Banks,4376819,4376819,0,2019_boxofficemojo_rankings.csv,2019,1.0,0.0
2515,Seven Days in Utopia,4373074,4373074,0,2011_boxofficemojo_rankings.csv,2011,1.0,0.0
2516,There Be Dragons,4372642,1069334,3303308,2011_boxofficemojo_rankings.csv,2011,0.24455100600506513,0.7554489939949349
2517,Mark Felt: The Man Who Brought Down the White House,4372130,768946,3603184,2017_boxofficemojo_rankings.csv,2017,0.17587445935962562,0.8241255406403744
2518,Demolition,4366460,1978592,2387868,2016_boxofficemojo_rankings.csv,2016,0.4531341177979416,0.5468658822020585
2519,King of Devil's Island,4360391,7615,4352776,2010_boxofficemojo_rankings.csv,2010,0.0017464030175275566,0.9982535969824724
2520,Blinky Bill the Movie,4344536,0,4344536,2015_boxofficemojo_rankings.csv,2015,0.0,1.0
2521,Standing Tall,4323120,26144,4296976,2015_boxofficemojo_rankings.csv,2015,0.006047484224356484,0.9939525157756435
2522,Storm Boy,4322950,71760,4251190,2018_boxofficemojo_rankings.csv,2018,0.01659977561618802,0.983400224383812
2523,Please Give,4313829,4033574,280255,2010_boxofficemojo_rankings.csv,2010,0.9350333543587379,0.06496664564126209
2524,The Grand Seduction,4292517,3430018,862499,2014_boxofficemojo_rankings.csv,2014,0.7990691708384614,0.20093082916153857
2525,High-Rise,4286576,346472,3940104,2016_boxofficemojo_rankings.csv,2016,0.08082721500796906,0.9191727849920309
2526,The Other Side of Hope,4282973,183943,4099030,2017_boxofficemojo_rankings.csv,2017,0.042947503988467826,0.9570524960115322
2527,Clueless 25th Anniversary,4263607,0,4263607,2020_boxofficemojo_rankings.csv,2020,0.0,1.0
2528,Linda Ronstadt: The Sound of My Voice,4252657,4252657,0,2019_boxofficemojo_rankings.csv,2019,1.0,0.0
2529,"Don't Worry, He Won't Get Far on Foot",4241656,1441705,2799951,2018_boxofficemojo_rankings.csv,2018,0.3398920138738266,0.6601079861261734
2530,Branded,4227984,353513,3874471,2012_boxofficemojo_rankings.csv,2012,0.08361266267800446,0.9163873373219955
2531,Dabangg 2,4216988,2519190,1697798,2012_boxofficemojo_rankings.csv,2012,0.5973908391487004,0.40260916085129955
2532,The Rabbi's Cat,4208573,23392,4185181,2011_boxofficemojo_rankings.csv,2011,0.005558178508487319,0.9944418214915127
2533,Diplomacy,4207242,230880,3976362,2014_boxofficemojo_rankings.csv,2014,0.05487680528003856,0.9451231947199614
2534,Let the Sunshine In,4192590,892421,3300169,2017_boxofficemojo_rankings.csv,2017,0.2128567305651161,0.7871432694348839
2535,Sheep & Wolves,4190750,0,4190750,2016_boxofficemojo_rankings.csv,2016,0.0,1.0
2536,Song of the Sea,4190670,857522,3333148,2014_boxofficemojo_rankings.csv,2014,0.20462646784404404,0.795373532155956
2537,Tanu Weds Manu Returns,4180081,3043479,1136602,2015_boxofficemojo_rankings.csv,2015,0.7280909149846618,0.2719090850153382
2538,Nitro Circus: The Movie,4174269,3377618,796651,2012_boxofficemojo_rankings.csv,2012,0.8091519736749117,0.1908480263250883
2539,Krrish 3,4170204,2191534,1978670,2013_boxofficemojo_rankings.csv,2013,0.5255220128319862,0.47447798716801387
2540,The Guardians,4167608,177331,3990277,2017_boxofficemojo_rankings.csv,2017,0.04254982714305184,0.9574501728569481
2541,A Quiet Passion,4159246,1865396,2293850,2016_boxofficemojo_rankings.csv,2016,0.44849378949934676,0.5515062105006533
2542,Savage,4140502,74491,4066011,2019_boxofficemojo_rankings.csv,2019,0.01799081367428394,0.9820091863257161
2543,The Last Princess,4135255,29259,4105996,2016_boxofficemojo_rankings.csv,2016,0.007075500785320373,0.9929244992146796
2544,Ghost Stories,4131358,148747,3982611,2018_boxofficemojo_rankings.csv,2018,0.03600438403062625,0.9639956159693738
2545,Military Wives,4127775,0,4127775,2020_boxofficemojo_rankings.csv,2020,0.0,1.0
2546,Apartment 143,4126744,383,4126361,2012_boxofficemojo_rankings.csv,2012,9.280924622414184e-05,0.9999071907537759
2547,Arctic 2019 Re-release,4124015,2410795,1713220,2019_boxofficemojo_rankings.csv,2019,0.5845747408775186,0.41542525912248135
2548,Carancho,4120012,85526,4034486,2010_boxofficemojo_rankings.csv,2010,0.02075867740191048,0.9792413225980895
2549,The Fall of the American Empire,4110928,2178460,1932468,2018_boxofficemojo_rankings.csv,2018,0.5299192785667859,0.4700807214332141
2550,Naam Hai Akira,4108063,219401,3888662,2016_boxofficemojo_rankings.csv,2016,0.05340740879582421,0.9465925912041758
2551,The Hero,4101699,4077333,24366,2017_boxofficemojo_rankings.csv,2017,0.9940595348415376,0.005940465158462384
2552,Force Majeure,4094339,1359497,2734842,2014_boxofficemojo_rankings.csv,2014,0.3320430965779824,0.6679569034220175
2553,2001: A Space Odyssey 2018 Re-release,4084582,3236321,848261,2018_boxofficemojo_rankings.csv,2018,0.7923261180703436,0.20767388192965644
2554,Tere Naal Love Ho Gaya,4083976,177743,3906233,2012_boxofficemojo_rankings.csv,2012,0.043522048121732354,0.9564779518782677
2555,American Animals,4080073,2856954,1223119,2018_boxofficemojo_rankings.csv,2018,0.700221295060162,0.2997787049398381
2556,Katti Batti,4079135,364932,3714203,2015_boxofficemojo_rankings.csv,2015,0.08946308469810389,0.9105369153018961
2557,From Prada to Nada,4058694,3033623,1025071,2011_boxofficemojo_rankings.csv,2011,0.7474382153471043,0.25256178465289575
2558,2 Days in New York,4058113,633210,3424903,2012_boxofficemojo_rankings.csv,2012,0.15603557614093053,0.8439644238590694
2559,The Killer Inside Me,4050140,217277,3832863,2010_boxofficemojo_rankings.csv,2010,0.053646787518456154,0.9463532124815438
2560,Film Stars Don't Die in Liverpool,4047917,1026124,3021793,2017_boxofficemojo_rankings.csv,2017,0.2534943280704619,0.7465056719295381
2561,Love in the Buff,4045381,256451,3788930,2012_boxofficemojo_rankings.csv,2012,0.06339353450268342,0.9366064654973165
2562,Junglee,4033587,295784,3737803,2019_boxofficemojo_rankings.csv,2019,0.07333026410487738,0.9266697358951226
2563,Rare Exports,4028971,236347,3792624,2010_boxofficemojo_rankings.csv,2010,0.05866187669258478,0.9413381233074152
2564,Vulgaria,4028543,59059,3969484,2012_boxofficemojo_rankings.csv,2012,0.014660138913746235,0.9853398610862537
2565,Jeepers Creepers III,4017852,2335162,1682690,2017_boxofficemojo_rankings.csv,2017,0.5811966194872284,0.4188033805127715
2566,A Perfect Day,4009440,14044,3995396,2015_boxofficemojo_rankings.csv,2015,0.0035027335488247734,0.9964972664511752
2567,Penguin Highway,4006647,104567,3902080,2018_boxofficemojo_rankings.csv,2018,0.026098381015347744,0.9739016189846522
2568,Faces Places,3998450,953717,3044733,2017_boxofficemojo_rankings.csv,2017,0.23852167714989558,0.7614783228501044
2569,Ride Your Wave,3995885,332432,3663453,2019_boxofficemojo_rankings.csv,2019,0.08319358540098126,0.9168064145990188
2570,Digimon Adventure: Last Evolution Kizuna,3989892,0,3989892,2020_boxofficemojo_rankings.csv,2020,0.0,1.0
2571,Sleight,3989705,3986245,3460,2017_boxofficemojo_rankings.csv,2017,0.999132767961541,0.0008672320384589838
2572,The Invisible Woman,3986888,1234254,2752634,2013_boxofficemojo_rankings.csv,2013,0.3095782976597286,0.6904217023402714
2573,The Nile Hilton Incident,3979536,81089,3898447,2017_boxofficemojo_rankings.csv,2017,0.02037649615432553,0.9796235038456744
2574,Ip Man: The Final Fight,3967001,37884,3929117,2013_boxofficemojo_rankings.csv,2013,0.009549783324985298,0.9904502166750146
2575,Lucifer,3956978,0,3956978,2019_boxofficemojo_rankings.csv,2019,0.0,1.0
2576,Break Ke Baad,3954699,427628,3527071,2010_boxofficemojo_rankings.csv,2010,0.10813161760224987,0.8918683823977501
2577,The Devil's Violinist,3952097,11294,3940803,2013_boxofficemojo_rankings.csv,2013,0.002857723380777344,0.9971422766192226
2578,Bully 2012 Re-release,3950244,3863446,86798,2012_boxofficemojo_rankings.csv,2012,0.978027180093179,0.021972819906820946
2579,2:22,3945729,422,3945307,2017_boxofficemojo_rankings.csv,2017,0.00010695108559153454,0.9998930489144084
2580,The Wretched,3935238,1814193,2121045,2020_boxofficemojo_rankings.csv,2020,0.46101226914356896,0.538987730856431
2581,Terminator 2: Judgment Day 2017 Re-release,3931111,1037809,2893302,2017_boxofficemojo_rankings.csv,2017,0.2639989051441183,0.7360010948558817
2582,Welcome to the Punch,3926386,9747,3916639,2013_boxofficemojo_rankings.csv,2013,0.002482435501756577,0.9975175644982435
2583,Loveless,3925992,566356,3359636,2017_boxofficemojo_rankings.csv,2017,0.1442580626756244,0.8557419373243756
2584,Seven Sins Forgiven,3924850,270207,3654643,2011_boxofficemojo_rankings.csv,2011,0.06884517879664191,0.9311548212033581
2585,Indignation,3924527,3401155,523372,2016_boxofficemojo_rankings.csv,2016,0.86664074422217,0.13335925577783003
2586,A Private War,3915207,1633208,2281999,2018_boxofficemojo_rankings.csv,2018,0.4171447384518877,0.5828552615481123
2587,The To Do List,3909596,3491669,417927,2013_boxofficemojo_rankings.csv,2013,0.8931022540436403,0.10689774595635969
2588,The Starving Games,3906308,0,3906308,2013_boxofficemojo_rankings.csv,2013,0.0,1.0
2589,Taxi,3906227,321642,3584585,2015_boxofficemojo_rankings.csv,2015,0.08234083682284721,0.9176591631771528
2590,The Wall,3889260,38674,3850586,2012_boxofficemojo_rankings.csv,2012,0.009943793935093051,0.990056206064907
2591,Rules Don't Apply,3885342,3652206,233136,2016_boxofficemojo_rankings.csv,2016,0.9399960157947486,0.06000398420525143
2592,Neruda,3884746,939101,2945645,2016_boxofficemojo_rankings.csv,2016,0.2417406440472556,0.7582593559527444
2593,The Perfect Game,3878993,1037071,2841922,2010_boxofficemojo_rankings.csv,2010,0.26735572866463025,0.7326442713353698
2594,"The Night Is Short, Walk on Girl",3878208,406490,3471718,2017_boxofficemojo_rankings.csv,2017,0.10481387279898345,0.8951861272010165
2595,Django,3876874,56556,3820318,2017_boxofficemojo_rankings.csv,2017,0.014588041808941946,0.9854119581910581
2596,Horns,3875442,173948,3701494,2014_boxofficemojo_rankings.csv,2014,0.044884686701542685,0.9551153132984573
2597,Submarine,3875173,467602,3407571,2011_boxofficemojo_rankings.csv,2011,0.1206660967136177,0.8793339032863823
2598,First Reformed,3862498,3448256,414242,2018_boxofficemojo_rankings.csv,2018,0.8927528247263817,0.10724717527361827
2599,Frozen,3843774,246176,3597598,2010_boxofficemojo_rankings.csv,2010,0.06404538872472731,0.9359546112752727
2600,Marley,3842919,1413480,2429439,2012_boxofficemojo_rankings.csv,2012,0.36781415377217164,0.6321858462278284
2601,To Save a Life,3824868,3777210,47658,2010_boxofficemojo_rankings.csv,2010,0.9875399621634001,0.012460037836599852
2602,Elles,3822241,157508,3664733,2012_boxofficemojo_rankings.csv,2012,0.04120828592440927,0.9587917140755907
2603,The Other Son,3820405,1285918,2534487,2012_boxofficemojo_rankings.csv,2012,0.3365920628833854,0.6634079371166146
2604,The Homesman,3819421,2429989,1389432,2014_boxofficemojo_rankings.csv,2014,0.6362192070473509,0.3637807929526491
2605,Infidel,3819389,3819389,0,2020_boxofficemojo_rankings.csv,2020,1.0,0.0
2606,Brad's Status,3816527,2133158,1683369,2017_boxofficemojo_rankings.csv,2017,0.558926479493005,0.441073520506995
2607,Sweet 20,3810429,71775,3738654,2015_boxofficemojo_rankings.csv,2015,0.01883646172123926,0.9811635382787607
2608,Custody,3790303,83882,3706421,2018_boxofficemojo_rankings.csv,2018,0.022130684538940553,0.9778693154610595
2609,The Paperboy,3783865,693286,3090579,2012_boxofficemojo_rankings.csv,2012,0.18322165299237683,0.8167783470076232
2610,Citizenfour,3780692,2800870,979822,2014_boxofficemojo_rankings.csv,2014,0.7408352756585302,0.25916472434146975
2611,Green Room,3769214,3220371,548843,2016_boxofficemojo_rankings.csv,2016,0.8543879440116693,0.1456120559883307
2612,Black Sea,3758103,1171559,2586544,2014_boxofficemojo_rankings.csv,2014,0.3117421209583665,0.6882578790416335
2613,The Trip,3741198,2030962,1710236,2011_boxofficemojo_rankings.csv,2011,0.542864077228738,0.457135922771262
2614,Take Shelter,3741098,1730296,2010802,2011_boxofficemojo_rankings.csv,2011,0.46251020422346595,0.5374897957765341
2615,Like Crazy,3731489,3395391,336098,2011_boxofficemojo_rankings.csv,2011,0.9099292534427945,0.09007074655720544
2616,Ragnarok,3721345,1369,3719976,2013_boxofficemojo_rankings.csv,2013,0.00036787774312782074,0.9996321222568721
2617,Free Fire,3719383,1799312,1920071,2017_boxofficemojo_rankings.csv,2017,0.4837662590811433,0.5162337409188567
2618,Summertime,3719031,35322,3683709,2015_boxofficemojo_rankings.csv,2015,0.009497635271123043,0.990502364728877
2619,Night of 7 Years,3716820,24281,3692539,2018_boxofficemojo_rankings.csv,2018,0.006532734972368853,0.9934672650276312
2620,The Last King,3705618,8905,3696713,2016_boxofficemojo_rankings.csv,2016,0.0024031079296354886,0.9975968920703645
2621,A Fantastic Woman,3702353,2020988,1681365,2017_boxofficemojo_rankings.csv,2017,0.5458658318102029,0.4541341681897971
2622,Spare Parts,3701281,3618912,82369,2015_boxofficemojo_rankings.csv,2015,0.9777458128685718,0.02225418713142828
2623,Western Stars,3681681,1581681,2100000,2019_boxofficemojo_rankings.csv,2019,0.4296083772602787,0.5703916227397213
2624,1911,3680151,135739,3544412,2011_boxofficemojo_rankings.csv,2011,0.03688408437588566,0.9631159156241144
2625,Gosnell: The Trial of America's Biggest Serial Killer,3679893,3679893,0,2018_boxofficemojo_rankings.csv,2018,1.0,0.0
2626,5 Flights Up,3679847,1020921,2658926,2015_boxofficemojo_rankings.csv,2015,0.2774357194742064,0.7225642805257936
2627,Love Crime,3663918,539792,3124126,2010_boxofficemojo_rankings.csv,2010,0.1473264412576919,0.8526735587423081
2628,Number One Fan,3650598,15549,3635049,2014_boxofficemojo_rankings.csv,2014,0.004259302174602627,0.9957406978253974
2629,Non-Fiction,3649042,704919,2944123,2018_boxofficemojo_rankings.csv,2018,0.19317919607392844,0.8068208039260716
2630,A la mala,3646627,3629842,16785,2015_boxofficemojo_rankings.csv,2015,0.9953971162940438,0.0046028837059562165
2631,Celeste & Jesse Forever,3640975,3094813,546162,2012_boxofficemojo_rankings.csv,2012,0.84999567423561,0.15000432576439005
2632,The German Doctor,3635718,418392,3217326,2013_boxofficemojo_rankings.csv,2013,0.11507823214011648,0.8849217678598835
2633,Karthik Calling Karthik,3627172,286409,3340763,2010_boxofficemojo_rankings.csv,2010,0.078962067417812,0.921037932582188
2634,Crooked House,3625952,0,3625952,2017_boxofficemojo_rankings.csv,2017,0.0,1.0
2635,Colonia,3621046,15709,3605337,2016_boxofficemojo_rankings.csv,2016,0.004338249224119219,0.9956617507758808
2636,The Last Circus,3604598,40548,3564050,2010_boxofficemojo_rankings.csv,2010,0.011248965904103592,0.9887510340958964
2637,The Insult,3601603,1001305,2600298,2017_boxofficemojo_rankings.csv,2017,0.2780164832159458,0.7219835167840543
2638,Phoenix Forgotten,3600146,3600146,0,2017_boxofficemojo_rankings.csv,2017,1.0,0.0
2639,Heart Blackened,3593480,37047,3556433,2017_boxofficemojo_rankings.csv,2017,0.010309504992375079,0.989690495007625
2640,Badla,3590894,1861000,1729894,2019_boxofficemojo_rankings.csv,2019,0.5182553425414396,0.48174465745856043
2641,Indivisible,3589633,3511417,78216,2018_boxofficemojo_rankings.csv,2018,0.9782105858732634,0.02178941412673663
2642,Ghostbusters 30th Anniversary Release,3580343,3580343,0,2014_boxofficemojo_rankings.csv,2014,1.0,0.0
2643,The Apparition,3562793,28293,3534500,2018_boxofficemojo_rankings.csv,2018,0.007941241604550137,0.9920587583954499
2644,Bacurau,3541476,58115,3483361,2019_boxofficemojo_rankings.csv,2019,0.016409824604204575,0.9835901753957954
2645,The Oscar Nominated Short Films 2019: Documentary,3538550,3531094,7456,2019_boxofficemojo_rankings.csv,2019,0.9978929222421613,0.0021070777578386627
2646,Catfish,3533711,3237343,296368,2010_boxofficemojo_rankings.csv,2010,0.9161312286149037,0.0838687713850963
2647,Ek Ladki Ko Dekha Toh Aisa Laga,3531837,1182636,2349201,2019_boxofficemojo_rankings.csv,2019,0.33485010774846063,0.6651498922515393
2648,The Riot Club,3517925,7734,3510191,2014_boxofficemojo_rankings.csv,2014,0.0021984550551816767,0.9978015449448183
2649,The Oscar Nominated Short Films 2018: Live Action,3511123,3508777,2346,2018_boxofficemojo_rankings.csv,2018,0.9993318377054863,0.0006681622945137496
2650,Ladrones,3504414,3063505,440909,2015_boxofficemojo_rankings.csv,2015,0.8741846711033571,0.12581532889664293
2651,Thanks for Sharing,3499442,1065881,2433561,2013_boxofficemojo_rankings.csv,2013,0.3045859882804173,0.6954140117195827
2652,Faustina: Love and Mercy,3498887,2243180,1255707,2019_boxofficemojo_rankings.csv,2019,0.6411124451861406,0.35888755481385937
2653,Maiden,3495241,3168978,326263,2019_boxofficemojo_rankings.csv,2019,0.9066550775754805,0.09334492242451951
2654,Wild Target,3494154,108589,3385565,2010_boxofficemojo_rankings.csv,2010,0.031077336602794266,0.9689226633972058
2655,Racetime,3493043,1875283,1617760,2018_boxofficemojo_rankings.csv,2018,0.5368622716639904,0.4631377283360096
2656,Veronica Mars: The Movie,3485383,3322127,163256,2014_boxofficemojo_rankings.csv,2014,0.9531598105574051,0.04684018944259497
2657,The Aeronauts,3485251,0,3485251,2019_boxofficemojo_rankings.csv,2019,0.0,1.0
2658,3,3484446,59954,3424492,2010_boxofficemojo_rankings.csv,2010,0.01720617854316009,0.9827938214568399
2659,Jack and the Cuckoo-Clock Heart,3484370,0,3484370,2014_boxofficemojo_rankings.csv,2014,0.0,1.0
2660,Miles Ahead,3473958,2610896,863062,2016_boxofficemojo_rankings.csv,2016,0.7515623389804943,0.2484376610195057
2661,Great Performances at the Met: Puccini: Tosca,3473616,2023749,1449867,2018_boxofficemojo_rankings.csv,2018,0.5826058493512236,0.4173941506487764
2662,Hors la loi,3470487,96933,3373554,2010_boxofficemojo_rankings.csv,2010,0.027930662180840903,0.972069337819159
2663,Enemy,3468224,1008726,2459498,2014_boxofficemojo_rankings.csv,2014,0.2908479959771918,0.7091520040228082
2664,Til Death Do Us Part,3455267,3455267,0,2017_boxofficemojo_rankings.csv,2017,1.0,0.0
2665,Obsession,3454709,528799,2925910,2016_boxofficemojo_rankings.csv,2016,0.1530661482631388,0.8469338517368612
2666,Words and Pictures,3438874,2171257,1267617,2014_boxofficemojo_rankings.csv,2014,0.63138602926423,0.3686139707357699
2667,A Gentleman,3438746,410055,3028691,2017_boxofficemojo_rankings.csv,2017,0.11924550402966663,0.8807544959703334
2668,The Rider,3434963,2419031,1015932,2018_boxofficemojo_rankings.csv,2018,0.7042378622418931,0.29576213775810684
2669,He Named Me Malala,3433606,2668936,764670,2015_boxofficemojo_rankings.csv,2015,0.7772982689335934,0.22270173106640656
2670,Borg vs. McEnroe,3430165,231346,3198819,2017_boxofficemojo_rankings.csv,2017,0.06744456899303677,0.9325554310069633
2671,Disconnect,3428048,1436900,1991148,2013_boxofficemojo_rankings.csv,2013,0.41915982506662686,0.5808401749333731
2672,Special Forces,3424648,10759,3413889,2011_boxofficemojo_rankings.csv,2011,0.0031416367463167017,0.9968583632536833
2673,Next Time I'll Aim for the Heart,3418213,815,3417398,2014_boxofficemojo_rankings.csv,2014,0.00023842867603627977,0.9997615713239637
2674,Midnight Diner,3412771,18555,3394216,2019_boxofficemojo_rankings.csv,2019,0.005436930869372718,0.9945630691306273
2675,Friends 25th: The One With The Anniversary,3403406,2884827,518579,2019_boxofficemojo_rankings.csv,2019,0.8476294041909781,0.1523705958090219
2676,Honey Boy,3400977,3012615,388362,2019_boxofficemojo_rankings.csv,2019,0.8858086955601288,0.11419130443987124
2677,The Protector 2,3399790,2463,3397327,2013_boxofficemojo_rankings.csv,2013,0.000724456510549181,0.9992755434894508
2678,The Good Lie,3396345,2722209,674136,2014_boxofficemojo_rankings.csv,2014,0.8015113305627078,0.19848866943729215
2679,Rock the Kasbah,3394174,3020664,373510,2015_boxofficemojo_rankings.csv,2015,0.889955553250953,0.11004444674904704
2680,"All's Well, Ends Well 2012",3390232,47919,3342313,2012_boxofficemojo_rankings.csv,2012,0.014134430918002072,0.985865569081998
2681,Gauguin: Voyage to Tahiti,3389322,200140,3189182,2017_boxofficemojo_rankings.csv,2017,0.059050158114218716,0.9409498418857812
2682,Anything for Alice,3387582,1092,3386490,2014_boxofficemojo_rankings.csv,2014,0.00032235382051268427,0.9996776461794873
2683,Apartment 1303 3D,3377891,0,3377891,2012_boxofficemojo_rankings.csv,2012,0.0,1.0
2684,The Neon Demon,3377430,1333124,2044306,2016_boxofficemojo_rankings.csv,2016,0.39471550853755666,0.6052844914624433
2685,The King's Speech PG-13 Version,3375215,3344306,30909,2011_boxofficemojo_rankings.csv,2011,0.9908423611532895,0.009157638846710506
2686,The Hole in the Ground,3373474,21072,3352402,2019_boxofficemojo_rankings.csv,2019,0.006246379844634937,0.9937536201553651
2687,Patrick the Pug,3369468,6290,3363178,2018_boxofficemojo_rankings.csv,2018,0.0018667635365582935,0.9981332364634417
2688,The Last Full Measure,3364426,2949212,415214,2020_boxofficemojo_rankings.csv,2020,0.8765869720421849,0.12341302795781509
2689,Echo in the Canyon,3355324,3355324,0,2019_boxofficemojo_rankings.csv,2019,1.0,0.0
2690,Reality,3350996,72577,3278419,2012_boxofficemojo_rankings.csv,2012,0.021658336804937995,0.978341663195062
2691,Panipat,3349899,461863,2888036,2019_boxofficemojo_rankings.csv,2019,0.13787370902824234,0.8621262909717576
2692,Mistress America,3340737,2500431,840306,2015_boxofficemojo_rankings.csv,2015,0.7484668802123603,0.25153311978763965
2693,Machine Gun Preacher,3338690,538690,2800000,2011_boxofficemojo_rankings.csv,2011,0.16134771422324326,0.8386522857767568
2694,Atlas Shrugged II: The Strike,3336053,3336053,0,2012_boxofficemojo_rankings.csv,2012,1.0,0.0
2695,On Chesil Beach,3335913,745971,2589942,2018_boxofficemojo_rankings.csv,2018,0.22361824184263798,0.776381758157362
2696,The Program,3335613,13074,3322539,2015_boxofficemojo_rankings.csv,2015,0.003919519440654536,0.9960804805593455
2697,By the Sea,3334927,538460,2796467,2015_boxofficemojo_rankings.csv,2015,0.16146080558884798,0.838539194411152
2698,Raiders of the Lost Ark 2012 IMAX Release,3332854,3125613,207241,2012_boxofficemojo_rankings.csv,2012,0.9378187583374489,0.062181241662551075
2699,Last Ounce of Courage,3329674,3329674,0,2012_boxofficemojo_rankings.csv,2012,1.0,0.0
2700,Vanishing Time: A Boy Who Returned,3328517,57759,3270758,2016_boxofficemojo_rankings.csv,2016,0.017352773021739112,0.9826472269782609
2701,The Death & Life of John F. Donovan,3326364,152713,3173651,2019_boxofficemojo_rankings.csv,2019,0.04590988839465555,0.9540901116053444
2702,Obvious Child,3325417,3123963,201454,2014_boxofficemojo_rankings.csv,2014,0.9394199283879285,0.06058007161207151
2703,Flying Swords of Dragon Gate,3323381,170276,3153105,2011_boxofficemojo_rankings.csv,2011,0.051235774652379606,0.9487642253476204
2704,Breath,3322479,37108,3285371,2018_boxofficemojo_rankings.csv,2018,0.01116876886204548,0.9888312311379546
2705,Wildlife,3321367,1050616,2270751,2018_boxofficemojo_rankings.csv,2018,0.31632035845481693,0.683679641545183
2706,Chhichhore,3311391,2004400,1306991,2019_boxofficemojo_rankings.csv,2019,0.6053045381835005,0.39469546181649945
2707,Samsam,3311093,53273,3257820,2020_boxofficemojo_rankings.csv,2020,0.01608924907877852,0.9839107509212215
2708,2020 Oscar Nominated Short Films,3306611,3306611,0,2020_boxofficemojo_rankings.csv,2020,1.0,0.0
2709,Heist,3294317,50136,3244181,2015_boxofficemojo_rankings.csv,2015,0.015218936125454836,0.9847810638745451
2710,Wonderstruck,3285916,1060377,2225539,2017_boxofficemojo_rankings.csv,2017,0.32270362358623894,0.6772963764137611
2711,Good Time,3283369,2026499,1256870,2017_boxofficemojo_rankings.csv,2017,0.6172011126376596,0.3827988873623403
2712,Bharath Ane Nenu,3276257,2663090,613167,2018_boxofficemojo_rankings.csv,2018,0.8128452682436085,0.18715473175639152
2713,Marianne & Leonard: Words of Love,3273573,1012034,2261539,2019_boxofficemojo_rankings.csv,2019,0.30915272089548634,0.6908472791045136
2714,Chicken with Plums,3265941,253874,3012067,2011_boxofficemojo_rankings.csv,2011,0.077733798620367,0.922266201379633
2715,No Escape,3258462,149458,3109004,2020_boxofficemojo_rankings.csv,2020,0.04586765167124858,0.9541323483287514
2716,Bilal: A New Breed of Hero,3254027,0,3254027,2016_boxofficemojo_rankings.csv,2016,0.0,1.0
2717,Your Sister's Sister,3242802,1636190,1606612,2012_boxofficemojo_rankings.csv,2012,0.5045605621311446,0.4954394378688554
2718,In Harmony,3242445,3144,3239301,2015_boxofficemojo_rankings.csv,2015,0.0009696386523133006,0.9990303613476867
2719,The Front Runner,3242235,2000105,1242130,2018_boxofficemojo_rankings.csv,2018,0.616890817599588,0.3831091824004121
2720,Sleeping with Other People,3224947,819431,2405516,2015_boxofficemojo_rankings.csv,2015,0.25409130754706977,0.7459086924529302
2721,Love is in the Air 2013 Re-release,3221554,8425,3213129,2013_boxofficemojo_rankings.csv,2013,0.0026151975102698885,0.9973848024897302
2722,Embrace of the Serpent,3217176,1329249,1887927,2015_boxofficemojo_rankings.csv,2015,0.41317260852374876,0.5868273914762512
2723,The Mystery of Happiness,3216374,8528,3207846,2014_boxofficemojo_rankings.csv,2014,0.0026514329490289375,0.9973485670509711
2724,6 Souls,3205167,0,3205167,2010_boxofficemojo_rankings.csv,2010,0.0,1.0
2725,Saint Laurent,3202241,429477,2772764,2014_boxofficemojo_rankings.csv,2014,0.13411763824146902,0.865882361758531
2726,I,3200113,1449232,1750881,2015_boxofficemojo_rankings.csv,2015,0.4528690080631528,0.5471309919368472
2727,Dear Zindagi,3199581,2376479,823102,2016_boxofficemojo_rankings.csv,2016,0.7427469409275778,0.2572530590724223
2728,Fill the Void,3197615,1775316,1422299,2012_boxofficemojo_rankings.csv,2012,0.5552000475354287,0.44479995246457127
2729,Victoria,3191971,0,3191971,2015_boxofficemojo_rankings.csv,2015,0.0,1.0
2730,Empire of Lust,3191168,10654,3180514,2015_boxofficemojo_rankings.csv,2015,0.003338589507039429,0.9966614104929605
2731,Thoroughbreds,3187255,3072605,114650,2018_boxofficemojo_rankings.csv,2018,0.9640286076890616,0.03597139231093841
2732,Showtime Championship Boxing: Floyd Mayweather vs. Conor McGregor,3184384,2620183,564201,2017_boxofficemojo_rankings.csv,2017,0.822822561600611,0.17717743839938901
2733,Tea With the Dames,3181152,889343,2291809,2018_boxofficemojo_rankings.csv,2018,0.2795663332025631,0.7204336667974369
2734,Pastorela,3179022,161194,3017828,2011_boxofficemojo_rankings.csv,2011,0.05070553144960935,0.9492944685503907
2735,Pilgrim's Progress,3173282,1294596,1878686,2019_boxofficemojo_rankings.csv,2019,0.4079675238443983,0.5920324761556017
2736,Rosewater,3171593,3128941,42652,2014_boxofficemojo_rankings.csv,2014,0.9865518684143899,0.013448131585610134
2737,Land of Mine,3169553,435266,2734287,2015_boxofficemojo_rankings.csv,2015,0.1373272508773319,0.8626727491226681
2738,The Lodge,3155858,2138907,1016951,2020_boxofficemojo_rankings.csv,2020,0.6777576811123948,0.3222423188876052
2739,Ingrid Goes West,3146831,3024308,122523,2017_boxofficemojo_rankings.csv,2017,0.9610646393149171,0.03893536068508287
2740,The Deep Blue Sea,3115609,1126525,1989084,2011_boxofficemojo_rankings.csv,2011,0.3615745749867843,0.6384254250132158
2741,In a World...,3114953,2963902,151051,2013_boxofficemojo_rankings.csv,2013,0.9515077755587323,0.048492224441267655
2742,Close Encounters of the Third Kind 2017 Re-release,3101507,3100479,1028,2017_boxofficemojo_rankings.csv,2017,0.9996685482251048,0.00033145177489523643
2743,Come Undone,3101465,10035,3091430,2010_boxofficemojo_rankings.csv,2010,0.003235567707518866,0.9967644322924811
2744,Raw,3096815,514870,2581945,2017_boxofficemojo_rankings.csv,2017,0.16625791337228735,0.8337420866277127
2745,Hocus Pocus 2020 Re-release,3086000,3086000,0,2020_boxofficemojo_rankings.csv,2020,1.0,0.0
2746,Aquarius,3085977,285930,2800047,2016_boxofficemojo_rankings.csv,2016,0.09265461148932737,0.9073453885106726
2747,The People Vs. Fritz Bauer,3083973,288483,2795490,2015_boxofficemojo_rankings.csv,2015,0.09354264774691608,0.9064573522530839
2748,Mumbai Diaries,3082958,576639,2506319,2011_boxofficemojo_rankings.csv,2011,0.1870408224828233,0.8129591775171767
2749,3 Hearts,3077754,161129,2916625,2014_boxofficemojo_rankings.csv,2014,0.052352787129835585,0.9476472128701644
2750,Ismael's Ghosts,3075562,102510,2973052,2017_boxofficemojo_rankings.csv,2017,0.03333049374390762,0.9666695062560924
2751,Living Is Easy with Eyes Closed,3075169,11600,3063569,2013_boxofficemojo_rankings.csv,2013,0.003772150408644208,0.9962278495913558
2752,The End of the Tour,3072991,3002884,70107,2015_boxofficemojo_rankings.csv,2015,0.9771860705091554,0.022813929490844587
2753,Jane Got a Gun,3067531,1513793,1553738,2015_boxofficemojo_rankings.csv,2015,0.49348906335420895,0.506510936645791
2754,'71,3062178,1270847,1791331,2014_boxofficemojo_rankings.csv,2014,0.4150140847462166,0.5849859152537834
2755,Remember,3054936,547009,2507927,2015_boxofficemojo_rankings.csv,2015,0.1790574336090838,0.8209425663909162
2756,Starred Up,3025189,54915,2970274,2014_boxofficemojo_rankings.csv,2014,0.018152584846764946,0.981847415153235
2757,The Greatest Miracle,3019382,555166,2464216,2011_boxofficemojo_rankings.csv,2011,0.18386742717549484,0.8161325728245051
2758,All Is True,3019143,1200481,1818662,2019_boxofficemojo_rankings.csv,2019,0.3976231003301268,0.6023768996698732
2759,Top Gun 2013 3D Release,3018873,3018873,0,2013_boxofficemojo_rankings.csv,2013,1.0,0.0
2760,Rigor Mortis,3016904,7865,3009039,2013_boxofficemojo_rankings.csv,2013,0.0026069772190298397,0.9973930227809702
2761,Star Wars: Episode V - The Empire Strikes Back 2020 Re-release,3016382,2403000,613382,2020_boxofficemojo_rankings.csv,2020,0.7966497612039855,0.20335023879601458
2762,The Second Mother,3003560,376986,2626574,2015_boxofficemojo_rankings.csv,2015,0.1255130578380322,0.8744869421619678
2763,The Imposter,3001877,898317,2103560,2012_boxofficemojo_rankings.csv,2012,0.2992517681437314,0.7007482318562686
2764,Made for More,2999134,2999134,0,2018_boxofficemojo_rankings.csv,2018,1.0,0.0
2765,The Last Word,2982004,1783421,1198583,2017_boxofficemojo_rankings.csv,2017,0.5980612366717147,0.40193876332828526
2766,Memoir of War,2980982,103636,2877346,2018_boxofficemojo_rankings.csv,2018,0.034765724851743486,0.9652342751482565
2767,Love Is Strange 2014 Re-release,2979739,2262223,717516,2014_boxofficemojo_rankings.csv,2014,0.759201728742014,0.24079827125798603
2768,Romeo and Juliet,2966268,1162635,1803633,2013_boxofficemojo_rankings.csv,2013,0.39195210951943654,0.6080478904805634
2769,The Last: Naruto the Movie,2949185,524451,2424734,2015_boxofficemojo_rankings.csv,2015,0.17782912906447035,0.8221708709355297
2770,Sibyl,2943278,0,2943278,2019_boxofficemojo_rankings.csv,2019,0.0,1.0
2771,Fearless,2942554,1288549,1654005,2010_boxofficemojo_rankings.csv,2010,0.4379015644232867,0.5620984355767132
2772,Filly Brown,2940411,2850357,90054,2013_boxofficemojo_rankings.csv,2013,0.9693736691911436,0.030626330808856312
2773,Joan Rivers: A Piece of Work,2930687,2930687,0,2010_boxofficemojo_rankings.csv,2010,1.0,0.0
2774,Brighton Rock,2913599,229653,2683946,2011_boxofficemojo_rankings.csv,2011,0.07882107318131287,0.9211789268186872
2775,The House That Jack Built,2911800,87993,2823807,2018_boxofficemojo_rankings.csv,2018,0.03021945188543169,0.9697805481145683
2776,Letters to God,2908893,2848578,60315,2010_boxofficemojo_rankings.csv,2010,0.9792653081429946,0.020734691857005397
2777,The Rental,2894793,1635345,1259448,2020_boxofficemojo_rankings.csv,2020,0.5649264040641248,0.4350735959358752
2778,The East,2891812,2301839,589973,2013_boxofficemojo_rankings.csv,2013,0.7959850087073433,0.20401499129265666
2779,The Oscar Nominated Short Films 2017: Live Action,2877797,2835355,42442,2017_boxofficemojo_rankings.csv,2017,0.9852519131822015,0.014748086817798475
2780,Maria By Callas,2869237,1267301,1601936,2017_boxofficemojo_rankings.csv,2017,0.4416857164465675,0.5583142835534325
2781,Starbuck,2865068,340058,2525010,2011_boxofficemojo_rankings.csv,2011,0.11869107469700545,0.8813089253029945
2782,Home Run,2861020,2861020,0,2013_boxofficemojo_rankings.csv,2013,1.0,0.0
2783,The Flowers of War,2855644,311434,2544210,2012_boxofficemojo_rankings.csv,2012,0.10905911241037047,0.8909408875896295
2784,Inhumans,2852282,1521787,1330495,2017_boxofficemojo_rankings.csv,2017,0.5335331499480065,0.46646685005199345
2785,The Salt of Life,2850852,317405,2533447,2011_boxofficemojo_rankings.csv,2011,0.1113368915678541,0.8886631084321459
2786,The Oscar Nominated Short Films 2016: Live Action,2850840,2816816,34024,2016_boxofficemojo_rankings.csv,2016,0.9880652719900099,0.011934728009990039
2787,God Bless the Broken Road,2848233,2846257,1976,2018_boxofficemojo_rankings.csv,2018,0.9993062365333173,0.0006937634666826766
2788,Remember You,2845124,14814,2830310,2016_boxofficemojo_rankings.csv,2016,0.005206802937235776,0.9947931970627643
2789,A Breath Away,2842040,77987,2764053,2018_boxofficemojo_rankings.csv,2018,0.027440500485566705,0.9725594995144333
2790,The Identical,2840991,2827666,13325,2014_boxofficemojo_rankings.csv,2014,0.9953097352297139,0.0046902647702861434
2791,Personal Shopper,2840408,1305195,1535213,2016_boxofficemojo_rankings.csv,2016,0.4595096901571887,0.5404903098428113
2792,The Fluffy Movie: Unity Through Laughter,2827393,2827393,0,2014_boxofficemojo_rankings.csv,2014,1.0,0.0
2793,A Coffee in Berlin,2826333,150275,2676058,2012_boxofficemojo_rankings.csv,2012,0.05316960174190373,0.9468303982580962
2794,Everything Must Go,2820490,2711643,108847,2011_boxofficemojo_rankings.csv,2011,0.9614084786686001,0.03859152133139986
2795,Captive,2801508,2583301,218207,2015_boxofficemojo_rankings.csv,2015,0.9221108774274427,0.07788912257255735
2796,To the Wonder,2801166,587615,2213551,2013_boxofficemojo_rankings.csv,2013,0.20977514363661418,0.7902248563633858
2797,"Cinco de Mayo, La Batalla",2794852,173472,2621380,2013_boxofficemojo_rankings.csv,2013,0.06206840290648664,0.9379315970935134
2798,After the Wedding,2790019,1574258,1215761,2019_boxofficemojo_rankings.csv,2019,0.564246336673693,0.4357536633263071
2799,Children of the Sea,2789668,0,2789668,2019_boxofficemojo_rankings.csv,2019,0.0,1.0
2800,Kirk Cameron's Saving Christmas,2783970,2783970,0,2014_boxofficemojo_rankings.csv,2014,1.0,0.0
2801,The Wonders,2772358,73378,2698980,2014_boxofficemojo_rankings.csv,2014,0.026467721701165577,0.9735322782988344
2802,Kinky Boots the Musical,2761654,900451,1861203,2019_boxofficemojo_rankings.csv,2019,0.3260549656111881,0.6739450343888119
2803,Battle for Incheon: Operation Chromite,2749918,1023348,1726570,2016_boxofficemojo_rankings.csv,2016,0.37213764192241366,0.6278623580775863
2804,McQueen,2739246,1257275,1481971,2018_boxofficemojo_rankings.csv,2018,0.4589857939009494,0.5410142060990506
2805,Edie,2731170,71790,2659380,2018_boxofficemojo_rankings.csv,2018,0.02628543810894232,0.9737145618910577
2806,Lucky,2728446,955925,1772521,2017_boxofficemojo_rankings.csv,2017,0.35035511056476837,0.6496448894352316
2807,Cocktail,2724695,1227789,1496906,2012_boxofficemojo_rankings.csv,2012,0.4506152064726511,0.5493847935273489
2808,Chi-Raq,2719699,2653032,66667,2015_boxofficemojo_rankings.csv,2015,0.9754873609175133,0.0245126390824867
2809,Billionaire Boys Club,2713955,1349,2712606,2018_boxofficemojo_rankings.csv,2018,0.0004970605629054277,0.9995029394370946
2810,What Maisie Knew,2711379,1066471,1644908,2013_boxofficemojo_rankings.csv,2013,0.3933315851454186,0.6066684148545813
2811,The Guest,2700051,332890,2367161,2014_boxofficemojo_rankings.csv,2014,0.12329026377649904,0.876709736223501
2812,Gangsterdam,2697522,954,2696568,2017_boxofficemojo_rankings.csv,2017,0.0003536579127065507,0.9996463420872934
2813,Jiro Dreams of Sushi,2692864,2552478,140386,2012_boxofficemojo_rankings.csv,2012,0.9478674006559559,0.05213259934404411
2814,A Hijacking,2688444,414437,2274007,2012_boxofficemojo_rankings.csv,2012,0.15415496845015184,0.8458450315498481
2815,The Cup,2660645,0,2660645,2011_boxofficemojo_rankings.csv,2011,0.0,1.0
2816,Ava,2657900,377037,2280863,2020_boxofficemojo_rankings.csv,2020,0.14185522404906128,0.8581447759509387
2817,Diego Maradona,2656890,0,2656890,2019_boxofficemojo_rankings.csv,2019,0.0,1.0
2818,Hillsong: Let Hope Rise,2649761,2394386,255375,2016_boxofficemojo_rankings.csv,2016,0.9036233833919362,0.0963766166080639
2819,Twelve,2648195,183920,2464275,2010_boxofficemojo_rankings.csv,2010,0.06945107894244948,0.9305489210575505
2820,Pioneer,2647820,6871,2640949,2013_boxofficemojo_rankings.csv,2013,0.0025949649145334654,0.9974050350854665
2821,Stories We Tell,2641053,1600145,1040908,2013_boxofficemojo_rankings.csv,2013,0.6058738692483642,0.39412613075163583
2822,Beautiful Accident,2632092,51766,2580326,2017_boxofficemojo_rankings.csv,2017,0.01966724567378344,0.9803327543262166
2823,Maniac,2631275,31081,2600194,2012_boxofficemojo_rankings.csv,2012,0.011812144302666958,0.988187855697333
2824,Third Person,2624761,1021398,1603363,2014_boxofficemojo_rankings.csv,2014,0.3891394302185989,0.610860569781401
2825,The Happy Prince,2621992,466440,2155552,2018_boxofficemojo_rankings.csv,2018,0.17789527961946489,0.8221047203805351
2826,The Informer,2620824,0,2620824,2019_boxofficemojo_rankings.csv,2019,0.0,1.0
2827,Happy End,2610794,301718,2309076,2017_boxofficemojo_rankings.csv,2017,0.11556560954253764,0.8844343904574624
2828,The Little Mermaid,2610742,147175,2463567,2018_boxofficemojo_rankings.csv,2018,0.05637286258082951,0.9436271374191705
2829,Poster Boys,2602256,97049,2505207,2017_boxofficemojo_rankings.csv,2017,0.03729417858965452,0.9627058214103454
2830,N-Secure,2595644,2595644,0,2010_boxofficemojo_rankings.csv,2010,1.0,0.0
2831,The Signal,2595622,600896,1994726,2014_boxofficemojo_rankings.csv,2014,0.23150366270589476,0.7684963372941053
2832,Leo Da Vinci: Mission Mona Lisa,2588859,19978,2568881,2018_boxofficemojo_rankings.csv,2018,0.007716913126593608,0.9922830868734064
2833,A Question of Faith,2587072,2587072,0,2017_boxofficemojo_rankings.csv,2017,1.0,0.0
2834,Blancanieves,2585522,279735,2305787,2012_boxofficemojo_rankings.csv,2012,0.10819285235244566,0.8918071476475543
2835,Assassination Nation,2584988,2005142,579846,2018_boxofficemojo_rankings.csv,2018,0.7756871598630245,0.2243128401369755
2836,Metallica & San Francisco Symphony - S&M2,2582847,1252385,1330462,2019_boxofficemojo_rankings.csv,2019,0.4848854771498273,0.5151145228501727
2837,The Gatekeepers,2573616,2415727,157889,2013_boxofficemojo_rankings.csv,2013,0.9386509098482446,0.06134909015175535
2838,Is Genesis History?,2570392,2570392,0,2017_boxofficemojo_rankings.csv,2017,1.0,0.0
2839,Maquia: When the Promised Flower Blooms 2018 Re-release,2569927,18539,2551388,2018_boxofficemojo_rankings.csv,2018,0.007213823583315791,0.9927861764166842
2840,Blood Ties,2566435,42472,2523963,2013_boxofficemojo_rankings.csv,2013,0.016549026178336874,0.9834509738216631
2841,Waves,2563497,1658790,904707,2019_boxofficemojo_rankings.csv,2019,0.6470809211011365,0.35291907889886354
2842,God's Own Country,2559939,335609,2224330,2017_boxofficemojo_rankings.csv,2017,0.1311003895014686,0.8688996104985314
2843,The Only Living Boy in New York,2550321,624332,1925989,2017_boxofficemojo_rankings.csv,2017,0.2448052617690087,0.7551947382309914
2844,"1,000 Times Good Night",2549568,53895,2495673,2013_boxofficemojo_rankings.csv,2013,0.021138875291814144,0.9788611247081859
2845,Disney's Newsies: The Broadway Musical!,2545060,2545060,0,2017_boxofficemojo_rankings.csv,2017,1.0,0.0
2846,The Dinner,2544921,1323312,1221609,2017_boxofficemojo_rankings.csv,2017,0.5199815632783886,0.4800184367216114
2847,El Jeremías,2540144,650465,1889679,2016_boxofficemojo_rankings.csv,2016,0.25607406509237274,0.7439259349076273
2848,In the Name of My Daughter,2537899,277528,2260371,2014_boxofficemojo_rankings.csv,2014,0.10935344550748473,0.8906465544925153
2849,IN OUR HANDS: Battle for Jerusalem,2534370,2534370,0,2017_boxofficemojo_rankings.csv,2017,1.0,0.0
2850,Shi,2533089,356149,2176940,2010_boxofficemojo_rankings.csv,2010,0.14059869195278965,0.8594013080472104
2851,Spirits in the Forest,2531785,704744,1827041,2019_boxofficemojo_rankings.csv,2019,0.2783585494028916,0.7216414505971084
2852,Bucky Larson: Born to Be a Star,2530394,2529395,999,2011_boxofficemojo_rankings.csv,2011,0.9996051998226363,0.00039480017736368326
2853,Ittefaq,2520487,298032,2222455,2017_boxofficemojo_rankings.csv,2017,0.11824381558008433,0.8817561844199157
2854,Restless,2518012,163265,2354747,2011_boxofficemojo_rankings.csv,2011,0.06483884906029042,0.9351611509397095
2855,Birds of Passage,2517405,507259,2010146,2018_boxofficemojo_rankings.csv,2018,0.2015007517662037,0.7984992482337963
2856,LBJ,2510151,2470979,39172,2017_boxofficemojo_rankings.csv,2017,0.9843945643110713,0.015605435688928674
2857,The Rover,2510007,1114423,1395584,2014_boxofficemojo_rankings.csv,2014,0.44399198886696334,0.5560080111330367
2858,Grace Unplugged,2507201,2507201,0,2013_boxofficemojo_rankings.csv,2013,1.0,0.0
2859,Words on Bathroom Walls,2505457,2505457,0,2020_boxofficemojo_rankings.csv,2020,1.0,0.0
2860,I'm in Love with a Church Girl,2503392,2387730,115662,2013_boxofficemojo_rankings.csv,2013,0.953797887026882,0.046202112973118076
2861,The Queen of Versailles,2495706,2401999,93707,2012_boxofficemojo_rankings.csv,2012,0.9624527087725878,0.037547291227412204
2862,Still Life,2495025,9481,2485544,2013_boxofficemojo_rankings.csv,2013,0.0037999619242292163,0.9962000380757707
2863,"One Nation, One King",2481681,6576,2475105,2018_boxofficemojo_rankings.csv,2018,0.0026498167975658434,0.9973501832024342
2864,Cairo Time,2477315,1603616,873699,2010_boxofficemojo_rankings.csv,2010,0.6473201833436604,0.35267981665633963
2865,The Christmas Candle,2476775,2258620,218155,2013_boxofficemojo_rankings.csv,2013,0.9119197343319437,0.08808026566805624
2866,Painted Skin: The Resurrection,2455359,50425,2404934,2012_boxofficemojo_rankings.csv,2012,0.020536711739505303,0.9794632882604947
2867,Piku,2452343,1801807,650536,2015_boxofficemojo_rankings.csv,2015,0.7347287879387182,0.2652712120612818
2868,Footnote,2451259,2007758,443501,2011_boxofficemojo_rankings.csv,2011,0.819072158429607,0.18092784157039302
2869,The Tree,2450045,71158,2378887,2010_boxofficemojo_rankings.csv,2010,0.029043548179727312,0.9709564518202727
2870,Love at First Fight,2446362,25229,2421133,2014_boxofficemojo_rankings.csv,2014,0.010312864571964411,0.9896871354280355
2871,Lean on Pete,2443584,1163056,1280528,2018_boxofficemojo_rankings.csv,2018,0.47596317540137767,0.5240368245986223
2872,Coriolanus,2435325,757195,1678130,2012_boxofficemojo_rankings.csv,2012,0.31092154024616836,0.6890784597538316
2873,The Unknown Girl,2432640,150549,2282091,2016_boxofficemojo_rankings.csv,2016,0.061887085635359114,0.9381129143646408
2874,Joe,2431443,373375,2058068,2014_boxofficemojo_rankings.csv,2014,0.15356107463757118,0.8464389253624288
2875,The Grace Card,2430735,2430735,0,2011_boxofficemojo_rankings.csv,2011,1.0,0.0
2876,The Breadwinner 2018 Re-release,2426907,834,2426073,2018_boxofficemojo_rankings.csv,2018,0.0003436472843829615,0.999656352715617
2877,The Secret: Dare to Dream,2423478,0,2423478,2020_boxofficemojo_rankings.csv,2020,0.0,1.0
2878,Life of Riley,2423379,11616,2411763,2014_boxofficemojo_rankings.csv,2014,0.004793307196274293,0.9952066928037258
2879,After.Life,2422634,108595,2314039,2010_boxofficemojo_rankings.csv,2010,0.044825177884897184,0.9551748221151029
2880,Hearts Beat Loud,2417165,2386251,30914,2018_boxofficemojo_rankings.csv,2018,0.9872106372548005,0.012789362745199439
2881,The Art of Self-Defense,2414269,2410914,3355,2019_boxofficemojo_rankings.csv,2019,0.9986103454089001,0.0013896545910998318
2882,The Oscar Nominated Short Films 2015: Live Action,2412593,2412593,0,2015_boxofficemojo_rankings.csv,2015,1.0,0.0
2883,Beloved Sisters,2407680,54030,2353650,2014_boxofficemojo_rankings.csv,2014,0.022440689792663476,0.9775593102073366
2884,Sound! Euphonium the Movie - Our Promise: A Brand New Day,2403030,90341,2312689,2019_boxofficemojo_rankings.csv,2019,0.037594620125424985,0.962405379874575
2885,The Stroller Strategy,2401291,3462,2397829,2013_boxofficemojo_rankings.csv,2013,0.0014417244723775669,0.9985582755276224
2886,The Man Who Killed Don Quixote,2390383,391963,1998420,2018_boxofficemojo_rankings.csv,2018,0.1639749780683681,0.8360250219316319
2887,Twilight/New Moon,2385237,2385237,0,2010_boxofficemojo_rankings.csv,2010,1.0,0.0
2888,Finding Vivian Maier,2384584,1514782,869802,2014_boxofficemojo_rankings.csv,2014,0.6352395218620942,0.3647604781379058
2889,Laggies,2379154,1066981,1312173,2014_boxofficemojo_rankings.csv,2014,0.44847075893363775,0.5515292410663623
2890,I Wish,2371548,145808,2225740,2011_boxofficemojo_rankings.csv,2011,0.06148220487209198,0.938517795127908
2891,Lore,2362019,970325,1391694,2012_boxofficemojo_rankings.csv,2012,0.4108032153848043,0.5891967846151958
2892,Cake,2360281,1951776,408505,2015_boxofficemojo_rankings.csv,2015,0.8269252686438606,0.17307473135613938
2893,Desi Boyz,2355293,1078826,1276467,2011_boxofficemojo_rankings.csv,2011,0.4580432243461854,0.5419567756538146
2894,Chico & Rita,2347919,350524,1997395,2010_boxofficemojo_rankings.csv,2010,0.14929135119226855,0.8507086488077314
2895,Memories of the Sword,2345062,111071,2233991,2015_boxofficemojo_rankings.csv,2015,0.047363779720962604,0.9526362202790374
2896,Terraferma,2343302,19996,2323306,2011_boxofficemojo_rankings.csv,2011,0.008533257770445295,0.9914667422295547
2897,1991,2342264,2342264,0,2018_boxofficemojo_rankings.csv,2018,1.0,0.0
2898,Housefull,2340550,1183658,1156892,2010_boxofficemojo_rankings.csv,2010,0.5057178868214736,0.49428211317852644
2899,Ong-bak 3,2340516,14890,2325626,2010_boxofficemojo_rankings.csv,2010,0.00636184499486438,0.9936381550051356
2900,Meru,2334228,2334228,0,2015_boxofficemojo_rankings.csv,2015,1.0,0.0
2901,Jem and the Holograms,2333684,2184640,149044,2015_boxofficemojo_rankings.csv,2015,0.9361335982078122,0.0638664017921878
2902,Bhaag Milkha Bhaag,2325917,1636731,689186,2013_boxofficemojo_rankings.csv,2013,0.7036927800949045,0.2963072199050955
2903,The Oranges,2316971,366377,1950594,2012_boxofficemojo_rankings.csv,2012,0.158127572593701,0.841872427406299
2904,Austenland,2313509,2159041,154468,2013_boxofficemojo_rankings.csv,2013,0.9332321594599373,0.06676784054006274
2905,A Aa,2313043,2313043,0,2016_boxofficemojo_rankings.csv,2016,1.0,0.0
2906,WARx2,2310625,2310625,0,2015_boxofficemojo_rankings.csv,2015,1.0,0.0
2907,The Resurrection of Gavin Stone,2308355,2303792,4563,2017_boxofficemojo_rankings.csv,2017,0.9980232676516394,0.001976732348360629
2908,Blackfish,2303417,2073582,229835,2013_boxofficemojo_rankings.csv,2013,0.900219977537719,0.09978002246228104
2909,Piranhas,2298525,23494,2275031,2019_boxofficemojo_rankings.csv,2019,0.010221337596937167,0.9897786624030628
2910,The Remaining,2297261,1169603,1127658,2014_boxofficemojo_rankings.csv,2014,0.509129350126085,0.49087064987391504
2911,3 from Hell,2295825,2172949,122876,2019_boxofficemojo_rankings.csv,2019,0.9464784990145155,0.05352150098548452
2912,Ek Main Aur Ekk Tu,2293823,1155545,1138278,2012_boxofficemojo_rankings.csv,2012,0.5037638039203548,0.4962361960796452
2913,Going Away,2290889,19501,2271388,2014_boxofficemojo_rankings.csv,2014,0.008512415922377732,0.9914875840776223
2914,American Honey,2290649,663246,1627403,2016_boxofficemojo_rankings.csv,2016,0.28954501540829697,0.7104549845917031
2915,RV: Resurrected Victims,2269892,20374,2249518,2017_boxofficemojo_rankings.csv,2017,0.008975757436917704,0.9910242425630823
2916,Luce,2268204,2010613,257591,2019_boxofficemojo_rankings.csv,2019,0.8864339362773366,0.1135660637226634
2917,Sleepwalk with Me,2266067,2266067,0,2012_boxofficemojo_rankings.csv,2012,1.0,0.0
2918,Puzzle,2260946,2032018,228928,2018_boxofficemojo_rankings.csv,2018,0.8987468077521533,0.1012531922478467
2919,Shadow Dancer,2253819,100616,2153203,2012_boxofficemojo_rankings.csv,2012,0.04464244910527421,0.9553575508947258
2920,An Interview with God,2251795,1201434,1050361,2018_boxofficemojo_rankings.csv,2018,0.5335450163092111,0.4664549836907889
2921,Marius,2249781,9781,2240000,2013_boxofficemojo_rankings.csv,2013,0.0043475342711135,0.9956524657288865
2922,My All-American,2246000,2246000,0,2015_boxofficemojo_rankings.csv,2015,1.0,0.0
2923,No culpes al karma de lo que te pasa por gilipollas,2242471,5614,2236857,2016_boxofficemojo_rankings.csv,2016,0.0025034883394255713,0.9974965116605744
2924,At War,2235052,4605,2230447,2018_boxofficemojo_rankings.csv,2018,0.002060354747898483,0.9979396452521015
2925,Elena,2227905,233380,1994525,2011_boxofficemojo_rankings.csv,2011,0.10475312008366605,0.895246879916334
2926,Delhi Safari,2225597,0,2225597,2012_boxofficemojo_rankings.csv,2012,0.0,1.0
2927,Heal the Living,2223529,3176,2220353,2016_boxofficemojo_rankings.csv,2016,0.0014283600528709093,0.998571639947129
2928,The Lovers,2216083,2194521,21562,2017_boxofficemojo_rankings.csv,2017,0.9902702200233475,0.0097297799766525
2929,Bill Cunningham: New York,2210382,1510026,700356,2011_boxofficemojo_rankings.csv,2011,0.6831516000401741,0.31684839995982594
2930,Goodnight Mommy,2193474,1178196,1015278,2015_boxofficemojo_rankings.csv,2015,0.5371369799687619,0.46286302003123814
2931,3 Faces,2191516,72324,2119192,2018_boxofficemojo_rankings.csv,2018,0.033001812443988546,0.9669981875560114
2932,What Will People Say,2191131,44156,2146975,2017_boxofficemojo_rankings.csv,2017,0.020152149734543486,0.9798478502654565
2933,Anchorman 2: The Legend Continues R-Rated Extended Cut,2185255,2184339,916,2014_boxofficemojo_rankings.csv,2014,0.9995808269515457,0.0004191730484542994
2934,Border,2177678,771930,1405748,2018_boxofficemojo_rankings.csv,2018,0.35447389375288724,0.6455261062471127
2935,Gone with the Wind 2019 Re-release,2176120,2176120,0,2019_boxofficemojo_rankings.csv,2019,1.0,0.0
2936,Veere Di Wedding,2176099,0,2176099,2018_boxofficemojo_rankings.csv,2018,0.0,1.0
2937,The Oscar Nominated Short Films 2014: Live Action,2171849,2171849,0,2014_boxofficemojo_rankings.csv,2014,1.0,0.0
2938,Henry's Crime,2169799,102541,2067258,2011_boxofficemojo_rankings.csv,2011,0.04725829443188056,0.9527417055681194
2939,The Reluctant Fundamentalist,2167020,552959,1614061,2013_boxofficemojo_rankings.csv,2013,0.25517023377726095,0.7448297662227391
2940,The Benefactor,2159380,0,2159380,2015_boxofficemojo_rankings.csv,2015,0.0,1.0
2941,The Saratov Approach,2146999,2146999,0,2013_boxofficemojo_rankings.csv,2013,1.0,0.0
2942,The Oscar Nominated Short Films 2013: Live Action,2142342,2142342,0,2013_boxofficemojo_rankings.csv,2013,1.0,0.0
2943,Let Yourself Go,2140190,12189,2128001,2017_boxofficemojo_rankings.csv,2017,0.0056952887360468,0.9943047112639533
2944,The Attack,2139516,1720325,419191,2013_boxofficemojo_rankings.csv,2013,0.80407204246194,0.19592795753806
2945,High Life,2133033,1225852,907181,2018_boxofficemojo_rankings.csv,2018,0.5746990318480774,0.42530096815192264
2946,My Scientology Movie,2130866,22936,2107930,2016_boxofficemojo_rankings.csv,2016,0.010763698890498042,0.989236301109502
2947,Mountain,2129889,365412,1764477,2017_boxofficemojo_rankings.csv,2017,0.17156387022985706,0.8284361297701429
2948,Heleno,2126384,0,2126384,2012_boxofficemojo_rankings.csv,2012,0.0,1.0
2949,Sightseers,2122909,61782,2061127,2012_boxofficemojo_rankings.csv,2012,0.029102519231865333,0.9708974807681346
2950,Jai Ho,2122804,1264515,858289,2014_boxofficemojo_rankings.csv,2014,0.595681466588531,0.404318533411469
2951,Abracadabra,2114260,13975,2100285,2017_boxofficemojo_rankings.csv,2017,0.006609877687701608,0.9933901223122984
2952,"20,000 Days on Earth",2105558,279558,1826000,2014_boxofficemojo_rankings.csv,2014,0.13277145535767715,0.8672285446423228
2953,The Eye of the Storm,2104689,83566,2021123,2011_boxofficemojo_rankings.csv,2011,0.03970467845843258,0.9602953215415674
2954,Once Upon a Time in Anatolia,2099472,152408,1947064,2011_boxofficemojo_rankings.csv,2011,0.07259349017276724,0.9274065098272327
2955,The Wizard of Oz 2019 Re-release,2097514,2076020,21494,2019_boxofficemojo_rankings.csv,2019,0.9897526309717122,0.010247369028287772
2956,Indian Horse,2097362,2097362,0,2018_boxofficemojo_rankings.csv,2018,1.0,0.0
2957,Mary Shelley,2096600,108900,1987700,2018_boxofficemojo_rankings.csv,2018,0.051941238195173135,0.9480587618048268
2958,The Captive,2090612,1075178,1015434,2014_boxofficemojo_rankings.csv,2014,0.5142886389248699,0.48571136107513013
2959,"The Butcher, the Chef, and the Swordsman",2089266,47896,2041370,2011_boxofficemojo_rankings.csv,2011,0.022924797512619263,0.9770752024873808
2960,Lost in Paris,2087225,691597,1395628,2017_boxofficemojo_rankings.csv,2017,0.33134760267819713,0.6686523973218029
2961,Girl Most Likely,2085617,1378591,707026,2013_boxofficemojo_rankings.csv,2013,0.6609991192054917,0.3390008807945083
2962,Equals,2084628,33258,2051370,2016_boxofficemojo_rankings.csv,2016,0.01595392559247981,0.9840460744075202
2963,High Strung,2084451,53447,2031004,2016_boxofficemojo_rankings.csv,2016,0.02564080422135133,0.9743591957786487
2964,I'm Not Ashamed,2082980,2082980,0,2016_boxofficemojo_rankings.csv,2016,1.0,0.0
2965,A Cat in Paris,2080634,309973,1770661,2010_boxofficemojo_rankings.csv,2010,0.1489800704977425,0.8510199295022575
2966,The King of Staten Island,2080275,0,2080275,2020_boxofficemojo_rankings.csv,2020,0.0,1.0
2967,Wi-heom-han gyan-gye,2074864,54000,2020864,2012_boxofficemojo_rankings.csv,2012,0.02602580217305809,0.973974197826942
2968,Black '47,2073063,57520,2015543,2018_boxofficemojo_rankings.csv,2018,0.027746383009102954,0.9722536169908971
2969,A Fool,2067820,8212,2059608,2015_boxofficemojo_rankings.csv,2015,0.003971332127554622,0.9960286678724454
2970,Hotchpotch 3,2067671,1132192,935479,2010_boxofficemojo_rankings.csv,2010,0.5475687379665334,0.4524312620334666
2971,American Pastoral,2063436,544098,1519338,2016_boxofficemojo_rankings.csv,2016,0.263685425668642,0.7363145743313579
2972,Hotchpotch Again,2057329,1013893,1043436,2017_boxofficemojo_rankings.csv,2017,0.4928200594071245,0.5071799405928755
2973,Under the Silver Lake,2053469,46083,2007386,2018_boxofficemojo_rankings.csv,2018,0.022441536736127986,0.977558463263872
2974,Being 17,2045219,52713,1992506,2016_boxofficemojo_rankings.csv,2016,0.025773767992571944,0.9742262320074281
2975,W.E.,2042203,583455,1458748,2012_boxofficemojo_rankings.csv,2012,0.2856988262185493,0.7143011737814507
2976,Raid,2031135,1010385,1020750,2018_boxofficemojo_rankings.csv,2018,0.49744847092881567,0.5025515290711844
2977,The High Note,2029462,0,2029462,2020_boxofficemojo_rankings.csv,2020,0.0,1.0
2978,Climax,2027391,817339,1210052,2018_boxofficemojo_rankings.csv,2018,0.40314818404540614,0.5968518159545939
2979,42nd Street - The Musical,2022093,187440,1834653,2019_boxofficemojo_rankings.csv,2019,0.09269603326849953,0.9073039667315005
2980,Armadillo,2018685,14566,2004119,2010_boxofficemojo_rankings.csv,2010,0.007215588365693509,0.9927844116343065
2981,Graduation,2015002,175975,1839027,2016_boxofficemojo_rankings.csv,2016,0.0873324195211717,0.9126675804788283
2982,Little Men,2008649,702537,1306112,2016_boxofficemojo_rankings.csv,2016,0.34975598026335114,0.6502440197366489
2983,Greater,2000093,2000093,0,2016_boxofficemojo_rankings.csv,2016,1.0,0.0
2984,Peterloo,1998945,151971,1846974,2018_boxofficemojo_rankings.csv,2018,0.07602560350584933,0.9239743964941507
2985,1898: Our Last Men in the Philippines,1995045,2848,1992197,2016_boxofficemojo_rankings.csv,2016,0.001427536722229323,0.9985724632777707
2986,Antboy,1994566,0,1994566,2013_boxofficemojo_rankings.csv,2013,0.0,1.0
2987,The Trip to Spain,1988841,1157604,831237,2017_boxofficemojo_rankings.csv,2017,0.5820495454387756,0.41795045456122437
2988,Summer 1993,1983149,185903,1797246,2017_boxofficemojo_rankings.csv,2017,0.0937413174703464,0.9062586825296536
2989,Great Performances at the Met: Verdi: La Traviata,1982588,1882931,99657,2018_boxofficemojo_rankings.csv,2018,0.9497338831870262,0.05026611681297375
2990,Singham Returns,1974745,1232018,742727,2014_boxofficemojo_rankings.csv,2014,0.6238871347946191,0.37611286520538095
2991,Beloved,1971858,137515,1834343,2011_boxofficemojo_rankings.csv,2011,0.06973879457851427,0.9302612054214857
2992,Diary of a Chambermaid,1971247,54235,1917012,2015_boxofficemojo_rankings.csv,2015,0.027513041237348743,0.9724869587626512
2993,Maquia: When the Promised Flower Blooms,1963575,185699,1777876,2018_boxofficemojo_rankings.csv,2018,0.09457189055676508,0.9054281094432349
2994,Menashe,1962265,1703036,259229,2017_boxofficemojo_rankings.csv,2017,0.8678929706232339,0.13210702937676613
2995,Holy Motors,1954125,641100,1313025,2012_boxofficemojo_rankings.csv,2012,0.3280752254845519,0.6719247745154481
2996,A Ghost Story,1951683,1596371,355312,2017_boxofficemojo_rankings.csv,2017,0.8179458446889172,0.1820541553110828
2997,Deadfall,1946254,66351,1879903,2012_boxofficemojo_rankings.csv,2012,0.03409164476990156,0.9659083552300984
2998,Marie Curie: The Courage of Knowledge,1944392,127986,1816406,2017_boxofficemojo_rankings.csv,2017,0.06582314677287296,0.9341768532271271
2999,V/H/S,1944287,100345,1843942,2012_boxofficemojo_rankings.csv,2012,0.0516101789499184,0.9483898210500816
3000,Housefull 3,1944262,1326999,617263,2016_boxofficemojo_rankings.csv,2016,0.6825206685107255,0.3174793314892746
3001,Another Earth,1938783,1321194,617589,2011_boxofficemojo_rankings.csv,2011,0.6814553253252169,0.3185446746747831
3002,Luka Chuppi,1923586,1042905,880681,2019_boxofficemojo_rankings.csv,2019,0.5421670775312359,0.45783292246876406
3003,Jane,1921221,1723379,197842,2017_boxofficemojo_rankings.csv,2017,0.8970227787433096,0.10297722125669041
3004,The Keeper,1916514,0,1916514,2019_boxofficemojo_rankings.csv,2019,0.0,1.0
3005,Old Fashioned,1914090,1914090,0,2015_boxofficemojo_rankings.csv,2015,1.0,0.0
3006,Professor Marston & the Wonder Women,1899615,1584759,314856,2017_boxofficemojo_rankings.csv,2017,0.8342527301584794,0.16574726984152052
3007,Frank,1897363,645186,1252177,2014_boxofficemojo_rankings.csv,2014,0.3400435235640202,0.6599564764359799
3008,Jurassic Park 2020 Re-release,1896545,1386600,509945,2020_boxofficemojo_rankings.csv,2020,0.7311189557853887,0.2688810442146113
3009,Game of Thrones Season 4 Finale,1896092,1896092,0,2015_boxofficemojo_rankings.csv,2015,1.0,0.0
3010,The Art of Getting By,1892130,1430241,461889,2011_boxofficemojo_rankings.csv,2011,0.7558893944919218,0.2441106055080782
3011,The Mighty Macs,1891936,1891936,0,2011_boxofficemojo_rankings.csv,2011,1.0,0.0
3012,Awake: The Life of Yogananda,1891918,1539680,352238,2014_boxofficemojo_rankings.csv,2014,0.8138196264320123,0.1861803735679876
3013,Red Lips,1889869,136163,1753706,2011_boxofficemojo_rankings.csv,2011,0.07204890921010927,0.9279510907898907
3014,Tusk,1882074,1826705,55369,2014_boxofficemojo_rankings.csv,2014,0.9705808592010728,0.02941914079892714
3015,Kill Your Darlings,1877924,1030064,847860,2013_boxofficemojo_rankings.csv,2013,0.5485120803610796,0.45148791963892043
3016,Fantastic Fungi,1877675,1788322,89353,2019_boxofficemojo_rankings.csv,2019,0.9524129575139467,0.04758704248605323
3017,Red State,1874460,1104682,769778,2011_boxofficemojo_rankings.csv,2011,0.5893334613702079,0.410666538629792
3018,Last Flag Flying,1872950,965481,907469,2017_boxofficemojo_rankings.csv,2017,0.5154867989001308,0.4845132010998692
3019,The Whistleblower,1870392,1124966,745426,2011_boxofficemojo_rankings.csv,2011,0.6014600147990368,0.39853998520096323
3020,Purple Rain 2016 Re-release,1868929,1868075,854,2016_boxofficemojo_rankings.csv,2016,0.9995430538024719,0.000456946197528103
3021,Inseparables,1864605,6258,1858347,2016_boxofficemojo_rankings.csv,2016,0.003356206810557732,0.9966437931894423
3022,Matthias & Maxime,1863999,374739,1489260,2019_boxofficemojo_rankings.csv,2019,0.2010403439057639,0.7989596560942361
3023,A Better Life,1863506,1759252,104254,2011_boxofficemojo_rankings.csv,2011,0.9440549158414301,0.05594508415856992
3024,Girlhood,1862990,60765,1802225,2014_boxofficemojo_rankings.csv,2014,0.03261692225937874,0.9673830777406213
3025,The Hallow,1862407,13906,1848501,2015_boxofficemojo_rankings.csv,2015,0.007466681557790537,0.9925333184422095
3026,The Dark Horse,1862114,67533,1794581,2014_boxofficemojo_rankings.csv,2014,0.036266845101857355,0.9637331548981426
3027,Made in Italy,1858824,101339,1757485,2020_boxofficemojo_rankings.csv,2020,0.054517802653720845,0.9454821973462791
3028,The Pact,1855647,2488,1853159,2018_boxofficemojo_rankings.csv,2018,0.0013407722481700453,0.9986592277518299
3029,Sweet Country,1847693,104297,1743396,2018_boxofficemojo_rankings.csv,2018,0.056447147875756415,0.9435528521242436
3030,Crooked Arrows,1832541,1832541,0,2012_boxofficemojo_rankings.csv,2012,1.0,0.0
3031,99 Homes,1828232,1411927,416305,2015_boxofficemojo_rankings.csv,2015,0.7722909346297406,0.22770906537025937
3032,Grease 2018 Re-release,1827688,1213413,614275,2018_boxofficemojo_rankings.csv,2018,0.6639059839534975,0.33609401604650246
3033,Rams,1826583,149250,1677333,2015_boxofficemojo_rankings.csv,2015,0.08170994693370079,0.9182900530662992
3034,A Somewhat Gentle Man,1826459,37743,1788716,2010_boxofficemojo_rankings.csv,2010,0.02066457555302364,0.9793354244469764
3035,The Little Stranger,1824902,713143,1111759,2018_boxofficemojo_rankings.csv,2018,0.39078427225133183,0.6092157277486682
3036,Mozart's Sister,1824891,707885,1117006,2010_boxofficemojo_rankings.csv,2010,0.3879053598269705,0.6120946401730295
3037,Infinitely Polar Bear,1824678,1430655,394023,2015_boxofficemojo_rankings.csv,2015,0.7840588860061884,0.21594111399381152
3038,Human Flow,1824537,527845,1296692,2017_boxofficemojo_rankings.csv,2017,0.28930353289629096,0.710696467103709
3039,The Seagull,1820461,1252960,567501,2018_boxofficemojo_rankings.csv,2018,0.688265225127042,0.311734774872958
3040,The Monk,1809527,13472,1796055,2011_boxofficemojo_rankings.csv,2011,0.0074450395047987675,0.9925549604952012
3041,The Other Side of Heaven 2: Fire of Faith,1807216,1807216,0,2019_boxofficemojo_rankings.csv,2019,1.0,0.0
3042,Moses,1807117,1807117,0,2018_boxofficemojo_rankings.csv,2018,1.0,0.0
3043,The Face of Love,1806548,350006,1456542,2013_boxofficemojo_rankings.csv,2013,0.19374298385650424,0.8062570161434958
3044,Elvis & Nixon,1798432,1055287,743145,2016_boxofficemojo_rankings.csv,2016,0.5867817076208608,0.41321829237913915
3045,The Polar Express 2010 IMAX Release,1798274,672796,1125478,2010_boxofficemojo_rankings.csv,2010,0.3741343087872037,0.6258656912127962
3046,Mine,1788934,0,1788934,2016_boxofficemojo_rankings.csv,2016,0.0,1.0
3047,Harry Potter IMAX Marathon,1784557,1729226,55331,2016_boxofficemojo_rankings.csv,2016,0.9689945459853622,0.031005454014637807
3048,Soldiers of Fortune,1784286,38898,1745388,2012_boxofficemojo_rankings.csv,2012,0.021800316765361608,0.9781996832346384
3049,Song to Song,1778021,443684,1334337,2017_boxofficemojo_rankings.csv,2017,0.2495381100673164,0.7504618899326836
3050,Ondine,1777019,550472,1226547,2010_boxofficemojo_rankings.csv,2010,0.30977271486686414,0.6902272851331359
3051,Tom of Finland,1776931,378296,1398635,2017_boxofficemojo_rankings.csv,2017,0.2128929035511227,0.7871070964488773
3052,The Diary of a Teenage Girl,1775133,1477002,298131,2015_boxofficemojo_rankings.csv,2015,0.832051457552758,0.16794854244724197
3053,Polaroid,1772204,0,1772204,2019_boxofficemojo_rankings.csv,2019,0.0,1.0
3054,Dior and I,1769832,1028953,740879,2015_boxofficemojo_rankings.csv,2015,0.5813845607944709,0.4186154392055291
3055,I Saw the Light,1767963,1646788,121175,2016_boxofficemojo_rankings.csv,2016,0.9314606697085855,0.06853933029141447
3056,Invisible Life,1766249,146535,1619714,2019_boxofficemojo_rankings.csv,2019,0.08296395355354766,0.9170360464464523
3057,Game,1764828,139528,1625300,2011_boxofficemojo_rankings.csv,2011,0.07906039568728511,0.9209396043127149
3058,Great Performances at the Met: Puccini: La Bohème,1764201,1764201,0,2018_boxofficemojo_rankings.csv,2018,1.0,0.0
3059,Tales of the Night,1762194,10975,1751219,2011_boxofficemojo_rankings.csv,2011,0.006228031646912883,0.9937719683530871
3060,Flipped,1755212,1755212,0,2010_boxofficemojo_rankings.csv,2010,1.0,0.0
3061,Great Performances at the Met: Massenet: Cendrillon,1747259,1243306,503953,2018_boxofficemojo_rankings.csv,2018,0.7115751013444487,0.2884248986555514
3062,Beast,1744071,800365,943706,2018_boxofficemojo_rankings.csv,2018,0.45890620278646915,0.5410937972135309
3063,"Turn Me On, Dammit!",1743743,126085,1617658,2011_boxofficemojo_rankings.csv,2011,0.07230710030090444,0.9276928996990955
3064,Wuthering Heights,1742215,100915,1641300,2011_boxofficemojo_rankings.csv,2011,0.057923390626300426,0.9420766093736995
3065,National Theatre Live: King Lear,1731751,185305,1546446,2018_boxofficemojo_rankings.csv,2018,0.1070044134520494,0.8929955865479506
3066,First Position,1730824,1014071,716753,2012_boxofficemojo_rankings.csv,2012,0.5858891487522706,0.4141108512477294
3067,After Love,1728251,13693,1714558,2016_boxofficemojo_rankings.csv,2016,0.007923038956725614,0.9920769610432744
3068,Girl Rising,1727259,1727259,0,2013_boxofficemojo_rankings.csv,2013,1.0,0.0
3069,Diana Vreeland: The Eye Has to Travel,1721472,1017579,703893,2012_boxofficemojo_rankings.csv,2012,0.5911098176444345,0.40889018235556546
3070,A Faithful Man,1720605,77491,1643114,2018_boxofficemojo_rankings.csv,2018,0.04503706545081527,0.9549629345491847
3071,The Souvenir,1719157,1036737,682420,2019_boxofficemojo_rankings.csv,2019,0.6030496342102554,0.39695036578974463
3072,Weiner,1715955,1676108,39847,2016_boxofficemojo_rankings.csv,2016,0.9767785285744672,0.02322147142553272
3073,"To Joey, with Love",1709073,1709073,0,2016_boxofficemojo_rankings.csv,2016,1.0,0.0
3074,Paradise: Love,1709036,24267,1684769,2012_boxofficemojo_rankings.csv,2012,0.01419923278386178,0.9858007672161382
3075,"Men, Women & Children",1705908,705908,1000000,2014_boxofficemojo_rankings.csv,2014,0.4138019166332534,0.5861980833667466
3076,The Oscar Nominated Short Films 2012: Live Action,1702415,1702415,0,2012_boxofficemojo_rankings.csv,2012,1.0,0.0
3077,Meet the Patels,1700681,1700681,0,2015_boxofficemojo_rankings.csv,2015,1.0,0.0
3078,Tekken,1697207,0,1697207,2010_boxofficemojo_rankings.csv,2010,0.0,1.0
3079,The Wild Pear Tree,1696258,34014,1662244,2018_boxofficemojo_rankings.csv,2018,0.020052374108184015,0.9799476258918159
3080,Dunkirk 2017 Re-release,1695119,1695119,0,2017_boxofficemojo_rankings.csv,2017,1.0,0.0
3081,All Good Things 2010 Re-release,1689646,582024,1107622,2010_boxofficemojo_rankings.csv,2010,0.34446505362661767,0.6555349463733824
3082,Slamma Jamma,1687000,1687000,0,2017_boxofficemojo_rankings.csv,2017,1.0,0.0
3083,Tim's Vermeer,1686917,1671377,15540,2014_boxofficemojo_rankings.csv,2014,0.9907879285110056,0.00921207148899442
3084,Janis: Little Girl Blue,1683166,410465,1272701,2015_boxofficemojo_rankings.csv,2015,0.2438648356727738,0.7561351643272262
3085,The Bride,1682689,0,1682689,2015_boxofficemojo_rankings.csv,2015,0.0,1.0
3086,Detachment,1681521,72689,1608832,2012_boxofficemojo_rankings.csv,2012,0.04322812501300906,0.9567718749869909
3087,The Hunter,1680778,176669,1504109,2011_boxofficemojo_rankings.csv,2011,0.10511144243915616,0.8948885575608438
3088,In Between,1679952,107977,1571975,2016_boxofficemojo_rankings.csv,2016,0.06427386020552968,0.9357261397944703
3089,Final Portrait,1677835,461972,1215863,2017_boxofficemojo_rankings.csv,2017,0.275338158996564,0.724661841003436
3090,Nothing Left to Fear,1675381,7886,1667495,2013_boxofficemojo_rankings.csv,2013,0.0047069890371205115,0.9952930109628795
3091,Ginger & Rosa,1674776,1012973,661803,2012_boxofficemojo_rankings.csv,2012,0.6048408861841822,0.39515911381581775
3092,Equity,1672306,1605463,66843,2016_boxofficemojo_rankings.csv,2016,0.9600294443720229,0.039970555627977175
3093,A Brother's Love,1671969,539524,1132445,2019_boxofficemojo_rankings.csv,2019,0.32268780102980377,0.6773121989701962
3094,Vanishing on 7th Street,1671196,22729,1648467,2011_boxofficemojo_rankings.csv,2011,0.013600439445762197,0.9863995605542378
3095,The Double,1662515,200406,1462109,2014_boxofficemojo_rankings.csv,2014,0.12054387479210714,0.8794561252078928
3096,The Comedian,1659002,1659002,0,2016_boxofficemojo_rankings.csv,2016,1.0,0.0
3097,Rustom,1658594,1087419,571175,2016_boxofficemojo_rankings.csv,2016,0.6556269949125585,0.3443730050874415
3098,Rockstar,1651601,986697,664904,2011_boxofficemojo_rankings.csv,2011,0.5974185048325836,0.40258149516741637
3099,Namaste England,1649863,104156,1545707,2018_boxofficemojo_rankings.csv,2018,0.06313009019536774,0.9368699098046323
3100,Two Lives,1649260,22620,1626640,2012_boxofficemojo_rankings.csv,2012,0.013715241987315524,0.9862847580126844
3101,Dough,1647429,1148304,499125,2016_boxofficemojo_rankings.csv,2016,0.6970279144048089,0.30297208559519107
3102,The Letters,1647416,1647416,0,2015_boxofficemojo_rankings.csv,2015,1.0,0.0
3103,The Little Hours,1647175,1647175,0,2017_boxofficemojo_rankings.csv,2017,1.0,0.0
3104,Short Term 12,1645164,1013100,632064,2013_boxofficemojo_rankings.csv,2013,0.6158048680860996,0.38419513191390037
3105,Deerskin,1641693,0,1641693,2019_boxofficemojo_rankings.csv,2019,0.0,1.0
3106,A Family Man,1641235,0,1641235,2017_boxofficemojo_rankings.csv,2017,0.0,1.0
3107,Sorry Angel,1636273,30628,1605645,2018_boxofficemojo_rankings.csv,2018,0.018718147888524713,0.9812818521114753
3108,Student of the Year 2,1635907,778566,857341,2019_boxofficemojo_rankings.csv,2019,0.47592314233021804,0.524076857669782
3109,Mohenjo Daro,1630231,1264339,365892,2016_boxofficemojo_rankings.csv,2016,0.7755581877660283,0.22444181223397175
3110,Iris,1620708,1310678,310030,2015_boxofficemojo_rankings.csv,2015,0.8087070588903121,0.19129294110968786
3111,All You Need Is Love,1620654,0,1620654,2014_boxofficemojo_rankings.csv,2014,0.0,1.0
3112,I Still See You,1620637,1359,1619278,2018_boxofficemojo_rankings.csv,2018,0.0008385591591454472,0.9991614408408546
3113,Son of Sardaar,1618361,771789,846572,2012_boxofficemojo_rankings.csv,2012,0.4768954516328557,0.5231045483671443
3114,Grand Piano,1618085,22555,1595530,2013_boxofficemojo_rankings.csv,2013,0.013939317155773645,0.9860606828442263
3115,Batman Begins 2012 Re-release,1612434,1508658,103776,2012_boxofficemojo_rankings.csv,2012,0.9356401564343099,0.06435984356569013
3116,Singin' in the Rain 2012 Re-release,1609789,1608925,864,2012_boxofficemojo_rankings.csv,2012,0.9994632836974287,0.0005367163025713307
3117,Walk With Me,1606705,726726,879979,2017_boxofficemojo_rankings.csv,2017,0.4523082955489651,0.5476917044510349
3118,More Than Honey,1604609,79772,1524837,2012_boxofficemojo_rankings.csv,2012,0.049714291768275014,0.950285708231725
3119,We are the Best!,1604273,180590,1423683,2013_boxofficemojo_rankings.csv,2013,0.11256812275716166,0.8874318772428383
3120,Monos,1601199,406473,1194726,2019_boxofficemojo_rankings.csv,2019,0.25385539211553343,0.7461446078844666
3121,Crazy Mad Lover,1597269,993031,604238,2011_boxofficemojo_rankings.csv,2011,0.6217055486583662,0.37829445134163375
3122,Great Performances at the Met: Verdi: Aida,1595902,1595902,0,2018_boxofficemojo_rankings.csv,2018,1.0,0.0
3123,Queen of the Desert,1592853,0,1592853,2015_boxofficemojo_rankings.csv,2015,0.0,1.0
3124,Beanpole,1591621,196258,1395363,2019_boxofficemojo_rankings.csv,2019,0.12330699331059342,0.8766930066894066
3125,I Am,1591034,1591034,0,2011_boxofficemojo_rankings.csv,2011,1.0,0.0
3126,The Crossing,1589212,90896,1498316,2019_boxofficemojo_rankings.csv,2019,0.05719564161357956,0.9428043583864204
3127,Dance Academy: The Movie,1586858,0,1586858,2017_boxofficemojo_rankings.csv,2017,0.0,1.0
3128,Lovelace,1585583,356582,1229001,2013_boxofficemojo_rankings.csv,2013,0.22489015081518912,0.7751098491848109
3129,Make Your Move,1583687,125106,1458581,2012_boxofficemojo_rankings.csv,2012,0.07899667042793178,0.9210033295720682
3130,The Bay,1581252,30668,1550584,2012_boxofficemojo_rankings.csv,2012,0.019394758077776346,0.9806052419222236
3131,Lou!,1581125,287,1580838,2014_boxofficemojo_rankings.csv,2014,0.00018151632540121747,0.9998184836745988
3132,The Stray,1579440,1579440,0,2017_boxofficemojo_rankings.csv,2017,1.0,0.0
3133,Lay the Favorite,1576687,20998,1555689,2012_boxofficemojo_rankings.csv,2012,0.013317798649953985,0.986682201350046
3134,Adore,1575749,318982,1256767,2013_boxofficemojo_rankings.csv,2013,0.2024319863125409,0.7975680136874591
3135,Genesis: Paradise Lost,1575000,1575000,0,2017_boxofficemojo_rankings.csv,2017,1.0,0.0
3136,Teri Meri Kahaani,1574703,781196,793507,2012_boxofficemojo_rankings.csv,2012,0.49609100890771146,0.5039089910922885
3137,Teen Spirit,1573601,441366,1132235,2019_boxofficemojo_rankings.csv,2019,0.2804815197753433,0.7195184802246567
3138,Caesar Must Die,1567339,76908,1490431,2012_boxofficemojo_rankings.csv,2012,0.04906915479038038,0.9509308452096196
3139,"Bless Me, Ultima",1561962,1561962,0,2013_boxofficemojo_rankings.csv,2013,1.0,0.0
3140,Persecuted,1558836,1558836,0,2014_boxofficemojo_rankings.csv,2014,1.0,0.0
3141,The Kid,1553483,1508593,44890,2019_boxofficemojo_rankings.csv,2019,0.9711036425889437,0.028896357411056315
3142,Still Mine,1552730,1159336,393394,2013_boxofficemojo_rankings.csv,2013,0.7466436534362059,0.2533563465637941
3143,Yardie,1551163,36012,1515151,2018_boxofficemojo_rankings.csv,2018,0.0232161288014219,0.9767838711985781
3144,Tel Aviv on Fire,1548893,506145,1042748,2019_boxofficemojo_rankings.csv,2019,0.3267785444184976,0.6732214555815024
3145,Cold in July,1547630,427418,1120212,2014_boxofficemojo_rankings.csv,2014,0.276175830140279,0.723824169859721
3146,Fed Up,1546229,1538899,7330,2014_boxofficemojo_rankings.csv,2014,0.9952594344046063,0.0047405655953936966
3147,"New York, New York",1545352,92377,1452975,2016_boxofficemojo_rankings.csv,2016,0.059777319342130465,0.9402226806578695
3148,The Lords of Salem,1544989,1165882,379107,2013_boxofficemojo_rankings.csv,2013,0.7546215539398662,0.24537844606013376
3149,Mystery Train,1544973,1541218,3755,2018_boxofficemojo_rankings.csv,2018,0.9975695368139119,0.0024304631860880416
3150,Rampart,1543613,972512,571101,2012_boxofficemojo_rankings.csv,2012,0.6300231988199114,0.3699768011800885
3151,The Wedding Plan,1542345,1412404,129941,2016_boxofficemojo_rankings.csv,2016,0.9157510154991263,0.08424898450087367
3152,The Chaperone,1541223,600654,940569,2019_boxofficemojo_rankings.csv,2019,0.38972556210230447,0.6102744378976955
3153,Reaching for the Moon,1534391,45502,1488889,2013_boxofficemojo_rankings.csv,2013,0.029654762052175748,0.9703452379478242
3154,Love,1533874,309200,1224674,2012_boxofficemojo_rankings.csv,2012,0.2015810946661851,0.7984189053338149
3155,The Bullet Vanishes,1528580,117629,1410951,2012_boxofficemojo_rankings.csv,2012,0.07695311988904735,0.9230468801109526
3156,Gold,1528185,5539,1522646,2017_boxofficemojo_rankings.csv,2017,0.0036245611624247066,0.9963754388375753
3157,Certain Women,1526698,1087585,439113,2016_boxofficemojo_rankings.csv,2016,0.7123773005532201,0.28762269944677993
3158,Mandy,1523052,1214525,308527,2018_boxofficemojo_rankings.csv,2018,0.7974284528696328,0.20257154713036718
3159,Shaadi Ke Side Effects,1521778,921277,600501,2014_boxofficemojo_rankings.csv,2014,0.605395136478514,0.39460486352148605
3160,Princess Mononoke 2018 Re-release,1519321,1423877,95444,2018_boxofficemojo_rankings.csv,2018,0.9371798323066686,0.06282016769333143
3161,Relic,1515433,1047083,468350,2020_boxofficemojo_rankings.csv,2020,0.6909464159748402,0.3090535840251598
3162,The Dark Knight 2012 Re-release,1513086,1513086,0,2012_boxofficemojo_rankings.csv,2012,1.0,0.0
3163,My Golden Days,1509773,269144,1240629,2015_boxofficemojo_rankings.csv,2015,0.17826785881056292,0.821732141189437
3164,Take a Shot,1508912,564489,944423,2011_boxofficemojo_rankings.csv,2011,0.3741033274306255,0.6258966725693745
3165,The Daughter,1505434,26376,1479058,2016_boxofficemojo_rankings.csv,2016,0.01752052896374069,0.9824794710362593
3166,The Kings of Summer,1501595,1315590,186005,2013_boxofficemojo_rankings.csv,2013,0.8761283834855603,0.12387161651443965
3167,Priceless,1499605,1499605,0,2016_boxofficemojo_rankings.csv,2016,1.0,0.0
3168,Moka,1493067,129547,1363520,2016_boxofficemojo_rankings.csv,2016,0.0867656977215356,0.9132343022784644
3169,The Artist and the Model,1492780,127958,1364822,2012_boxofficemojo_rankings.csv,2012,0.08571792226583957,0.9142820777341605
3170,Mully,1489771,1489771,0,2017_boxofficemojo_rankings.csv,2017,1.0,0.0
3171,Patti Cake$,1482356,800148,682208,2017_boxofficemojo_rankings.csv,2017,0.5397812671180202,0.4602187328819798
3172,Oasis: Supersonic,1478119,242867,1235252,2016_boxofficemojo_rankings.csv,2016,0.16430815110285438,0.8356918488971457
3173,The Miseducation of Cameron Post,1474577,904703,569874,2018_boxofficemojo_rankings.csv,2018,0.613533915149904,0.386466084850096
3174,Freeheld,1474471,573335,901136,2015_boxofficemojo_rankings.csv,2015,0.3888411504871917,0.6111588495128083
3175,Good Kill,1474471,316472,1157999,2015_boxofficemojo_rankings.csv,2015,0.21463426544163974,0.7853657345583602
3176,Mausam,1473341,728316,745025,2011_boxofficemojo_rankings.csv,2011,0.4943295543937215,0.5056704456062785
3177,De De Pyaar De,1473116,425934,1047182,2019_boxofficemojo_rankings.csv,2019,0.28913812625753843,0.7108618737424616
3178,A Pigeon Sat on a Branch Reflecting on Existence,1472431,222989,1249442,2014_boxofficemojo_rankings.csv,2014,0.15144275011868127,0.8485572498813188
3179,Jimmy P.,1470582,30283,1440299,2013_boxofficemojo_rankings.csv,2013,0.020592527312315805,0.9794074726876842
3180,Violeta Went to Heaven,1466032,21496,1444536,2011_boxofficemojo_rankings.csv,2011,0.014662708590262696,0.9853372914097374
3181,Thelma,1463727,147391,1316336,2017_boxofficemojo_rankings.csv,2017,0.10069568983833733,0.8993043101616627
3182,Greed,1460431,355308,1105123,2020_boxofficemojo_rankings.csv,2020,0.24328982334666957,0.7567101766533304
3183,Life of Crime,1456675,265452,1191223,2014_boxofficemojo_rankings.csv,2014,0.1822314517651501,0.8177685482348499
3184,The Other Woman,1451343,25423,1425920,2010_boxofficemojo_rankings.csv,2010,0.017516879193960354,0.9824831208060396
3185,The Disappearance of Eleanor Rigby: Them,1448076,587774,860302,2014_boxofficemojo_rankings.csv,2014,0.4058999665763399,0.5941000334236601
3186,The City of Your Final Destination,1444401,493296,951105,2010_boxofficemojo_rankings.csv,2010,0.34152288734222697,0.658477112657773
3187,Shameless,1443479,679866,763613,2013_boxofficemojo_rankings.csv,2013,0.4709912648538704,0.5290087351461296
3188,The Dawn Wall 2018 Re-release,1442013,970032,471981,2018_boxofficemojo_rankings.csv,2018,0.6726929646265325,0.3273070353734675
3189,Vox Lux,1439539,727119,712420,2018_boxofficemojo_rankings.csv,2018,0.5051054538987829,0.49489454610121714
3190,Tomboy,1437501,129834,1307667,2011_boxofficemojo_rankings.csv,2011,0.09031924151704938,0.9096807584829506
3191,My Friend Dahmer,1436751,1361611,75140,2017_boxofficemojo_rankings.csv,2017,0.947701445831602,0.052298554168398
3192,Restrepo,1436391,1330894,105497,2010_boxofficemojo_rankings.csv,2010,0.9265541207094725,0.07344587929052744
3193,Kai Po Che,1435272,1122527,312745,2013_boxofficemojo_rankings.csv,2013,0.7821005356475985,0.21789946435240148
3194,The Devil's Hand,1428494,5746,1422748,2014_boxofficemojo_rankings.csv,2014,0.004022418015056416,0.9959775819849436
3195,The Zero Theorem,1428362,257706,1170656,2014_boxofficemojo_rankings.csv,2014,0.18042064966724122,0.8195793503327587
3196,Fairy Tail: Dragon Cry,1420035,519461,900574,2017_boxofficemojo_rankings.csv,2017,0.3658085892249135,0.6341914107750866
3197,Black Butterflies,1416573,0,1416573,2011_boxofficemojo_rankings.csv,2011,0.0,1.0
3198,It 2019 Re-release,1414696,1347126,67570,2019_boxofficemojo_rankings.csv,2019,0.9522370883921352,0.04776291160786487
3199,The Wolfpack,1414140,1301696,112444,2015_boxofficemojo_rankings.csv,2015,0.9204859490573777,0.07951405094262237
3200,Parkland,1412181,653651,758530,2013_boxofficemojo_rankings.csv,2013,0.4628663039652849,0.5371336960347151
3201,Lazer Team,1406538,1186426,220112,2016_boxofficemojo_rankings.csv,2016,0.8435079606807637,0.1564920393192363
3202,Just a Sigh,1406331,75531,1330800,2013_boxofficemojo_rankings.csv,2013,0.053707839761763056,0.9462921602382369
3203,El Chicano,1404646,1400603,4043,2019_boxofficemojo_rankings.csv,2019,0.9971216947188117,0.002878305281188285
3204,Haider,1404307,1048143,356164,2014_boxofficemojo_rankings.csv,2014,0.7463773946864894,0.2536226053135105
3205,Universal Soldier: Day of Reckoning,1402307,5460,1396847,2012_boxofficemojo_rankings.csv,2012,0.0038935839299097845,0.9961064160700902
3206,Saheb Biwi Aur Gangster 3,1401894,0,1401894,2018_boxofficemojo_rankings.csv,2018,0.0,1.0
3207,Born to Be Blue 2016 Re-release,1401411,678203,723208,2016_boxofficemojo_rankings.csv,2016,0.4839429689077651,0.5160570310922349
3208,For Sama,1397546,43796,1353750,2019_boxofficemojo_rankings.csv,2019,0.03133778780805784,0.9686622121919422
3209,Maggie,1394052,187112,1206940,2015_boxofficemojo_rankings.csv,2015,0.1342216789617604,0.8657783210382396
3210,Light of My Life,1392898,20056,1372842,2019_boxofficemojo_rankings.csv,2019,0.014398757123637194,0.9856012428763629
3211,White Material,1392434,304020,1088414,2010_boxofficemojo_rankings.csv,2010,0.21833709892174422,0.7816629010782558
3212,Holiday: A Soldier is Never Off Duty,1390054,706893,683161,2014_boxofficemojo_rankings.csv,2014,0.5085363590191461,0.491463640980854
3213,"Oslo, August 31st",1386378,101475,1284903,2011_boxofficemojo_rankings.csv,2011,0.07319432362602407,0.9268056763739759
3214,"For a Good Time, Call...",1386088,1251749,134339,2012_boxofficemojo_rankings.csv,2012,0.9030804681953816,0.09691953180461847
3215,National Lampoon's Christmas Vacation 2019 Re-release,1385620,1385620,0,2019_boxofficemojo_rankings.csv,2019,1.0,0.0
3216,House of Tolerance,1384443,19327,1365116,2011_boxofficemojo_rankings.csv,2011,0.013960126924691013,0.9860398730753089
3217,Sometimes Always Never,1377856,0,1377856,2018_boxofficemojo_rankings.csv,2018,0.0,1.0
3218,Swimming with Men,1377748,24708,1353040,2018_boxofficemojo_rankings.csv,2018,0.0179336134039026,0.9820663865960974
3219,Ma ma,1375709,47258,1328451,2015_boxofficemojo_rankings.csv,2015,0.03435174153836313,0.9656482584616368
3220,Khoobsurat,1375623,710508,665115,2014_boxofficemojo_rankings.csv,2014,0.5164990698759762,0.4835009301240238
3221,A Good Old Fashioned Orgy,1369485,200227,1169258,2011_boxofficemojo_rankings.csv,2011,0.14620605556103206,0.8537939444389679
3222,The Outpost,1369175,0,1369175,2020_boxofficemojo_rankings.csv,2020,0.0,1.0
3223,Sarileru Neekevvaru,1366335,821000,545335,2020_boxofficemojo_rankings.csv,2020,0.600877530034728,0.39912246996527206
3224,The Salvation,1363964,44903,1319061,2014_boxofficemojo_rankings.csv,2014,0.03292095685809889,0.9670790431419011
3225,Little Italy,1362536,990230,372306,2018_boxofficemojo_rankings.csv,2018,0.726755109589765,0.27324489041023503
3226,Gimme Shelter,1362018,1359910,2108,2014_boxofficemojo_rankings.csv,2014,0.9984522965188419,0.0015477034811581052
3227,Chasing Ice,1358668,1328467,30201,2012_boxofficemojo_rankings.csv,2012,0.9777716116078394,0.022228388392160556
3228,Raavan,1356461,708726,647735,2010_boxofficemojo_rankings.csv,2010,0.5224816636821847,0.47751833631781526
3229,Foxtrot,1356159,618883,737276,2018_boxofficemojo_rankings.csv,2018,0.45634988227781553,0.5436501177221845
3230,Papa,1356033,26677,1329356,2016_boxofficemojo_rankings.csv,2016,0.019672825071366258,0.9803271749286337
3231,National Theater Live: Cyrano de Bergerac 2020 Re-release,1354584,198352,1156232,2020_boxofficemojo_rankings.csv,2020,0.14643019554342884,0.8535698044565712
3232,The Oscar Nominated Short Films 2011: Live Action,1352152,1352152,0,2011_boxofficemojo_rankings.csv,2011,1.0,0.0
3233,Unforgivable,1351146,154189,1196957,2011_boxofficemojo_rankings.csv,2011,0.11411720124990193,0.885882798750098
3234,The Teacher,1350426,64437,1285989,2016_boxofficemojo_rankings.csv,2016,0.04771605404516797,0.952283945954832
3235,The Snowtown Murders,1349387,8452,1340935,2011_boxofficemojo_rankings.csv,2011,0.006263584872241989,0.993736415127758
3236,The Cokeville Miracle,1348456,1348456,0,2015_boxofficemojo_rankings.csv,2015,1.0,0.0
3237,Bolshoi Ballet: The Nutcracker,1348248,252935,1095313,2019_boxofficemojo_rankings.csv,2019,0.18760272590799318,0.8123972740920068
3238,The Assistant,1338220,1100313,237907,2020_boxofficemojo_rankings.csv,2020,0.8222213089028709,0.17777869109712902
3239,Student of the Year,1337281,670086,667195,2012_boxofficemojo_rankings.csv,2012,0.5010809246523356,0.4989190753476644
3240,Barney Thomson,1336254,0,1336254,2015_boxofficemojo_rankings.csv,2015,0.0,1.0
3241,Godard Mon Amour,1335846,82264,1253582,2017_boxofficemojo_rankings.csv,2017,0.06158194881745351,0.9384180511825465
3242,Great Performances at the Met: Rossini: Semiramide,1332900,1033651,299249,2018_boxofficemojo_rankings.csv,2018,0.7754902843424113,0.2245097156575887
3243,Ghost in the Shell: The New Movie,1332311,101203,1231108,2015_boxofficemojo_rankings.csv,2015,0.0759604927077837,0.9240395072922163
3244,Kapow,1331922,812737,519185,2016_boxofficemojo_rankings.csv,2016,0.6101986452660141,0.3898013547339859
3245,Ajami,1331651,622403,709248,2010_boxofficemojo_rankings.csv,2010,0.4673919818330779,0.5326080181669222
3246,The Ultimate Life,1327841,1327841,0,2013_boxofficemojo_rankings.csv,2013,1.0,0.0
3247,Spirited Away 2019 Re-release,1322927,1322927,0,2019_boxofficemojo_rankings.csv,2019,1.0,0.0
3248,It's a Wonderful Afterlife,1321438,0,1321438,2010_boxofficemojo_rankings.csv,2010,0.0,1.0
3249,The Look of Love,1318468,21252,1297216,2013_boxofficemojo_rankings.csv,2013,0.016118707469578327,0.9838812925304217
3250,Erased,1314735,0,1314735,2012_boxofficemojo_rankings.csv,2012,0.0,1.0
3251,Damsels in Distress,1314358,1008455,305903,2012_boxofficemojo_rankings.csv,2012,0.7672605180628109,0.2327394819371891
3252,Air Racers,1309987,1309987,0,2012_boxofficemojo_rankings.csv,2012,1.0,0.0
3253,Come What May,1309818,37766,1272052,2015_boxofficemojo_rankings.csv,2015,0.02883301344156211,0.9711669865584379
3254,Dom Hemingway,1307599,523511,784088,2013_boxofficemojo_rankings.csv,2013,0.40036050807625273,0.5996394919237472
3255,Something in the Air,1305473,85154,1220319,2012_boxofficemojo_rankings.csv,2012,0.06522846508506878,0.9347715349149313
3256,Great Performances at the Met: Mozart: Così fan tutte,1302949,1302949,0,2018_boxofficemojo_rankings.csv,2018,1.0,0.0
3257,Les Cowboys,1302493,73725,1228768,2015_boxofficemojo_rankings.csv,2015,0.056602991340452505,0.9433970086595475
3258,Sunset Song,1302482,159714,1142768,2015_boxofficemojo_rankings.csv,2015,0.12262280783918703,0.877377192160813
3259,Hard to Be a God,1299035,28608,1270427,2014_boxofficemojo_rankings.csv,2014,0.022022501318286265,0.9779774986817137
3260,Slow West,1295574,229094,1066480,2015_boxofficemojo_rankings.csv,2015,0.17682818580798934,0.8231718141920107
3261,Roger Waters - Us + Them,1294480,611644,682836,2019_boxofficemojo_rankings.csv,2019,0.47250169952413323,0.5274983004758668
3262,No Safe Spaces,1291514,1291514,0,2019_boxofficemojo_rankings.csv,2019,1.0,0.0
3263,The Cakemaker,1287568,875751,411817,2018_boxofficemojo_rankings.csv,2018,0.6801590284940291,0.31984097150597096
3264,Filmistaan,1282717,45406,1237311,2014_boxofficemojo_rankings.csv,2014,0.035398299079220125,0.9646017009207799
3265,I Spit on Your Grave,1278650,93051,1185599,2010_boxofficemojo_rankings.csv,2010,0.07277284636139679,0.9272271536386032
3266,Howl,1278390,617334,661056,2010_boxofficemojo_rankings.csv,2010,0.4828995846337972,0.5171004153662028
3267,Black Souls,1278360,101088,1177272,2014_boxofficemojo_rankings.csv,2014,0.07907631653055477,0.9209236834694452
3268,The Villain,1278108,730530,547578,2014_boxofficemojo_rankings.csv,2014,0.5715714165000141,0.4284285834999859
3269,Shed Skin Papa,1278065,13331,1264734,2018_boxofficemojo_rankings.csv,2018,0.0104306119015856,0.9895693880984144
3270,Yellow Submarine,1273261,992305,280956,2018_boxofficemojo_rankings.csv,2018,0.7793413919062941,0.22065860809370585
3271,The Women's Balcony,1272517,1200885,71632,2017_boxofficemojo_rankings.csv,2017,0.94370841411156,0.05629158588844
3272,Beautifully Broken,1271572,1209645,61927,2018_boxofficemojo_rankings.csv,2018,0.9512988647123403,0.04870113528765969
3273,Tai ji 1: Cong ling kai shi,1271521,212094,1059427,2012_boxofficemojo_rankings.csv,2012,0.16680337957454106,0.833196620425459
3274,Texas Killing Fields,1271319,45469,1225850,2011_boxofficemojo_rankings.csv,2011,0.03576521706983062,0.9642347829301694
3275,Fagara,1265949,43417,1222532,2019_boxofficemojo_rankings.csv,2019,0.03429601034480852,0.9657039896551914
3276,Why Don't You Play in Hell?,1265872,28534,1237338,2013_boxofficemojo_rankings.csv,2013,0.022540983606557378,0.9774590163934426
3277,Batla House,1264337,493180,771157,2019_boxofficemojo_rankings.csv,2019,0.39007005252555293,0.6099299474744471
3278,Valley of Love,1264277,28648,1235629,2015_boxofficemojo_rankings.csv,2015,0.02265959121300158,0.9773404087869985
3279,Chonda Pierce: Enough,1260116,1260116,0,2017_boxofficemojo_rankings.csv,2017,1.0,0.0
3280,Meerkats,1259616,777595,482021,2012_boxofficemojo_rankings.csv,2012,0.6173270266493915,0.38267297335060846
3281,The Music of Strangers: Yo-Yo Ma and the Silk Road Ensemble,1259588,1176781,82807,2016_boxofficemojo_rankings.csv,2016,0.9342586623562625,0.06574133764373748
3282,Gett,1259160,988150,271010,2014_boxofficemojo_rankings.csv,2014,0.7847692112201785,0.21523078877982146
3283,Guy,1257937,1319,1256618,2018_boxofficemojo_rankings.csv,2018,0.0010485421765954893,0.9989514578234046
3284,Anna,1257142,4288,1252854,2014_boxofficemojo_rankings.csv,2014,0.0034109114165305114,0.9965890885834695
3285,For a Woman,1252416,32286,1220130,2013_boxofficemojo_rankings.csv,2013,0.025778974398283,0.974221025601717
3286,Demi-soeur,1251642,943,1250699,2013_boxofficemojo_rankings.csv,2013,0.0007534103202033809,0.9992465896797966
3287,The Ledge,1247188,9216,1237972,2011_boxofficemojo_rankings.csv,2011,0.007389423246535406,0.9926105767534646
3288,Midnight's Children,1243980,190022,1053958,2012_boxofficemojo_rankings.csv,2012,0.15275325969870898,0.847246740301291
3289,Slumber,1243832,0,1243832,2017_boxofficemojo_rankings.csv,2017,0.0,1.0
3290,1945,1240663,1006193,234470,2017_boxofficemojo_rankings.csv,2017,0.811012337758118,0.18898766224188196
3291,The Goonies 2020 Re-release,1236438,825000,411438,2020_boxofficemojo_rankings.csv,2020,0.6672392792845254,0.33276072071547463
3292,Beyond the Mask,1236094,1236094,0,2015_boxofficemojo_rankings.csv,2015,1.0,0.0
3293,The Blue Room,1232900,254666,978234,2014_boxofficemojo_rankings.csv,2014,0.2065585205612783,0.7934414794387217
3294,The Cut,1232140,28066,1204074,2014_boxofficemojo_rankings.csv,2014,0.02277825571769442,0.9772217442823056
3295,Honeyland,1231697,815082,416615,2019_boxofficemojo_rankings.csv,2019,0.6617552855937784,0.33824471440622167
3296,Life,1231606,0,1231606,2015_boxofficemojo_rankings.csv,2015,0.0,1.0
3297,True to the Game,1231040,1231040,0,2017_boxofficemojo_rankings.csv,2017,1.0,0.0
3298,Steve McQueen: American Icon,1229782,1229782,0,2017_boxofficemojo_rankings.csv,2017,1.0,0.0
3299,The Perfect Candidate,1229580,0,1229580,2020_boxofficemojo_rankings.csv,2020,0.0,1.0
3300,Casablanca 2011 Re-release,1226808,1155330,71478,2011_boxofficemojo_rankings.csv,2011,0.9417366042608134,0.05826339573918657
3301,BTS World Tour 'Love Yourself: Speak Yourself' (The Final) Seoul Live Viewing,1226552,1226552,0,2019_boxofficemojo_rankings.csv,2019,1.0,0.0
3302,That Sugar Film,1226399,3500,1222899,2015_boxofficemojo_rankings.csv,2015,0.0028538836055802394,0.9971461163944197
3303,The Revolution Has Begun,1223419,738525,484894,2013_boxofficemojo_rankings.csv,2013,0.6036566376686973,0.3963433623313027
3304,Sister,1218174,154659,1063515,2012_boxofficemojo_rankings.csv,2012,0.12695969541297056,0.8730403045870294
3305,Ilo Ilo,1216181,56773,1159408,2013_boxofficemojo_rankings.csv,2013,0.04668137390733781,0.9533186260926622
3306,When We Leave,1214076,19631,1194445,2010_boxofficemojo_rankings.csv,2010,0.016169498449849926,0.9838305015501501
3307,Woman Thou Art Loosed: On the 7th Day,1213128,1213128,0,2012_boxofficemojo_rankings.csv,2012,1.0,0.0
3308,Clandestine Childhood,1212354,9017,1203337,2012_boxofficemojo_rankings.csv,2012,0.007437596609571132,0.9925624033904289
3309,Uncle Boonmee Who Can Recall His Past Lives,1212206,184292,1027914,2010_boxofficemojo_rankings.csv,2010,0.15203026548292947,0.8479697345170706
3310,Kochadaiiyaan,1210580,817192,393388,2014_boxofficemojo_rankings.csv,2014,0.6750417155413108,0.32495828445868924
3311,Casino Jack,1209709,1042959,166750,2010_boxofficemojo_rankings.csv,2010,0.862156931956363,0.13784306804363694
3312,The Way He Looks,1207841,101451,1106390,2014_boxofficemojo_rankings.csv,2014,0.08399367135243795,0.916006328647562
3313,Noble 2014 Re-release,1207386,347321,860065,2014_boxofficemojo_rankings.csv,2014,0.2876635972257422,0.7123364027742578
3314,Alone in Berlin,1205598,33125,1172473,2016_boxofficemojo_rankings.csv,2016,0.02747599116786856,0.9725240088321314
3315,Inequality for All,1205273,1205273,0,2013_boxofficemojo_rankings.csv,2013,1.0,0.0
3316,Meek's Cutoff,1205257,977772,227485,2011_boxofficemojo_rankings.csv,2011,0.8112560225744385,0.1887439774255615
3317,In the Land of Blood and Honey,1203699,303877,899822,2011_boxofficemojo_rankings.csv,2011,0.25245264804573236,0.7475473519542677
3318,"Beats, Rhymes & Life: The Travels of A Tribe Called Quest",1200326,1200326,0,2011_boxofficemojo_rankings.csv,2011,1.0,0.0
3319,Phantom,1197759,1034589,163170,2013_boxofficemojo_rankings.csv,2013,0.8637705915797752,0.13622940842022477
3320,Spirited Away 2017 Re-release,1196791,1196791,0,2017_boxofficemojo_rankings.csv,2017,1.0,0.0
3321,The Captain,1196669,109226,1087443,2018_boxofficemojo_rankings.csv,2018,0.09127503094005109,0.9087249690599489
3322,Great Performances at the Met: Saint-Saëns: Samson et Dalila,1195758,1195758,0,2018_boxofficemojo_rankings.csv,2018,1.0,0.0
3323,Repentance,1194961,1189612,5349,2014_boxofficemojo_rankings.csv,2014,0.9955237032840403,0.0044762967159597674
3324,The First Grader,1194710,332000,862710,2011_boxofficemojo_rankings.csv,2011,0.27789170593700563,0.7221082940629944
3325,When You're Strange,1194182,246078,948104,2010_boxofficemojo_rankings.csv,2010,0.20606406728622606,0.7939359327137739
3326,Free Men,1192651,53810,1138841,2011_boxofficemojo_rankings.csv,2011,0.04511797667549015,0.9548820233245099
3327,Kingdom Men Rising,1188936,1188936,0,2019_boxofficemojo_rankings.csv,2019,1.0,0.0
3328,Shubh Mangal Savdhan,1188541,689874,498667,2017_boxofficemojo_rankings.csv,2017,0.5804376963016,0.4195623036984
3329,Kill the Irishman,1188194,1188194,0,2011_boxofficemojo_rankings.csv,2011,1.0,0.0
3330,Dead Snow 2: Red vs. Dead,1187477,37473,1150004,2014_boxofficemojo_rankings.csv,2014,0.03155682173212618,0.9684431782678738
3331,Los Domirriqueños 2,1187280,1187280,0,2019_boxofficemojo_rankings.csv,2019,1.0,0.0
3332,Remember 2016 Re-release,1181023,637555,543468,2016_boxofficemojo_rankings.csv,2016,0.5398328398346179,0.46016716016538206
3333,Alien 2019 Re-release,1178844,833658,345186,2014_boxofficemojo_rankings.csv,2014,0.7071826297627167,0.2928173702372833
3334,Fire at Sea,1178377,120933,1057444,2016_boxofficemojo_rankings.csv,2016,0.10262674848541681,0.8973732515145832
3335,Any Body Can Dance 2,1176958,892133,284825,2015_boxofficemojo_rankings.csv,2015,0.7579990110097387,0.24200098899026135
3336,Raanjhanaa,1171761,903232,268529,2013_boxofficemojo_rankings.csv,2013,0.7708329599636786,0.2291670400363214
3337,The Innkeepers,1169750,78396,1091354,2012_boxofficemojo_rankings.csv,2012,0.06701944860012823,0.9329805513998718
3338,Dark Tide,1167612,0,1167612,2012_boxofficemojo_rankings.csv,2012,0.0,1.0
3339,Great Performances at the Met: Verdi: Luisa Miller,1166858,1166858,0,2018_boxofficemojo_rankings.csv,2018,1.0,0.0
3340,Her & Him,1166781,857986,308795,2016_boxofficemojo_rankings.csv,2016,0.7353445076668201,0.2646554923331799
3341,You Ain't Seen Nothin' Yet,1166740,18929,1147811,2012_boxofficemojo_rankings.csv,2012,0.01622383735879459,0.9837761626412054
3342,Vaxxed: From Cover-Up to Catastrophe,1163265,1163265,0,2016_boxofficemojo_rankings.csv,2016,1.0,0.0
3343,Louder Than Bombs,1160724,163807,996917,2015_boxofficemojo_rankings.csv,2015,0.14112484966279668,0.8588751503372033
3344,Where Hope Grows,1159072,1156000,3072,2015_boxofficemojo_rankings.csv,2015,0.9973496038209878,0.002650396179012175
3345,Breathe,1158695,42297,1116398,2014_boxofficemojo_rankings.csv,2014,0.03650399803226906,0.9634960019677309
3346,Darling Companion,1157257,793815,363442,2012_boxofficemojo_rankings.csv,2012,0.6859452999636209,0.31405470003637914
3347,Napping Princess,1156847,48198,1108649,2017_boxofficemojo_rankings.csv,2017,0.041663245009927845,0.9583367549900722
3348,Embrace: The Documentary,1155263,629126,526137,2016_boxofficemojo_rankings.csv,2016,0.5445738329713667,0.4554261670286333
3349,Detective Jagga,1154862,861740,293122,2017_boxofficemojo_rankings.csv,2017,0.7461843925940935,0.25381560740590653
3350,Step,1152839,1146292,6547,2017_boxofficemojo_rankings.csv,2017,0.9943209763028489,0.00567902369715112
3351,Liberal Arts,1150681,327345,823336,2012_boxofficemojo_rankings.csv,2012,0.28447936482830605,0.715520635171694
3352,Cartel Land,1145923,704352,441571,2015_boxofficemojo_rankings.csv,2015,0.6146591001315097,0.3853408998684903
3353,Elliot the Littlest Reindeer 2018 Re-release,1142187,24262,1117925,2018_boxofficemojo_rankings.csv,2018,0.021241705605124204,0.9787582943948758
3354,Roma,1140769,0,1140769,2018_boxofficemojo_rankings.csv,2018,0.0,1.0
3355,The Song of Names,1138962,1077584,61378,2019_boxofficemojo_rankings.csv,2019,0.9461105813890192,0.05388941861098088
3356,The Hollars,1138609,1016985,121624,2016_boxofficemojo_rankings.csv,2016,0.8931819439333433,0.10681805606665677
3357,Fathom Premieres 6 Below: Miracle on the Mountain,1135531,14838,1120693,2017_boxofficemojo_rankings.csv,2017,0.01306701446283721,0.9869329855371628
3358,Cell,1133031,0,1133031,2016_boxofficemojo_rankings.csv,2016,0.0,1.0
3359,Miral,1132843,373420,759423,2010_boxofficemojo_rankings.csv,2010,0.3296308491114832,0.6703691508885168
3360,Dancer,1131649,71917,1059732,2016_boxofficemojo_rankings.csv,2016,0.06355062391253825,0.9364493760874617
3361,Stranger by the Lake,1131241,325196,806045,2013_boxofficemojo_rankings.csv,2013,0.2874683643891974,0.7125316356108027
3362,Weekend,1128477,484592,643885,2011_boxofficemojo_rankings.csv,2011,0.4294212465118917,0.5705787534881083
3363,In the Name Of,1127938,9883,1118055,2013_boxofficemojo_rankings.csv,2013,0.008762006422338816,0.9912379935776612
3364,Look Away,1119537,0,1119537,2018_boxofficemojo_rankings.csv,2018,0.0,1.0
3365,Papa Hemingway in Cuba,1117399,1115615,1784,2016_boxofficemojo_rankings.csv,2016,0.9984034351203106,0.00159656487968935
3366,The Mill and the Cross,1116180,312187,803993,2011_boxofficemojo_rankings.csv,2011,0.2796923435288215,0.7203076564711784
3367,Great Performances at the Met: Donizetti: L'Elisir d'Amore,1115018,1115018,0,2018_boxofficemojo_rankings.csv,2018,1.0,0.0
3368,A War,1114663,122902,991761,2015_boxofficemojo_rankings.csv,2015,0.11025933398704361,0.8897406660129564
3369,The Selfish Giant,1114027,12189,1101838,2013_boxofficemojo_rankings.csv,2013,0.01094138651935725,0.9890586134806427
3370,Walking With The Enemy,1112592,1112592,0,2014_boxofficemojo_rankings.csv,2014,1.0,0.0
3371,The Overnight,1110522,1110522,0,2015_boxofficemojo_rankings.csv,2015,1.0,0.0
3372,My Neighbor Totoro 2019 Re-release,1105564,1105564,0,2019_boxofficemojo_rankings.csv,2019,1.0,0.0
3373,"Peace, Love & Misunderstanding",1105020,590700,514320,2012_boxofficemojo_rankings.csv,2012,0.5345604604441548,0.46543953955584516
3374,The Heart Specialist,1103037,1103037,0,2011_boxofficemojo_rankings.csv,2011,1.0,0.0
3375,The Insanity of God,1102525,1102525,0,2016_boxofficemojo_rankings.csv,2016,1.0,0.0
3376,El Coyote,1101470,1101470,0,2019_boxofficemojo_rankings.csv,2019,1.0,0.0
3377,Chaar Sahibzaade 2: Rise of Banda Singh Bahadur 2016 Re-release,1100947,700723,400224,2016_boxofficemojo_rankings.csv,2016,0.6364729637303158,0.3635270362696842
3378,Beyond the Reach,1100432,45895,1054537,2015_boxofficemojo_rankings.csv,2015,0.04170634805240124,0.9582936519475987
3379,Columbus,1093077,1017107,75970,2017_boxofficemojo_rankings.csv,2017,0.9304989492963441,0.06950105070365582
3380,Northern Soul,1092359,8886,1083473,2014_boxofficemojo_rankings.csv,2014,0.008134688321330259,0.9918653116786698
3381,Bombshell: The Hedy Lamarr Story,1092277,820300,271977,2017_boxofficemojo_rankings.csv,2017,0.7509999752809956,0.24900002471900443
3382,The Son of No One,1091132,30680,1060452,2011_boxofficemojo_rankings.csv,2011,0.028117587972857547,0.9718824120271424
3383,The Goonies 2019 Re-release,1089463,864378,225085,2019_boxofficemojo_rankings.csv,2019,0.7933982154510983,0.2066017845489016
3384,The Sky Is Pink,1088641,652592,436049,2019_boxofficemojo_rankings.csv,2019,0.5994556515876216,0.40054434841237835
3385,Sunset,1083299,164906,918393,2018_boxofficemojo_rankings.csv,2018,0.15222574746215034,0.8477742525378497
3386,Jesus Is King,1082629,973000,109629,2019_boxofficemojo_rankings.csv,2019,0.8987381642280042,0.10126183577199577
3387,Mystify: Michael Hutchence,1082456,289573,792883,2019_boxofficemojo_rankings.csv,2019,0.2675147996777698,0.7324852003222302
3388,Page One: Inside the New York Times,1077982,1067028,10954,2011_boxofficemojo_rankings.csv,2011,0.9898384203075747,0.010161579692425291
3389,Merci pour tout,1073969,1073969,0,2019_boxofficemojo_rankings.csv,2019,1.0,0.0
3390,The First Monday in May,1072943,527474,545469,2016_boxofficemojo_rankings.csv,2016,0.4916141864013279,0.5083858135986721
3391,Killing Season,1071322,39881,1031441,2013_boxofficemojo_rankings.csv,2013,0.03722596940975729,0.9627740305902427
3392,Chal Mera Putt 2,1070997,445000,625997,2020_boxofficemojo_rankings.csv,2020,0.4155006970140906,0.5844993029859094
3393,Au nom de ma fille,1066493,1623,1064870,2016_boxofficemojo_rankings.csv,2016,0.001521810269734541,0.9984781897302655
3394,The Oogieloves in the Big Balloon Adventure,1065907,1065907,0,2012_boxofficemojo_rankings.csv,2012,1.0,0.0
3395,50 to 1,1064454,1064454,0,2014_boxofficemojo_rankings.csv,2014,1.0,0.0
3396,La Mission,1062941,1062941,0,2010_boxofficemojo_rankings.csv,2010,1.0,0.0
3397,Dangerous Ishq,1062825,0,1062825,2012_boxofficemojo_rankings.csv,2012,0.0,1.0
3398,Carlos,1059369,145526,913843,2010_boxofficemojo_rankings.csv,2010,0.1373704535435717,0.8626295464564283
3399,Bennett's War,1056416,1056416,0,2019_boxofficemojo_rankings.csv,2019,1.0,0.0
3400,Borgman,1052010,57474,994536,2013_boxofficemojo_rankings.csv,2013,0.05463256052699119,0.9453674394730088
3401,Misbehaviour,1051083,0,1051083,2020_boxofficemojo_rankings.csv,2020,0.0,1.0
3402,No One Lives,1048704,74918,973786,2013_boxofficemojo_rankings.csv,2013,0.07143865189796167,0.9285613481020383
3403,Princess Mononoke 2019 Re-release,1046446,1046446,0,2019_boxofficemojo_rankings.csv,2019,1.0,0.0
3404,Becky,1045873,1003700,42173,2020_boxofficemojo_rankings.csv,2020,0.9596767485153551,0.040323251484644884
3405,A Brilliant Young Mind,1043620,171793,871827,2015_boxofficemojo_rankings.csv,2015,0.16461259845537649,0.8353874015446235
3406,Made In Mexico,1042673,151133,891540,2012_boxofficemojo_rankings.csv,2012,0.14494764897527795,0.855052351024722
3407,Spark: A Space Tail,1040689,196458,844231,2017_boxofficemojo_rankings.csv,2017,0.18877685840822764,0.8112231415917723
3408,Befikre,1040421,498000,542421,2016_boxofficemojo_rankings.csv,2016,0.4786523916760619,0.5213476083239381
3409,The Dark Crystal 2018 Re-release,1036956,1036956,0,2018_boxofficemojo_rankings.csv,2018,1.0,0.0
3410,Noah,1035603,1035603,0,2019_boxofficemojo_rankings.csv,2019,1.0,0.0
3411,Unconditional,1034448,1005800,28648,2012_boxofficemojo_rankings.csv,2012,0.9723060028150279,0.02769399718497208
3412,Ain't Them Bodies Saints,1031243,396519,634724,2013_boxofficemojo_rankings.csv,2013,0.38450588270659775,0.6154941172934022
3413,We Are Family,1031070,638144,392926,2010_boxofficemojo_rankings.csv,2010,0.6189143317136567,0.3810856682863433
3414,Knight of Cups,1026288,566006,460282,2015_boxofficemojo_rankings.csv,2015,0.5515079587796018,0.44849204122039815
3415,Casablanca 2017 Re-release,1024560,1024560,0,2017_boxofficemojo_rankings.csv,2017,1.0,0.0
3416,Tangerines,1024132,144501,879631,2015_boxofficemojo_rankings.csv,2015,0.14109606964727203,0.8589039303527279
3417,Color Out of Space,1023510,765561,257949,2020_boxofficemojo_rankings.csv,2020,0.7479760823050092,0.2520239176949908
3418,Great Performances at the Met: Puccini: La Fanciulla del West,1023233,1023233,0,2018_boxofficemojo_rankings.csv,2018,1.0,0.0
3419,Leaves of Grass,1018753,70066,948687,2010_boxofficemojo_rankings.csv,2010,0.06877623918653492,0.9312237608134651
3420,The Oscar Nominated Short Films 2010: Live Action,1018169,1018169,0,2010_boxofficemojo_rankings.csv,2010,1.0,0.0
3421,Husband Material,1016545,567417,449128,2018_boxofficemojo_rankings.csv,2018,0.5581818807824543,0.4418181192175457
3422,Big Stone Gap,1012804,1009301,3503,2015_boxofficemojo_rankings.csv,2015,0.9965412853819693,0.0034587146180307345
3423,Transit,1012747,815290,197457,2018_boxofficemojo_rankings.csv,2018,0.8050283042062825,0.19497169579371748
3424,L'attesa,1010766,55804,954962,2015_boxofficemojo_rankings.csv,2015,0.05520961330317799,0.944790386696822
3425,Elvis: The Comeback Special,1010657,1010657,0,2018_boxofficemojo_rankings.csv,2018,1.0,0.0
3426,Far from Men,1010485,5336,1005149,2015_boxofficemojo_rankings.csv,2015,0.0052806325675294535,0.9947193674324706
3427,Cold Blood,1009888,5083,1004805,2019_boxofficemojo_rankings.csv,2019,0.005033231407839285,0.9949667685921607
3428,The Song,1009620,1009620,0,2014_boxofficemojo_rankings.csv,2014,1.0,0.0
3429,Francofonia,1008154,307040,701114,2015_boxofficemojo_rankings.csv,2015,0.3045566451157264,0.6954433548842737
3430,Sidewalls,1008116,2377,1005739,2011_boxofficemojo_rankings.csv,2011,0.0023578635791912834,0.9976421364208087
3431,Ghost House,1004155,0,1004155,2017_boxofficemojo_rankings.csv,2017,0.0,1.0
3432,Faith of Our Fathers,1004105,1004105,0,2015_boxofficemojo_rankings.csv,2015,1.0,0.0
3433,Kiki's Delivery Service 2019 Re-release,1004057,1004057,0,2019_boxofficemojo_rankings.csv,2019,1.0,0.0
3434,The Workshop,1000056,22061,977995,2017_boxofficemojo_rankings.csv,2017,0.022059764653179423,0.9779402353468206
3435,Gabbar is Back,998582,534601,463981,2015_boxofficemojo_rankings.csv,2015,0.5353601406794835,0.4646398593205165
3436,National Theatre Live: Antony & Cleopatra,998079,83672,914407,2018_boxofficemojo_rankings.csv,2018,0.08383304327613346,0.9161669567238665
3437,"Polina, danser sa vie",996425,165203,831222,2016_boxofficemojo_rankings.csv,2016,0.16579571969792006,0.8342042803020799
3438,Photograph,996171,344534,651637,2019_boxofficemojo_rankings.csv,2019,0.34585829139776203,0.654141708602238
3439,Burn,996103,996103,0,2012_boxofficemojo_rankings.csv,2012,1.0,0.0
3440,Long Live Freedom 2014 Re-release,995990,48541,947449,2014_boxofficemojo_rankings.csv,2014,0.04873643309671784,0.9512635669032822
3441,Child's Pose,994126,97170,896956,2013_boxofficemojo_rankings.csv,2013,0.09774414913200137,0.9022558508679986
3442,Labyrinth 2018 Re-release,993336,993336,0,2013_boxofficemojo_rankings.csv,2013,1.0,0.0
3443,Blue Ruin,993313,258384,734929,2014_boxofficemojo_rankings.csv,2014,0.2601234454799243,0.7398765545200757
3444,Beyond Skyline,992181,0,992181,2017_boxofficemojo_rankings.csv,2017,0.0,1.0
3445,Blackthorn,987883,200558,787325,2011_boxofficemojo_rankings.csv,2011,0.20301796872706585,0.7969820312729341
3446,The Greatest,985181,114766,870415,2010_boxofficemojo_rankings.csv,2010,0.1164922993845801,0.8835077006154199
3447,American Masters: Miles Davis: Birth of the Cool,984499,614201,370298,2019_boxofficemojo_rankings.csv,2019,0.6238716342017615,0.3761283657982385
3448,Being Flynn,983124,540152,442972,2012_boxofficemojo_rankings.csv,2012,0.5494240807873676,0.4505759192126324
3449,Schindler's List 2018 Re-release,981489,833050,148439,2018_boxofficemojo_rankings.csv,2018,0.8487614226955167,0.15123857730448328
3450,Mr. Pip,977855,1714,976141,2013_boxofficemojo_rankings.csv,2013,0.0017528161128183626,0.9982471838871816
3451,Stuck in Love.,977671,81071,896600,2013_boxofficemojo_rankings.csv,2013,0.08292257824973841,0.9170774217502616
3452,Journey's End,970809,161796,809013,2018_boxofficemojo_rankings.csv,2018,0.166661001288616,0.8333389987113841
3453,The Irishman,968853,0,968853,2019_boxofficemojo_rankings.csv,2019,0.0,1.0
3454,Trishna,967672,240381,727291,2012_boxofficemojo_rankings.csv,2012,0.24841165188204267,0.7515883481179573
3455,Ryuichi Sakamoto: Coda,962139,117460,844679,2018_boxofficemojo_rankings.csv,2018,0.12208215237091521,0.8779178476290848
3456,Rush: Cinema Strangiato 2019,960073,960073,0,2019_boxofficemojo_rankings.csv,2019,1.0,0.0
3457,A Prayer Before Dawn,958883,14453,944430,2018_boxofficemojo_rankings.csv,2018,0.015072746101453462,0.9849272538985465
3458,The Endless,956425,272020,684405,2018_boxofficemojo_rankings.csv,2018,0.2844133099824869,0.7155866900175132
3459,The Fighting Preacher,954641,954641,0,2019_boxofficemojo_rankings.csv,2019,1.0,0.0
3460,The Catcher Was a Spy,953953,725223,228730,2018_boxofficemojo_rankings.csv,2018,0.7602292775430236,0.2397707224569764
3461,The Farewell Party,951531,172860,778671,2015_boxofficemojo_rankings.csv,2015,0.1816651270426292,0.8183348729573708
3462,Gimme Danger,950040,440627,509413,2016_boxofficemojo_rankings.csv,2016,0.4637983663845733,0.5362016336154267
3463,Under the Tree,944991,67596,877395,2017_boxofficemojo_rankings.csv,2017,0.07153083997625374,0.9284691600237462
3464,The Dinner,944808,7282,937526,2014_boxofficemojo_rankings.csv,2014,0.0077073860509225154,0.9922926139490775
3465,Rebel in the Rye,944370,378294,566076,2017_boxofficemojo_rankings.csv,2017,0.4005781632199244,0.5994218367800757
3466,Dark Horse 2016 Re-release,944061,940715,3346,2016_boxofficemojo_rankings.csv,2016,0.9964557375000133,0.0035442624999867593
3467,Afterimage,943029,33443,909586,2017_boxofficemojo_rankings.csv,2017,0.03546338447704153,0.9645366155229584
3468,The Tax Collector,942666,942666,0,2020_boxofficemojo_rankings.csv,2020,1.0,0.0
3469,The Road,942041,92476,849565,2011_boxofficemojo_rankings.csv,2011,0.0981655787805414,0.9018344212194586
3470,Landline,940854,940854,0,2017_boxofficemojo_rankings.csv,2017,1.0,0.0
3471,Becoming Astrid,938766,120486,818280,2018_boxofficemojo_rankings.csv,2018,0.12834508280018664,0.8716549171998134
3472,Revenge,938055,102091,835964,2018_boxofficemojo_rankings.csv,2018,0.10883263774512156,0.8911673622548785
3473,The Vigil,935484,0,935484,2020_boxofficemojo_rankings.csv,2020,0.0,1.0
3474,Kaili Blues,935236,32164,903072,2016_boxofficemojo_rankings.csv,2016,0.034391319410287884,0.9656086805897122
3475,Barely Lethal,933847,6075,927772,2015_boxofficemojo_rankings.csv,2015,0.006505348306521304,0.9934946516934787
3476,Perfect Sense,933352,2959,930393,2011_boxofficemojo_rankings.csv,2011,0.0031702937369824033,0.9968297062630176
3477,A Borrowed Identity,930958,281540,649418,2015_boxofficemojo_rankings.csv,2015,0.30241965802968557,0.6975803419703145
3478,White Christmas 2018 Re-release,928298,928298,0,2018_boxofficemojo_rankings.csv,2018,1.0,0.0
3479,Like Arrows,928265,817990,110275,2018_boxofficemojo_rankings.csv,2018,0.8812031047168642,0.11879689528313574
3480,Toni Morrison: The Pieces I Am,927495,903018,24477,2019_boxofficemojo_rankings.csv,2019,0.9736095612375268,0.026390438762473115
3481,How I Live Now,925762,60213,865549,2013_boxofficemojo_rankings.csv,2013,0.06504155495688957,0.9349584450431104
3482,Patterns of Evidence: Exodus,925576,925576,0,2015_boxofficemojo_rankings.csv,2015,1.0,0.0
3483,Gentleman,923884,897876,26008,2016_boxofficemojo_rankings.csv,2016,0.9718492797797126,0.028150720220287397
3484,ATM,921752,3010,918742,2012_boxofficemojo_rankings.csv,2012,0.003265520443676824,0.9967344795563232
3485,Paradise,921242,14873,906369,2017_boxofficemojo_rankings.csv,2017,0.01614450926032465,0.9838554907396754
3486,Riverdance 25th Anniversary Show,919732,81879,837853,2020_boxofficemojo_rankings.csv,2020,0.08902484636828989,0.9109751536317101
3487,Palo Alto,919591,767732,151859,2014_boxofficemojo_rankings.csv,2014,0.8348624551566947,0.16513754484330534
3488,Back to 1942,918487,312954,605533,2012_boxofficemojo_rankings.csv,2012,0.3407277402946367,0.6592722597053633
3489,Kirk Cameron: Connect,918127,918127,0,2018_boxofficemojo_rankings.csv,2018,1.0,0.0
3490,The Lodgers,916727,7362,909365,2018_boxofficemojo_rankings.csv,2018,0.00803074415829358,0.9919692558417064
3491,Kings,910269,274635,635634,2018_boxofficemojo_rankings.csv,2018,0.3017075172284237,0.6982924827715763
3492,Seymour: An Introduction,907742,743541,164201,2015_boxofficemojo_rankings.csv,2015,0.8191104961541936,0.1808895038458064
3493,Sholem Aleichem: Laughing in the Darkness,906666,906666,0,2011_boxofficemojo_rankings.csv,2011,1.0,0.0
3494,The Dead Lands,906158,5240,900918,2014_boxofficemojo_rankings.csv,2014,0.0057826560048026944,0.9942173439951973
3495,Bitter Harvest,904399,557241,347158,2017_boxofficemojo_rankings.csv,2017,0.6161450864054472,0.38385491359455287
3496,Generation Iron,901649,849521,52128,2013_boxofficemojo_rankings.csv,2013,0.9421859282270595,0.05781407177294047
3497,The Wildest Dream,898137,898137,0,2010_boxofficemojo_rankings.csv,2010,1.0,0.0
3498,The Game Changers,897992,739711,158281,2019_boxofficemojo_rankings.csv,2019,0.8237389642669423,0.17626103573305776
3499,The Disappearance of Alice Creed,896919,166980,729939,2010_boxofficemojo_rankings.csv,2010,0.1861706575510163,0.8138293424489836
3500,A Woman's Life,895944,37626,858318,2016_boxofficemojo_rankings.csv,2016,0.04199592831694838,0.9580040716830516
3501,You're Not You,894964,11486,883478,2014_boxofficemojo_rankings.csv,2014,0.01283403578244488,0.9871659642175551
3502,Best of Enemies: Buckley vs. Vidal,892802,892802,0,2015_boxofficemojo_rankings.csv,2015,1.0,0.0
3503,Believe,890303,890303,0,2016_boxofficemojo_rankings.csv,2016,1.0,0.0
3504,Mafia Inc,889863,889863,0,2020_boxofficemojo_rankings.csv,2020,1.0,0.0
3505,Alone Yet Not Alone,887851,887851,0,2013_boxofficemojo_rankings.csv,2013,1.0,0.0
3506,The Future,887172,568662,318510,2011_boxofficemojo_rankings.csv,2011,0.6409828082942203,0.3590171917057797
3507,The Nightingale,885916,400209,485707,2019_boxofficemojo_rankings.csv,2019,0.4517459894617548,0.5482540105382452
3508,Princess Kaiulani,883887,883887,0,2010_boxofficemojo_rankings.csv,2010,1.0,0.0
3509,Ai Weiwei: Never Sorry,881661,534100,347561,2012_boxofficemojo_rankings.csv,2012,0.6057883925908031,0.394211607409197
3510,The Hummingbird Project,876980,371784,505196,2019_boxofficemojo_rankings.csv,2019,0.423936691828776,0.576063308171224
3511,Between Me and My Mind,875191,875191,0,2019_boxofficemojo_rankings.csv,2019,1.0,0.0
3512,The Polar Express 2017 IMAX Release,875150,875150,0,2017_boxofficemojo_rankings.csv,2017,1.0,0.0
3513,Particle Fever,869838,869838,0,2014_boxofficemojo_rankings.csv,2014,1.0,0.0
3514,Bird People,866211,32111,834100,2014_boxofficemojo_rankings.csv,2014,0.037070644450370636,0.9629293555496293
3515,Howl's Moving Castle 2019 Re-release,865647,865647,0,2019_boxofficemojo_rankings.csv,2019,1.0,0.0
3516,Great Performances at the Met: Nico Muhly: Marnie,865551,849710,15841,2018_boxofficemojo_rankings.csv,2018,0.981698363239139,0.018301636760861002
3517,Brave,861630,527193,334437,2010_boxofficemojo_rankings.csv,2010,0.6118554367884127,0.38814456321158736
3518,Love,861057,249083,611974,2015_boxofficemojo_rankings.csv,2015,0.2892758551408327,0.7107241448591672
3519,Highway,858783,529136,329647,2014_boxofficemojo_rankings.csv,2014,0.6161463373168775,0.3838536626831225
3520,Night Moves,858513,271755,586758,2014_boxofficemojo_rankings.csv,2014,0.3165415083988245,0.6834584916011756
3521,Steel Magnolias 2019 Re-release,855421,855421,0,2019_boxofficemojo_rankings.csv,2019,1.0,0.0
3522,Chain Letter,855185,138788,716397,2010_boxofficemojo_rankings.csv,2010,0.16229003081204652,0.8377099691879535
3523,A Touch of Sin,854891,154120,700771,2013_boxofficemojo_rankings.csv,2013,0.18028029304320667,0.8197197069567933
3524,Happythankyoumoreplease,853862,216110,637752,2011_boxofficemojo_rankings.csv,2011,0.2530971046843635,0.7469028953156365
3525,The Sea of Trees,850985,20444,830541,2016_boxofficemojo_rankings.csv,2016,0.02402392521607314,0.9759760747839269
3526,31,850419,779820,70599,2016_boxofficemojo_rankings.csv,2016,0.9169832753031153,0.08301672469688472
3527,Wilson,848646,653951,194695,2017_boxofficemojo_rankings.csv,2017,0.7705816088215817,0.22941839117841833
3528,Atlas Shrugged: Who Is John Galt?,846704,846704,0,2014_boxofficemojo_rankings.csv,2014,1.0,0.0
3529,The Polar Express 2015 IMAX Release,846602,846602,0,2015_boxofficemojo_rankings.csv,2015,1.0,0.0
3530,Lizzie,844786,642157,202629,2018_boxofficemojo_rankings.csv,2018,0.7601416216651318,0.23985837833486823
3531,Heartbeats,843423,68723,774700,2010_boxofficemojo_rankings.csv,2010,0.08148105991892561,0.9185189400810744
3532,Higher Ground 2011 Re-release,843370,841733,1637,2011_boxofficemojo_rankings.csv,2011,0.9980589776729075,0.001941022327092498
3533,Gunday,843232,0,843232,2014_boxofficemojo_rankings.csv,2014,0.0,1.0
3534,Mary Kom,839840,621300,218540,2014_boxofficemojo_rankings.csv,2014,0.739783768336826,0.2602162316631739
3535,BANDSTAND: The Broadway Musical on Screen,839554,839554,0,2018_boxofficemojo_rankings.csv,2018,1.0,0.0
3536,Hôtel Normandy,836709,4640,832069,2013_boxofficemojo_rankings.csv,2013,0.005545536142195196,0.9944544638578048
3537,Khiladi 786,835095,379466,455629,2012_boxofficemojo_rankings.csv,2012,0.4543986013567319,0.5456013986432682
3538,The Exception,834572,708973,125599,2017_boxofficemojo_rankings.csv,2017,0.8495048959227005,0.1504951040772995
3539,Premam,834525,828278,6247,2016_boxofficemojo_rankings.csv,2016,0.9925143045445014,0.007485695455498637
3540,Children's Party,832150,6330,825820,2011_boxofficemojo_rankings.csv,2011,0.0076068016583548635,0.9923931983416452
3541,Byzantium,828284,89237,739047,2013_boxofficemojo_rankings.csv,2013,0.10773720124981287,0.8922627987501871
3542,Detective Byomkesh Bakshy!,827437,579055,248382,2015_boxofficemojo_rankings.csv,2015,0.6998176296201403,0.30018237037985973
3543,13 Sins,826913,13809,813104,2014_boxofficemojo_rankings.csv,2014,0.01669945931434141,0.9833005406856586
3544,Savage,826631,0,826631,2020_boxofficemojo_rankings.csv,2020,0.0,1.0
3545,Gekijouban K: Missing Kings,826323,33531,792792,2014_boxofficemojo_rankings.csv,2014,0.04057856310425826,0.9594214368957418
3546,Cut Throat City,825222,816188,9034,2020_boxofficemojo_rankings.csv,2020,0.989052642803997,0.010947357196003015
3547,Inside,824414,0,824414,2017_boxofficemojo_rankings.csv,2017,0.0,1.0
3548,Que Leones,822828,822828,0,2019_boxofficemojo_rankings.csv,2019,1.0,0.0
3549,The Lord of the Rings: The Return of the King 2011 Re-release,818580,818580,0,2011_boxofficemojo_rankings.csv,2011,1.0,0.0
3550,Life Itself,815645,810454,5191,2014_boxofficemojo_rankings.csv,2014,0.9936357116147343,0.0063642883852656484
3551,Saw 10th Anniversary Release,815324,815324,0,2014_boxofficemojo_rankings.csv,2014,1.0,0.0
3552,What If...,814906,814906,0,2010_boxofficemojo_rankings.csv,2010,1.0,0.0
3553,Tangerine,814868,702354,112514,2015_boxofficemojo_rankings.csv,2015,0.861923648983639,0.13807635101636093
3554,Age of Uprising: The Legend of Michael Kohlhaas,813550,3313,810237,2013_boxofficemojo_rankings.csv,2013,0.004072275828160531,0.9959277241718395
3555,The Heiresses,811196,78473,732723,2018_boxofficemojo_rankings.csv,2018,0.09673740994778081,0.9032625900522192
3556,Bangistan,810419,48694,761725,2015_boxofficemojo_rankings.csv,2015,0.06008496839289306,0.939915031607107
3557,Bill W.,809590,809590,0,2012_boxofficemojo_rankings.csv,2012,1.0,0.0
3558,Joni 75: A Birthday Celebration,808831,752205,56626,2019_boxofficemojo_rankings.csv,2019,0.9299903193621412,0.07000968063785884
3559,The Whistlers,808743,55608,753135,2019_boxofficemojo_rankings.csv,2019,0.06875855494267029,0.9312414450573298
3560,Breathing,807436,4630,802806,2011_boxofficemojo_rankings.csv,2011,0.005734200605373057,0.9942657993946269
3561,V/H/S/2,805574,21833,783741,2013_boxofficemojo_rankings.csv,2013,0.027102413930936202,0.9728975860690638
3562,The Tillman Story,802535,802535,0,2010_boxofficemojo_rankings.csv,2010,1.0,0.0
3563,The Wrecking Crew!,801606,801606,0,2015_boxofficemojo_rankings.csv,2015,1.0,0.0
3564,Red Army,798680,694600,104080,2015_boxofficemojo_rankings.csv,2015,0.8696849802173586,0.13031501978264134
3565,Wakefield,798214,262599,535615,2017_boxofficemojo_rankings.csv,2017,0.32898320500517403,0.6710167949948259
3566,Babyteeth,793453,4507,788946,2020_boxofficemojo_rankings.csv,2020,0.005680235628323291,0.9943197643716767
3567,Vita & Virginia,793439,42741,750698,2019_boxofficemojo_rankings.csv,2019,0.05386803522387985,0.9461319647761202
3568,Tickled,790519,613956,176563,2016_boxofficemojo_rankings.csv,2016,0.7766492645970559,0.22335073540294414
3569,Thin Ice,790421,790421,0,2012_boxofficemojo_rankings.csv,2012,1.0,0.0
3570,Lootera,789671,581813,207858,2013_boxofficemojo_rankings.csv,2013,0.7367789877050063,0.26322101229499373
3571,Momentum,789406,0,789406,2015_boxofficemojo_rankings.csv,2015,0.0,1.0
3572,Chonda Pierce: Unashamed,787979,787979,0,2019_boxofficemojo_rankings.csv,2019,1.0,0.0
3573,Elf 2019 Re-release,786249,786249,0,2019_boxofficemojo_rankings.csv,2019,1.0,0.0
3574,George Takei's Allegiance,784850,784850,0,2017_boxofficemojo_rankings.csv,2017,1.0,0.0
3575,Life During Wartime,783232,281447,501785,2010_boxofficemojo_rankings.csv,2010,0.3593405274554666,0.6406594725445334
3576,The Paris Opera,781039,55482,725557,2017_boxofficemojo_rankings.csv,2017,0.07103614544216102,0.928963854557839
3577,Futuro Beach,779835,20262,759573,2014_boxofficemojo_rankings.csv,2014,0.025982419357941103,0.9740175806420589
3578,Mrs. Hyde,778142,18627,759515,2018_boxofficemojo_rankings.csv,2018,0.023937790274782753,0.9760622097252173
3579,Enter the Void,775385,336467,438918,2010_boxofficemojo_rankings.csv,2010,0.43393539983363105,0.566064600166369
3580,Ordinary Love,774877,323688,451189,2019_boxofficemojo_rankings.csv,2019,0.41772823299697887,0.5822717670030211
3581,The D Train,774780,673151,101629,2015_boxofficemojo_rankings.csv,2015,0.8688285706910349,0.13117142930896514
3582,The Church,772000,772000,0,2019_boxofficemojo_rankings.csv,2019,1.0,0.0
3583,Grand Masti,770535,413903,356632,2013_boxofficemojo_rankings.csv,2013,0.5371631398963058,0.4628368601036942
3584,Pariah,769552,769552,0,2011_boxofficemojo_rankings.csv,2011,1.0,0.0
3585,The Lord of the Rings: The Fellowship of the Ring 2011 Re-release,768580,768580,0,2011_boxofficemojo_rankings.csv,2011,1.0,0.0
3586,Theeb,768449,283024,485425,2015_boxofficemojo_rankings.csv,2015,0.3683055088886836,0.6316944911113165
3587,Yalom's Cure,766974,1164,765810,2014_boxofficemojo_rankings.csv,2014,0.0015176524888718523,0.9984823475111282
3588,Lo and Behold: Reveries of the Connected World,765796,594912,170884,2016_boxofficemojo_rankings.csv,2016,0.7768544103129293,0.2231455896870707
3589,DanTDM Presents The Contest,765363,307484,457879,2019_boxofficemojo_rankings.csv,2019,0.4017492353301636,0.5982507646698364
3590,Patterns of Evidence: Moses Controversy,765361,765361,0,2019_boxofficemojo_rankings.csv,2019,1.0,0.0
3591,The Polar Express 2016 IMAX Release,765154,765154,0,2016_boxofficemojo_rankings.csv,2016,1.0,0.0
3592,The Lord of the Rings: The Two Towers 2011 Re-release,764607,764607,0,2011_boxofficemojo_rankings.csv,2011,1.0,0.0
3593,Kahlil Gibran's The Prophet,764498,355343,409155,2015_boxofficemojo_rankings.csv,2015,0.4648056633241683,0.5351943366758317
3594,The Invisibles,764250,407373,356877,2018_boxofficemojo_rankings.csv,2018,0.5330363101079489,0.466963689892051
3595,Pick of the Litter,763688,578717,184971,2018_boxofficemojo_rankings.csv,2018,0.7577924492724778,0.24220755072752223
3596,Museo,762284,148505,613779,2018_boxofficemojo_rankings.csv,2018,0.19481584291418946,0.8051841570858106
3597,The Shining 2017 Re-release,760309,421572,338737,2017_boxofficemojo_rankings.csv,2017,0.5544745623161109,0.445525437683889
3598,Bombay Velvet,758478,450692,307786,2015_boxofficemojo_rankings.csv,2015,0.59420576470247,0.40579423529753006
3599,Jaws 2020 Re-release,758367,758300,67,2020_boxofficemojo_rankings.csv,2020,0.999911652273899,8.834772610095112e-05
3600,Shortcut,758223,758223,0,2020_boxofficemojo_rankings.csv,2020,1.0,0.0
3601,Boundaries,755977,703438,52539,2018_boxofficemojo_rankings.csv,2018,0.9305018538923803,0.06949814610761967
3602,I Love Lucy: A Colorized Celebration,754323,754323,0,2019_boxofficemojo_rankings.csv,2019,1.0,0.0
3603,Middle Men,754301,754301,0,2010_boxofficemojo_rankings.csv,2010,1.0,0.0
3604,Tommy's Honour,751345,569306,182039,2017_boxofficemojo_rankings.csv,2017,0.7577158296122287,0.24228417038777125
3605,A Five Star Life 2014 Re-release,749653,306917,442736,2014_boxofficemojo_rankings.csv,2014,0.4094120879927113,0.5905879120072887
3606,Everybody's Everything,748539,547207,201332,2019_boxofficemojo_rankings.csv,2019,0.731033386369982,0.26896661363001795
3607,Hobo with a Shotgun,748453,703372,45081,2011_boxofficemojo_rankings.csv,2011,0.9397677609682906,0.060232239031709406
3608,Arthur Newman,747140,207853,539287,2013_boxofficemojo_rankings.csv,2013,0.27819819578659954,0.7218018042134005
3609,Holy Rollers,744266,303064,441202,2010_boxofficemojo_rankings.csv,2010,0.40719850161098314,0.5928014983890169
3610,Saturday's Warrior,744046,744046,0,2016_boxofficemojo_rankings.csv,2016,1.0,0.0
3611,"Kumiko, The Treasure Hunter",739623,623383,116240,2015_boxofficemojo_rankings.csv,2015,0.8428388516852504,0.15716114831474953
3612,Forks Over Knives,739561,739561,0,2011_boxofficemojo_rankings.csv,2011,1.0,0.0
3613,Vicky Donor,739085,549001,190084,2012_boxofficemojo_rankings.csv,2012,0.7428117198968995,0.25718828010310046
3614,Ramen Shop,735008,88455,646553,2018_boxofficemojo_rankings.csv,2018,0.12034562889111411,0.8796543711088859
3615,Wiener-Dog,734729,477453,257276,2016_boxofficemojo_rankings.csv,2016,0.6498355175853955,0.35016448241460457
3616,David Crosby: Remember My Name,732793,732793,0,2019_boxofficemojo_rankings.csv,2019,1.0,0.0
3617,Once I Was a Beehive,732655,732655,0,2015_boxofficemojo_rankings.csv,2015,1.0,0.0
3618,Tabloid,731925,696921,35004,2011_boxofficemojo_rankings.csv,2011,0.9521754278102265,0.04782457218977354
3619,The Polar Express 2018 Re-release,731018,731018,0,2018_boxofficemojo_rankings.csv,2018,1.0,0.0
3620,Slaughterhouse Rulez,730762,4665,726097,2018_boxofficemojo_rankings.csv,2018,0.006383747376026668,0.9936162526239734
3621,How I Ended This Summer,730412,8733,721679,2010_boxofficemojo_rankings.csv,2010,0.011956265778765957,0.988043734221234
3622,Land Ho!,727594,727594,0,2014_boxofficemojo_rankings.csv,2014,1.0,0.0
3623,Peggy Guggenheim: Art Addict,727591,498428,229163,2015_boxofficemojo_rankings.csv,2015,0.6850387099345648,0.3149612900654351
3624,Liz and the Blue Bird,726454,63204,663250,2018_boxofficemojo_rankings.csv,2018,0.08700344412722623,0.9129965558727737
3625,Bullett Raja,725588,0,725588,2013_boxofficemojo_rankings.csv,2013,0.0,1.0
3626,May It Last,725286,725286,0,2017_boxofficemojo_rankings.csv,2017,1.0,0.0
3627,A Tale of Love and Darkness,724885,572212,152673,2015_boxofficemojo_rankings.csv,2015,0.7893831435331121,0.21061685646688785
3628,The Act of Killing,722714,486919,235795,2013_boxofficemojo_rankings.csv,2013,0.6737367755432992,0.3262632244567007
3629,Where's My Roy Cohn?,722603,705274,17329,2019_boxofficemojo_rankings.csv,2019,0.9760186437089245,0.023981356291075458
3630,Singham,722451,350864,371587,2011_boxofficemojo_rankings.csv,2011,0.4856578508438635,0.5143421491561365
3631,12 Days,722049,5204,716845,2017_boxofficemojo_rankings.csv,2017,0.007207267096831379,0.9927927329031686
3632,Effie Gray,721143,352534,368609,2014_boxofficemojo_rankings.csv,2014,0.4888544990383322,0.5111455009616678
3633,Revive Us 2,718607,718607,0,2017_boxofficemojo_rankings.csv,2017,1.0,0.0
3634,2001: A Space Odyssey 2014 Re-release,717744,214618,503126,2014_boxofficemojo_rankings.csv,2014,0.299017476983437,0.700982523016563
3635,The Shining 2012 Re-release,715736,342749,372987,2012_boxofficemojo_rankings.csv,2012,0.4788762895816335,0.5211237104183666
3636,Passion,713616,92181,621435,2013_boxofficemojo_rankings.csv,2013,0.12917451402434924,0.8708254859756508
3637,Gerhard Richter Painting,713188,242646,470542,2011_boxofficemojo_rankings.csv,2011,0.34022726125509684,0.6597727387449032
3638,Shootout at Wadala,711366,369573,341793,2013_boxofficemojo_rankings.csv,2013,0.5195258137161461,0.48047418628385385
3639,The Polar Express 2011 IMAX Release,711168,711168,0,2011_boxofficemojo_rankings.csv,2011,1.0,0.0
3640,Extraction,710636,16775,693861,2015_boxofficemojo_rankings.csv,2015,0.023605615251690037,0.97639438474831
3641,Muscle Shoals,709415,696241,13174,2013_boxofficemojo_rankings.csv,2013,0.9814297695988948,0.018570230401105135
3642,Paris Countdown,708757,1055,707702,2013_boxofficemojo_rankings.csv,2013,0.001488521453756365,0.9985114785462437
3643,Gori Tere Pyaar Mein!,708440,342184,366256,2013_boxofficemojo_rankings.csv,2013,0.48301055841002766,0.5169894415899723
3644,HBO Boxing: Canelo Alvarez vs. Gennady Golovkin II,707875,707875,0,2018_boxofficemojo_rankings.csv,2018,1.0,0.0
3645,Passione,707460,255355,452105,2010_boxofficemojo_rankings.csv,2010,0.3609462019054081,0.639053798094592
3646,The Lost Medallion: The Adventures of Billy Stone,705854,549632,156222,2013_boxofficemojo_rankings.csv,2013,0.7786766101771755,0.22132338982282454
3647,Itzhak,704968,607290,97678,2018_boxofficemojo_rankings.csv,2018,0.8614433562941864,0.1385566437058136
3648,Blaze,704955,704955,0,2018_boxofficemojo_rankings.csv,2018,1.0,0.0
3649,The Shining 2019 Re-release,704716,551257,153459,2019_boxofficemojo_rankings.csv,2019,0.7822399377905426,0.21776006220945743
3650,Countdown to Canelo vs. Golovkin,703396,703396,0,2017_boxofficemojo_rankings.csv,2017,1.0,0.0
3651,Buena Vista Social Club: Adios,701575,123445,578130,2017_boxofficemojo_rankings.csv,2017,0.1759541032676478,0.8240458967323522
3652,Le Quattro Volte,701334,152530,548804,2010_boxofficemojo_rankings.csv,2010,0.21748553470956777,0.7825144652904322
3653,56 Up,701278,701278,0,2013_boxofficemojo_rankings.csv,2013,1.0,0.0
3654,Our Children,700215,23203,677012,2012_boxofficemojo_rankings.csv,2012,0.033136965075012674,0.9668630349249874
3655,The Greatest Movie Ever Sold,698249,638476,59773,2011_boxofficemojo_rankings.csv,2011,0.914395867376824,0.08560413262317597
3656,Patterns of Evidence: The Red Sea Miracle,696191,696191,0,2020_boxofficemojo_rankings.csv,2020,1.0,0.0
3657,Frankie & Alice 2014 Re-release,695876,695876,0,2014_boxofficemojo_rankings.csv,2014,1.0,0.0
3658,Frankie,695680,171781,523899,2019_boxofficemojo_rankings.csv,2019,0.24692531048758048,0.7530746895124195
3659,The Least of These: The Graham Staines Story,695164,607015,88149,2019_boxofficemojo_rankings.csv,2019,0.8731968283743117,0.12680317162568833
3660,The Congress 2013 Re-release,695131,137815,557316,2013_boxofficemojo_rankings.csv,2013,0.19825759461166312,0.8017424053883369
3661,Jim Henson's Holiday Special with Fraggle Rock and Emmet Otter,695130,695130,0,2018_boxofficemojo_rankings.csv,2018,1.0,0.0
3662,The Secret Scripture,694981,0,694981,2017_boxofficemojo_rankings.csv,2017,0.0,1.0
3663,In the Aisles,694586,28394,666192,2018_boxofficemojo_rankings.csv,2018,0.04087902721909166,0.9591209727809084
3664,Raise Hell: The Life & Times of Molly Ivins,694410,694410,0,2019_boxofficemojo_rankings.csv,2019,1.0,0.0
3665,Chris Brown: Welcome To My Life,693984,693984,0,2017_boxofficemojo_rankings.csv,2017,1.0,0.0
3666,Titanic 2017 Re-release,693626,691642,1984,2017_boxofficemojo_rankings.csv,2017,0.997139668928212,0.0028603310717879664
3667,Hope Gap,692134,104732,587402,2020_boxofficemojo_rankings.csv,2020,0.15131751943987726,0.8486824805601227
3668,Ferrari Ki Sawaari,689861,434107,255754,2012_boxofficemojo_rankings.csv,2012,0.6292673451608367,0.37073265483916323
3669,Romeo Akbar Walter,688719,236299,452420,2019_boxofficemojo_rankings.csv,2019,0.34309929013138885,0.6569007098686112
3670,Cobain: Montage of Heck,687649,0,687649,2015_boxofficemojo_rankings.csv,2015,0.0,1.0
3671,Vettai,687636,204373,483263,2012_boxofficemojo_rankings.csv,2012,0.29721102443734765,0.7027889755626523
3672,Mr. Church,685780,685780,0,2016_boxofficemojo_rankings.csv,2016,1.0,0.0
3673,Bethany Hamilton: Unstoppable,684078,590671,93407,2019_boxofficemojo_rankings.csv,2019,0.8634556293288193,0.13654437067118078
3674,Stefan Zweig: Farewell to Europe 2017 Re-release,683063,78372,604691,2017_boxofficemojo_rankings.csv,2017,0.11473612243672984,0.8852638775632702
3675,Brigsby Bear,681632,532669,148963,2017_boxofficemojo_rankings.csv,2017,0.7814612576874325,0.21853874231256748
3676,"Right Now, Wrong Then",680728,24470,656258,2015_boxofficemojo_rankings.csv,2015,0.035946809885886874,0.9640531901141132
3677,3 Generations,680351,155936,524415,2016_boxofficemojo_rankings.csv,2016,0.2291993397525689,0.7708006602474311
3678,A Matter of Faith,680113,680113,0,2014_boxofficemojo_rankings.csv,2014,1.0,0.0
3679,I Spit on Your Grave 2,678604,809,677795,2013_boxofficemojo_rankings.csv,2013,0.0011921533029572474,0.9988078466970427
3680,All I See Is You,678150,217644,460506,2017_boxofficemojo_rankings.csv,2017,0.32093784560937844,0.6790621543906216
3681,Baaghi,676602,438207,238395,2016_boxofficemojo_rankings.csv,2016,0.6476584461766297,0.3523415538233703
3682,Tyrannosaur,676111,22321,653790,2011_boxofficemojo_rankings.csv,2011,0.03301380986258173,0.9669861901374183
3683,5 to 7,674579,162685,511894,2015_boxofficemojo_rankings.csv,2015,0.24116523046225868,0.7588347695377413
3684,Beyond the Hills,673493,124919,548574,2012_boxofficemojo_rankings.csv,2012,0.18547928486264892,0.8145207151373511
3685,The Trump Prophecy,671198,671198,0,2018_boxofficemojo_rankings.csv,2018,1.0,0.0
3686,Anna and the Apocalypse,670430,545597,124833,2018_boxofficemojo_rankings.csv,2018,0.8138015900243127,0.18619840997568723
3687,The Polar Express 2012 IMAX Release,669289,669289,0,2012_boxofficemojo_rankings.csv,2012,1.0,0.0
3688,Bright Days Ahead 2013 Re-release,669085,21770,647315,2013_boxofficemojo_rankings.csv,2013,0.03253697213358542,0.9674630278664146
3689,The Torn Poster Let Out a Hero,669070,410526,258544,2013_boxofficemojo_rankings.csv,2013,0.6135770547177425,0.38642294528225746
3690,Tai Chi 2: The Hero Rises,668484,35067,633417,2012_boxofficemojo_rankings.csv,2012,0.05245750085267561,0.9475424991473244
3691,Girlfriend Boyfriend,667626,64414,603212,2012_boxofficemojo_rankings.csv,2012,0.09648216216863933,0.9035178378313606
3692,A Bottle in the Gaza Sea,666011,5872,660139,2012_boxofficemojo_rankings.csv,2012,0.008816671196121385,0.9911833288038786
3693,Mr. Gaga: A True Story of Love and Dance,665617,173994,491623,2016_boxofficemojo_rankings.csv,2016,0.2614025783596272,0.7385974216403728
3694,Stockholm,665527,292590,372937,2019_boxofficemojo_rankings.csv,2019,0.43963655869709267,0.5603634413029073
3695,The Stanford Prison Experiment,663114,660561,2553,2015_boxofficemojo_rankings.csv,2015,0.9961499832607967,0.0038500167392032138
3696,City of Gold,660445,640979,19466,2016_boxofficemojo_rankings.csv,2016,0.9705259332722634,0.0294740667277366
3697,Camille Claudel 1915,660355,35296,625059,2013_boxofficemojo_rankings.csv,2013,0.05345003823700888,0.9465499617629911
3698,Another Happy Day,659937,8464,651473,2011_boxofficemojo_rankings.csv,2011,0.012825466673333969,0.987174533326666
3699,The Woman in the Fifth,659769,113800,545969,2011_boxofficemojo_rankings.csv,2011,0.1724846120384559,0.8275153879615441
3700,Dragon Ball Z: Broly - The Legendary Super Saiyan,658982,658982,0,2018_boxofficemojo_rankings.csv,2018,1.0,0.0
3701,Madame Bovary,658532,44235,614297,2015_boxofficemojo_rankings.csv,2015,0.06717213438375053,0.9328278656162495
3702,Terri,655802,655802,0,2011_boxofficemojo_rankings.csv,2011,1.0,0.0
3703,The Patience Stone,654587,148671,505916,2013_boxofficemojo_rankings.csv,2013,0.22712183407247624,0.7728781659275238
3704,No Problem,654369,285468,368901,2010_boxofficemojo_rankings.csv,2010,0.4362492721996305,0.5637507278003695
3705,Whisky Galore,653866,20991,632875,2017_boxofficemojo_rankings.csv,2017,0.032102907935265025,0.967897092064735
3706,Ponyo 2018 Re-release,653072,653072,0,2018_boxofficemojo_rankings.csv,2018,1.0,0.0
3707,Rascals,652756,273829,378927,2011_boxofficemojo_rankings.csv,2011,0.4194967185288224,0.5805032814711776
3708,In Secret,652228,444179,208049,2013_boxofficemojo_rankings.csv,2013,0.6810179875748972,0.3189820124251029
3709,Salinger,650675,583633,67042,2013_boxofficemojo_rankings.csv,2013,0.8969654589464786,0.10303454105352135
3710,The Extra Man,649626,453377,196249,2010_boxofficemojo_rankings.csv,2010,0.6979046405162355,0.3020953594837645
3711,The Family Fang,649555,262921,386634,2016_boxofficemojo_rankings.csv,2016,0.4047709585793351,0.5952290414206649
3712,Jodorowsky's Dune,647280,647280,0,2014_boxofficemojo_rankings.csv,2014,1.0,0.0
3713,Storage 24,646175,72,646103,2012_boxofficemojo_rankings.csv,2012,0.00011142492358881108,0.9998885750764112
3714,The Public,644740,573503,71237,2019_boxofficemojo_rankings.csv,2019,0.889510500356733,0.11048949964326706
3715,Dracula 3D,643758,8139,635619,2012_boxofficemojo_rankings.csv,2012,0.012642949679848638,0.9873570503201513
3716,Love and Honor,641929,19684,622245,2012_boxofficemojo_rankings.csv,2012,0.030663827308004467,0.9693361726919956
3717,Marjaavaan,641154,174164,466990,2019_boxofficemojo_rankings.csv,2019,0.2716414465167495,0.7283585534832505
3718,Museum Hours,639121,561457,77664,2012_boxofficemojo_rankings.csv,2012,0.87848310413834,0.12151689586166
3719,Aquarela,638907,307346,331561,2019_boxofficemojo_rankings.csv,2019,0.48104966763550877,0.5189503323644913
3720,Jack Goes Boating,637479,541992,95487,2010_boxofficemojo_rankings.csv,2010,0.8502115363800219,0.14978846361997808
3721,Welcome to Me,636819,608852,27967,2015_boxofficemojo_rankings.csv,2015,0.9560832826910001,0.04391671730899989
3722,The Virginity Hit,636706,636706,0,2010_boxofficemojo_rankings.csv,2010,1.0,0.0
3723,Not Fade Away,636399,610792,25607,2012_boxofficemojo_rankings.csv,2012,0.9597626646176377,0.04023733538236232
3724,Elsa & Fred,635901,285863,350038,2014_boxofficemojo_rankings.csv,2014,0.4495401013679802,0.5504598986320197
3725,Batti Gul Meter Chalu,635869,249539,386330,2018_boxofficemojo_rankings.csv,2018,0.39243775054295776,0.6075622494570423
3726,The Last Lions,635325,635325,0,2011_boxofficemojo_rankings.csv,2011,1.0,0.0
3727,Kaboom,635162,118919,516243,2010_boxofficemojo_rankings.csv,2010,0.18722625094070489,0.8127737490592951
3728,A Beautiful Life,634784,66171,568613,2011_boxofficemojo_rankings.csv,2011,0.10424175782628421,0.8957582421737158
3729,No One Killed Jessica,634297,440525,193772,2011_boxofficemojo_rankings.csv,2011,0.6945090391409703,0.30549096085902977
3730,The Black Prince,632823,0,632823,2017_boxofficemojo_rankings.csv,2017,0.0,1.0
3731,Grace Jones: Bloodlight and Bami,632394,375208,257186,2017_boxofficemojo_rankings.csv,2017,0.5933136620524546,0.4066863379475454
3732,The Great Alaskan Race,632157,485603,146554,2019_boxofficemojo_rankings.csv,2019,0.7681683505837948,0.23183164941620515
3733,Jonah: The Musical,631154,631154,0,2017_boxofficemojo_rankings.csv,2017,1.0,0.0
3734,Shut Up and Play the Hits,629107,510334,118773,2012_boxofficemojo_rankings.csv,2012,0.8112038174746108,0.18879618252538916
3735,Short Peace,628807,22862,605945,2013_boxofficemojo_rankings.csv,2013,0.03635773774783042,0.9636422622521695
3736,Black Water: Abyss,628683,0,628683,2020_boxofficemojo_rankings.csv,2020,0.0,1.0
3737,Asako I & II,627102,25559,601543,2019_boxofficemojo_rankings.csv,2019,0.04075732496467879,0.9592426750353212
3738,Korkoro,627088,8242,618846,2010_boxofficemojo_rankings.csv,2010,0.013143290893782054,0.9868567091062179
3739,I'm Still Here,626396,408983,217413,2010_boxofficemojo_rankings.csv,2010,0.652914450283846,0.347085549716154
3740,"Love, Gilda",626318,626318,0,2018_boxofficemojo_rankings.csv,2018,1.0,0.0
3741,Sleepless Night,624913,3358,621555,2011_boxofficemojo_rankings.csv,2011,0.005373547997881305,0.9946264520021187
3742,Give Me Liberty,624818,242734,382084,2019_boxofficemojo_rankings.csv,2019,0.3884875275680278,0.6115124724319722
3743,The Sound of Music 2018 Re-release,624392,616171,8221,2018_boxofficemojo_rankings.csv,2018,0.9868335917180233,0.013166408281976707
3744,Winter in Wartime 2010 Re-release,623392,543100,80292,2010_boxofficemojo_rankings.csv,2010,0.8712014270314665,0.12879857296853345
3745,Nancy Drew and the Hidden Staircase,623088,623088,0,2019_boxofficemojo_rankings.csv,2019,1.0,0.0
3746,Dirty Dancing 2019 Re-release,622968,622968,0,2019_boxofficemojo_rankings.csv,2019,1.0,0.0
3747,Range 15,621738,621738,0,2016_boxofficemojo_rankings.csv,2016,1.0,0.0
3748,Ghostbusters 2020 Re-release,620883,605000,15883,2020_boxofficemojo_rankings.csv,2020,0.974418690800038,0.025581309199961988
3749,Die Hard 30th Anniversary Release,620525,510241,110284,2018_boxofficemojo_rankings.csv,2018,0.822273075218565,0.17772692478143506
3750,"Happy, Happy",620238,45154,575084,2010_boxofficemojo_rankings.csv,2010,0.0728010860347157,0.9271989139652843
3751,Killerman,619855,291477,328378,2019_boxofficemojo_rankings.csv,2019,0.470234167668245,0.529765832331755
3752,The Transformers,619597,619597,0,2018_boxofficemojo_rankings.csv,2018,1.0,0.0
3753,Nowitzki: The Perfect Shot,619517,41340,578177,2014_boxofficemojo_rankings.csv,2014,0.06672940371289246,0.9332705962871075
3754,Paradise: Faith,618696,6508,612188,2013_boxofficemojo_rankings.csv,2013,0.010518897810879656,0.9894811021891203
3755,Paulo Coelho's Best Story,617377,8808,608569,2014_boxofficemojo_rankings.csv,2014,0.014266809421147856,0.9857331905788521
3756,The Bronze,615816,615816,0,2016_boxofficemojo_rankings.csv,2016,1.0,0.0
3757,Lost River,615500,45431,570069,2015_boxofficemojo_rankings.csv,2015,0.07381153533712428,0.9261884646628757
3758,"A White, White Day",614674,0,614674,2019_boxofficemojo_rankings.csv,2019,0.0,1.0
3759,Omar,614444,356000,258444,2013_boxofficemojo_rankings.csv,2013,0.5793855908756534,0.42061440912434656
3760,Walking the Camino: Six Ways to Santiago,612717,612717,0,2013_boxofficemojo_rankings.csv,2013,1.0,0.0
3761,The Returned,612521,0,612521,2013_boxofficemojo_rankings.csv,2013,0.0,1.0
3762,In Another Country,611365,25079,586286,2012_boxofficemojo_rankings.csv,2012,0.04102132114203463,0.9589786788579654
3763,The Muppet Movie 2019 Re-release,610475,610475,0,2019_boxofficemojo_rankings.csv,2019,1.0,0.0
3764,Project Nim,609880,411184,198696,2011_boxofficemojo_rankings.csv,2011,0.6742047615924445,0.3257952384075556
3765,Dead Before Dawn 3D,608881,0,608881,2012_boxofficemojo_rankings.csv,2012,0.0,1.0
3766,The Last Suit,608209,73548,534661,2017_boxofficemojo_rankings.csv,2017,0.12092553710977641,0.8790744628902236
3767,The Last Shift,607605,607605,0,2020_boxofficemojo_rankings.csv,2020,1.0,0.0
3768,Mr. Right,607595,34694,572901,2016_boxofficemojo_rankings.csv,2016,0.057100535718694195,0.9428994642813058
3769,The Reports on Sarah and Saleem,607206,117479,489727,2018_boxofficemojo_rankings.csv,2018,0.1934747021603871,0.8065252978396129
3770,Life in a Day,607169,252788,354381,2011_boxofficemojo_rankings.csv,2011,0.4163387788243471,0.5836612211756529
3771,Bolshoi Ballet: The Sleeping Beauty,606872,311368,295504,2019_boxofficemojo_rankings.csv,2019,0.513070301480378,0.4869296985196219
3772,Neither Wolf Nor Dog,606511,606511,0,2017_boxofficemojo_rankings.csv,2017,1.0,0.0
3773,The Walking Dead: Wrath/The Walking Dead/Fear the Walking Dead: What's Your Story?/Fear the Walking Dead,605764,605764,0,2018_boxofficemojo_rankings.csv,2018,1.0,0.0
3774,Summer in February,605403,1624,603779,2013_boxofficemojo_rankings.csv,2013,0.0026825106581896685,0.9973174893418103
3775,The Golden Glove,604479,6160,598319,2019_boxofficemojo_rankings.csv,2019,0.010190593883327626,0.9898094061166723
3776,"DCI 2019: Big, Loud & Live 16",603320,603320,0,2018_boxofficemojo_rankings.csv,2018,1.0,0.0
3777,Undertow,602059,108620,493439,2010_boxofficemojo_rankings.csv,2010,0.1804142118961763,0.8195857881038238
3778,The Little Death,601162,18238,582924,2014_boxofficemojo_rankings.csv,2014,0.03033791224328883,0.9696620877567111
3779,The Grateful Dead Meet-Up 2018,600554,600554,0,2018_boxofficemojo_rankings.csv,2018,1.0,0.0
3780,Oh Lucy!,600145,375391,224754,2018_boxofficemojo_rankings.csv,2018,0.6255005040448558,0.37449949595514415
3781,Jimi: All Is by My Side,599840,340911,258929,2014_boxofficemojo_rankings.csv,2014,0.568336556415044,0.431663443584956
3782,The Fencer 2016 Re-release,599537,95952,503585,2016_boxofficemojo_rankings.csv,2016,0.1600435002343475,0.8399564997656525
3783,The One I Love,596933,513447,83486,2014_boxofficemojo_rankings.csv,2014,0.8601417579527351,0.13985824204726494
3784,Trust,595802,120016,475786,2011_boxofficemojo_rankings.csv,2011,0.20143604754599684,0.7985639524540031
3785,Skin Trade,595268,1242,594026,2015_boxofficemojo_rankings.csv,2015,0.002086455176491933,0.997913544823508
3786,Blue Like Jazz,595018,595018,0,2012_boxofficemojo_rankings.csv,2012,1.0,0.0
3787,Ixcanul,594836,295157,299679,2015_boxofficemojo_rankings.csv,2015,0.4961989523162687,0.5038010476837314
3788,Are You Here,594396,0,594396,2014_boxofficemojo_rankings.csv,2014,0.0,1.0
3789,The Armstrong Lie,594394,383294,211100,2013_boxofficemojo_rankings.csv,2013,0.644848366571668,0.35515163342833206
3790,Boss,594283,0,594283,2013_boxofficemojo_rankings.csv,2013,0.0,1.0
3791,The Big Lebowski 2018 Re-release,592832,582585,10247,2018_boxofficemojo_rankings.csv,2018,0.9827151705710893,0.01728482942891072
3792,To Kill a Mockingbird 2019 Re-release,592237,592237,0,2019_boxofficemojo_rankings.csv,2019,1.0,0.0
3793,Compliance,592116,319285,272831,2012_boxofficemojo_rankings.csv,2012,0.5392271109039445,0.4607728890960555
3794,The Cure: Anniversary 1978-2018 Live in Hyde Park,591904,378405,213499,2019_boxofficemojo_rankings.csv,2019,0.6393013056171271,0.3606986943828729
3795,The Wonderland,591857,50876,540981,2019_boxofficemojo_rankings.csv,2019,0.08595995316436233,0.9140400468356377
3796,The Human Resources Manager,590567,64014,526553,2010_boxofficemojo_rankings.csv,2010,0.10839413648239743,0.8916058635176026
3797,Storm Surfers 3D,589945,117090,472855,2012_boxofficemojo_rankings.csv,2012,0.19847612913068166,0.8015238708693183
3798,Starry Starry Night,589299,10033,579266,2011_boxofficemojo_rankings.csv,2011,0.01702531312627376,0.9829746868737262
3799,The Painted Bird,588749,1460,587289,2019_boxofficemojo_rankings.csv,2019,0.002479834360652842,0.9975201656393472
3800,Elvis on Tour,587818,587818,0,2010_boxofficemojo_rankings.csv,2010,1.0,0.0
3801,Thunderstruck,587211,587211,0,2012_boxofficemojo_rankings.csv,2012,1.0,0.0
3802,Upstream Color,587174,444098,143076,2013_boxofficemojo_rankings.csv,2013,0.7563311727017885,0.24366882729821143
3803,Seberg,585845,434702,151143,2020_boxofficemojo_rankings.csv,2020,0.7420085517500363,0.25799144824996373
3804,The Black Panthers: Vanguard of the Revolution,584109,516893,67216,2015_boxofficemojo_rankings.csv,2015,0.8849255875187679,0.1150744124812321
3805,Undefeated,583844,562218,21626,2012_boxofficemojo_rankings.csv,2012,0.9629592836442611,0.03704071635573886
3806,Gleason,583664,583664,0,2016_boxofficemojo_rankings.csv,2016,1.0,0.0
3807,The Flat,583443,471842,111601,2012_boxofficemojo_rankings.csv,2012,0.8087199606473983,0.1912800393526017
3808,White God,581904,282358,299546,2014_boxofficemojo_rankings.csv,2014,0.48523124089196845,0.5147687591080315
3809,Novitiate,580346,580346,0,2017_boxofficemojo_rankings.csv,2017,1.0,0.0
3810,Bedeviled,579942,0,579942,2017_boxofficemojo_rankings.csv,2017,0.0,1.0
3811,And Then We Danced,579574,177262,402312,2019_boxofficemojo_rankings.csv,2019,0.30584877858565085,0.6941512214143492
3812,Harry & Snowman,578820,561460,17360,2016_boxofficemojo_rankings.csv,2016,0.9700079472029302,0.0299920527970699
3813,Bilal: A New Breed of Hero 2018 Re-release,576805,490973,85832,2018_boxofficemojo_rankings.csv,2018,0.8511940777212402,0.14880592227875972
3814,Mesrine Part 1: Killer Instinct 2010 Re-release,572790,551697,21093,2010_boxofficemojo_rankings.csv,2010,0.9631749855968156,0.03682501440318441
3815,The Room 2017 Re-release,572340,549602,22738,2017_boxofficemojo_rankings.csv,2017,0.9602718663731349,0.03972813362686515
3816,The Falling,569498,0,569498,2015_boxofficemojo_rankings.csv,2015,0.0,1.0
3817,Goodbye to Language,566423,401889,164534,2014_boxofficemojo_rankings.csv,2014,0.7095209763727814,0.2904790236272185
3818,Margaret,564864,46495,518369,2011_boxofficemojo_rankings.csv,2011,0.08231184851574892,0.9176881514842511
3819,Palm Springs,564597,164000,400597,2020_boxofficemojo_rankings.csv,2020,0.2904726734290122,0.7095273265709878
3820,The Cat Returns 2018 Re-release,563718,563718,0,2018_boxofficemojo_rankings.csv,2018,1.0,0.0
3821,Like Someone in Love,562878,239056,323822,2012_boxofficemojo_rankings.csv,2012,0.4247030439988772,0.5752969560011229
3822,Beetlejuice 2018 Re-release,562613,512947,49666,2018_boxofficemojo_rankings.csv,2018,0.911722622833102,0.08827737716689803
3823,The Happiest Day in the Life of Olli Maki,562537,0,562537,2016_boxofficemojo_rankings.csv,2016,0.0,1.0
3824,My Fair Lady 2019 Re-release,560711,560711,0,2019_boxofficemojo_rankings.csv,2019,1.0,0.0
3825,Fiddler: A Miracle of Miracles,558816,549386,9430,2019_boxofficemojo_rankings.csv,2019,0.9831250357899559,0.016874964210044092
3826,The Dance of Reality,558636,293680,264956,2013_boxofficemojo_rankings.csv,2013,0.5257090484680543,0.47429095153194567
3827,Kusama: Infinity,558052,360931,197121,2018_boxofficemojo_rankings.csv,2018,0.6467694766795926,0.35323052332040744
3828,Forrest Gump 2014 IMAX Release,557683,557683,0,2014_boxofficemojo_rankings.csv,2014,1.0,0.0
3829,Castle in the Sky 2018 Re-release,557541,523664,33877,2018_boxofficemojo_rankings.csv,2018,0.9392385492726095,0.060761450727390455
3830,Rojo,557092,94757,462335,2018_boxofficemojo_rankings.csv,2018,0.1700921930309536,0.8299078069690464
3831,Samaritan's Purse presents Facing Darkness,555533,555533,0,2017_boxofficemojo_rankings.csv,2017,1.0,0.0
3832,Circumstance,555511,454121,101390,2011_boxofficemojo_rankings.csv,2011,0.8174833621656457,0.18251663783435432
3833,Dolores,555309,555309,0,2017_boxofficemojo_rankings.csv,2017,1.0,0.0
3834,Every Thing Will Be Fine,554953,9233,545720,2015_boxofficemojo_rankings.csv,2015,0.01663744497281752,0.9833625550271825
3835,Endless Poetry,554706,153440,401266,2016_boxofficemojo_rankings.csv,2016,0.2766149996574762,0.7233850003425238
3836,Viral,551760,0,551760,2016_boxofficemojo_rankings.csv,2016,0.0,1.0
3837,Open Windows,550108,1750,548358,2014_boxofficemojo_rankings.csv,2014,0.0031811935110923673,0.9968188064889076
3838,Dhadak,549628,0,549628,2018_boxofficemojo_rankings.csv,2018,0.0,1.0
3839,23 Blast,549185,549185,0,2014_boxofficemojo_rankings.csv,2014,1.0,0.0
3840,Followed,548608,538179,10429,2020_boxofficemojo_rankings.csv,2020,0.9809900694120391,0.019009930587960803
3841,We Are X,548126,45270,502856,2016_boxofficemojo_rankings.csv,2016,0.0825904992647676,0.9174095007352324
3842,Planetarium,546584,3262,543322,2016_boxofficemojo_rankings.csv,2016,0.005967975645097551,0.9940320243549025
3843,A Girl Walks Home Alone at Night,546352,491910,54442,2014_boxofficemojo_rankings.csv,2014,0.9003536181802209,0.0996463818197792
3844,My Generation,546183,0,546183,2018_boxofficemojo_rankings.csv,2018,0.0,1.0
3845,Rudderless,546149,58293,487856,2014_boxofficemojo_rankings.csv,2014,0.10673460905357329,0.8932653909464268
3846,"DCI 2019: Big, Loud & Live 16",546060,546060,0,2019_boxofficemojo_rankings.csv,2019,1.0,0.0
3847,The Art of the Steal,544890,544890,0,2010_boxofficemojo_rankings.csv,2010,1.0,0.0
3848,He's Out There,544674,0,544674,2018_boxofficemojo_rankings.csv,2018,0.0,1.0
3849,The Day Shall Come,543993,26972,517021,2019_boxofficemojo_rankings.csv,2019,0.04958152035044568,0.9504184796495543
3850,Beauty and the Beast 2020 Re-release,543260,467000,76260,2020_boxofficemojo_rankings.csv,2020,0.859625225490557,0.140374774509443
3851,On Any Sunday: The Next Chapter,543044,543044,0,2014_boxofficemojo_rankings.csv,2014,1.0,0.0
3852,The Club,541515,52761,488754,2015_boxofficemojo_rankings.csv,2015,0.09743220409406941,0.9025677959059306
3853,Dragon Ball Z: Bardock - The Father of Goku/Dragon Ball Z: Fusion Reborn,540707,540707,0,2018_boxofficemojo_rankings.csv,2018,1.0,0.0
3854,On the Way to School 2015 Re-release,540658,7424,533234,2015_boxofficemojo_rankings.csv,2015,0.013731416163267722,0.9862685838367323
3855,Grateful Dead Meet-Up 2019,537153,537153,0,2019_boxofficemojo_rankings.csv,2019,1.0,0.0
3856,CatVideoFest,536566,470923,65643,2019_boxofficemojo_rankings.csv,2019,0.8776609028525848,0.12233909714741523
3857,Karwaan,536525,182009,354516,2018_boxofficemojo_rankings.csv,2018,0.3392367550440334,0.6607632449559666
3858,Once Were Brothers: Robbie Robertson and the Band,536317,449561,86756,2020_boxofficemojo_rankings.csv,2020,0.8382374603079895,0.16176253969201052
3859,Hungry Hearts,534549,6921,527628,2015_boxofficemojo_rankings.csv,2015,0.012947363104224308,0.9870526368957757
3860,What They Had,533579,260136,273443,2018_boxofficemojo_rankings.csv,2018,0.4875304312950847,0.5124695687049153
3861,Creature,533235,508714,24521,2011_boxofficemojo_rankings.csv,2011,0.9540146464504393,0.0459853535495607
3862,Kill Your Friends,533147,0,533147,2015_boxofficemojo_rankings.csv,2015,0.0,1.0
3863,Kahaani 2,532877,350703,182174,2016_boxofficemojo_rankings.csv,2016,0.6581312385409767,0.3418687614590234
3864,Standing Ovation,531806,531806,0,2010_boxofficemojo_rankings.csv,2010,1.0,0.0
3865,Possessor Uncut,529855,529855,0,2020_boxofficemojo_rankings.csv,2020,1.0,0.0
3866,Metropolis 2010 Re-release,529603,529603,0,2010_boxofficemojo_rankings.csv,2010,1.0,0.0
3867,Margaret Atwood: Live in Cinemas,529285,93690,435595,2019_boxofficemojo_rankings.csv,2019,0.177012384632098,0.822987615367902
3868,Willy Wonka & the Chocolate Factory 2016 Re-release,526954,526633,321,2016_boxofficemojo_rankings.csv,2016,0.9993908386690299,0.0006091613309700657
3869,Only Yesterday 2016 Re-release,525958,453243,72715,2016_boxofficemojo_rankings.csv,2016,0.8617475159613506,0.13825248403864948
3870,The Audience 2019 Re-release,523432,106529,416903,2019_boxofficemojo_rankings.csv,2019,0.20352022803344083,0.7964797719665592
3871,Bolshoi Ballet: Carmen Suite/Petrushka,522179,207523,314656,2019_boxofficemojo_rankings.csv,2019,0.39741736071347183,0.6025826392865282
3872,Sound City,521181,422853,98328,2013_boxofficemojo_rankings.csv,2013,0.8113361768752123,0.18866382312478774
3873,The Spy Behind Home Plate,519525,519525,0,2019_boxofficemojo_rankings.csv,2019,1.0,0.0
3874,Wild Nights with Emily,519487,519487,0,2019_boxofficemojo_rankings.csv,2019,1.0,0.0
3875,Scatter My Ashes at Bergdorf's,518342,518342,0,2013_boxofficemojo_rankings.csv,2013,1.0,0.0
3876,Trespass Against Us,517197,5711,511486,2017_boxofficemojo_rankings.csv,2017,0.011042214088635472,0.9889577859113645
3877,Grave of the Fireflies,516962,516962,0,2018_boxofficemojo_rankings.csv,2018,1.0,0.0
3878,Listen to Me Marlon,516337,425831,90506,2015_boxofficemojo_rankings.csv,2015,0.824715253797423,0.175284746202577
3879,The Sandlot 2018 Re-release,516130,516130,0,2018_boxofficemojo_rankings.csv,2018,1.0,0.0
3880,"Love, Wedding, Marriage",515823,1926,513897,2011_boxofficemojo_rankings.csv,2011,0.003733838933122408,0.9962661610668776
3881,The Big Ugly,515399,514107,1292,2020_boxofficemojo_rankings.csv,2020,0.9974932042941488,0.002506795705851195
3882,Preacher's Kid,515065,515065,0,2010_boxofficemojo_rankings.csv,2010,1.0,0.0
3883,A Hard Day's Night 2014 Re-release,515005,515005,0,2014_boxofficemojo_rankings.csv,2014,1.0,0.0
3884,Goodbye First Love,514913,95000,419913,2011_boxofficemojo_rankings.csv,2011,0.18449718690341863,0.8155028130965813
3885,Black Panther 2020 Re-release,513326,367000,146326,2020_boxofficemojo_rankings.csv,2020,0.7149452784390427,0.28505472156095735
3886,Bullitt 2018 Re-release,511350,511350,0,2018_boxofficemojo_rankings.csv,2018,1.0,0.0
3887,Black Butler: Book of the Atlantic,511132,248286,262846,2017_boxofficemojo_rankings.csv,2017,0.4857571038401039,0.514242896159896
3888,Monsters and Men,510967,500101,10866,2018_boxofficemojo_rankings.csv,2018,0.9787344388189453,0.021265561181054746
3889,Unsullied,510957,510957,0,2016_boxofficemojo_rankings.csv,2016,1.0,0.0
3890,Bol,509872,188850,321022,2011_boxofficemojo_rankings.csv,2011,0.3703870775410299,0.62961292245897
3891,Saving Private Ryan 2019 Re-release,508694,508694,0,2019_boxofficemojo_rankings.csv,2019,1.0,0.0
3892,Una,508169,22815,485354,2017_boxofficemojo_rankings.csv,2017,0.04489648128870514,0.9551035187112948
3893,The Inevitable Defeat of Mister & Pete,506303,494608,11695,2013_boxofficemojo_rankings.csv,2013,0.9769011836785482,0.02309881632145178
3894,Our Last Tango,505885,100086,405799,2015_boxofficemojo_rankings.csv,2015,0.19784338337764512,0.8021566166223549
3895,Gabriel and the Mountain,505769,18415,487354,2017_boxofficemojo_rankings.csv,2017,0.03640990254444223,0.9635900974555578
3896,Have a Nice Day,504003,79393,424610,2018_boxofficemojo_rankings.csv,2018,0.15752485600284125,0.8424751439971587
3897,Letters From Baghdad,502941,359735,143206,2017_boxofficemojo_rankings.csv,2017,0.7152628240688271,0.2847371759311728
3898,Chuck,502518,320725,181793,2017_boxofficemojo_rankings.csv,2017,0.6382358442881648,0.3617641557118352
3899,Deli Man,502294,502294,0,2015_boxofficemojo_rankings.csv,2015,1.0,0.0
3900,Bride Flight 2011 Re-release,501360,501360,0,2011_boxofficemojo_rankings.csv,2011,1.0,0.0
3901,Synonyms,501223,206003,295220,2019_boxofficemojo_rankings.csv,2019,0.411000692306618,0.5889993076933819
3902,Smashed,499725,376597,123128,2012_boxofficemojo_rankings.csv,2012,0.7536084846665666,0.2463915153334334
3903,The Burnt Orange Heresy,499391,144201,355190,2020_boxofficemojo_rankings.csv,2020,0.28875370200904704,0.711246297990953
3904,Hamari Adhuri Kahani,498774,235361,263413,2015_boxofficemojo_rankings.csv,2015,0.4718790474242843,0.5281209525757157
3905,Whisper of the Heart 2019 Re-release,498156,498156,0,2019_boxofficemojo_rankings.csv,2019,1.0,0.0
3906,Kahlil Gibran's The Prophet 2015 Re-release,496914,370146,126768,2015_boxofficemojo_rankings.csv,2015,0.7448894577331289,0.25511054226687113
3907,Felix and Meira,496714,447353,49361,2015_boxofficemojo_rankings.csv,2015,0.9006249068880684,0.09937509311193161
3908,April and the Extraordinary World,495879,295488,200391,2015_boxofficemojo_rankings.csv,2015,0.5958873031525836,0.4041126968474164
3909,Nausicaä of the Valley of the Wind 2019 Re-release,495770,495770,0,2019_boxofficemojo_rankings.csv,2019,1.0,0.0
3910,Eden,494949,65460,429489,2014_boxofficemojo_rankings.csv,2014,0.13225605062339757,0.8677439493766025
3911,Steve Jobs: The Man in the Machine,494506,494506,0,2015_boxofficemojo_rankings.csv,2015,1.0,0.0
3912,Monty Python's Life of Brian 2019 Re-release,494444,161507,332937,2019_boxofficemojo_rankings.csv,2019,0.32664366439879944,0.6733563356012006
3913,The Polar Express 2013 IMAX Release,493776,493776,0,2013_boxofficemojo_rankings.csv,2013,1.0,0.0
3914,Two Night Stand,492332,18612,473720,2014_boxofficemojo_rankings.csv,2014,0.03780375843942705,0.9621962415605729
3915,Soul on a String,491294,3669,487625,2017_boxofficemojo_rankings.csv,2017,0.007468033397517576,0.9925319666024824
3916,Wolves,491154,12139,479015,2014_boxofficemojo_rankings.csv,2014,0.024715262422783893,0.9752847375772161
3917,Joker,490291,169181,321110,2012_boxofficemojo_rankings.csv,2012,0.34506242211258215,0.6549375778874179
3918,Open Grave,489812,0,489812,2013_boxofficemojo_rankings.csv,2013,0.0,1.0
3919,Zama,489692,200600,289092,2017_boxofficemojo_rankings.csv,2017,0.40964524639977784,0.5903547536002222
3920,L'amour fou,489126,312494,176632,2010_boxofficemojo_rankings.csv,2010,0.638882414756116,0.361117585243884
3921,What Richard Did,488327,2749,485578,2012_boxofficemojo_rankings.csv,2012,0.0056294245454377905,0.9943705754545622
3922,At Any Price,487455,380594,106861,2013_boxofficemojo_rankings.csv,2013,0.7807777128145162,0.21922228718548378
3923,London Fields,487420,252676,234744,2018_boxofficemojo_rankings.csv,2018,0.5183948135078577,0.4816051864921423
3924,Beach Rats,486623,473771,12852,2017_boxofficemojo_rankings.csv,2017,0.973589411104695,0.02641058889530499
3925,Cooties,485544,60058,425486,2015_boxofficemojo_rankings.csv,2015,0.12369218855551711,0.8763078114444829
3926,The Russian Five,485049,485049,0,2019_boxofficemojo_rankings.csv,2019,1.0,0.0
3927,63 Up,483684,483684,0,2019_boxofficemojo_rankings.csv,2019,1.0,0.0
3928,Our Little Sister 2016 Re-release,483559,467555,16004,2016_boxofficemojo_rankings.csv,2016,0.9669037283971552,0.03309627160284474
3929,Lawrence of Arabia 2019 Re-release,482281,482281,0,2019_boxofficemojo_rankings.csv,2019,1.0,0.0
3930,The Journey,482209,155475,326734,2017_boxofficemojo_rankings.csv,2017,0.32242243508520163,0.6775775649147984
3931,I Origins,481234,336472,144762,2014_boxofficemojo_rankings.csv,2014,0.6991858430617953,0.3008141569382047
3932,Breathe In,481079,89661,391418,2013_boxofficemojo_rankings.csv,2013,0.1863747949920907,0.8136252050079094
3933,Father of My Children,480834,144022,336812,2010_boxofficemojo_rankings.csv,2010,0.29952540793704274,0.7004745920629573
3934,The Third Man 2015 Re-release,478945,449191,29754,2015_boxofficemojo_rankings.csv,2015,0.9378759565294553,0.062124043470544635
3935,Brotherly Love,478595,478595,0,2015_boxofficemojo_rankings.csv,2015,1.0,0.0
3936,Liam Gallagher: As It Was,477009,0,477009,2019_boxofficemojo_rankings.csv,2019,0.0,1.0
3937,Heart of a Dog,476384,420813,55571,2015_boxofficemojo_rankings.csv,2015,0.8833483072479345,0.11665169275206556
3938,The Babymakers,475511,7889,467622,2012_boxofficemojo_rankings.csv,2012,0.016590573088740325,0.9834094269112597
3939,Gorillaz: Reject False Icons,475465,453687,21778,2019_boxofficemojo_rankings.csv,2019,0.9541964182431935,0.045803581756806495
3940,The Shawshank Redemption 2019 Re-release,473776,358507,115269,2019_boxofficemojo_rankings.csv,2019,0.7567014791800345,0.24329852081996556
3941,On the Job,472890,164620,308270,2013_boxofficemojo_rankings.csv,2013,0.34811478356488823,0.6518852164351118
3942,Pearl Jam Twenty,471334,471334,0,2011_boxofficemojo_rankings.csv,2011,1.0,0.0
3943,Darbareye Elly 2015 Re-release,470760,470760,0,2015_boxofficemojo_rankings.csv,2015,1.0,0.0
3944,White Bird in a Blizzard,469701,33821,435880,2014_boxofficemojo_rankings.csv,2014,0.07200538214736608,0.9279946178526339
3945,Matangi/Maya/M.I.A,469489,230808,238681,2018_boxofficemojo_rankings.csv,2018,0.49161535201037726,0.5083846479896228
3946,DCI 2017 Tour Premeire,467817,467817,0,2017_boxofficemojo_rankings.csv,2017,1.0,0.0
3947,Time Freak,467693,10003,457690,2018_boxofficemojo_rankings.csv,2018,0.021387961761240814,0.9786120382387592
3948,Hail Satan?,467361,424284,43077,2019_boxofficemojo_rankings.csv,2019,0.9078292797216713,0.09217072027832875
3949,True History of the Kelly Gang,467198,33817,433381,2020_boxofficemojo_rankings.csv,2020,0.07238258725422626,0.9276174127457737
3950,Last Days in Vietnam,466114,466114,0,2014_boxofficemojo_rankings.csv,2014,1.0,0.0
3951,Neighboring Sounds,465082,60255,404827,2012_boxofficemojo_rankings.csv,2012,0.1295577984097428,0.8704422015902572
3952,Ghanchakkar,464803,203044,261759,2013_boxofficemojo_rankings.csv,2013,0.43683883279582963,0.5631611672041704
3953,Puffs: Filmed Live Off Broadway,464483,464483,0,2018_boxofficemojo_rankings.csv,2018,1.0,0.0
3954,Deepsea Challenge,462959,235659,227300,2014_boxofficemojo_rankings.csv,2014,0.5090277972779447,0.4909722027220553
3955,Before We Go,462875,37151,425724,2015_boxofficemojo_rankings.csv,2015,0.08026140966783689,0.9197385903321631
3956,The Bag Man,461780,56574,405206,2014_boxofficemojo_rankings.csv,2014,0.12251288492355668,0.8774871150764433
3957,MFKZ,461724,229423,232301,2018_boxofficemojo_rankings.csv,2018,0.4968834195320148,0.5031165804679852
3958,Scotty and the Secret History of Hollywood,461689,461689,0,2018_boxofficemojo_rankings.csv,2018,1.0,0.0
3959,Bully,461405,279202,182203,2012_boxofficemojo_rankings.csv,2012,0.6051126450732003,0.39488735492679966
3960,Disorder,460997,51879,409118,2015_boxofficemojo_rankings.csv,2015,0.11253652409885531,0.8874634759011447
3961,The Dark Knight 2018 Re-release,460178,375589,84589,2018_boxofficemojo_rankings.csv,2018,0.8161819991394634,0.18381800086053657
3962,Inside Out 2020 Re-release,460176,460000,176,2020_boxofficemojo_rankings.csv,2020,0.9996175376377734,0.0003824623622266263
3963,Manglehorn,459636,143101,316535,2015_boxofficemojo_rankings.csv,2015,0.3113354915628889,0.6886645084371111
3964,Christmas Jars,459462,459462,0,2019_boxofficemojo_rankings.csv,2019,1.0,0.0
3965,Eric Clapton: A Life in 12 Bars,459088,0,459088,2017_boxofficemojo_rankings.csv,2017,0.0,1.0
3966,South Pacific 2018 Re-release,458000,458000,0,2018_boxofficemojo_rankings.csv,2018,1.0,0.0
3967,We Steal Secrets,457517,166243,291274,2013_boxofficemojo_rankings.csv,2013,0.3633591757246179,0.6366408242753822
3968,Paradise: Hope,457132,6701,450431,2013_boxofficemojo_rankings.csv,2013,0.014658785646159096,0.9853412143538409
3969,Sound of Noise,456366,24565,431801,2010_boxofficemojo_rankings.csv,2010,0.05382741045564306,0.9461725895443569
3970,Staying Vertical,456271,12158,444113,2016_boxofficemojo_rankings.csv,2016,0.026646444766377876,0.9733535552336221
3971,Lola Versus,455754,252603,203151,2012_boxofficemojo_rankings.csv,2012,0.5542529522505563,0.4457470477494438
3972,Alone,455148,428111,27037,2020_boxofficemojo_rankings.csv,2020,0.9405973441605807,0.05940265583941927
3973,The Gospel According to André,454550,400713,53837,2018_boxofficemojo_rankings.csv,2018,0.881559784402156,0.11844021559784403
3974,The Most Dangerous Man in America: Daniel Ellsberg and the Pentagon Papers,453993,453993,0,2010_boxofficemojo_rankings.csv,2010,1.0,0.0
3975,Kajillionaire,453705,453705,0,2020_boxofficemojo_rankings.csv,2020,1.0,0.0
3976,Leaning Into The Wind,452372,400530,51842,2018_boxofficemojo_rankings.csv,2018,0.8853996268557736,0.11460037314422643
3977,Sailor Moon R: The Movie: The Promise of the Rose,452053,452053,0,2017_boxofficemojo_rankings.csv,2017,1.0,0.0
3978,The Perfect Host,450885,48764,402121,2011_boxofficemojo_rankings.csv,2011,0.10815174601062355,0.8918482539893764
3979,Perfect Blue 2017 Re-release,450594,446062,4532,2017_boxofficemojo_rankings.csv,2017,0.9899421652307843,0.010057834769215747
3980,Kill List,450275,29063,421212,2011_boxofficemojo_rankings.csv,2011,0.06454500027760812,0.9354549997223919
3981,Pearl Jam: Let's Play Two,450273,348833,101440,2017_boxofficemojo_rankings.csv,2017,0.7747144510108313,0.2252855489891688
3982,Hesher,449702,382946,66756,2011_boxofficemojo_rankings.csv,2011,0.8515550297752734,0.1484449702247266
3983,17 Girls,449626,15123,434503,2011_boxofficemojo_rankings.csv,2011,0.033634620773709704,0.9663653792262903
3984,The Rocket,449064,56823,392241,2013_boxofficemojo_rankings.csv,2013,0.1265365293143071,0.8734634706856929
3985,Before We Vanish,448829,52087,396742,2017_boxofficemojo_rankings.csv,2017,0.11605087906530104,0.8839491209346989
3986,The Sleeping Beauty,446131,29066,417065,2011_boxofficemojo_rankings.csv,2011,0.06515126722868395,0.9348487327713161
3987,Cruel Intentions 2019 Re-release,445218,445218,0,2019_boxofficemojo_rankings.csv,2019,1.0,0.0
3988,Charlie Countryman,443990,11650,432340,2013_boxofficemojo_rankings.csv,2013,0.026239329714633212,0.9737606702853668
3989,Porco Rosso 2018 Re-release,443059,443059,0,2018_boxofficemojo_rankings.csv,2018,1.0,0.0
3990,StarDog and TurboCat,443030,80490,362540,2019_boxofficemojo_rankings.csv,2019,0.1816806988240074,0.8183193011759926
3991,Prince Avalanche,442313,205139,237174,2013_boxofficemojo_rankings.csv,2013,0.46378695629565486,0.5362130437043451
3992,Elf 2018 Re-release,442073,442073,0,2018_boxofficemojo_rankings.csv,2018,1.0,0.0
3993,Bastards,439935,24525,415410,2013_boxofficemojo_rankings.csv,2013,0.05574687169695523,0.9442531283030448
3994,Bitch Slap,439587,17365,422222,2010_boxofficemojo_rankings.csv,2010,0.03950298803194817,0.9604970119680518
3995,Desert Dancer,438165,155271,282894,2014_boxofficemojo_rankings.csv,2014,0.3543665057683749,0.6456334942316251
3996,CatVideoFest 2020,437625,437625,0,2020_boxofficemojo_rankings.csv,2020,1.0,0.0
3997,My Kingdom,435759,36533,399226,2011_boxofficemojo_rankings.csv,2011,0.08383762584364293,0.916162374156357
3998,We the Animals,434743,400961,33782,2018_boxofficemojo_rankings.csv,2018,0.9222943210126443,0.07770567898735575
3999,What We Left Behind: Star Trek DS9,434437,382457,51980,2019_boxofficemojo_rankings.csv,2019,0.8803508909231949,0.11964910907680515
4000,DCI 2018 Tour Premeire,434008,434008,0,2018_boxofficemojo_rankings.csv,2018,1.0,0.0
4001,Rosenwald,433924,433924,0,2015_boxofficemojo_rankings.csv,2015,1.0,0.0
4002,The Shining 40th Anniversary,433807,0,433807,2020_boxofficemojo_rankings.csv,2020,0.0,1.0
4003,Bjork: Biophilia Live,433686,127754,305932,2014_boxofficemojo_rankings.csv,2014,0.29457718256987775,0.7054228174301223
4004,I Want Your Money,433588,433588,0,2010_boxofficemojo_rankings.csv,2010,1.0,0.0
4005,The Sower,433112,36233,396879,2018_boxofficemojo_rankings.csv,2018,0.08365734498236022,0.9163426550176398
4006,Harmony,430568,23248,407320,2015_boxofficemojo_rankings.csv,2015,0.0539937942438825,0.9460062057561175
4007,Ghostbusters 2019 Re-release,430435,369612,60823,2019_boxofficemojo_rankings.csv,2019,0.8586941117706506,0.1413058882293494
4008,Andy Irons: Kissed by God,430393,285933,144460,2018_boxofficemojo_rankings.csv,2018,0.6643532771211428,0.3356467228788572
4009,Iron Man 2020 Re-release,430000,430000,0,2020_boxofficemojo_rankings.csv,2020,1.0,0.0
4010,Go Goa Gone,429350,298457,130893,2013_boxofficemojo_rankings.csv,2013,0.6951368347502038,0.30486316524979623
4011,On the Beach at Night Alone,429159,37489,391670,2017_boxofficemojo_rankings.csv,2017,0.08735457021756506,0.9126454297824349
4012,Infamous,429148,429148,0,2020_boxofficemojo_rankings.csv,2020,1.0,0.0
4013,Blackway,426491,27079,399412,2016_boxofficemojo_rankings.csv,2016,0.06349254732221782,0.9365074526777821
4014,Happy Bhaag Jayegi 2016 Re-release,426345,351840,74505,2016_boxofficemojo_rankings.csv,2016,0.825247158990958,0.17475284100904198
4015,Killing Sarai,425332,425332,0,2019_boxofficemojo_rankings.csv,2019,1.0,0.0
4016,Vertigo 2018 Re-release,425152,394212,30940,2018_boxofficemojo_rankings.csv,2018,0.9272260273972602,0.07277397260273973
4017,Sound of My Voice,424088,408015,16073,2012_boxofficemojo_rankings.csv,2012,0.9620998472015242,0.037900152798475785
4018,Viva,423976,178008,245968,2016_boxofficemojo_rankings.csv,2016,0.41985395399739606,0.5801460460026039
4019,God Help the Girl,423306,102757,320549,2014_boxofficemojo_rankings.csv,2014,0.2427487444071192,0.7572512555928808
4020,Cirque du Soleil in Cinema: KURIOS - Cabinet of Curiosities,422760,413039,9721,2018_boxofficemojo_rankings.csv,2018,0.9770058662125083,0.02299413378749172
4021,Mississippi Grind,422746,130541,292205,2015_boxofficemojo_rankings.csv,2015,0.3087929868053157,0.6912070131946842
4022,Behaving Badly,422697,0,422697,2014_boxofficemojo_rankings.csv,2014,0.0,1.0
4023,Ben-Hur 2019 Re-release,422622,422622,0,2019_boxofficemojo_rankings.csv,2019,1.0,0.0
4024,Super,422618,327716,94902,2011_boxofficemojo_rankings.csv,2011,0.7754425982802436,0.22455740171975638
4025,Settai,422247,87838,334409,2013_boxofficemojo_rankings.csv,2013,0.20802516062873153,0.7919748393712684
4026,Mad Max: Fury Road 2016 Re-release,421986,421986,0,2016_boxofficemojo_rankings.csv,2016,1.0,0.0
4027,She's Beautiful When She's Angry,421573,421573,0,2014_boxofficemojo_rankings.csv,2014,1.0,0.0
4028,The Bounce Back,421404,321910,99494,2016_boxofficemojo_rankings.csv,2016,0.7638987764710349,0.23610122352896507
4029,The Cold Blue,420177,420177,0,2019_boxofficemojo_rankings.csv,2019,1.0,0.0
4030,Voiceless,419952,419952,0,2016_boxofficemojo_rankings.csv,2016,1.0,0.0
4031,Frankenstein 2018 Re-release,417783,417783,0,2018_boxofficemojo_rankings.csv,2018,1.0,0.0
4032,Happy Phirr Bhag Jayegi,417669,103385,314284,2018_boxofficemojo_rankings.csv,2018,0.2475285453313509,0.7524714546686491
4033,Bolshoi Ballet: Le Corsaire,417152,190192,226960,2019_boxofficemojo_rankings.csv,2019,0.4559297330469469,0.544070266953053
4034,Dirty Wars,416853,384473,32380,2013_boxofficemojo_rankings.csv,2013,0.922322737271892,0.07767726272810799
4035,Tales of Halloween,416792,0,416792,2015_boxofficemojo_rankings.csv,2015,0.0,1.0
4036,Manifesto,416389,161101,255288,2017_boxofficemojo_rankings.csv,2017,0.3869002303134809,0.6130997696865191
4037,Status Update,416178,4764,411414,2018_boxofficemojo_rankings.csv,2018,0.011447025071003272,0.9885529749289967
4038,Sand Storm,414698,86800,327898,2016_boxofficemojo_rankings.csv,2016,0.20930894289338264,0.7906910571066174
4039,The Ottoman Lieutenant,413844,240978,172866,2017_boxofficemojo_rankings.csv,2017,0.5822918780989939,0.4177081219010062
4040,The Mafia Kills Only in Summer 2015 Re-release,413236,37134,376102,2015_boxofficemojo_rankings.csv,2015,0.08986148351063315,0.9101385164893668
4041,The Climb,413161,0,413161,2020_boxofficemojo_rankings.csv,2020,0.0,1.0
4042,The Moth Diaries,413035,3838,409197,2012_boxofficemojo_rankings.csv,2012,0.009292190734441392,0.9907078092655586
4043,Unbranded,412792,410185,2607,2015_boxofficemojo_rankings.csv,2015,0.9936844706292758,0.006315529370724239
4044,Rage,411967,5594,406373,2010_boxofficemojo_rankings.csv,2010,0.013578757521840342,0.9864212424781597
4045,R... Rajkumar,410495,166503,243992,2013_boxofficemojo_rankings.csv,2013,0.4056151719265764,0.5943848280734235
4046,Badlapur,409166,409166,0,2015_boxofficemojo_rankings.csv,2015,1.0,0.0
4047,Song One,408918,32251,376667,2015_boxofficemojo_rankings.csv,2015,0.0788691131229244,0.9211308868770756
4048,The Reliant,408747,408747,0,2019_boxofficemojo_rankings.csv,2019,1.0,0.0
4049,Sleeping Beauty,408680,36578,372102,2011_boxofficemojo_rankings.csv,2011,0.08950278946853284,0.9104972105314671
4050,The 5th Quarter,408159,408159,0,2011_boxofficemojo_rankings.csv,2011,1.0,0.0
4051,Back to the Future 2020 Re-release,407977,247000,160977,2020_boxofficemojo_rankings.csv,2020,0.6054262862857465,0.3945737137142535
4052,"Love, Kennedy",407871,407871,0,2017_boxofficemojo_rankings.csv,2017,1.0,0.0
4053,Please Stand By,406732,9868,396864,2018_boxofficemojo_rankings.csv,2018,0.024261675993037184,0.9757383240069628
4054,Chasing Trane: The John Coltrane Documentary,406284,406284,0,2017_boxofficemojo_rankings.csv,2017,1.0,0.0
4055,Gabrielle,406256,5534,400722,2013_boxofficemojo_rankings.csv,2013,0.013621952660391477,0.9863780473396085
4056,The Square 2010 Re-release,406116,406116,0,2010_boxofficemojo_rankings.csv,2010,1.0,0.0
4057,The Hunting Ground,405917,405917,0,2015_boxofficemojo_rankings.csv,2015,1.0,0.0
4058,The Tempest,405861,277943,127918,2010_boxofficemojo_rankings.csv,2010,0.6848231291008497,0.3151768708991502
4059,Stake Land,405380,33245,372135,2011_boxofficemojo_rankings.csv,2011,0.08200947259361586,0.9179905274063841
4060,Happy Magic,405268,10697,394571,2011_boxofficemojo_rankings.csv,2011,0.02639487943780412,0.9736051205621958
4061,Tezz,405214,229931,175283,2012_boxofficemojo_rankings.csv,2012,0.5674310364400046,0.43256896355999547
4062,The Philadelphia Story 2018 Re-release,404524,404524,0,2018_boxofficemojo_rankings.csv,2018,1.0,0.0
4063,God's Pocket,403713,169976,233737,2014_boxofficemojo_rankings.csv,2014,0.4210317725711087,0.5789682274288913
4064,Meet Me in St. Louis 75th Anniversary,403521,403521,0,2019_boxofficemojo_rankings.csv,2019,1.0,0.0
4065,The Apu Trilogy,402723,402723,0,2015_boxofficemojo_rankings.csv,2015,1.0,0.0
4066,Drinking Buddies,401914,343341,58573,2013_boxofficemojo_rankings.csv,2013,0.8542648427275487,0.14573515727245132
4067,The Oath,401463,401463,0,2018_boxofficemojo_rankings.csv,2018,1.0,0.0
4068,Freetown,401328,401328,0,2015_boxofficemojo_rankings.csv,2015,1.0,0.0
4069,"Hello, Dolly!",400881,400881,0,2019_boxofficemojo_rankings.csv,2019,1.0,0.0
4070,Racer and the Jailbird,400026,46337,353689,2017_boxofficemojo_rankings.csv,2017,0.11583497072690276,0.8841650292730973
4071,West Side Story 2018 Re-release,398670,398670,0,2018_boxofficemojo_rankings.csv,2018,1.0,0.0
4072,Space Mutiny,397887,397887,0,2018_boxofficemojo_rankings.csv,2018,1.0,0.0
4073,Berlin Syndrome,397783,28660,369123,2017_boxofficemojo_rankings.csv,2017,0.07204933343053876,0.9279506665694612
4074,Krull 2018 Re-release,397157,397157,0,2018_boxofficemojo_rankings.csv,2018,1.0,0.0
4075,13 Minutes 2015 Re-release,395557,161531,234026,2015_boxofficemojo_rankings.csv,2015,0.40836339642579955,0.5916366035742004
4076,God Bless America,393880,122550,271330,2012_boxofficemojo_rankings.csv,2012,0.3111353711790393,0.6888646288209607
4077,Into the Abyss,393714,223880,169834,2011_boxofficemojo_rankings.csv,2011,0.5686361165719278,0.43136388342807214
4078,Cuban Fury 2014 Re-release,392705,92384,300321,2014_boxofficemojo_rankings.csv,2014,0.235250378783056,0.764749621216944
4079,Three,391957,331507,60450,2016_boxofficemojo_rankings.csv,2016,0.8457738986674559,0.15422610133254414
4080,Tiny Furniture,391674,391674,0,2010_boxofficemojo_rankings.csv,2010,1.0,0.0
4081,The Escape,390881,14018,376863,2018_boxofficemojo_rankings.csv,2018,0.03586257710147078,0.9641374228985292
4082,Detropia,390024,390024,0,2012_boxofficemojo_rankings.csv,2012,1.0,0.0
4083,Once Upon a Time in Mumbaai Dobara,389237,0,389237,2013_boxofficemojo_rankings.csv,2013,0.0,1.0
4084,Singh Saab the Great,388622,225668,162954,2013_boxofficemojo_rankings.csv,2013,0.580687660503008,0.4193123394969919
4085,Keep the Lights On,388331,246112,142219,2012_boxofficemojo_rankings.csv,2012,0.6337686149187163,0.3662313850812838
4086,"Westwood: Punk, Icon, Activist",386856,58979,327877,2018_boxofficemojo_rankings.csv,2018,0.15245724507310213,0.8475427549268979
4087,Hitchcock/Truffaut,386471,260430,126041,2015_boxofficemojo_rankings.csv,2015,0.6738668619378945,0.3261331380621056
4088,The Wedding Guest,386166,386166,0,2019_boxofficemojo_rankings.csv,2019,1.0,0.0
4089,How to Talk to Girls at Parties,385733,84809,300924,2018_boxofficemojo_rankings.csv,2018,0.21986451768451235,0.7801354823154877
4090,Samurai Cop,384756,384756,0,2017_boxofficemojo_rankings.csv,2017,1.0,0.0
4091,Bethlehem,384670,201700,182970,2014_boxofficemojo_rankings.csv,2014,0.5243455429329035,0.47565445706709647
4092,The Secret World of Arrietty 2019 Re-release,384289,384289,0,2019_boxofficemojo_rankings.csv,2019,1.0,0.0
4093,Digimon Adventure tri. Part 5: Coexistence,382119,52339,329780,2017_boxofficemojo_rankings.csv,2017,0.1369704202094112,0.8630295797905888
4094,Z for Zachariah,381839,121461,260378,2015_boxofficemojo_rankings.csv,2015,0.3180947991169053,0.6819052008830947
4095,Flower,380553,328188,52365,2018_boxofficemojo_rankings.csv,2018,0.8623976161007797,0.13760238389922033
4096,Tulsa,380456,380456,0,2020_boxofficemojo_rankings.csv,2020,1.0,0.0
4097,Jane and Emma,380030,380030,0,2018_boxofficemojo_rankings.csv,2018,1.0,0.0
4098,Daughter of Mine,379010,10628,368382,2018_boxofficemojo_rankings.csv,2018,0.02804147647819319,0.9719585235218068
4099,I'll Push You: A Real-Life Inspiration,378899,378899,0,2017_boxofficemojo_rankings.csv,2017,1.0,0.0
4100,Shahid,377803,12153,365650,2013_boxofficemojo_rankings.csv,2013,0.03216755822478911,0.9678324417752109
4101,Miss Hokusai,377702,222670,155032,2015_boxofficemojo_rankings.csv,2015,0.589538842791407,0.410461157208593
4102,Attack on Titan: Smoke Signal,377334,377334,0,2018_boxofficemojo_rankings.csv,2018,1.0,0.0
4103,Le talent de mes amis,376522,889,375633,2015_boxofficemojo_rankings.csv,2015,0.0023610838144915835,0.9976389161855084
4104,Great Performances at the Met: Puccini: Turandot,375295,0,375295,2019_boxofficemojo_rankings.csv,2019,0.0,1.0
4105,Chronic,374704,9033,365671,2016_boxofficemojo_rankings.csv,2016,0.024107028481147787,0.9758929715188522
4106,Jurassic Park 2018 Re-release,374238,374238,0,2018_boxofficemojo_rankings.csv,2018,1.0,0.0
4107,Pom Poko 2018 Re-release,372405,372405,0,2018_boxofficemojo_rankings.csv,2018,1.0,0.0
4108,Eloise,372137,0,372137,2017_boxofficemojo_rankings.csv,2017,0.0,1.0
4109,Fanny,371657,8735,362922,2013_boxofficemojo_rankings.csv,2013,0.023502853437443665,0.9764971465625564
4110,7 Boxes,370892,38106,332786,2013_boxofficemojo_rankings.csv,2013,0.10274149887298728,0.8972585011270127
4111,Hava Nagila,370218,370218,0,2013_boxofficemojo_rankings.csv,2013,1.0,0.0
4112,"Ruben Brandt, Collector 2018 Re-release",369809,117963,251846,2018_boxofficemojo_rankings.csv,2018,0.31898358341738575,0.6810164165826142
4113,Mooz-Lum,369129,369129,0,2011_boxofficemojo_rankings.csv,2011,1.0,0.0
4114,When Comedy Went to School,369065,369065,0,2013_boxofficemojo_rankings.csv,2013,1.0,0.0
4115,The Void,368372,151042,217330,2017_boxofficemojo_rankings.csv,2017,0.41002573485498356,0.5899742651450165
4116,Dark Awakening,367925,0,367925,2015_boxofficemojo_rankings.csv,2015,0.0,1.0
4117,Room 237,367406,296359,71047,2012_boxofficemojo_rankings.csv,2012,0.8066253681213699,0.1933746318786302
4118,INXS: Baby Live at Wembly Stadium,366425,161750,204675,2019_boxofficemojo_rankings.csv,2019,0.44142730435969163,0.5585726956403084
4119,Grease 2010 Sing-a-long,365802,365802,0,2010_boxofficemojo_rankings.csv,2010,1.0,0.0
4120,Eat That Question,365540,355074,10466,2016_boxofficemojo_rankings.csv,2016,0.9713683864966899,0.02863161350331017
4121,Glen Campbell: I'll Be Me,365422,365422,0,2014_boxofficemojo_rankings.csv,2014,1.0,0.0
4122,Lords of Chaos,365353,253184,112169,2019_boxofficemojo_rankings.csv,2019,0.692984592982677,0.307015407017323
4123,Clemency,364952,364716,236,2019_boxofficemojo_rankings.csv,2019,0.9993533396172647,0.0006466603827352638
4124,Cunningham,364727,265102,99625,2019_boxofficemojo_rankings.csv,2019,0.7268504936568996,0.2731495063431005
4125,BOSTON: An American Running Story,364369,364369,0,2017_boxofficemojo_rankings.csv,2017,1.0,0.0
4126,Jig,363320,183790,179530,2011_boxofficemojo_rankings.csv,2011,0.5058626004624023,0.4941373995375977
4127,The Breadwinner,363307,312381,50926,2017_boxofficemojo_rankings.csv,2017,0.8598265378866908,0.14017346211330914
4128,Breathless 2010 Re-release,363031,363031,0,2010_boxofficemojo_rankings.csv,2010,1.0,0.0
4129,The Tobacconist,360996,0,360996,2019_boxofficemojo_rankings.csv,2019,0.0,1.0
4130,These Final Hours,360234,0,360234,2014_boxofficemojo_rankings.csv,2014,0.0,1.0
4131,Souvenir,359798,11411,348387,2016_boxofficemojo_rankings.csv,2016,0.031715017871138805,0.9682849821288612
4132,Disney Junior HalloVeen Party!,359745,359745,0,2017_boxofficemojo_rankings.csv,2017,1.0,0.0
4133,Happy Ending,359542,313770,45772,2014_boxofficemojo_rankings.csv,2014,0.8726935935161956,0.1273064064838044
4134,K-12,359377,303230,56147,2019_boxofficemojo_rankings.csv,2019,0.8437657390428436,0.15623426095715642
4135,Government 3,358928,249588,109340,2017_boxofficemojo_rankings.csv,2017,0.695370659296572,0.304629340703428
4136,Love in Space,358486,34787,323699,2011_boxofficemojo_rankings.csv,2011,0.09703865701868414,0.9029613429813159
4137,Everly,358156,0,358156,2015_boxofficemojo_rankings.csv,2015,0.0,1.0
4138,Welcome to the Rileys,358014,158898,199116,2010_boxofficemojo_rankings.csv,2010,0.4438318054601217,0.5561681945398783
4139,Bel Canto,357462,125569,231893,2018_boxofficemojo_rankings.csv,2018,0.3512792968203613,0.6487207031796387
4140,National Gallery,354971,253941,101030,2014_boxofficemojo_rankings.csv,2014,0.715385200481166,0.28461479951883395
4141,Hello I Must Be Going,354939,106709,248230,2012_boxofficemojo_rankings.csv,2012,0.3006403917292831,0.699359608270717
4142,The Invitation,354835,231737,123098,2016_boxofficemojo_rankings.csv,2016,0.6530838276945623,0.34691617230543775
4143,Kaashmora,354631,327959,26672,2016_boxofficemojo_rankings.csv,2016,0.9247894290121281,0.0752105709878719
4144,Las Acacias,354391,6000,348391,2011_boxofficemojo_rankings.csv,2011,0.016930452522778514,0.9830695474772215
4145,The Tomorrow Man,354103,354103,0,2019_boxofficemojo_rankings.csv,2019,1.0,0.0
4146,Like Dandelion Dust,352810,352810,0,2010_boxofficemojo_rankings.csv,2010,1.0,0.0
4147,Long Strange Trip - The Untold Story of The Grateful Dead,351957,351957,0,2017_boxofficemojo_rankings.csv,2017,1.0,0.0
4148,The Wizard of Oz 2018 Re-release,351839,351839,0,2018_boxofficemojo_rankings.csv,2018,1.0,0.0
4149,Aferim!,350110,108110,242000,2015_boxofficemojo_rankings.csv,2015,0.3087886664191254,0.6912113335808746
4150,Howards End 2016 Re-release,349993,160282,189711,2016_boxofficemojo_rankings.csv,2016,0.45795773058318306,0.5420422694168169
4151,Tehran Taboo,349886,74758,275128,2017_boxofficemojo_rankings.csv,2017,0.21366387909204712,0.7863361209079529
4152,Satanic,349183,252,348931,2016_boxofficemojo_rankings.csv,2016,0.0007216846180942371,0.9992783153819058
4153,Marie's Story 2014 Re-release,348906,11720,337186,2014_boxofficemojo_rankings.csv,2014,0.03359070924547013,0.9664092907545299
4154,Suicide the Ripple Effect,347468,347468,0,2018_boxofficemojo_rankings.csv,2018,1.0,0.0
4155,The Good Heart,346851,20930,325921,2010_boxofficemojo_rankings.csv,2010,0.06034291381601898,0.939657086183981
4156,The Vault,346729,5728,341001,2017_boxofficemojo_rankings.csv,2017,0.016520106480853922,0.9834798935191461
4157,Summerland,346723,58498,288225,2020_boxofficemojo_rankings.csv,2020,0.16871681428690916,0.8312831857130909
4158,Star Trek: The Motion Picture 2019 Re-release,346243,346243,0,2019_boxofficemojo_rankings.csv,2019,1.0,0.0
4159,She Dies Tomorrow,346079,346079,0,2020_boxofficemojo_rankings.csv,2020,1.0,0.0
4160,Triple Threat,345900,76289,269611,2019_boxofficemojo_rankings.csv,2019,0.2205521827117664,0.7794478172882336
4161,Countdown to Canelo vs. Chavez Jr.,343387,343387,0,2017_boxofficemojo_rankings.csv,2017,1.0,0.0
4162,El Bulli: Cooking in Progress,343116,237181,105935,2011_boxofficemojo_rankings.csv,2011,0.6912560183727952,0.3087439816272048
4163,The Idol,343059,0,343059,2016_boxofficemojo_rankings.csv,2016,0.0,1.0
4164,Koch,342941,342941,0,2013_boxofficemojo_rankings.csv,2013,1.0,0.0
4165,"Life, Animated",342664,255388,87276,2016_boxofficemojo_rankings.csv,2016,0.7453015198561856,0.25469848014381435
4166,Bolshoi Ballet: Swan Lake,342391,88905,253486,2018_boxofficemojo_rankings.csv,2018,0.25965927842729514,0.7403407215727049
4167,Nureyev: Lifting the Curtain,342255,165203,177052,2018_boxofficemojo_rankings.csv,2018,0.482689807307417,0.517310192692583
4168,Knife + Heart,341847,32516,309331,2018_boxofficemojo_rankings.csv,2018,0.09511857643916723,0.9048814235608328
4169,The Lady in the Car with Glasses and a Gun,339461,2167,337294,2015_boxofficemojo_rankings.csv,2015,0.006383649373565741,0.9936163506264343
4170,The Green Prince,339208,258237,80971,2014_boxofficemojo_rankings.csv,2014,0.7612939553312422,0.2387060446687578
4171,Happy People: A Year in the Taiga,338987,338987,0,2013_boxofficemojo_rankings.csv,2013,1.0,0.0
4172,Red Hook Summer,338803,338803,0,2012_boxofficemojo_rankings.csv,2012,1.0,0.0
4173,Is It Wrong to Try to Pick Up Girls in a Dungeon - Arrow of the Orion,338632,271489,67143,2019_boxofficemojo_rankings.csv,2019,0.80172281414633,0.19827718585367007
4174,Silencio,338596,158723,179873,2018_boxofficemojo_rankings.csv,2018,0.46876808940448206,0.531231910595518
4175,Dark Horse,337150,166228,170922,2012_boxofficemojo_rankings.csv,2012,0.4930387068070592,0.5069612931929408
4176,Voyage of Time: The IMAX Experience,337038,55409,281629,2016_boxofficemojo_rankings.csv,2016,0.16439985995644407,0.8356001400435559
4177,First Love,336756,218329,118427,2019_boxofficemojo_rankings.csv,2019,0.6483299480929813,0.3516700519070187
4178,Kings of Pastry,336386,336386,0,2010_boxofficemojo_rankings.csv,2010,1.0,0.0
4179,Diane,336166,336166,0,2019_boxofficemojo_rankings.csv,2019,1.0,0.0
4180,Sailor Moon R: The Movie: The Promise of the Rose/Sailor Moon S: The Movie - Hearts in Ice,335697,335697,0,2018_boxofficemojo_rankings.csv,2018,1.0,0.0
4181,Freaks,335050,276591,58459,2019_boxofficemojo_rankings.csv,2019,0.8255215639456798,0.17447843605432026
4182,Russ Taff: I Still Believe,334983,334983,0,2018_boxofficemojo_rankings.csv,2018,1.0,0.0
4183,Bhavesh Joshi Superhero,334723,57376,277347,2018_boxofficemojo_rankings.csv,2018,0.1714133776286661,0.828586622371334
4184,Anthropocene: The Human Epoch,334162,104806,229356,2019_boxofficemojo_rankings.csv,2019,0.3136382951981374,0.6863617048018625
4185,A Silent Voice: The Movie 2019 Re-release,333984,333984,0,2019_boxofficemojo_rankings.csv,2019,1.0,0.0
4186,Ballet 422,333554,333554,0,2015_boxofficemojo_rankings.csv,2015,1.0,0.0
4187,Shine,333388,333388,0,2018_boxofficemojo_rankings.csv,2018,1.0,0.0
4188,Something from Nothing: The Art of Rap,333388,288000,45388,2012_boxofficemojo_rankings.csv,2012,0.8638583272343335,0.13614167276566644
4189,Linsanity,332990,302645,30345,2013_boxofficemojo_rankings.csv,2013,0.9088711372713896,0.09112886272861047
4190,Don't Hang Up,332571,0,332571,2017_boxofficemojo_rankings.csv,2017,0.0,1.0
4191,Shamitabh,331821,324597,7224,2015_boxofficemojo_rankings.csv,2015,0.9782292259983545,0.021770774001645465
4192,The Big Fight Live: IBF Welterweight Title: Errol Spence Jr. vs. Mikey Garcia,328979,328979,0,2019_boxofficemojo_rankings.csv,2019,1.0,0.0
4193,Ladies vs. Ricky Bahl,328870,0,328870,2011_boxofficemojo_rankings.csv,2011,0.0,1.0
4194,The Last Sentence,328005,62506,265499,2012_boxofficemojo_rankings.csv,2012,0.19056416822914285,0.8094358317708572
4195,Burden,327838,139270,188568,2020_boxofficemojo_rankings.csv,2020,0.4248134749479926,0.5751865250520074
4196,Elaine Stritch: Shoot Me,327452,327452,0,2014_boxofficemojo_rankings.csv,2014,1.0,0.0
4197,You Will Be My Son 2012 Re-release,326061,285151,40910,2012_boxofficemojo_rankings.csv,2012,0.8745326794679523,0.12546732053204768
4198,Formosa Betrayed,326034,225341,100693,2010_boxofficemojo_rankings.csv,2010,0.6911579773888613,0.3088420226111387
4199,Lucy in the Sky,325950,319976,5974,2019_boxofficemojo_rankings.csv,2019,0.9816720355882804,0.018327964411719588
4200,The Central Park Five,325653,325653,0,2012_boxofficemojo_rankings.csv,2012,1.0,0.0
4201,The Opera House,325235,320079,5156,2018_boxofficemojo_rankings.csv,2018,0.9841468476639968,0.015853152336003196
4202,Camp,324977,324977,0,2013_boxofficemojo_rankings.csv,2013,1.0,0.0
4203,Juan of the Dead,324834,18000,306834,2012_boxofficemojo_rankings.csv,2012,0.05541291859842258,0.9445870814015774
4204,Teefa In Trouble,324633,0,324633,2018_boxofficemojo_rankings.csv,2018,0.0,1.0
4205,Red Hill,324424,21087,303337,2010_boxofficemojo_rankings.csv,2010,0.06499827386383251,0.9350017261361675
4206,The Bolshoi Ballet: Live From Moscow - The Nutcracker,323928,323928,0,2018_boxofficemojo_rankings.csv,2018,1.0,0.0
4207,The Cured,323776,26630,297146,2018_boxofficemojo_rankings.csv,2018,0.08224822099229097,0.917751779007709
4208,Three Worlds,323748,3952,319796,2012_boxofficemojo_rankings.csv,2012,0.012207025217144198,0.9877929747828558
4209,Sword of Trust,323369,322421,948,2019_boxofficemojo_rankings.csv,2019,0.9970683646236962,0.002931635376303851
4210,Damsel,323235,305136,18099,2018_boxofficemojo_rankings.csv,2018,0.944006682444661,0.055993317555339
4211,Citizen Jane: Battle for the City,323124,313411,9713,2017_boxofficemojo_rankings.csv,2017,0.9699403325039304,0.03005966749606962
4212,The Day He Arrives,322348,13746,308602,2011_boxofficemojo_rankings.csv,2011,0.042643354387184036,0.957356645612816
4213,Fatima,322016,0,322016,2020_boxofficemojo_rankings.csv,2020,0.0,1.0
4214,Nocturama,321768,30157,291611,2016_boxofficemojo_rankings.csv,2016,0.09372280649411999,0.90627719350588
4215,Double Trouble,321081,44788,276293,2012_boxofficemojo_rankings.csv,2012,0.13949128101631675,0.8605087189836832
4216,Woodstock,320610,126562,194048,2019_boxofficemojo_rankings.csv,2019,0.39475375066279905,0.605246249337201
4217,A Film Unfinished,320486,320486,0,2010_boxofficemojo_rankings.csv,2010,1.0,0.0
4218,The English Teacher,320013,104810,215203,2013_boxofficemojo_rankings.csv,2013,0.3275179445835013,0.6724820554164987
4219,Beats,319595,0,319595,2019_boxofficemojo_rankings.csv,2019,0.0,1.0
4220,Meeting Gorbachev,319230,251837,67393,2019_boxofficemojo_rankings.csv,2019,0.7888888888888889,0.2111111111111111
4221,You Are Here: A Come From Away Story,318885,318885,0,2019_boxofficemojo_rankings.csv,2019,1.0,0.0
4222,The Yellow Handkerchief,318623,318623,0,2010_boxofficemojo_rankings.csv,2010,1.0,0.0
4223,West of Memphis,318317,310154,8163,2012_boxofficemojo_rankings.csv,2012,0.9743557522846722,0.025644247715327802
4224,Ask Dr. Ruth,318230,297195,21035,2019_boxofficemojo_rankings.csv,2019,0.9339000094271439,0.06609999057285611
4225,The Student,318123,1126,316997,2016_boxofficemojo_rankings.csv,2016,0.003539511446830314,0.9964604885531697
4226,Not Today,318121,318121,0,2013_boxofficemojo_rankings.csv,2013,1.0,0.0
4227,Today's Special,317831,317831,0,2010_boxofficemojo_rankings.csv,2010,1.0,0.0
4228,Inch'Allah,317656,9840,307816,2013_boxofficemojo_rankings.csv,2013,0.030976905835243155,0.9690230941647568
4229,Sauvage / Wild,317536,61604,255932,2018_boxofficemojo_rankings.csv,2018,0.19400634888642548,0.8059936511135746
4230,6 Days,316946,0,316946,2017_boxofficemojo_rankings.csv,2017,0.0,1.0
4231,5 Days of War,316944,17479,299465,2011_boxofficemojo_rankings.csv,2011,0.05514854359129689,0.9448514564087032
4232,AmeriGeddon,316554,316554,0,2016_boxofficemojo_rankings.csv,2016,1.0,0.0
4233,Corpo Celeste 2011 Re-release,316504,8919,307585,2011_boxofficemojo_rankings.csv,2011,0.028179738644693274,0.9718202613553067
4234,The Riot and the Dance,316103,316103,0,2018_boxofficemojo_rankings.csv,2018,1.0,0.0
4235,David and Goliath,316100,316100,0,2015_boxofficemojo_rankings.csv,2015,1.0,0.0
4236,Josh Groban Bridges Live from Madison Square Garden,315173,315173,0,2019_boxofficemojo_rankings.csv,2019,1.0,0.0
4237,Obit.,315049,315049,0,2017_boxofficemojo_rankings.csv,2017,1.0,0.0
4238,Time Out of Mind,314082,166775,147307,2015_boxofficemojo_rankings.csv,2015,0.5309919065721691,0.46900809342783095
4239,Christine,313465,298525,14940,2016_boxofficemojo_rankings.csv,2016,0.9523391766225895,0.04766082337741056
4240,War Witch,313387,70544,242843,2012_boxofficemojo_rankings.csv,2012,0.22510187084977998,0.77489812915022
4241,The Bolshoi Ballet: Live From Moscow - Romeo and Juliet,313088,313088,0,2018_boxofficemojo_rankings.csv,2018,1.0,0.0
4242,Berberian Sound Studio,312757,38493,274264,2012_boxofficemojo_rankings.csv,2012,0.1230763819834568,0.8769236180165432
4243,The Hornet's Nest,312706,312706,0,2014_boxofficemojo_rankings.csv,2014,1.0,0.0
4244,David Lynch: The Art Life,311470,171419,140051,2017_boxofficemojo_rankings.csv,2017,0.5503547693196776,0.44964523068032236
4245,Plácido Domingo Gala,311246,52502,258744,2019_boxofficemojo_rankings.csv,2019,0.16868329231540324,0.8313167076845968
4246,Dancing in Jaffa,311001,151098,159903,2014_boxofficemojo_rankings.csv,2014,0.48584409696431846,0.5141559030356816
4247,Being Elmo: A Puppeteer's Journey,310812,304052,6760,2011_boxofficemojo_rankings.csv,2011,0.9782505179980181,0.021749482001981905
4248,I Am Eleven 2014 Re-release,310116,310116,0,2014_boxofficemojo_rankings.csv,2014,1.0,0.0
4249,Bohemian Rhapsody 2020 Re-release,308715,240000,68715,2020_boxofficemojo_rankings.csv,2020,0.7774160633594092,0.22258393664059084
4250,The Amazing Catfish,308349,11342,297007,2014_boxofficemojo_rankings.csv,2014,0.03678299589101959,0.9632170041089804
4251,Merchants of Doubt,308156,308156,0,2015_boxofficemojo_rankings.csv,2015,1.0,0.0
4252,Great Performances at the Met: MET Opera: Magic Flute,307686,307686,0,2018_boxofficemojo_rankings.csv,2018,1.0,0.0
4253,Okko's Inn,306927,134787,172140,2018_boxofficemojo_rankings.csv,2018,0.43915002590192453,0.5608499740980755
4254,Half of a Yellow Sun,306393,54529,251864,2014_boxofficemojo_rankings.csv,2014,0.17797077609475412,0.8220292239052459
4255,The Mercy 2018 Re-release,306205,29538,276667,2018_boxofficemojo_rankings.csv,2018,0.09646478666253,0.90353521333747
4256,Monsters: Dark Continent,306004,0,306004,2015_boxofficemojo_rankings.csv,2015,0.0,1.0
4257,Under the Sun,305993,105036,200957,2016_boxofficemojo_rankings.csv,2016,0.3432627543767341,0.6567372456232659
4258,The Third Wife,305755,84933,220822,2019_boxofficemojo_rankings.csv,2019,0.27778123006982713,0.7222187699301729
4259,The Kingmaker,304840,122587,182253,2019_boxofficemojo_rankings.csv,2019,0.4021355465162052,0.5978644534837948
4260,Showtime Championship Boxing: Deontay Wilder vs. Tyson Fury,304482,304482,0,2018_boxofficemojo_rankings.csv,2018,1.0,0.0
4261,Microbe & Gasoline,303787,63802,239985,2015_boxofficemojo_rankings.csv,2015,0.21002215368004556,0.7899778463199545
4262,N.H 10,303587,303587,0,2015_boxofficemojo_rankings.csv,2015,1.0,0.0
4263,Alamar,303574,61613,241961,2010_boxofficemojo_rankings.csv,2010,0.20295875140822336,0.7970412485917766
4264,The Bolshoi Ballet: Live From Moscow - Giselle,302681,302681,0,2018_boxofficemojo_rankings.csv,2018,1.0,0.0
4265,The Unknown Known,301604,276497,25107,2014_boxofficemojo_rankings.csv,2014,0.9167550828238352,0.08324491717616478
4266,Cliffs of Freedom,300842,72476,228366,2019_boxofficemojo_rankings.csv,2019,0.2409105111653293,0.7590894888346706
4267,Sunset Blvd. 2018 Re-release,299645,299645,0,2018_boxofficemojo_rankings.csv,2018,1.0,0.0
4268,Jinn,297381,202348,95033,2014_boxofficemojo_rankings.csv,2014,0.6804335179449931,0.3195664820550069
4269,Kaptaan,296715,203790,92925,2016_boxofficemojo_rankings.csv,2016,0.6868206865173652,0.31317931348263484
4270,The We and the I,295930,42172,253758,2012_boxofficemojo_rankings.csv,2012,0.1425066738755787,0.8574933261244213
4271,Harry Potter and the Sorcerer's Stone 2018 Re-release,295917,295917,0,2018_boxofficemojo_rankings.csv,2018,1.0,0.0
4272,Chic!,295295,5587,289708,2015_boxofficemojo_rankings.csv,2015,0.018920062987859598,0.9810799370121404
4273,Gremlins 2020 Re-release,295159,295000,159,2020_boxofficemojo_rankings.csv,2020,0.99946130729539,0.0005386927046100576
4274,The Tenth Man,295129,63564,231565,2016_boxofficemojo_rankings.csv,2016,0.21537700463187284,0.7846229953681272
4275,Aftershock,294696,58510,236186,2013_boxofficemojo_rankings.csv,2013,0.19854358389662569,0.8014564161033744
4276,Shakira in Concert: El Dorado World Tour,294677,271586,23091,2019_boxofficemojo_rankings.csv,2019,0.9216396257597301,0.07836037424026986
4277,Khodorkovsky,294599,39522,255077,2011_boxofficemojo_rankings.csv,2011,0.1341552415317092,0.8658447584682908
4278,Special Treatment,294483,8856,285627,2010_boxofficemojo_rankings.csv,2010,0.0300730432656554,0.9699269567343446
4279,44 Inch Chest 2010 Re-release,294245,39033,255212,2010_boxofficemojo_rankings.csv,2010,0.1326547604887084,0.8673452395112916
4280,The Giant Spider Invasion,293053,293053,0,2019_boxofficemojo_rankings.csv,2019,1.0,0.0
4281,Pianomania,292870,49852,243018,2010_boxofficemojo_rankings.csv,2010,0.17021886843992215,0.8297811315600778
4282,Stonewall,292669,187674,104995,2015_boxofficemojo_rankings.csv,2015,0.6412500128131097,0.35874998718689033
4283,Mesrine Part 2: Public Enemy #1 2010 Re-release,292150,275387,16763,2010_boxofficemojo_rankings.csv,2010,0.9426219407838439,0.05737805921615608
4284,The Last Five Years,292092,145427,146665,2015_boxofficemojo_rankings.csv,2015,0.4978808046779782,0.5021191953220219
4285,Dreams of a Life,291898,8405,283493,2011_boxofficemojo_rankings.csv,2011,0.02879430485991682,0.9712056951400831
4286,The Godfather: Part II 45th Anniversary,291754,291754,0,2019_boxofficemojo_rankings.csv,2019,1.0,0.0
4287,The Man in 3B,291513,291513,0,2015_boxofficemojo_rankings.csv,2015,1.0,0.0
4288,Waste Land,291307,187716,103591,2010_boxofficemojo_rankings.csv,2010,0.644392342099572,0.3556076579004281
4289,Big Bad Wolves,291239,33232,258007,2014_boxofficemojo_rankings.csv,2014,0.11410559712126467,0.8858944028787353
4290,More Than Funny,290498,290498,0,2018_boxofficemojo_rankings.csv,2018,1.0,0.0
4291,Illégal,290108,651,289457,2010_boxofficemojo_rankings.csv,2010,0.0022439918926744525,0.9977560081073256
4292,Jimmy Vestvood: Amerikan Hero,290080,230069,60011,2016_boxofficemojo_rankings.csv,2016,0.7931225868725869,0.20687741312741312
4293,Best F(r)iends: Volume 1,290064,252410,37654,2018_boxofficemojo_rankings.csv,2018,0.8701872690164929,0.1298127309835071
4294,The Zoya Factor,289631,128831,160800,2019_boxofficemojo_rankings.csv,2019,0.4448108109974416,0.5551891890025584
4295,Best Night Ever,289511,0,289511,2014_boxofficemojo_rankings.csv,2014,0.0,1.0
4296,The Silence of Others,289455,67986,221469,2018_boxofficemojo_rankings.csv,2018,0.2348758874436441,0.7651241125563559
4297,Welcome to New York,288837,0,288837,2014_boxofficemojo_rankings.csv,2014,0.0,1.0
4298,Antarctica: A Year on Ice,288757,288757,0,2014_boxofficemojo_rankings.csv,2014,1.0,0.0
4299,Above and Beyond,288751,288751,0,2015_boxofficemojo_rankings.csv,2015,1.0,0.0
4300,The Last of Robin Hood,288545,288545,0,2014_boxofficemojo_rankings.csv,2014,1.0,0.0
4301,Saga of Tanya the Evil - The Movie,288460,288460,0,2019_boxofficemojo_rankings.csv,2019,1.0,0.0
4302,Last Train Home,288328,288328,0,2010_boxofficemojo_rankings.csv,2010,1.0,0.0
4303,Countdown to Zero,287711,272040,15671,2010_boxofficemojo_rankings.csv,2010,0.9455321485796511,0.05446785142034889
4304,Generation Wealth,287709,237709,50000,2018_boxofficemojo_rankings.csv,2018,0.8262132919025821,0.17378670809741786
4305,Skate Kitchen,287307,236799,50508,2018_boxofficemojo_rankings.csv,2018,0.824201986028882,0.175798013971118
4306,Post Mortem,286702,9750,276952,2010_boxofficemojo_rankings.csv,2010,0.03400743629273601,0.9659925637072639
4307,The Interrupters,286457,282448,4009,2011_boxofficemojo_rankings.csv,2011,0.9860048803136248,0.013995119686375268
4308,But Deliver Us from Evil,285169,285169,0,2018_boxofficemojo_rankings.csv,2018,1.0,0.0
4309,The Silence 2012 Re-release,284471,100214,184257,2012_boxofficemojo_rankings.csv,2012,0.35228195492686426,0.6477180450731358
4310,Khalid: Free Spirit,284229,284229,0,2019_boxofficemojo_rankings.csv,2019,1.0,0.0
4311,South of the Border,284214,198600,85614,2010_boxofficemojo_rankings.csv,2010,0.6987692372648778,0.3012307627351221
4312,The Anonymous People,284147,284147,0,2013_boxofficemojo_rankings.csv,2013,1.0,0.0
4313,The Kindergarten Teacher,284065,36190,247875,2014_boxofficemojo_rankings.csv,2014,0.12740041891820533,0.8725995810817947
4314,Disney's Newsies: The Broadway Musical! 2018 Re-release,282429,282429,0,2018_boxofficemojo_rankings.csv,2018,1.0,0.0
4315,Resistance,282228,7464,274764,2020_boxofficemojo_rankings.csv,2020,0.026446702665929675,0.9735532973340704
4316,Created Equal: Clarence Thomas in His Own Words,282149,282149,0,2020_boxofficemojo_rankings.csv,2020,1.0,0.0
4317,Tumbledown,282083,135026,147057,2016_boxofficemojo_rankings.csv,2016,0.47867471630690256,0.5213252836930974
4318,Ho Mann Jahaan,281926,208611,73315,2016_boxofficemojo_rankings.csv,2016,0.7399494902917787,0.2600505097082213
4319,Mike Wallace Is Here,281245,281245,0,2019_boxofficemojo_rankings.csv,2019,1.0,0.0
4320,"If I Want to Whistle, I Whistle",280892,12135,268757,2010_boxofficemojo_rankings.csv,2010,0.04320165757657748,0.9567983424234225
4321,Octaman,280710,280710,0,2019_boxofficemojo_rankings.csv,2019,1.0,0.0
4322,I Do... Until I Don't,280668,280668,0,2017_boxofficemojo_rankings.csv,2017,1.0,0.0
4323,The Black Power Mixtape 1967-1975,280025,273749,6276,2011_boxofficemojo_rankings.csv,2011,0.9775877153825552,0.02241228461744487
4324,Wonders of the Sea,279415,100780,178635,2018_boxofficemojo_rankings.csv,2018,0.360682139469964,0.6393178605300359
4325,Havenhurst,279372,0,279372,2016_boxofficemojo_rankings.csv,2016,0.0,1.0
4326,"Lovely, Still",279170,127564,151606,2010_boxofficemojo_rankings.csv,2010,0.4569402156392163,0.5430597843607837
4327,"Lou Andreas-Salomé, The Audacity to be Free",278982,12875,266107,2017_boxofficemojo_rankings.csv,2017,0.04614993081990953,0.9538500691800905
4328,10 Years,278336,203373,74963,2012_boxofficemojo_rankings.csv,2012,0.730674436652104,0.2693255633478961
4329,The Nest,277800,135163,142637,2020_boxofficemojo_rankings.csv,2020,0.4865478761699064,0.5134521238300936
4330,Bolshoi Ballet: The Golden Age,277666,171916,105750,2019_boxofficemojo_rankings.csv,2019,0.6191467446500472,0.38085325534995285
4331,The Summit,277651,243550,34101,2013_boxofficemojo_rankings.csv,2013,0.8771803451095079,0.12281965489049201
4332,Science Fair,277338,276195,1143,2018_boxofficemojo_rankings.csv,2018,0.9958786751184475,0.004121324881552474
4333,See You Soon,277126,0,277126,2019_boxofficemojo_rankings.csv,2019,0.0,1.0
4334,True Grit 2019 Re-release,276418,276418,0,2019_boxofficemojo_rankings.csv,2019,1.0,0.0
4335,Life After Beth,274717,88273,186444,2014_boxofficemojo_rankings.csv,2014,0.3213233982607556,0.6786766017392444
4336,Lovely Molly,274480,18464,256016,2012_boxofficemojo_rankings.csv,2012,0.06726901777907315,0.9327309822209269
4337,Swallow,274259,33419,240840,2020_boxofficemojo_rankings.csv,2020,0.1218519720410269,0.8781480279589731
4338,The King,273601,259291,14310,2018_boxofficemojo_rankings.csv,2018,0.9476975595849431,0.05230244041505696
4339,Slayer: The Repentless Killogy,272874,268727,4147,2019_boxofficemojo_rankings.csv,2019,0.9848025095831776,0.015197490416822416
4340,Chavela,272842,148666,124176,2017_boxofficemojo_rankings.csv,2017,0.5448794540429992,0.45512054595700074
4341,Black Death,272445,22554,249891,2010_boxofficemojo_rankings.csv,2010,0.0827836811099488,0.9172163188900512
4342,One Child Nation,271841,270128,1713,2019_boxofficemojo_rankings.csv,2019,0.993698522297961,0.0063014777020390595
4343,Come Out and Play,271735,2638,269097,2013_boxofficemojo_rankings.csv,2013,0.009707987561410933,0.9902920124385891
4344,The Tale of The Princess Kaguya 2019 Re-release,271681,271681,0,2019_boxofficemojo_rankings.csv,2019,1.0,0.0
4345,Aloft,270971,53086,217885,2015_boxofficemojo_rankings.csv,2015,0.19591026345992746,0.8040897365400725
4346,The Canyons,270185,56825,213360,2013_boxofficemojo_rankings.csv,2013,0.21031885559894148,0.7896811444010585
4347,Exposed,269915,0,269915,2016_boxofficemojo_rankings.csv,2016,0.0,1.0
4348,Stalker,269881,269881,0,2017_boxofficemojo_rankings.csv,2017,1.0,0.0
4349,Shirin Farhad Ki Toh Nikal Padi,269845,155758,114087,2012_boxofficemojo_rankings.csv,2012,0.5772128444106802,0.4227871555893198
4350,Save Yourselves!,269467,269467,0,2020_boxofficemojo_rankings.csv,2020,1.0,0.0
4351,The Loneliest Planet,268933,129579,139354,2012_boxofficemojo_rankings.csv,2012,0.4818263284907393,0.5181736715092606
4352,The World Before Your Feet,268644,268644,0,2018_boxofficemojo_rankings.csv,2018,1.0,0.0
4353,Meri Pyaari Bindu,268067,0,268067,2017_boxofficemojo_rankings.csv,2017,0.0,1.0
4354,The Carer,267995,6208,261787,2016_boxofficemojo_rankings.csv,2016,0.023164611280061195,0.9768353887199388
4355,Conan O'Brien Can't Stop,267965,267965,0,2011_boxofficemojo_rankings.csv,2011,1.0,0.0
4356,An American in Paris 2020 Re-release,267824,267824,0,2020_boxofficemojo_rankings.csv,2020,1.0,0.0
4357,Falcon Rising,267476,11774,255702,2014_boxofficemojo_rankings.csv,2014,0.04401890263051638,0.9559810973694837
4358,Munger Road,266689,266689,0,2011_boxofficemojo_rankings.csv,2011,1.0,0.0
4359,Never Rarely Sometimes Always,265808,16565,249243,2020_boxofficemojo_rankings.csv,2020,0.062319418527659064,0.9376805814723409
4360,Luzia: Cirque du Soleil in Cinema,265673,265673,0,2019_boxofficemojo_rankings.csv,2019,1.0,0.0
4361,Félicité,265495,12433,253062,2017_boxofficemojo_rankings.csv,2017,0.04682950714702725,0.9531704928529727
4362,Out of Liberty,265279,265279,0,2019_boxofficemojo_rankings.csv,2019,1.0,0.0
4363,Asbury Park: Riot Redemption Rock 'n Roll,264983,167684,97299,2019_boxofficemojo_rankings.csv,2019,0.6328104067053358,0.36718959329466416
4364,Doctor Who,264629,264629,0,2018_boxofficemojo_rankings.csv,2018,1.0,0.0
4365,Phil Ochs: There But for Fortune,263723,263723,0,2011_boxofficemojo_rankings.csv,2011,1.0,0.0
4366,The Producers 2018 Re-release,263277,216807,46470,2018_boxofficemojo_rankings.csv,2018,0.8234938866668946,0.17650611333310542
4367,Grand départ,262412,677,261735,2013_boxofficemojo_rankings.csv,2013,0.0025799125040013413,0.9974200874959986
4368,Augustine,262390,107352,155038,2013_boxofficemojo_rankings.csv,2013,0.40913144555813863,0.5908685544418614
4369,The Final Year,262286,191900,70386,2018_boxofficemojo_rankings.csv,2018,0.73164408317638,0.26835591682362003
4370,Minimalism: A Documentary About the Important Things,261865,261865,0,2016_boxofficemojo_rankings.csv,2016,1.0,0.0
4371,Any Day Now,261747,201395,60352,2012_boxofficemojo_rankings.csv,2012,0.7694262016374591,0.23057379836254094
4372,Half Girlfriend,261597,0,261597,2017_boxofficemojo_rankings.csv,2017,0.0,1.0
4373,Eating You Alive,260534,260534,0,2018_boxofficemojo_rankings.csv,2018,1.0,0.0
4374,Her Smell,260481,255599,4882,2019_boxofficemojo_rankings.csv,2019,0.9812577500854189,0.0187422499145811
4375,Star Raiders: The Adventures of Saber Raine,260234,260234,0,2019_boxofficemojo_rankings.csv,2019,1.0,0.0
4376,The Cave,258921,62625,196296,2019_boxofficemojo_rankings.csv,2019,0.24186914155282885,0.7581308584471711
4377,The Unspoken,258760,0,258760,2016_boxofficemojo_rankings.csv,2016,0.0,1.0
4378,Across the Universe 2018 Re-release,258618,258618,0,2018_boxofficemojo_rankings.csv,2018,1.0,0.0
4379,Big 2018 Re-release,258507,258507,0,2018_boxofficemojo_rankings.csv,2018,1.0,0.0
4380,The Music Never Stopped,258223,258223,0,2011_boxofficemojo_rankings.csv,2011,1.0,0.0
4381,Mysteries of Lisbon,257065,110507,146558,2010_boxofficemojo_rankings.csv,2010,0.42987960243518175,0.5701203975648182
4382,Spiders,257019,0,257019,2013_boxofficemojo_rankings.csv,2013,0.0,1.0
4383,Raja Natwarlal,256978,131105,125873,2014_boxofficemojo_rankings.csv,2014,0.5101798597545315,0.4898201402454685
4384,Helicopter Eela,256952,71971,184981,2018_boxofficemojo_rankings.csv,2018,0.2800951150409415,0.7199048849590585
4385,Alive Inside: A Story of Music and Memory,256682,256682,0,2014_boxofficemojo_rankings.csv,2014,1.0,0.0
4386,Jean-Michel Basquiat: The Radiant Child,256242,256242,0,2010_boxofficemojo_rankings.csv,2010,1.0,0.0
4387,Officer Down,255080,1463,253617,2013_boxofficemojo_rankings.csv,2013,0.005735455543358946,0.994264544456641
4388,Dean,254536,254536,0,2017_boxofficemojo_rankings.csv,2017,1.0,0.0
4389,The Robber,254489,83451,171038,2010_boxofficemojo_rankings.csv,2010,0.3279159413569938,0.6720840586430061
4390,Fall in Love Like a Star 2015 Re-release,253785,212508,41277,2015_boxofficemojo_rankings.csv,2015,0.8373544535729062,0.1626455464270938
4391,Mistaken for Strangers,253285,138991,114294,2014_boxofficemojo_rankings.csv,2014,0.5487533805791894,0.45124661942081057
4392,The Call,253272,253272,0,2020_boxofficemojo_rankings.csv,2020,1.0,0.0
4393,Battlefield America,252805,172000,80805,2012_boxofficemojo_rankings.csv,2012,0.6803662902236902,0.3196337097763098
4394,When Harry Met Sally... 30th Anniversary,252320,252320,0,2019_boxofficemojo_rankings.csv,2019,1.0,0.0
4395,I Got the Hook Up 2,252293,252293,0,2019_boxofficemojo_rankings.csv,2019,1.0,0.0
4396,The Human Centipede (First Sequence),252207,181467,70740,2010_boxofficemojo_rankings.csv,2010,0.7195161117653356,0.28048388823466436
4397,Caterpillar,251922,4157,247765,2010_boxofficemojo_rankings.csv,2010,0.01650113924151126,0.9834988607584887
4398,Canal Street,251917,251917,0,2019_boxofficemojo_rankings.csv,2019,1.0,0.0
4399,Gook,251541,250130,1411,2017_boxofficemojo_rankings.csv,2017,0.994390576486537,0.005609423513463014
4400,The Twilight Zone: A 60th Anniversary Celebration,248514,248514,0,2019_boxofficemojo_rankings.csv,2019,1.0,0.0
4401,Band Aid,248370,248370,0,2017_boxofficemojo_rankings.csv,2017,1.0,0.0
4402,The Attacks of 26/11,248346,248346,0,2013_boxofficemojo_rankings.csv,2013,1.0,0.0
4403,Wild Oats,247949,40598,207351,2016_boxofficemojo_rankings.csv,2016,0.16373528427216888,0.8362647157278311
4404,Doctor Who: The End of Time: Part One,247798,247798,0,2019_boxofficemojo_rankings.csv,2019,1.0,0.0
4405,Lilting,247377,27054,220323,2014_boxofficemojo_rankings.csv,2014,0.10936344122533623,0.8906365587746637
4406,The Galapagos Affair: Satan Came to Eden,247159,247159,0,2014_boxofficemojo_rankings.csv,2014,1.0,0.0
4407,My Dog Tulip,246574,246574,0,2010_boxofficemojo_rankings.csv,2010,1.0,0.0
4408,The Notebook 2013 Re-release,246557,66559,179998,2013_boxofficemojo_rankings.csv,2013,0.2699538037857372,0.7300461962142628
4409,The Love Witch,246218,228894,17324,2016_boxofficemojo_rankings.csv,2016,0.9296395876824602,0.07036041231753974
4410,Friendsgiving Day #1,246168,246168,0,2019_boxofficemojo_rankings.csv,2019,1.0,0.0
4411,Hot Summer Nights,246133,0,246133,2018_boxofficemojo_rankings.csv,2018,0.0,1.0
4412,Play the Flute,245943,245943,0,2019_boxofficemojo_rankings.csv,2019,1.0,0.0
4413,"Tuesday, After Christmas",245833,27813,218020,2010_boxofficemojo_rankings.csv,2010,0.1131377805258041,0.8868622194741959
4414,Harry Potter and the Chamber of Secrets 2018 Re-release,245501,245501,0,2018_boxofficemojo_rankings.csv,2018,1.0,0.0
4415,American Woman,245416,236637,8779,2019_boxofficemojo_rankings.csv,2019,0.9642280861883495,0.03577191381165042
4416,The Fireflies Are Gone,245006,245006,0,2018_boxofficemojo_rankings.csv,2018,1.0,0.0
4417,The Waiting Room,244951,244951,0,2012_boxofficemojo_rankings.csv,2012,1.0,0.0
4418,Term Life,243793,21256,222537,2016_boxofficemojo_rankings.csv,2016,0.08718872157937266,0.9128112784206274
4419,My Uncle Rafael,243616,243616,0,2012_boxofficemojo_rankings.csv,2012,1.0,0.0
4420,Rangeelay,243246,148418,94828,2013_boxofficemojo_rankings.csv,2013,0.6101559737878526,0.38984402621214737
4421,Out of Blue,242847,18779,224068,2019_boxofficemojo_rankings.csv,2019,0.07732852372069657,0.9226714762793035
4422,My Perestroika,242707,242707,0,2011_boxofficemojo_rankings.csv,2011,1.0,0.0
4423,Tevar,242453,236002,6451,2015_boxofficemojo_rankings.csv,2015,0.9733927812813205,0.026607218718679496
4424,Archive,242195,139593,102602,2020_boxofficemojo_rankings.csv,2020,0.576366151241768,0.423633848758232
4425,Ophelia,242115,50722,191393,2019_boxofficemojo_rankings.csv,2019,0.2094954876814737,0.7905045123185264
4426,Brotherhood,240887,8979,231908,2010_boxofficemojo_rankings.csv,2010,0.03727473877793322,0.9627252612220668
4427,Road to Ninja - Naruto the Movie 2014 Re-release,240687,43171,197516,2014_boxofficemojo_rankings.csv,2014,0.17936573225807792,0.820634267741922
4428,Boulevard,240450,126150,114300,2015_boxofficemojo_rankings.csv,2015,0.5246412975670618,0.47535870243293826
4429,Carter High,240214,240214,0,2015_boxofficemojo_rankings.csv,2015,1.0,0.0
4430,Of Horses and Men,239969,11894,228075,2013_boxofficemojo_rankings.csv,2013,0.04956473544499498,0.950435264555005
4431,Dark River,239182,7714,231468,2018_boxofficemojo_rankings.csv,2018,0.03225159083877549,0.9677484091612245
4432,311 Enlarged to Show Detail 3,238791,238791,0,2019_boxofficemojo_rankings.csv,2019,1.0,0.0
4433,Crown Heights,238558,238558,0,2017_boxofficemojo_rankings.csv,2017,1.0,0.0
4434,RWBY: Argus Limited,238379,238379,0,2018_boxofficemojo_rankings.csv,2018,1.0,0.0
4435,Red Obsession,238223,13199,225024,2013_boxofficemojo_rankings.csv,2013,0.05540606910331916,0.9445939308966809
4436,American Satan,237708,237708,0,2017_boxofficemojo_rankings.csv,2017,1.0,0.0
4437,Tokyo Godfathers 2020 Re-release,237571,237571,0,2020_boxofficemojo_rankings.csv,2020,1.0,0.0
4438,Alien Intrusion: Unmasking a Deception,237411,237411,0,2018_boxofficemojo_rankings.csv,2018,1.0,0.0
4439,Shuddh Desi Romance,237249,0,237249,2013_boxofficemojo_rankings.csv,2013,0.0,1.0
4440,Middle of Nowhere,236806,236806,0,2012_boxofficemojo_rankings.csv,2012,1.0,0.0
4441,India's Most Wanted,235351,176858,58493,2019_boxofficemojo_rankings.csv,2019,0.7514648333765312,0.24853516662346878
4442,Varda by Agnès,235262,160765,74497,2019_boxofficemojo_rankings.csv,2019,0.683344526527871,0.31665547347212897
4443,The Exorcist Extended Director's Cut,235134,235134,0,2010_boxofficemojo_rankings.csv,2010,1.0,0.0
4444,Diamantino,235041,70088,164953,2018_boxofficemojo_rankings.csv,2018,0.29819478303785296,0.701805216962147
4445,Art and Craft,235037,235037,0,2014_boxofficemojo_rankings.csv,2014,1.0,0.0
4446,Blind Eyes Opened,234505,234505,0,2020_boxofficemojo_rankings.csv,2020,1.0,0.0
4447,After the Ball,234417,161820,72597,2015_boxofficemojo_rankings.csv,2015,0.6903082967532218,0.3096917032467782
4448,Little Shop of Horrors 2017 Re-release,233865,233865,0,2017_boxofficemojo_rankings.csv,2017,1.0,0.0
4449,Superman 2018 Re-release,233585,233585,0,2018_boxofficemojo_rankings.csv,2018,1.0,0.0
4450,The Trip to Greece,233014,8340,224674,2020_boxofficemojo_rankings.csv,2020,0.03579184083359798,0.964208159166402
4451,Premier Boxing Champions: PBC on FOX: Spence vs. Porter,232973,232973,0,2019_boxofficemojo_rankings.csv,2019,1.0,0.0
4452,Lost and Found in Armenia,232857,122305,110552,2012_boxofficemojo_rankings.csv,2012,0.5252365185500114,0.47476348144998864
4453,Bishôjo senshi Sailor Moon Super S Special,231434,231434,0,2018_boxofficemojo_rankings.csv,2018,1.0,0.0
4454,A Place at the Table,231378,231378,0,2013_boxofficemojo_rankings.csv,2013,1.0,0.0
4455,DAZN Boxing: Canelo Alvarez vs. Daniel Jacobs,230703,230703,0,2019_boxofficemojo_rankings.csv,2019,1.0,0.0
4456,"Life, Above All",230529,134461,96068,2011_boxofficemojo_rankings.csv,2011,0.5832715189845963,0.4167284810154037
4457,Chakravyuh,230136,151778,78358,2012_boxofficemojo_rankings.csv,2012,0.6595143741092224,0.34048562589077763
4458,"Belle and Sebastian, Friends for Life 2018 Re-release",229983,105890,124093,2018_boxofficemojo_rankings.csv,2018,0.4604253357856885,0.5395746642143114
4459,Wrecked,229532,8020,221512,2011_boxofficemojo_rankings.csv,2011,0.03494066186849764,0.9650593381315024
4460,Luv Shuv Tey Chicken Khurana,229136,143507,85629,2012_boxofficemojo_rankings.csv,2012,0.6262961734515746,0.3737038265484254
4461,The Last Tree,228676,10128,218548,2019_boxofficemojo_rankings.csv,2019,0.04428973744511886,0.9557102625548811
4462,Doctor Who Live Q&A And Screening,228615,228615,0,2020_boxofficemojo_rankings.csv,2020,1.0,0.0
4463,City of Ghosts,228225,128015,100210,2017_boxofficemojo_rankings.csv,2017,0.560915762953226,0.439084237046774
4464,Jeremiah Tower: The Last Magnificent,228153,228153,0,2017_boxofficemojo_rankings.csv,2017,1.0,0.0
4465,InAPPropriate Comedy,228004,228004,0,2013_boxofficemojo_rankings.csv,2013,1.0,0.0
4466,Like Water,227332,0,227332,2012_boxofficemojo_rankings.csv,2012,0.0,1.0
4467,Studio 54,227062,199767,27295,2018_boxofficemojo_rankings.csv,2018,0.879790541790348,0.120209458209652
4468,Mine 9,226421,226421,0,2019_boxofficemojo_rankings.csv,2019,1.0,0.0
4469,Rumble: The Indians Who Rocked The World,226006,226006,0,2017_boxofficemojo_rankings.csv,2017,1.0,0.0
4470,Dr. Cabbie,225490,225490,0,2014_boxofficemojo_rankings.csv,2014,1.0,0.0
4471,Millennium Actress 2019 Re-release,225250,225250,0,2019_boxofficemojo_rankings.csv,2019,1.0,0.0
4472,The Black Waters of Echo's Pond,224409,224409,0,2010_boxofficemojo_rankings.csv,2010,1.0,0.0
4473,Experimenter,224145,155575,68570,2015_boxofficemojo_rankings.csv,2015,0.6940819558767762,0.3059180441232238
4474,Tampopo,224097,224097,0,2016_boxofficemojo_rankings.csv,2016,1.0,0.0
4475,Extra Ordinary,223898,164346,59552,2019_boxofficemojo_rankings.csv,2019,0.7340217420432519,0.2659782579567482
4476,Premier Boxing Champions: PBC on FOX PPV: Pacquiao vs. Thurman,223858,223858,0,2019_boxofficemojo_rankings.csv,2019,1.0,0.0
4477,Crystal Fairy & the Magical Cactus,223821,202370,21451,2013_boxofficemojo_rankings.csv,2013,0.9041600207308519,0.09583997926914811
4478,BuyBust,223720,178471,45249,2018_boxofficemojo_rankings.csv,2018,0.7977427141069193,0.20225728589308065
4479,Tim and Eric's Billion Dollar Movie,223580,201436,22144,2012_boxofficemojo_rankings.csv,2012,0.9009571518024868,0.09904284819751319
4480,Take Every Wave: The Life of Laird Hamilton,223301,176076,47225,2017_boxofficemojo_rankings.csv,2017,0.7885141580198924,0.21148584198010756
4481,Never Surrender: A Galaxy Quest Documentary,222971,222971,0,2019_boxofficemojo_rankings.csv,2019,1.0,0.0
4482,Spirit of the Game,222565,222565,0,2016_boxofficemojo_rankings.csv,2016,1.0,0.0
4483,10.000 Km,222530,12423,210107,2014_boxofficemojo_rankings.csv,2014,0.055826180739675546,0.9441738192603244
4484,High School,221590,139034,82556,2012_boxofficemojo_rankings.csv,2012,0.627438061284354,0.372561938715646
4485,Neil Young Journeys,221082,215026,6056,2012_boxofficemojo_rankings.csv,2012,0.9726074488198949,0.02739255118010512
4486,Phantom Boy,221016,34362,186654,2015_boxofficemojo_rankings.csv,2015,0.15547290693886415,0.8445270930611358
4487,Little Pink House,220948,220948,0,2018_boxofficemojo_rankings.csv,2018,1.0,0.0
4488,Chance Pe Dance,220619,168643,51976,2010_boxofficemojo_rankings.csv,2010,0.7644083238524334,0.23559167614756663
4489,Supermensch: The Legend of Shep Gordon,220065,213064,7001,2014_boxofficemojo_rankings.csv,2014,0.9681866721196011,0.03181332788039897
4490,Great Performances at the Met: Puccini: Turandot,219619,172627,46992,2016_boxofficemojo_rankings.csv,2016,0.7860294418971037,0.2139705581028964
4491,Brooklyn Castle,219407,219407,0,2012_boxofficemojo_rankings.csv,2012,1.0,0.0
4492,Fragments of Truth,219342,219342,0,2018_boxofficemojo_rankings.csv,2018,1.0,0.0
4493,Club Life,219229,4444,214785,2015_boxofficemojo_rankings.csv,2015,0.020271040783837905,0.9797289592161621
4494,The House I Live In,219159,210752,8407,2012_boxofficemojo_rankings.csv,2012,0.9616397227583626,0.03836027724163735
4495,The Secrets We Keep,219001,207928,11073,2020_boxofficemojo_rankings.csv,2020,0.9494385870384153,0.05056141296158465
4496,Harry Potter and the Prisoner of Azkaban 2018 Re-release,218774,218774,0,2018_boxofficemojo_rankings.csv,2018,1.0,0.0
4497,California Typewriter,218563,218563,0,2017_boxofficemojo_rankings.csv,2017,1.0,0.0
4498,Dark Money,217932,217932,0,2018_boxofficemojo_rankings.csv,2018,1.0,0.0
4499,Getting Grace,217812,217812,0,2018_boxofficemojo_rankings.csv,2018,1.0,0.0
4500,Jane's Journey,217615,27253,190362,2010_boxofficemojo_rankings.csv,2010,0.12523493325368196,0.874765066746318
4501,Complete Unknown,217473,191761,25712,2016_boxofficemojo_rankings.csv,2016,0.881769231122944,0.118230768877056
4502,The Karate Kid 2019 Re-release,215447,215447,0,2019_boxofficemojo_rankings.csv,2019,1.0,0.0
4503,The Treasure of the Sierra Madre,215295,215295,0,2018_boxofficemojo_rankings.csv,2018,1.0,0.0
4504,The Tribe,215034,150564,64470,2015_boxofficemojo_rankings.csv,2015,0.7001869471804458,0.2998130528195541
4505,Risk,214669,200219,14450,2017_boxofficemojo_rankings.csv,2017,0.9326870670660412,0.06731293293395879
4506,Hamlet 2019 Re-release,214578,214578,0,2019_boxofficemojo_rankings.csv,2019,1.0,0.0
4507,The Pervert's Guide to Ideology,214313,67966,146347,2013_boxofficemojo_rankings.csv,2013,0.31713428490105594,0.6828657150989441
4508,Ingrid Bergman: In Her Own Words,214014,138148,75866,2015_boxofficemojo_rankings.csv,2015,0.6455091722971394,0.35449082770286056
4509,Marjorie Prime,213858,180608,33250,2017_boxofficemojo_rankings.csv,2017,0.844523001243816,0.155476998756184
4510,Thaandavam,213476,213476,0,2012_boxofficemojo_rankings.csv,2012,1.0,0.0
4511,The Wound,213043,30678,182365,2017_boxofficemojo_rankings.csv,2017,0.14399909877348704,0.856000901226513
4512,The Afflicted,212940,212940,0,2011_boxofficemojo_rankings.csv,2011,1.0,0.0
4513,Chocolate City,212662,212662,0,2015_boxofficemojo_rankings.csv,2015,1.0,0.0
4514,Young & Wild,212624,5514,207110,2012_boxofficemojo_rankings.csv,2012,0.025933102566032058,0.9740668974339679
4515,Big Sonia,212471,212471,0,2017_boxofficemojo_rankings.csv,2017,1.0,0.0
4516,Fatima,212228,50105,162123,2016_boxofficemojo_rankings.csv,2016,0.23609043104585634,0.7639095689541436
4517,Donnie Darko 2016 Re-release,212034,207971,4063,2016_boxofficemojo_rankings.csv,2016,0.9808379788147183,0.019162021185281607
4518,Tesla,211083,92344,118739,2020_boxofficemojo_rankings.csv,2020,0.4374772009114898,0.5625227990885102
4519,Somewhere Between,210975,210975,0,2012_boxofficemojo_rankings.csv,2012,1.0,0.0
4520,La soga,210625,210625,0,2010_boxofficemojo_rankings.csv,2010,1.0,0.0
4521,A Glimpse Inside the Mind of Charles Swan III,210565,45350,165215,2013_boxofficemojo_rankings.csv,2013,0.2153729252249899,0.7846270747750101
4522,Tigers Are Not Afraid 2019 Re-release,210138,175559,34579,2019_boxofficemojo_rankings.csv,2019,0.8354462305722906,0.1645537694277094
4523,Beware of Mr. Baker,210123,116476,93647,2012_boxofficemojo_rankings.csv,2012,0.5543229441803135,0.4456770558196866
4524,"Faith, Hope & Love",210091,210091,0,2019_boxofficemojo_rankings.csv,2019,1.0,0.0
4525,House,209765,209765,0,2010_boxofficemojo_rankings.csv,2010,1.0,0.0
4526,The Death of Louis XIV,209715,43635,166080,2016_boxofficemojo_rankings.csv,2016,0.2080680924111294,0.7919319075888707
4527,Rob the Mob,209613,208693,920,2014_boxofficemojo_rankings.csv,2014,0.99561095924394,0.004389040756059977
4528,SEED: The Untold Story,209580,207825,1755,2016_boxofficemojo_rankings.csv,2016,0.9916261093615804,0.008373890638419696
4529,Kathy Griffin: A Hell of a Story,208907,208907,0,2019_boxofficemojo_rankings.csv,2019,1.0,0.0
4530,Casablanca 2013 Re-release,208608,208608,0,2013_boxofficemojo_rankings.csv,2013,1.0,0.0
4531,Agent Mr. Chan,208351,208351,0,2018_boxofficemojo_rankings.csv,2018,1.0,0.0
4532,The Right Kind of Wrong,208105,2098,206007,2014_boxofficemojo_rankings.csv,2014,0.010081449268398164,0.9899185507316018
4533,The Dating Project,208100,208100,0,2018_boxofficemojo_rankings.csv,2018,1.0,0.0
4534,Batman 2019 Re-release,207901,159419,48482,2019_boxofficemojo_rankings.csv,2019,0.766802468482595,0.2331975315174049
4535,Under the Electric Sky,207584,207584,0,2014_boxofficemojo_rankings.csv,2014,1.0,0.0
4536,Heading Home: The Tale of Team Israel,207533,207533,0,2018_boxofficemojo_rankings.csv,2018,1.0,0.0
4537,Sweetgrass,207473,207473,0,2010_boxofficemojo_rankings.csv,2010,1.0,0.0
4538,Advanced Style,207231,87879,119352,2014_boxofficemojo_rankings.csv,2014,0.4240630021570132,0.5759369978429868
4539,Ek Thi Daayan,206279,112135,94144,2013_boxofficemojo_rankings.csv,2013,0.5436084138472651,0.4563915861527349
4540,The Desert Bride,205350,30110,175240,2017_boxofficemojo_rankings.csv,2017,0.14662770878987094,0.853372291210129
4541,Sicilian Ghost Story,204892,15285,189607,2017_boxofficemojo_rankings.csv,2017,0.07460027721921793,0.9253997227807821
4542,The Iron Orchard,204881,204881,0,2019_boxofficemojo_rankings.csv,2019,1.0,0.0
4543,Working Woman,204727,64048,140679,2019_boxofficemojo_rankings.csv,2019,0.3128458874501165,0.6871541125498835
4544,Hesburgh,204709,204709,0,2019_boxofficemojo_rankings.csv,2019,1.0,0.0
4545,Don't Call Me Son,204583,11678,192905,2016_boxofficemojo_rankings.csv,2016,0.05708196673232869,0.9429180332676713
4546,Pop Aye,204464,77976,126488,2017_boxofficemojo_rankings.csv,2017,0.3813678691603412,0.6186321308396588
4547,Touchback,204232,204232,0,2012_boxofficemojo_rankings.csv,2012,1.0,0.0
4548,Forrest Gump 2019 Re-release,203088,203088,0,2019_boxofficemojo_rankings.csv,2019,1.0,0.0
4549,Charlie's Country,202966,42937,160029,2014_boxofficemojo_rankings.csv,2014,0.2115477469132761,0.7884522530867238
4550,Keep the Change,202788,202788,0,2018_boxofficemojo_rankings.csv,2018,1.0,0.0
4551,"Filth to Ashes, Flesh to Dust",202531,202531,0,2011_boxofficemojo_rankings.csv,2011,1.0,0.0
4552,The Bolshoi Ballet: Live From Moscow - Coppélia,202217,202217,0,2018_boxofficemojo_rankings.csv,2018,1.0,0.0
4553,"Hieronymus Bosch, Touched by the Devil",201907,172533,29374,2016_boxofficemojo_rankings.csv,2016,0.8545171787010851,0.14548282129891485
4554,The Bad Batch,201890,180851,21039,2017_boxofficemojo_rankings.csv,2017,0.8957897865174105,0.10421021348258953
4555,Blink of an Eye,201874,201874,0,2019_boxofficemojo_rankings.csv,2019,1.0,0.0
4556,Zombi Child,200909,25878,175031,2019_boxofficemojo_rankings.csv,2019,0.12880458316949464,0.8711954168305054
4557,Legendary,200393,200393,0,2010_boxofficemojo_rankings.csv,2010,1.0,0.0
4558,Gemini,200340,200340,0,2018_boxofficemojo_rankings.csv,2018,1.0,0.0
4559,White Girl,200242,200242,0,2016_boxofficemojo_rankings.csv,2016,1.0,0.0
4560,No Place on Earth,200238,200238,0,2013_boxofficemojo_rankings.csv,2013,1.0,0.0
4561,9/11,200229,170000,30229,2017_boxofficemojo_rankings.csv,2017,0.8490278630967543,0.1509721369032458
4562,Listen Up Philip,200126,200126,0,2014_boxofficemojo_rankings.csv,2014,1.0,0.0
4563,Cutie and the Boxer,200036,200036,0,2013_boxofficemojo_rankings.csv,2013,1.0,0.0
4564,Rebel Without a Cause 2018 Re-release,199963,199963,0,2018_boxofficemojo_rankings.csv,2018,1.0,0.0
4565,The Fallen Idol 2016 Re-release,199619,199619,0,2016_boxofficemojo_rankings.csv,2016,1.0,0.0
4566,October Baby,199442,199442,0,2011_boxofficemojo_rankings.csv,2011,1.0,0.0
4567,Friendsgiving Day #2,198869,198869,0,2019_boxofficemojo_rankings.csv,2019,1.0,0.0
4568,Little Joe,198674,23862,174812,2019_boxofficemojo_rankings.csv,2019,0.1201063048008295,0.8798936951991705
4569,The Warrior Queen of Jhansi,198544,177289,21255,2019_boxofficemojo_rankings.csv,2019,0.8929456442904343,0.10705435570956563
4570,Ex Libris: New York Public Library,198239,158192,40047,2017_boxofficemojo_rankings.csv,2017,0.7979862690994204,0.2020137309005796
4571,A Summer's Tale,198126,198126,0,2014_boxofficemojo_rankings.csv,2014,1.0,0.0
4572,Whores' Glory,197932,31420,166512,2011_boxofficemojo_rankings.csv,2011,0.1587413859305216,0.8412586140694784
4573,Pusher,197857,0,197857,2012_boxofficemojo_rankings.csv,2012,0.0,1.0
4574,Madeline's Madeline,197309,185576,11733,2018_boxofficemojo_rankings.csv,2018,0.9405348970396687,0.05946510296033126
4575,Have It All -The Movie,197142,197142,0,2018_boxofficemojo_rankings.csv,2018,1.0,0.0
4576,Mom,195701,0,195701,2017_boxofficemojo_rankings.csv,2017,0.0,1.0
4577,Boom for Real: The Late Teenage Years of Jean-Michel Basquiat,195517,166616,28901,2018_boxofficemojo_rankings.csv,2018,0.8521816517233796,0.14781834827662044
4578,The Divine Order,195081,76277,118804,2017_boxofficemojo_rankings.csv,2017,0.3910016864789498,0.6089983135210503
4579,Free Angela and All Political Prisoners,195005,194102,903,2013_boxofficemojo_rankings.csv,2013,0.9953693495038589,0.004630650496141125
4580,Family,194601,194601,0,2019_boxofficemojo_rankings.csv,2019,1.0,0.0
4581,A Screaming Man,193981,9862,184119,2010_boxofficemojo_rankings.csv,2010,0.0508400307246586,0.9491599692753414
4582,Mr. Klein,193028,193028,0,2019_boxofficemojo_rankings.csv,2019,1.0,0.0
4583,Client 9: The Rise and Fall of Eliot Spitzer,192870,189416,3454,2010_boxofficemojo_rankings.csv,2010,0.982091564266086,0.017908435733914034
4584,Claire's Camera,191980,83418,108562,2018_boxofficemojo_rankings.csv,2018,0.4345140118762371,0.5654859881237629
4585,Harry Potter and the Deathly Hallows: Part 2 2018 Re-release,191886,181938,9948,2018_boxofficemojo_rankings.csv,2018,0.9481567180513429,0.05184328194865701
4586,Past Life,191678,180099,11579,2017_boxofficemojo_rankings.csv,2017,0.9395913980738531,0.06040860192614698
4587,Chalo Dilli,191185,94300,96885,2011_boxofficemojo_rankings.csv,2011,0.4932395323900934,0.5067604676099067
4588,The Romantics,191019,106524,84495,2010_boxofficemojo_rankings.csv,2010,0.5576618032761139,0.4423381967238861
4589,Digimon Adventure tri. Part 1: Reunion Domestic Release,190581,190581,0,2016_boxofficemojo_rankings.csv,2016,1.0,0.0
4590,Code Black,190229,190229,0,2014_boxofficemojo_rankings.csv,2014,1.0,0.0
4591,The Doors: Break On Thru - A Celebration Of Ray Manzarek,190160,190160,0,2020_boxofficemojo_rankings.csv,2020,1.0,0.0
4592,The Divine Plan,190031,190031,0,2019_boxofficemojo_rankings.csv,2019,1.0,0.0
4593,Java Heat,189739,1061,188678,2013_boxofficemojo_rankings.csv,2013,0.0055918920200907565,0.9944081079799092
4594,Munna Michael,189105,99629,89476,2017_boxofficemojo_rankings.csv,2017,0.5268448745405991,0.47315512545940086
4595,Nick Saban: Gamechanger,189000,189000,0,2010_boxofficemojo_rankings.csv,2010,1.0,0.0
4596,Harry Potter and the Goblet of Fire 2018 Re-release,188716,188716,0,2018_boxofficemojo_rankings.csv,2018,1.0,0.0
4597,Leap Year,188242,12979,175263,2010_boxofficemojo_rankings.csv,2010,0.06894848121035688,0.9310515187896431
4598,The Bolshoi Ballet: Live From Moscow - Don Quixote,187946,187946,0,2018_boxofficemojo_rankings.csv,2018,1.0,0.0
4599,Owaranai hito: Miyazaki Hayao,187320,187320,0,2018_boxofficemojo_rankings.csv,2018,1.0,0.0
4600,The Last Days on Mars,187191,24084,163107,2013_boxofficemojo_rankings.csv,2013,0.12866003173229482,0.8713399682677052
4601,In the Fog,186838,11894,174944,2013_boxofficemojo_rankings.csv,2013,0.06365942688318223,0.9363405731168177
4602,Good for Nothing,186119,0,186119,2012_boxofficemojo_rankings.csv,2012,0.0,1.0
4603,Twiceland,186078,52874,133204,2018_boxofficemojo_rankings.csv,2018,0.28414965767043926,0.7158503423295607
4604,Salt of This Sea 2010 Re-release,186045,11662,174383,2010_boxofficemojo_rankings.csv,2010,0.06268375930554436,0.9373162406944556
4605,In the Basement,186036,3643,182393,2014_boxofficemojo_rankings.csv,2014,0.019582231396073877,0.9804177686039262
4606,Britt-Marie Was Here,185794,36549,149245,2019_boxofficemojo_rankings.csv,2019,0.19671787032950472,0.8032821296704953
4607,Buñuel in the Labyrinth of the Turtles,185675,36205,149470,2019_boxofficemojo_rankings.csv,2019,0.19499124814864682,0.8050087518513531
4608,The Duke of Burgundy,185147,64521,120626,2015_boxofficemojo_rankings.csv,2015,0.3484852576601295,0.6515147423398705
4609,Cobra Kai Premiere Event feat. The Karate Kid,185082,185082,0,2018_boxofficemojo_rankings.csv,2018,1.0,0.0
4610,Amigo,184705,184705,0,2011_boxofficemojo_rankings.csv,2011,1.0,0.0
4611,To Dust,184495,184495,0,2019_boxofficemojo_rankings.csv,2019,1.0,0.0
4612,Score,184025,101382,82643,2017_boxofficemojo_rankings.csv,2017,0.5509142779513653,0.4490857220486347
4613,The River and the Wall,183602,183602,0,2019_boxofficemojo_rankings.csv,2019,1.0,0.0
4614,"The Man Nobody Knew: In Search of My Father, CIA Spymaster William Colby",183342,183342,0,2011_boxofficemojo_rankings.csv,2011,1.0,0.0
4615,Lambert & Stamp,183320,183320,0,2015_boxofficemojo_rankings.csv,2015,1.0,0.0
4616,Whose Streets?,182799,182799,0,2017_boxofficemojo_rankings.csv,2017,1.0,0.0
4617,The Masked Saint,182695,182695,0,2016_boxofficemojo_rankings.csv,2016,1.0,0.0
4618,I Am Not A Witch,182462,50868,131594,2017_boxofficemojo_rankings.csv,2017,0.2787868158849514,0.7212131841150486
4619,Shock and Awe,182415,77980,104435,2018_boxofficemojo_rankings.csv,2018,0.42748677466217144,0.5725132253378286
4620,Giant Little Ones,181507,181507,0,2019_boxofficemojo_rankings.csv,2019,1.0,0.0
4621,Bolshoi Ballet: Raymonda domestic,181361,181361,0,2019_boxofficemojo_rankings.csv,2019,1.0,0.0
4622,Raymonda: Bolshoi Ballet,181361,181361,0,2019_boxofficemojo_rankings.csv,2019,1.0,0.0
4623,Rafiki,181316,137968,43348,2019_boxofficemojo_rankings.csv,2019,0.7609256767190982,0.23907432328090186
4624,Winnebago Man,181039,181039,0,2010_boxofficemojo_rankings.csv,2010,1.0,0.0
4625,1001 Grams,181030,10983,170047,2014_boxofficemojo_rankings.csv,2014,0.06066950229243772,0.9393304977075623
4626,An Honest Liar,180590,180590,0,2015_boxofficemojo_rankings.csv,2015,1.0,0.0
4627,Fukrey,180331,125279,55052,2013_boxofficemojo_rankings.csv,2013,0.694716937187727,0.30528306281227297
4628,Go for It!,180237,180237,0,2011_boxofficemojo_rankings.csv,2011,1.0,0.0
4629,Lost Woods,180117,180117,0,2012_boxofficemojo_rankings.csv,2012,1.0,0.0
4630,Lila & Eve,179807,38263,141544,2015_boxofficemojo_rankings.csv,2015,0.21280039153091926,0.7871996084690808
4631,Offender,178158,0,178158,2012_boxofficemojo_rankings.csv,2012,0.0,1.0
4632,Walking on Water,178119,102140,75979,2019_boxofficemojo_rankings.csv,2019,0.5734368596275524,0.42656314037244764
4633,Modest Heroes,178027,178027,0,2019_boxofficemojo_rankings.csv,2019,1.0,0.0
4634,Zaytoun,177753,42330,135423,2013_boxofficemojo_rankings.csv,2013,0.2381394406845454,0.7618605593154546
4635,Monumental: In Search of America's National Treasure,177729,177729,0,2012_boxofficemojo_rankings.csv,2012,1.0,0.0
4636,Nostalgia for the Light,177634,163962,13672,2010_boxofficemojo_rankings.csv,2010,0.9230327527387775,0.07696724726122252
4637,People Places Things,177338,67046,110292,2015_boxofficemojo_rankings.csv,2015,0.3780689981842583,0.6219310018157417
4638,Anita: Speaking Truth to Power,176979,176979,0,2014_boxofficemojo_rankings.csv,2014,1.0,0.0
4639,Bye Bye Germany,176933,73730,103203,2017_boxofficemojo_rankings.csv,2017,0.4167114105339309,0.5832885894660691
4640,Casino Jack and the United States of Money,176865,176865,0,2010_boxofficemojo_rankings.csv,2010,1.0,0.0
4641,Anchor Baby,176784,15790,160994,2010_boxofficemojo_rankings.csv,2010,0.08931803783147796,0.910681962168522
4642,Vigilante Diaries,176777,1991,174786,2016_boxofficemojo_rankings.csv,2016,0.01126277739751212,0.9887372226024879
4643,"Iyengar: The Man, Yoga, and the Student's Journey",176387,176387,0,2019_boxofficemojo_rankings.csv,2019,1.0,0.0
4644,Better Watch Out,176288,20369,155919,2017_boxofficemojo_rankings.csv,2017,0.1155438827373389,0.884456117262661
4645,Girl on a Bicycle,176272,91401,84871,2013_boxofficemojo_rankings.csv,2013,0.5185225106653354,0.4814774893346646
4646,The Bolshoi Ballet: Live From Moscow - The Flames of Paris,175922,175922,0,2018_boxofficemojo_rankings.csv,2018,1.0,0.0
4647,Afternoon Delight,175755,174496,1259,2013_boxofficemojo_rankings.csv,2013,0.9928366191573497,0.00716338084265028
4648,Butter,175706,105018,70688,2012_boxofficemojo_rankings.csv,2012,0.5976915984656187,0.4023084015343813
4649,A.C.O.D.,175705,175705,0,2013_boxofficemojo_rankings.csv,2013,1.0,0.0
4650,Black Rock,175682,0,175682,2013_boxofficemojo_rankings.csv,2013,0.0,1.0
4651,Champion,175232,175232,0,2017_boxofficemojo_rankings.csv,2017,1.0,0.0
4652,Always at The Carlyle,174251,174251,0,2018_boxofficemojo_rankings.csv,2018,1.0,0.0
4653,SOMM,174197,174197,0,2013_boxofficemojo_rankings.csv,2013,1.0,0.0
4654,Grand Illusion,174065,174065,0,2012_boxofficemojo_rankings.csv,2012,1.0,0.0
4655,Neon Bull,173219,26734,146485,2016_boxofficemojo_rankings.csv,2016,0.15433641806037443,0.8456635819396255
4656,Cirkus Columbia,173083,3457,169626,2011_boxofficemojo_rankings.csv,2011,0.019973076500869526,0.9800269234991305
4657,Them That Follow,172952,159218,13734,2019_boxofficemojo_rankings.csv,2019,0.9205906841204496,0.0794093158795504
4658,Bellflower,172935,168226,4709,2011_boxofficemojo_rankings.csv,2011,0.9727701159395149,0.027229884060485154
4659,Rodin 2017 Re-release,172619,44261,128358,2017_boxofficemojo_rankings.csv,2017,0.256408622457551,0.743591377542449
4660,Afternoon of a Faun: Tanaquil Le Clercq,172450,172450,0,2014_boxofficemojo_rankings.csv,2014,1.0,0.0
4661,All Things Must Pass,172394,172394,0,2015_boxofficemojo_rankings.csv,2015,1.0,0.0
4662,Escape from Tomorrow,171962,171962,0,2013_boxofficemojo_rankings.csv,2013,1.0,0.0
4663,Little Woods,171912,150010,21902,2019_boxofficemojo_rankings.csv,2019,0.8725976080785518,0.12740239192144817
4664,Copperhead,171740,171740,0,2013_boxofficemojo_rankings.csv,2013,1.0,0.0
4665,Abuse of Weakness,171660,31611,140049,2014_boxofficemojo_rankings.csv,2014,0.1841488989863684,0.8158511010136316
4666,United Passions,171511,607,170904,2014_boxofficemojo_rankings.csv,2014,0.003539131600888573,0.9964608683991114
4667,The Bolshoi Ballet: Live From Moscow - La Sylphide,171177,171177,0,2018_boxofficemojo_rankings.csv,2018,1.0,0.0
4668,Palau the Movie,171155,134696,36459,2019_boxofficemojo_rankings.csv,2019,0.786982559668137,0.21301744033186293
4669,Cheerful Weather for the Wedding,170922,2651,168271,2012_boxofficemojo_rankings.csv,2012,0.015509998712863177,0.9844900012871368
4670,Apparition Hill,170457,170457,0,2016_boxofficemojo_rankings.csv,2016,1.0,0.0
4671,The Human Centipede II (Full Sequence),170323,141877,28446,2011_boxofficemojo_rankings.csv,2011,0.8329879112040065,0.1670120887959935
4672,The House That Jack Built,170113,170113,0,2018_boxofficemojo_rankings.csv,2018,1.0,0.0
4673,The Fits,169236,166425,2811,2016_boxofficemojo_rankings.csv,2016,0.9833900588527263,0.01660994114727363
4674,Viva Riva!,168982,61759,107223,2011_boxofficemojo_rankings.csv,2011,0.3654767963451729,0.6345232036548272
4675,Free the Mind,168916,157201,11715,2013_boxofficemojo_rankings.csv,2013,0.930646001562907,0.06935399843709299
4676,Girls of the Sun,168771,19712,149059,2018_boxofficemojo_rankings.csv,2018,0.1167973170746159,0.8832026829253841
4677,Valley of Bones,168738,168738,0,2017_boxofficemojo_rankings.csv,2017,1.0,0.0
4678,Be Natural: The Untold Story of Alice Guy-Blaché,168169,115804,52365,2019_boxofficemojo_rankings.csv,2019,0.68861680809186,0.31138319190814
4679,De Palma,168045,165237,2808,2016_boxofficemojo_rankings.csv,2016,0.9832901901276444,0.016709809872355617
4680,The Clovehitch Killer,167994,8208,159786,2018_boxofficemojo_rankings.csv,2018,0.04885888781742205,0.9511411121825779
4681,The Bolshoi Ballet: Live From Moscow - The Lady of the Camellias,167991,167991,0,2018_boxofficemojo_rankings.csv,2018,1.0,0.0
4682,Perrier's Bounty,167938,828,167110,2010_boxofficemojo_rankings.csv,2010,0.004930390977622694,0.9950696090223773
4683,Beauty and the Dogs,167723,8915,158808,2017_boxofficemojo_rankings.csv,2017,0.05315311555362115,0.9468468844463789
4684,Genius Within: The Inner Life of Glenn Gould,167508,167508,0,2010_boxofficemojo_rankings.csv,2010,1.0,0.0
4685,Is Genesis History? 2018 Re-release,166763,166763,0,2018_boxofficemojo_rankings.csv,2018,1.0,0.0
4686,The Day After,166022,24746,141276,2017_boxofficemojo_rankings.csv,2017,0.1490525352061775,0.8509474647938225
4687,Far From the Tree,166018,166018,0,2018_boxofficemojo_rankings.csv,2018,1.0,0.0
4688,Fool for Love,165987,165987,0,2010_boxofficemojo_rankings.csv,2010,1.0,0.0
4689,The Film Critic,165891,7358,158533,2014_boxofficemojo_rankings.csv,2014,0.04435442549625959,0.9556455745037404
4690,Bright Ones,165627,165627,0,2019_boxofficemojo_rankings.csv,2019,1.0,0.0
4691,2001: A Space Odyssey 2019 Re-release,165494,135370,30124,2019_boxofficemojo_rankings.csv,2019,0.8179752740280615,0.18202472597193856
4692,Christmas Eve,164839,91302,73537,2015_boxofficemojo_rankings.csv,2015,0.5538859129210927,0.4461140870789073
4693,Nas: Time Is Illmatic,164540,164540,0,2014_boxofficemojo_rankings.csv,2014,1.0,0.0
4694,The Chambermaid,164531,86422,78109,2019_boxofficemojo_rankings.csv,2019,0.525262716448572,0.474737283551428
4695,Saint Judy,164336,78935,85401,2019_boxofficemojo_rankings.csv,2019,0.48032689124720085,0.5196731087527992
4696,Eastern Boys,164290,16831,147459,2014_boxofficemojo_rankings.csv,2014,0.10244689268975592,0.8975531073102441
4697,Lost & Found,164026,125173,38853,2018_boxofficemojo_rankings.csv,2018,0.7631290161315889,0.2368709838684111
4698,Cruel Peter,163925,0,163925,2020_boxofficemojo_rankings.csv,2020,0.0,1.0
4699,Keep on Keepin' On,163745,163745,0,2014_boxofficemojo_rankings.csv,2014,1.0,0.0
4700,Narco Cultura,163690,145088,18602,2013_boxofficemojo_rankings.csv,2013,0.88635836031523,0.11364163968477
4701,Halston,163446,151991,11455,2019_boxofficemojo_rankings.csv,2019,0.9299156908091969,0.07008430919080308
4702,Walking Out,162445,101947,60498,2017_boxofficemojo_rankings.csv,2017,0.6275785650527871,0.3724214349472129
4703,The Turin Horse,162088,56391,105697,2011_boxofficemojo_rankings.csv,2011,0.34790360791668723,0.6520963920833127
4704,Road to Nowhere,161619,40294,121325,2011_boxofficemojo_rankings.csv,2011,0.24931474640976617,0.7506852535902339
4705,The Samuel Project,161565,161565,0,2018_boxofficemojo_rankings.csv,2018,1.0,0.0
4706,Lu Over the Wall,161253,109857,51396,2018_boxofficemojo_rankings.csv,2018,0.6812710461200722,0.31872895387992783
4707,Tharlo,161229,17091,144138,2016_boxofficemojo_rankings.csv,2016,0.10600450291200715,0.8939954970879929
4708,Spring Fever,161110,10824,150286,2010_boxofficemojo_rankings.csv,2010,0.06718391161318354,0.9328160883868165
4709,"Diana Ross: Her Life, Love and Legacy",160968,160968,0,2019_boxofficemojo_rankings.csv,2019,1.0,0.0
4710,National Theatre Live: The Curious Incident of the Dog in the Night-Time 2018 Re-release,160381,160381,0,2018_boxofficemojo_rankings.csv,2018,1.0,0.0
4711,Beauty and the Beast 2016 Re-release,160215,160215,0,2016_boxofficemojo_rankings.csv,2016,1.0,0.0
4712,Sinbad: The Fifth Voyage,159862,159862,0,2014_boxofficemojo_rankings.csv,2014,1.0,0.0
4713,The Eclipse,159852,133411,26441,2010_boxofficemojo_rankings.csv,2010,0.8345907464404574,0.16540925355954259
4714,Murder 3,159798,0,159798,2013_boxofficemojo_rankings.csv,2013,0.0,1.0
4715,The Model,159743,0,159743,2016_boxofficemojo_rankings.csv,2016,0.0,1.0
4716,Eames: The Architect & The Painter,159715,153088,6627,2011_boxofficemojo_rankings.csv,2011,0.9585073412015152,0.0414926587984848
4717,The Body,159317,68196,91121,2019_boxofficemojo_rankings.csv,2019,0.42805224803379427,0.5719477519662057
4718,The Witness,159305,159305,0,2016_boxofficemojo_rankings.csv,2016,1.0,0.0
4719,We Are What We Are,159047,81381,77666,2013_boxofficemojo_rankings.csv,2013,0.5116789376725119,0.4883210623274881
4720,Until Forever,158872,35839,123033,2016_boxofficemojo_rankings.csv,2016,0.2255841180321265,0.7744158819678735
4721,The Last Resort,158646,158646,0,2018_boxofficemojo_rankings.csv,2018,1.0,0.0
4722,The Big Picture 2012 Re-release,158411,158411,0,2012_boxofficemojo_rankings.csv,2012,1.0,0.0
4723,Mother of George,157937,157937,0,2013_boxofficemojo_rankings.csv,2013,1.0,0.0
4724,The Look of Silence,157857,109089,48768,2015_boxofficemojo_rankings.csv,2015,0.6910621638571619,0.30893783614283815
4725,Crazy Horse,157782,157782,0,2012_boxofficemojo_rankings.csv,2012,1.0,0.0
4726,Hell and Back,157768,157768,0,2015_boxofficemojo_rankings.csv,2015,1.0,0.0
4727,Chasing Madoff,157612,157612,0,2011_boxofficemojo_rankings.csv,2011,1.0,0.0
4728,Eva Hesse,157481,157481,0,2016_boxofficemojo_rankings.csv,2016,1.0,0.0
4729,Suntan,157267,6643,150624,2016_boxofficemojo_rankings.csv,2016,0.042240266553059444,0.9577597334469405
4730,LUV,156996,156996,0,2013_boxofficemojo_rankings.csv,2013,1.0,0.0
4731,Marina Abramovic: The Artist Is Present,156695,86637,70058,2012_boxofficemojo_rankings.csv,2012,0.5529021347203166,0.4470978652796835
4732,The Booksellers,156502,25694,130808,2020_boxofficemojo_rankings.csv,2020,0.1641768156317491,0.8358231843682509
4733,Hatchet II,156190,52604,103586,2010_boxofficemojo_rankings.csv,2010,0.3367949292528331,0.663205070747167
4734,Deadtime,156072,156072,0,2012_boxofficemojo_rankings.csv,2012,1.0,0.0
4735,Queen & Country,155881,41297,114584,2015_boxofficemojo_rankings.csv,2015,0.26492645030504036,0.7350735496949596
4736,Money,155732,155732,0,2019_boxofficemojo_rankings.csv,2019,1.0,0.0
4737,The Forgiveness of Blood,155383,126700,28683,2012_boxofficemojo_rankings.csv,2012,0.8154045165816081,0.18459548341839196
4738,The Boy and the World 2015 Re-release,155215,129480,25735,2015_boxofficemojo_rankings.csv,2015,0.8341977257352704,0.16580227426472957
4739,Western,155215,41072,114143,2018_boxofficemojo_rankings.csv,2018,0.2646136004896434,0.7353863995103566
4740,Magic Trip: Ken Kesey's Search for a Kool Place,155005,154521,484,2011_boxofficemojo_rankings.csv,2011,0.9968775200799974,0.0031224799200025807
4741,Bad Reputation,154190,148568,5622,2018_boxofficemojo_rankings.csv,2018,0.963538491471561,0.03646150852843894
4742,Eating Animals,153993,149614,4379,2018_boxofficemojo_rankings.csv,2018,0.9715636425032307,0.028436357496769333
4743,Citizen Koch,153908,153908,0,2014_boxofficemojo_rankings.csv,2014,1.0,0.0
4744,The Tag Along: Devil Fish,153895,20726,133169,2018_boxofficemojo_rankings.csv,2018,0.13467624029370676,0.8653237597062933
4745,Love Story 50th Anniversary,153504,153504,0,2020_boxofficemojo_rankings.csv,2020,1.0,0.0
4746,Harmonium,153283,17191,136092,2017_boxofficemojo_rankings.csv,2017,0.11215203251502123,0.8878479674849787
4747,Backstreet Boys: Show 'Em What You're Made Of,153068,153068,0,2015_boxofficemojo_rankings.csv,2015,1.0,0.0
4748,In the Shadow of Women,152802,50291,102511,2015_boxofficemojo_rankings.csv,2015,0.329125273229408,0.670874726770592
4749,Deceptive Practice: The Mysteries and Mentors of Ricky Jay,152791,152791,0,2013_boxofficemojo_rankings.csv,2013,1.0,0.0
4750,Finding Fela,152346,120980,31366,2014_boxofficemojo_rankings.csv,2014,0.7941133997610702,0.2058866002389298
4751,The Call Up,152294,0,152294,2016_boxofficemojo_rankings.csv,2016,0.0,1.0
4752,Snake & Mongoose,152200,152200,0,2013_boxofficemojo_rankings.csv,2013,1.0,0.0
4753,Irresistible,152192,0,152192,2020_boxofficemojo_rankings.csv,2020,0.0,1.0
4754,One Week and a Day,152178,41614,110564,2016_boxofficemojo_rankings.csv,2016,0.2734560843223068,0.7265439156776933
4755,"Buttons, A New Musical Film",151983,151983,0,2018_boxofficemojo_rankings.csv,2018,1.0,0.0
4756,Born to Be Blue,151926,151926,0,2016_boxofficemojo_rankings.csv,2016,1.0,0.0
4757,Lupin the 3rd: Castle of Cagliostro 2017 Re-release,151802,142425,9377,2017_boxofficemojo_rankings.csv,2017,0.9382287453393235,0.06177125466067641
4758,Generation Found,151751,151751,0,2016_boxofficemojo_rankings.csv,2016,1.0,0.0
4759,Red Riding: The Year of Our Lord 1974,151644,151644,0,2010_boxofficemojo_rankings.csv,2010,1.0,0.0
4760,Before You Know It,151507,151507,0,2019_boxofficemojo_rankings.csv,2019,1.0,0.0
4761,We Summon the Darkness,151479,60794,90685,2020_boxofficemojo_rankings.csv,2020,0.40133615880749146,0.5986638411925085
4762,Jay Myself,151331,151331,0,2019_boxofficemojo_rankings.csv,2019,1.0,0.0
4763,Revenge of the Electric Car,151272,150886,386,2011_boxofficemojo_rankings.csv,2011,0.9974483050399281,0.0025516949600719236
4764,The Cremaster Cycle 2010 Re-release,151239,151239,0,2010_boxofficemojo_rankings.csv,2010,1.0,0.0
4765,Glory 2019 Re-release,150801,150801,0,2019_boxofficemojo_rankings.csv,2019,1.0,0.0
4766,Tasting Menu,150718,18686,132032,2013_boxofficemojo_rankings.csv,2013,0.12397988296023037,0.8760201170397697
4767,Godzilla 2014 Re-release,150191,150191,0,2014_boxofficemojo_rankings.csv,2014,1.0,0.0
4768,Kicks,150191,150191,0,2016_boxofficemojo_rankings.csv,2016,1.0,0.0
4769,Nobody Else But You,150173,43040,107133,2011_boxofficemojo_rankings.csv,2011,0.28660278478821094,0.7133972152117891
4770,Only the Brave,150000,150000,0,2010_boxofficemojo_rankings.csv,2010,1.0,0.0
4771,Yellow Rose,150000,150000,0,2020_boxofficemojo_rankings.csv,2020,1.0,0.0
4772,Piercing,149211,15856,133355,2019_boxofficemojo_rankings.csv,2019,0.10626562384810771,0.8937343761518923
4773,Michael Moore in TrumpLand,149090,149090,0,2016_boxofficemojo_rankings.csv,2016,1.0,0.0
4774,Gun Hill Road,148994,148994,0,2011_boxofficemojo_rankings.csv,2011,1.0,0.0
4775,From Afar,148630,30169,118461,2016_boxofficemojo_rankings.csv,2016,0.2029805557424477,0.7970194442575523
4776,Trial by Fire,148504,148504,0,2019_boxofficemojo_rankings.csv,2019,1.0,0.0
4777,War and Peace,148503,148503,0,2019_boxofficemojo_rankings.csv,2019,1.0,0.0
4778,Harry Potter and the Deathly Hallows: Part 1 2018 Re-release,148263,148263,0,2010_boxofficemojo_rankings.csv,2010,1.0,0.0
4779,Restless Creature: Wendy Whelan,147780,147780,0,2017_boxofficemojo_rankings.csv,2017,1.0,0.0
4780,Night of the Living Dead 2018 Re-release,147423,147423,0,2018_boxofficemojo_rankings.csv,2018,1.0,0.0
4781,The Strange Case of Angelica,147173,50135,97038,2010_boxofficemojo_rankings.csv,2010,0.3406535166097042,0.6593464833902958
4782,Driven,147172,0,147172,2019_boxofficemojo_rankings.csv,2019,0.0,1.0
4783,Songs My Brothers Taught Me,146937,34793,112144,2015_boxofficemojo_rankings.csv,2015,0.23678855563949175,0.7632114443605083
4784,American Promise,146702,146702,0,2013_boxofficemojo_rankings.csv,2013,1.0,0.0
4785,Watermark,146572,84464,62108,2014_boxofficemojo_rankings.csv,2014,0.576262860573643,0.423737139426357
4786,Touched with Fire,146487,146487,0,2016_boxofficemojo_rankings.csv,2016,1.0,0.0
4787,5 Broken Cameras,146475,109983,36492,2012_boxofficemojo_rankings.csv,2012,0.7508653353814644,0.2491346646185356
4788,Hannah,146325,11700,134625,2018_boxofficemojo_rankings.csv,2018,0.07995899538698104,0.920041004613019
4789,Starlet,146222,88212,58010,2012_boxofficemojo_rankings.csv,2012,0.6032744730615092,0.3967255269384908
4790,Deadly Renovations,146146,146146,0,2012_boxofficemojo_rankings.csv,2012,1.0,0.0
4791,The Punk Singer,146000,122742,23258,2013_boxofficemojo_rankings.csv,2013,0.8406986301369863,0.1593013698630137
4792,Citizen K,145941,120411,25530,2019_boxofficemojo_rankings.csv,2019,0.8250662939132938,0.17493370608670628
4793,Framing John DeLorean,145625,145625,0,2019_boxofficemojo_rankings.csv,2019,1.0,0.0
4794,The Last Dalai Lama?,145524,145524,0,2017_boxofficemojo_rankings.csv,2017,1.0,0.0
4795,Krisha,144822,144822,0,2016_boxofficemojo_rankings.csv,2016,1.0,0.0
4796,Mr. Smith Goes to Washington 2018 Re-release,144738,144738,0,2018_boxofficemojo_rankings.csv,2018,1.0,0.0
4797,Wendy,144564,143518,1046,2020_boxofficemojo_rankings.csv,2020,0.992764450347251,0.0072355496527489556
4798,Irving Berlin's Holiday Inn The Broadway Musical,144550,144550,0,2017_boxofficemojo_rankings.csv,2017,1.0,0.0
4799,The Price of Everything,144446,87400,57046,2018_boxofficemojo_rankings.csv,2018,0.6050704069340792,0.39492959306592085
4800,Yellow Day 2015 Re-release,144163,144163,0,2015_boxofficemojo_rankings.csv,2015,1.0,0.0
4801,From Beneath,144123,144123,0,2012_boxofficemojo_rankings.csv,2012,1.0,0.0
4802,Cold Weather,144056,141358,2698,2011_boxofficemojo_rankings.csv,2011,0.9812711723218748,0.018728827678125174
4803,Thunder Soul,143986,143986,0,2011_boxofficemojo_rankings.csv,2011,1.0,0.0
4804,Cop Car,143658,134552,9106,2015_boxofficemojo_rankings.csv,2015,0.9366133455846525,0.06338665441534756
4805,Dirty Girl,143485,55125,88360,2011_boxofficemojo_rankings.csv,2011,0.38418650033104507,0.6158134996689549
4806,Doctor Who: Logopolis,143248,143248,0,2019_boxofficemojo_rankings.csv,2019,1.0,0.0
4807,Alpeis,143234,16057,127177,2012_boxofficemojo_rankings.csv,2012,0.1121032715695994,0.8878967284304006
4808,Survival of the Dead,143191,101740,41451,2010_boxofficemojo_rankings.csv,2010,0.7105195158913619,0.28948048410863814
4809,Kids for Cash,143178,143178,0,2014_boxofficemojo_rankings.csv,2014,1.0,0.0
4810,Clash,143121,18215,124906,2016_boxofficemojo_rankings.csv,2016,0.12726993243479293,0.8727300675652071
4811,Disguising,143108,0,143108,2018_boxofficemojo_rankings.csv,2018,0.0,1.0
4812,Dragon 2012 Re-release,142029,11137,130892,2012_boxofficemojo_rankings.csv,2012,0.0784135634271874,0.9215864365728126
4813,John Dies at the End,141951,141951,0,2013_boxofficemojo_rankings.csv,2013,1.0,0.0
4814,Citadel,141886,13377,128509,2012_boxofficemojo_rankings.csv,2012,0.09427991486122662,0.9057200851387733
4815,May in the Summer,141605,22004,119601,2014_boxofficemojo_rankings.csv,2014,0.15538999329119735,0.8446100067088027
4816,Best F(r)iends Volume Two,141524,141524,0,2018_boxofficemojo_rankings.csv,2018,1.0,0.0
4817,The Silencing,141479,100746,40733,2020_boxofficemojo_rankings.csv,2020,0.7120915471554082,0.28790845284459177
4818,Branagh Theatre Live: The Winter's Tale,141143,141143,0,2019_boxofficemojo_rankings.csv,2019,1.0,0.0
4819,Metropolis Giorgio Moroder Presents,140907,27362,113545,2011_boxofficemojo_rankings.csv,2011,0.19418481693599324,0.8058151830640068
4820,Canelo vs. Kovalev,140820,140820,0,2019_boxofficemojo_rankings.csv,2019,1.0,0.0
4821,The Cordillera of Dreams,140465,20943,119522,2019_boxofficemojo_rankings.csv,2019,0.14909763998149006,0.8509023600185099
4822,Incitement,140306,140306,0,2020_boxofficemojo_rankings.csv,2020,1.0,0.0
4823,Gore Vidal: The United States of Amnesia,140164,140164,0,2014_boxofficemojo_rankings.csv,2014,1.0,0.0
4824,Beautiful Boy,140123,77247,62876,2011_boxofficemojo_rankings.csv,2011,0.5512799469037917,0.4487200530962083
4825,The Weathered Underground,140091,140091,0,2010_boxofficemojo_rankings.csv,2010,1.0,0.0
4826,Liv & Ingmar,140041,10347,129694,2012_boxofficemojo_rankings.csv,2012,0.07388550495926192,0.9261144950407381
4827,Coherence,139745,102617,37128,2014_boxofficemojo_rankings.csv,2014,0.7343160757093277,0.2656839242906723
4828,Hunky Dory,139653,20296,119357,2012_boxofficemojo_rankings.csv,2012,0.14533164343050275,0.8546683565694972
4829,Support the Girls,139550,129124,10426,2018_boxofficemojo_rankings.csv,2018,0.9252884270870656,0.07471157291293443
4830,Flowers,139421,61568,77853,2014_boxofficemojo_rankings.csv,2014,0.44159775069752766,0.5584022493024724
4831,Wilder vs. Ortiz,139207,139207,0,2019_boxofficemojo_rankings.csv,2019,1.0,0.0
4832,Rock on 2,139173,98868,40305,2016_boxofficemojo_rankings.csv,2016,0.710396413097368,0.289603586902632
4833,The Polar Express 2014 IMAX Release,139055,139055,0,2014_boxofficemojo_rankings.csv,2014,1.0,0.0
4834,Grease,138981,102000,36981,2014_boxofficemojo_rankings.csv,2014,0.7339132687201848,0.26608673127981525
4835,Who Will Write Our History,138868,138039,829,2019_boxofficemojo_rankings.csv,2019,0.9940303021574445,0.0059696978425555205
4836,Head Full of Honey,138844,12350,126494,2018_boxofficemojo_rankings.csv,2018,0.0889487482354297,0.9110512517645704
4837,Good Ol' Freda,138811,138811,0,2013_boxofficemojo_rankings.csv,2013,1.0,0.0
4838,Zero Motivation,138609,116044,22565,2014_boxofficemojo_rankings.csv,2014,0.8372039333665202,0.16279606663347979
4839,The Brawler,138515,75929,62586,2018_boxofficemojo_rankings.csv,2018,0.548164458722882,0.451835541277118
4840,Psycho-Pass: The Movie,138366,138366,0,2016_boxofficemojo_rankings.csv,2016,1.0,0.0
4841,Most Wanted,138000,138000,0,2020_boxofficemojo_rankings.csv,2020,1.0,0.0
4842,Lynryd Skynyrd: Last of the Street Survivors Farewell Tour,137888,137888,0,2019_boxofficemojo_rankings.csv,2019,1.0,0.0
4843,Love Ranch,137885,137885,0,2010_boxofficemojo_rankings.csv,2010,1.0,0.0
4844,Beneath Us,137260,137260,0,2020_boxofficemojo_rankings.csv,2020,1.0,0.0
4845,Is the Man Who Is Tall Happy?,137042,137042,0,2013_boxofficemojo_rankings.csv,2013,1.0,0.0
4846,Slaughter Creek,136815,136815,0,2012_boxofficemojo_rankings.csv,2012,1.0,0.0
4847,Made in Abyss: Journey's Dawn,135821,134047,1774,2019_boxofficemojo_rankings.csv,2019,0.9869386913658418,0.013061308634158194
4848,I Will Follow,135809,135809,0,2011_boxofficemojo_rankings.csv,2011,1.0,0.0
4849,Mantra: Sounds Into Silence,135684,115013,20671,2018_boxofficemojo_rankings.csv,2018,0.8476533710680699,0.15234662893193007
4850,Sonchiriya,135413,86765,48648,2019_boxofficemojo_rankings.csv,2019,0.6407435032087022,0.35925649679129773
4851,La Sapienza,135392,135392,0,2015_boxofficemojo_rankings.csv,2015,1.0,0.0
4852,The Kind Words,135382,135382,0,2016_boxofficemojo_rankings.csv,2016,1.0,0.0
4853,The Other Dream Team,135228,135228,0,2012_boxofficemojo_rankings.csv,2012,1.0,0.0
4854,The Other Story,135191,135191,0,2019_boxofficemojo_rankings.csv,2019,1.0,0.0
4855,The Bolshoi Ballet: Live From Moscow - A Hero of Our Time,135168,104837,30331,2017_boxofficemojo_rankings.csv,2017,0.7756051728219697,0.2243948271780303
4856,My Neighbor Totoro 2015 Re-release,134877,0,134877,2015_boxofficemojo_rankings.csv,2015,0.0,1.0
4857,Another Day of Life,134801,3190,131611,2018_boxofficemojo_rankings.csv,2018,0.023664512874533573,0.9763354871254665
4858,Led Zeppelin: Celebration Day,134753,0,134753,2012_boxofficemojo_rankings.csv,2012,0.0,1.0
4859,Attenberg,134503,24036,110467,2010_boxofficemojo_rankings.csv,2010,0.17870233377694178,0.8212976662230582
4860,The Times of Bill Cunningham,134288,134288,0,2020_boxofficemojo_rankings.csv,2020,1.0,0.0
4861,Ism,134165,134165,0,2016_boxofficemojo_rankings.csv,2016,1.0,0.0
4862,Redwood Highway,134049,134049,0,2014_boxofficemojo_rankings.csv,2014,1.0,0.0
4863,The Great Museum,133905,18020,115885,2014_boxofficemojo_rankings.csv,2014,0.13457301818453382,0.8654269818154662
4864,Pure Country 2: The Gift,133771,133771,0,2010_boxofficemojo_rankings.csv,2010,1.0,0.0
4865,Don't Think I've Forgotten: Cambodia's Lost Rock and Roll,133443,133443,0,2015_boxofficemojo_rankings.csv,2015,1.0,0.0
4866,Under the Shadow,133324,31900,101424,2016_boxofficemojo_rankings.csv,2016,0.23926674867240708,0.760733251327593
4867,The Jewish Cardinal,133232,133232,0,2014_boxofficemojo_rankings.csv,2014,1.0,0.0
4868,"Hare Krishna! The Mantra, the Movement and the Swami Who Started It",133006,133006,0,2017_boxofficemojo_rankings.csv,2017,1.0,0.0
4869,Tonight You're Mine,132787,6255,126532,2011_boxofficemojo_rankings.csv,2011,0.04710551484708594,0.9528944851529141
4870,Dawson City: Frozen Time,132369,132369,0,2016_boxofficemojo_rankings.csv,2016,1.0,0.0
4871,Kumaré,132160,132160,0,2012_boxofficemojo_rankings.csv,2012,1.0,0.0
4872,My Brother the Devil,132056,44906,87150,2012_boxofficemojo_rankings.csv,2012,0.34005270491306716,0.6599472950869328
4873,How to Survive a Plague,132055,132055,0,2012_boxofficemojo_rankings.csv,2012,1.0,0.0
4874,A Ballerina's Tale,131995,131995,0,2015_boxofficemojo_rankings.csv,2015,1.0,0.0
4875,Mugamoodi,131965,101000,30965,2012_boxofficemojo_rankings.csv,2012,0.7653544500435722,0.23464554995642783
4876,28 Hotel Rooms,131208,18869,112339,2012_boxofficemojo_rankings.csv,2012,0.1438098286689836,0.8561901713310164
4877,Rudy 2018 Re-release,131200,131200,0,2018_boxofficemojo_rankings.csv,2018,1.0,0.0
4878,The Wind,130974,28252,102722,2019_boxofficemojo_rankings.csv,2019,0.21570693420068104,0.7842930657993189
4879,Mister America,130897,130897,0,2019_boxofficemojo_rankings.csv,2019,1.0,0.0
4880,The Image Book,130802,94153,36649,2018_boxofficemojo_rankings.csv,2018,0.7198131527040871,0.2801868472959129
4881,October,130335,32127,98208,2010_boxofficemojo_rankings.csv,2010,0.24649556911036943,0.7535044308896306
4882,Five Seasons: The Gardens of Piet Oudolf,130319,119223,11096,2018_boxofficemojo_rankings.csv,2018,0.9148550863649967,0.08514491363500334
4883,Requiem for the American Dream,130152,130152,0,2016_boxofficemojo_rankings.csv,2016,1.0,0.0
4884,Harry Potter and the Half-Blood Prince 2018 Re-release,130081,130081,0,2018_boxofficemojo_rankings.csv,2018,1.0,0.0
4885,Section 375,129916,0,129916,2019_boxofficemojo_rankings.csv,2019,0.0,1.0
4886,The Fairy,129818,38399,91419,2011_boxofficemojo_rankings.csv,2011,0.2957910305196506,0.7042089694803494
4887,Great Performances at the Met: Puccini: Madama Butterfly,129730,129730,0,2018_boxofficemojo_rankings.csv,2018,1.0,0.0
4888,Great Performances at the Met: Tchaikovsky: Eugene Onegin 2018 Re-release,129498,129498,0,2018_boxofficemojo_rankings.csv,2018,1.0,0.0
4889,Great Performances at the Met: Verdi: Il Trovatore,129393,129393,0,2018_boxofficemojo_rankings.csv,2018,1.0,0.0
4890,I Called Him Morgan,128986,128986,0,2017_boxofficemojo_rankings.csv,2017,1.0,0.0
4891,The Golden Era 2014 Re-release,128926,102931,25995,2014_boxofficemojo_rankings.csv,2014,0.7983727099266246,0.20162729007337543
4892,Yossi,128668,117047,11621,2012_boxofficemojo_rankings.csv,2012,0.9096822830851494,0.09031771691485062
4893,Love After Love,128602,121098,7504,2018_boxofficemojo_rankings.csv,2018,0.9416494300244164,0.058350569975583584
4894,The Adventurer: The Curse of the Midas Box,128471,6399,122072,2014_boxofficemojo_rankings.csv,2014,0.04980890629013552,0.9501910937098644
4895,Where Hands Touch,128269,67743,60526,2018_boxofficemojo_rankings.csv,2018,0.5281322844958641,0.47186771550413587
4896,Stonewall Uprising,128203,128203,0,2010_boxofficemojo_rankings.csv,2010,1.0,0.0
4897,Computer Chess,127852,102041,25811,2013_boxofficemojo_rankings.csv,2013,0.7981181365954385,0.20188186340456152
4898,Steve Jobs: The Lost Interview,127541,105710,21831,2011_boxofficemojo_rankings.csv,2011,0.8288315130036615,0.17116848699633844
4899,Benda Bilili!,127362,13420,113942,2010_boxofficemojo_rankings.csv,2010,0.10536894835194172,0.8946310516480583
4900,Sleepless in Seattle 2018 Re-release,127281,127281,0,2018_boxofficemojo_rankings.csv,2018,1.0,0.0
4901,A Band Called Death,127257,127257,0,2013_boxofficemojo_rankings.csv,2013,1.0,0.0
4902,Chimes at Midnight,126724,126724,0,2016_boxofficemojo_rankings.csv,2016,1.0,0.0
4903,Silent Night,126594,14567,112027,2012_boxofficemojo_rankings.csv,2012,0.11506864464350601,0.884931355356494
4904,Escape Fire: The Fight to Rescue American Healthcare,126238,126238,0,2012_boxofficemojo_rankings.csv,2012,1.0,0.0
4905,The Arbor,126182,21620,104562,2010_boxofficemojo_rankings.csv,2010,0.17133981074955223,0.8286601892504478
4906,The Great Buster,125807,118344,7463,2018_boxofficemojo_rankings.csv,2018,0.9406789765275382,0.059321023472461785
4907,Europa Report,125687,125687,0,2013_boxofficemojo_rankings.csv,2013,1.0,0.0
4908,Rosie,125679,6839,118840,2019_boxofficemojo_rankings.csv,2019,0.05441641006055108,0.9455835899394489
4909,Paris Is Burning 2019 Re-release,125677,125677,0,2019_boxofficemojo_rankings.csv,2019,1.0,0.0
4910,Only,125603,0,125603,2020_boxofficemojo_rankings.csv,2020,0.0,1.0
4911,This Changes Everything,125348,64988,60360,2019_boxofficemojo_rankings.csv,2019,0.5184606056738041,0.48153939432619586
4912,The B-Side: Elsa Dorfman's Portrait Photography,125227,125227,0,2017_boxofficemojo_rankings.csv,2017,1.0,0.0
4913,Spinning Plates,124856,112449,12407,2013_boxofficemojo_rankings.csv,2013,0.9006295252130454,0.09937047478695457
4914,Mary Magdalene 2019 Re-release,124741,124741,0,2019_boxofficemojo_rankings.csv,2019,1.0,0.0
4915,Every Secret Thing,124733,103536,21197,2015_boxofficemojo_rankings.csv,2015,0.8300610103180394,0.16993898968196067
4916,Hymn: Sarah Brightman in Concert,124707,113274,11433,2018_boxofficemojo_rankings.csv,2018,0.9083211046693449,0.09167889533065506
4917,Ran 2010 Re-release,124673,124673,0,2010_boxofficemojo_rankings.csv,2010,1.0,0.0
4918,A Tuba to Cuba,124592,121772,2820,2019_boxofficemojo_rankings.csv,2019,0.9773661230255554,0.022633876974444588
4919,'85: The Greatest Team in Football History,124573,124573,0,2018_boxofficemojo_rankings.csv,2018,1.0,0.0
4920,Final: The Rapture,124561,124561,0,2013_boxofficemojo_rankings.csv,2013,1.0,0.0
4921,Vidal Sassoon: The Movie,124532,85974,38558,2011_boxofficemojo_rankings.csv,2011,0.6903767706292359,0.30962322937076414
4922,Shirley,124318,0,124318,2020_boxofficemojo_rankings.csv,2020,0.0,1.0
4923,Post Tenebras Lux,124279,39185,85094,2012_boxofficemojo_rankings.csv,2012,0.31529864257034573,0.6847013574296542
4924,The Square,124244,124244,0,2013_boxofficemojo_rankings.csv,2013,1.0,0.0
4925,Marguerite & Julien,123918,0,123918,2015_boxofficemojo_rankings.csv,2015,0.0,1.0
4926,Knights of Badassdom,123854,123854,0,2014_boxofficemojo_rankings.csv,2014,1.0,0.0
4927,Wings of Desire 2018 Re-release,123830,123830,0,2018_boxofficemojo_rankings.csv,2018,1.0,0.0
4928,The Magic of Belle Isle,123821,102388,21433,2012_boxofficemojo_rankings.csv,2012,0.8269033524200257,0.1730966475799743
4929,Puncture,123700,68945,54755,2011_boxofficemojo_rankings.csv,2011,0.5573565076798707,0.44264349232012934
4930,Appropriate Behavior,123699,46912,76787,2015_boxofficemojo_rankings.csv,2015,0.37924316283882653,0.6207568371611735
4931,Sigur Rós: Inni,123482,123482,0,2011_boxofficemojo_rankings.csv,2011,1.0,0.0
4932,Downtown 81 2019 Re-release,123387,123387,0,2019_boxofficemojo_rankings.csv,2019,1.0,0.0
4933,Easy Rider 2019 Re-release,123276,123276,0,2019_boxofficemojo_rankings.csv,2019,1.0,0.0
4934,The Last Mountain,122961,122961,0,2011_boxofficemojo_rankings.csv,2011,1.0,0.0
4935,Ashby,122919,4631,118288,2015_boxofficemojo_rankings.csv,2015,0.03767521701282959,0.9623247829871704
4936,Blood Fest,122833,82774,40059,2018_boxofficemojo_rankings.csv,2018,0.6738742845977872,0.32612571540221275
4937,"14 Days, 12 Nights",122806,122530,276,2020_boxofficemojo_rankings.csv,2020,0.9977525528068661,0.002247447193133886
4938,Do I Sound Gay?,122595,119388,3207,2015_boxofficemojo_rankings.csv,2015,0.9738406949712468,0.026159305028753212
4939,Film socialisme 2010 Re-release,122264,42925,79339,2010_boxofficemojo_rankings.csv,2010,0.3510845383759733,0.6489154616240267
4940,Tragedy Girls,122211,61899,60312,2017_boxofficemojo_rankings.csv,2017,0.506492868890689,0.49350713110931094
4941,The Ones Below,121827,12488,109339,2016_boxofficemojo_rankings.csv,2016,0.10250601262445927,0.8974939873755408
4942,Tremors,121813,23911,97902,2019_boxofficemojo_rankings.csv,2019,0.19629267812138276,0.8037073218786173
4943,Yu-Gi-Oh!: The Movie - Pyramid of Light 2018 Re-release,121688,121688,0,2018_boxofficemojo_rankings.csv,2018,1.0,0.0
4944,Letters to Elena,121254,8511,112743,2012_boxofficemojo_rankings.csv,2012,0.07019149883715177,0.9298085011628482
4945,Afflicted,121179,121179,0,2014_boxofficemojo_rankings.csv,2014,1.0,0.0
4946,In Jackson Heights,121094,121094,0,2015_boxofficemojo_rankings.csv,2015,1.0,0.0
4947,Michael,121034,15715,105319,2011_boxofficemojo_rankings.csv,2011,0.12983954921757523,0.8701604507824248
4948,The Girl Without Hands,121020,21787,99233,2016_boxofficemojo_rankings.csv,2016,0.1800280945298298,0.8199719054701702
4949,Miss Sharon Jones!,120880,120880,0,2016_boxofficemojo_rankings.csv,2016,1.0,0.0
4950,Better Living Through Chemistry,120823,75143,45680,2014_boxofficemojo_rankings.csv,2014,0.6219262888688412,0.3780737111311588
4951,Hockney 2016 Re-release,120745,120745,0,2016_boxofficemojo_rankings.csv,2016,1.0,0.0
4952,Cowgirls 'n Angels,120680,120680,0,2012_boxofficemojo_rankings.csv,2012,1.0,0.0
4953,Spark: A Burning Man Story,120459,120459,0,2013_boxofficemojo_rankings.csv,2013,1.0,0.0
4954,Foodfight!,120141,0,120141,2012_boxofficemojo_rankings.csv,2012,0.0,1.0
4955,Blank City,119929,116037,3892,2011_boxofficemojo_rankings.csv,2011,0.9675474655838038,0.03245253441619625
4956,Avant qu'on explose,119894,119894,0,2019_boxofficemojo_rankings.csv,2019,1.0,0.0
4957,The Pearl Button,119753,42166,77587,2015_boxofficemojo_rankings.csv,2015,0.35210808915016745,0.6478919108498326
4958,Digging for Fire,119364,119364,0,2015_boxofficemojo_rankings.csv,2015,1.0,0.0
4959,Valley of the Heart's Delight,119290,119290,0,2010_boxofficemojo_rankings.csv,2010,1.0,0.0
4960,Celine: Through the Eyes of the World,119274,0,119274,2010_boxofficemojo_rankings.csv,2010,0.0,1.0
4961,Remember the Goal,119100,119100,0,2016_boxofficemojo_rankings.csv,2016,1.0,0.0
4962,Until Forever 2016 Re-release,118795,105358,13437,2016_boxofficemojo_rankings.csv,2016,0.8868891788374932,0.11311082116250684
4963,Neither Heaven Nor Earth,118663,12810,105853,2015_boxofficemojo_rankings.csv,2015,0.10795277382166303,0.892047226178337
4964,The Levelling,118451,3040,115411,2017_boxofficemojo_rankings.csv,2017,0.025664620813669787,0.9743353791863302
4965,See What I'm Saying: The Deaf Entertainers Documentary,118206,118206,0,2010_boxofficemojo_rankings.csv,2010,1.0,0.0
4966,Styx 2018 Re-release,118188,70794,47394,2018_boxofficemojo_rankings.csv,2018,0.5989948218093207,0.40100517819067927
4967,Come to Daddy,117947,96713,21234,2020_boxofficemojo_rankings.csv,2020,0.8199699865193689,0.18003001348063113
4968,Victor,117755,117755,0,2016_boxofficemojo_rankings.csv,2016,1.0,0.0
4969,The Decoy Bride,117754,759,116995,2011_boxofficemojo_rankings.csv,2011,0.006445640912410619,0.9935543590875894
4970,Freakonomics,117678,101270,16408,2010_boxofficemojo_rankings.csv,2010,0.8605686704396743,0.13943132956032564
4971,Bisbee '17,117470,117470,0,2018_boxofficemojo_rankings.csv,2018,1.0,0.0
4972,George Takei's Allegiance 2018 Re-release,117162,117162,0,2018_boxofficemojo_rankings.csv,2018,1.0,0.0
4973,Jauja 2014 Re-release,117117,60231,56886,2014_boxofficemojo_rankings.csv,2014,0.5142805912036681,0.48571940879633185
4974,Skin,116863,0,116863,2019_boxofficemojo_rankings.csv,2019,0.0,1.0
4975,Gimme the Loot,116783,104442,12341,2013_boxofficemojo_rankings.csv,2013,0.8943253726997936,0.10567462730020637
4976,A Case of You,116559,4187,112372,2013_boxofficemojo_rankings.csv,2013,0.035921722046345625,0.9640782779536544
4977,The Undefeated,116381,116381,0,2011_boxofficemojo_rankings.csv,2011,1.0,0.0
4978,Touching Home,116353,116353,0,2010_boxofficemojo_rankings.csv,2010,1.0,0.0
4979,The Art of Flight,116134,0,116134,2012_boxofficemojo_rankings.csv,2012,0.0,1.0
4980,Sputnik,116062,18853,97209,2020_boxofficemojo_rankings.csv,2020,0.1624390412021161,0.8375609587978838
4981,Mob Psycho 100,115766,115766,0,2019_boxofficemojo_rankings.csv,2019,1.0,0.0
4982,I Am Divine,115739,81497,34242,2013_boxofficemojo_rankings.csv,2013,0.7041446703358418,0.2958553296641582
4983,Headshot,115511,1373,114138,2011_boxofficemojo_rankings.csv,2011,0.011886313857554691,0.9881136861424453
4984,Caged No More,114959,114959,0,2016_boxofficemojo_rankings.csv,2016,1.0,0.0
4985,Nostalgia,114603,114603,0,2018_boxofficemojo_rankings.csv,2018,1.0,0.0
4986,Sympathy for the Devil,114301,51150,63151,2019_boxofficemojo_rankings.csv,2019,0.44750264652102784,0.5524973534789722
4987,John McEnroe: In the Realm of Perfection,114289,90964,23325,2018_boxofficemojo_rankings.csv,2018,0.795912117526621,0.2040878824733789
4988,Ain't in It for My Health: A Film About Levon Helm,113966,113966,0,2013_boxofficemojo_rankings.csv,2013,1.0,0.0
4989,Bodied,113956,113956,0,2018_boxofficemojo_rankings.csv,2018,1.0,0.0
4990,The Woman Who Loves Giraffes,113858,113858,0,2019_boxofficemojo_rankings.csv,2019,1.0,0.0
4991,35 and Ticking,113794,113794,0,2011_boxofficemojo_rankings.csv,2011,1.0,0.0
4992,The Goonies 2015 Re-release,113538,113538,0,2015_boxofficemojo_rankings.csv,2015,1.0,0.0
4993,"We Love You, Sally Carmichael!",113435,113435,0,2017_boxofficemojo_rankings.csv,2017,1.0,0.0
4994,Abacus: Small Enough to Jail,113278,113278,0,2017_boxofficemojo_rankings.csv,2017,1.0,0.0
4995,God the Father,113276,113276,0,2014_boxofficemojo_rankings.csv,2014,1.0,0.0
4996,Burn 2012 Re-release,113173,113173,0,2012_boxofficemojo_rankings.csv,2012,1.0,0.0
4997,Road Hard,113169,113169,0,2015_boxofficemojo_rankings.csv,2015,1.0,0.0
4998,Police Story,113164,113164,0,2019_boxofficemojo_rankings.csv,2019,1.0,0.0
4999,Filmworker,112828,102609,10219,2018_boxofficemojo_rankings.csv,2018,0.9094285106533839,0.09057148934661609
5000,Follow Me: The Yoni Netanyahu Story,112679,112679,0,2012_boxofficemojo_rankings.csv,2012,1.0,0.0
5001,A Boy. A Girl. A Dream.,112552,112552,0,2018_boxofficemojo_rankings.csv,2018,1.0,0.0
5002,The Recall,112357,22943,89414,2017_boxofficemojo_rankings.csv,2017,0.20419733527951084,0.7958026647204891
5003,"Hale County This Morning, This Evening",112282,112282,0,2018_boxofficemojo_rankings.csv,2018,1.0,0.0
5004,The Dawn Wall,112191,112191,0,2018_boxofficemojo_rankings.csv,2018,1.0,0.0
5005,Penton: The John Penton Story,112159,112159,0,2014_boxofficemojo_rankings.csv,2014,1.0,0.0
5006,How Viktor 'The Garlic' Took Alexey 'The Stud' to the Nursing Home,112071,12954,99117,2017_boxofficemojo_rankings.csv,2017,0.11558744010493348,0.8844125598950665
5007,Marwencol,112036,112036,0,2010_boxofficemojo_rankings.csv,2010,1.0,0.0
5008,A Chance in the World,112007,112007,0,2018_boxofficemojo_rankings.csv,2018,1.0,0.0
5009,Una noche,111903,100887,11016,2013_boxofficemojo_rankings.csv,2013,0.9015575989919842,0.09844240100801586
5010,Saint John of Las Vegas,111731,102645,9086,2010_boxofficemojo_rankings.csv,2010,0.9186796860316295,0.08132031396837046
5011,1915,111682,111682,0,2015_boxofficemojo_rankings.csv,2015,1.0,0.0
5012,Rich Hill,111376,111376,0,2014_boxofficemojo_rankings.csv,2014,1.0,0.0
5013,Elevator to the Gallows 2016 Re-release,111267,111267,0,2016_boxofficemojo_rankings.csv,2016,1.0,0.0
5014,"Wild Horse, Wild Ride",111205,111205,0,2012_boxofficemojo_rankings.csv,2012,1.0,0.0
5015,A Paris Education,111197,21598,89599,2018_boxofficemojo_rankings.csv,2018,0.19423185877316834,0.8057681412268317
5016,Strangerland,111107,17472,93635,2015_boxofficemojo_rankings.csv,2015,0.15725381839128047,0.8427461816087195
5017,The Obama Effect,110904,110904,0,2012_boxofficemojo_rankings.csv,2012,1.0,0.0
5018,The Overnighters,110763,110763,0,2014_boxofficemojo_rankings.csv,2014,1.0,0.0
5019,Duran Duran: Unstaged,110746,110746,0,2014_boxofficemojo_rankings.csv,2014,1.0,0.0
5020,The Perfect Family,110313,110313,0,2012_boxofficemojo_rankings.csv,2012,1.0,0.0
5021,The Trouble with Terkel,110289,110289,0,2017_boxofficemojo_rankings.csv,2017,1.0,0.0
5022,Roar,110048,110048,0,2015_boxofficemojo_rankings.csv,2015,1.0,0.0
5023,Best Worst Movie,109895,109895,0,2010_boxofficemojo_rankings.csv,2010,1.0,0.0
5024,The Fifth Element 2017 Re-release,109786,0,109786,2017_boxofficemojo_rankings.csv,2017,0.0,1.0
5025,Babylon,109749,109749,0,2019_boxofficemojo_rankings.csv,2019,1.0,0.0
5026,Zero Days,109649,109649,0,2016_boxofficemojo_rankings.csv,2016,1.0,0.0
5027,Anohana the Movie: The Flower We Saw That Day (Ano hi mita hana no namae wo bokutachi wa mada shiran,109630,109630,0,2014_boxofficemojo_rankings.csv,2014,1.0,0.0
5028,Cameraperson,109464,102033,7431,2016_boxofficemojo_rankings.csv,2016,0.9321146678360008,0.06788533216399913
5029,Wedding Party 2,109459,11140,98319,2017_boxofficemojo_rankings.csv,2017,0.10177326670260098,0.898226733297399
5030,Blood Done Sign My Name,109383,109383,0,2010_boxofficemojo_rankings.csv,2010,1.0,0.0
5031,The Lure,108846,101657,7189,2017_boxofficemojo_rankings.csv,2017,0.9339525568234018,0.06604744317659814
5032,Adult Beginners,108808,108808,0,2015_boxofficemojo_rankings.csv,2015,1.0,0.0
5033,Sworn Virgin,108681,4636,104045,2015_boxofficemojo_rankings.csv,2015,0.042656950156881146,0.9573430498431188
5034,Red Sorghum,108371,0,108371,2018_boxofficemojo_rankings.csv,2018,0.0,1.0
5035,Violet & Daisy,108139,17186,90953,2013_boxofficemojo_rankings.csv,2013,0.15892508715634507,0.8410749128436549
5036,Bettie Page Reveals All,108118,108118,0,2013_boxofficemojo_rankings.csv,2013,1.0,0.0
5037,"Love, Cecil",107940,106057,1883,2017_boxofficemojo_rankings.csv,2017,0.9825551232166018,0.017444876783398185
5038,Kidnapping of Michel Houellebecq,107641,11546,96095,2014_boxofficemojo_rankings.csv,2014,0.10726396075844706,0.892736039241553
5039,Revenge of the Green Dragons,107412,0,107412,2014_boxofficemojo_rankings.csv,2014,0.0,1.0
5040,"No Date, No Signature",107368,36444,70924,2018_boxofficemojo_rankings.csv,2018,0.3394307428656583,0.6605692571343417
5041,Cockneys vs Zombies,107348,0,107348,2012_boxofficemojo_rankings.csv,2012,0.0,1.0
5042,National Theatre Live: Julius Caesar,107057,107057,0,2018_boxofficemojo_rankings.csv,2018,1.0,0.0
5043,Jeruzalem,107024,11287,95737,2016_boxofficemojo_rankings.csv,2016,0.10546232620720586,0.8945376737927941
5044,Best Worst Thing That Ever Could Have Happened...,106986,106986,0,2016_boxofficemojo_rankings.csv,2016,1.0,0.0
5045,The Tales of Hoffmann,106860,91930,14930,2015_boxofficemojo_rankings.csv,2015,0.8602844843720756,0.1397155156279244
5046,Ivory Tower,106771,106771,0,2014_boxofficemojo_rankings.csv,2014,1.0,0.0
5047,Vita Activa: The Spirit of Hannah Arendt,106768,82143,24625,2016_boxofficemojo_rankings.csv,2016,0.7693597332534092,0.23064026674659074
5048,Dekalog 2016 Re-release,106494,106494,0,2016_boxofficemojo_rankings.csv,2016,1.0,0.0
5049,Wrong,106425,46021,60404,2012_boxofficemojo_rankings.csv,2012,0.4324265914963589,0.567573408503641
5050,The Charmer,106379,26167,80212,2018_boxofficemojo_rankings.csv,2018,0.24597899961458558,0.7540210003854144
5051,Six Dance Lessons in Six Weeks,106323,106323,0,2014_boxofficemojo_rankings.csv,2014,1.0,0.0
5052,The Bachelors,106212,0,106212,2017_boxofficemojo_rankings.csv,2017,0.0,1.0
5053,The Brink,106057,106057,0,2019_boxofficemojo_rankings.csv,2019,1.0,0.0
5054,Big Star: Nothing Can Hurt Me,105998,105998,0,2013_boxofficemojo_rankings.csv,2013,1.0,0.0
5055,Never Heard,105271,105271,0,2018_boxofficemojo_rankings.csv,2018,1.0,0.0
5056,Cold Case Hammarskjöld,104965,104965,0,2019_boxofficemojo_rankings.csv,2019,1.0,0.0
5057,A Ciambra,104808,41934,62874,2017_boxofficemojo_rankings.csv,2017,0.4001030455690405,0.5998969544309595
5058,Dictator,104734,104734,0,2016_boxofficemojo_rankings.csv,2016,1.0,0.0
5059,Band Baaja Baaraat,104532,43820,60712,2010_boxofficemojo_rankings.csv,2010,0.4192017755328512,0.5807982244671488
5060,Results,104507,104507,0,2015_boxofficemojo_rankings.csv,2015,1.0,0.0
5061,Demon,104038,104038,0,2016_boxofficemojo_rankings.csv,2016,1.0,0.0
5062,The Investigator,103739,103739,0,2013_boxofficemojo_rankings.csv,2013,1.0,0.0
5063,Stevie Nicks: In Your Dreams,103028,103028,0,2013_boxofficemojo_rankings.csv,2013,1.0,0.0
5064,Lucky Grandma,102972,102000,972,2020_boxofficemojo_rankings.csv,2020,0.9905605407295187,0.009439459270481296
5065,Puerto Ricans in Paris,102890,102890,0,2016_boxofficemojo_rankings.csv,2016,1.0,0.0
5066,Brake,102819,4876,97943,2012_boxofficemojo_rankings.csv,2012,0.047423141637246036,0.952576858362754
5067,The Gracefield Incident,102256,0,102256,2017_boxofficemojo_rankings.csv,2017,0.0,1.0
5068,Tanna,102225,46654,55571,2016_boxofficemojo_rankings.csv,2016,0.45638542430912205,0.543614575690878
5069,Andrei Rublev 2018 Re-release,102021,102021,0,2018_boxofficemojo_rankings.csv,2018,1.0,0.0
5070,Becoming Traviata,102015,62652,39363,2013_boxofficemojo_rankings.csv,2013,0.6141449786796059,0.38585502132039406
5071,Tower,101987,101987,0,2016_boxofficemojo_rankings.csv,2016,1.0,0.0
5072,In the Family,101934,101934,0,2011_boxofficemojo_rankings.csv,2011,1.0,0.0
5073,Hotel by the River,101879,28354,73525,2019_boxofficemojo_rankings.csv,2019,0.2783105448620422,0.7216894551379578
5074,Kill Me Three Times,101807,24296,77511,2015_boxofficemojo_rankings.csv,2015,0.23864763719587062,0.7613523628041294
5075,Magnus,101739,8944,92795,2016_boxofficemojo_rankings.csv,2016,0.08791122381780832,0.9120887761821916
5076,Those Who Remained,101737,0,101737,2019_boxofficemojo_rankings.csv,2019,0.0,1.0
5077,Rubber,101729,100370,1359,2011_boxofficemojo_rankings.csv,2011,0.9866409774990416,0.01335902250095843
5078,Kickboxer: Retaliation,101690,4537,97153,2018_boxofficemojo_rankings.csv,2018,0.044615989772839024,0.955384010227161
5079,A Lego Brickumentary,101531,101531,0,2015_boxofficemojo_rankings.csv,2015,1.0,0.0
5080,Blazing Saddles 2013 Re-release,101481,101481,0,2013_boxofficemojo_rankings.csv,2013,1.0,0.0
5081,Man from Reno,101438,101438,0,2015_boxofficemojo_rankings.csv,2015,1.0,0.0
5082,James White,101368,101368,0,2015_boxofficemojo_rankings.csv,2015,1.0,0.0
5083,QT8: The First Eight,101346,51896,49450,2019_boxofficemojo_rankings.csv,2019,0.5120675705010558,0.4879324294989442
5084,Korengal,101310,101310,0,2014_boxofficemojo_rankings.csv,2014,1.0,0.0
5085,Feed the Fish,101170,101170,0,2010_boxofficemojo_rankings.csv,2010,1.0,0.0
5086,Beyond Sight: The Derek Rabelo Story,101074,101074,0,2014_boxofficemojo_rankings.csv,2014,1.0,0.0
5087,First Cow,101068,101068,0,2020_boxofficemojo_rankings.csv,2020,1.0,0.0
5088,Miss Juneteenth,100947,92349,8598,2020_boxofficemojo_rankings.csv,2020,0.9148265921721299,0.08517340782787007
5089,The Good Guy,100688,100688,0,2010_boxofficemojo_rankings.csv,2010,1.0,0.0
5090,The Man Who Fell to Earth,100468,100072,396,2011_boxofficemojo_rankings.csv,2011,0.996058446470518,0.003941553529482024
5091,The United States of Autism,100403,100403,0,2013_boxofficemojo_rankings.csv,2013,1.0,0.0
5092,One Track Heart: The Story of Krishna Das,100401,100401,0,2013_boxofficemojo_rankings.csv,2013,1.0,0.0
5093,All About Nina,100335,100335,0,2018_boxofficemojo_rankings.csv,2018,1.0,0.0
5094,8: The Mormon Proposition,100280,100280,0,2010_boxofficemojo_rankings.csv,2010,1.0,0.0
5095,Rejoice and Shout,100237,100237,0,2011_boxofficemojo_rankings.csv,2011,1.0,0.0
5096,Bhutto,100202,100202,0,2010_boxofficemojo_rankings.csv,2010,1.0,0.0
5097,White Lion,99635,0,99635,2010_boxofficemojo_rankings.csv,2010,0.0,1.0
5098,Papi Chulo,99546,84703,14843,2019_boxofficemojo_rankings.csv,2019,0.8508930544672815,0.14910694553271855
5099,The Roads Not Taken,99546,3518,96028,2020_boxofficemojo_rankings.csv,2020,0.035340445623129005,0.964659554376871
5100,Heavy Water,99503,55446,44057,2019_boxofficemojo_rankings.csv,2019,0.5572294302684341,0.44277056973156587
5101,Meow Wolf: Origin Story,99488,99488,0,2018_boxofficemojo_rankings.csv,2018,1.0,0.0
5102,Kings of the Evening,99270,99270,0,2010_boxofficemojo_rankings.csv,2010,1.0,0.0
5103,Cemetery of Splendor,98932,51950,46982,2015_boxofficemojo_rankings.csv,2015,0.5251081550964298,0.4748918449035701
5104,High Strung Free Dance 2019 Re-release,98481,83891,14590,2019_boxofficemojo_rankings.csv,2019,0.8518495953534184,0.14815040464658158
5105,Aida's Secrets,98468,98468,0,2017_boxofficemojo_rankings.csv,2017,1.0,0.0
5106,Reign of Judges: Title of Liberty - Concept Short,98408,93224,5184,2018_boxofficemojo_rankings.csv,2018,0.9473213559873181,0.052678644012681894
5107,Blind,98280,12522,85758,2017_boxofficemojo_rankings.csv,2017,0.1274114774114774,0.8725885225885226
5108,Charlie Says,98240,40685,57555,2019_boxofficemojo_rankings.csv,2019,0.41413884364820847,0.5858611563517915
5109,National Theatre Live: Macbeth,97857,97857,0,2018_boxofficemojo_rankings.csv,2018,1.0,0.0
5110,"Tim Timmerman, Hope of America",97727,97727,0,2017_boxofficemojo_rankings.csv,2017,1.0,0.0
5111,The Here After,97699,0,97699,2015_boxofficemojo_rankings.csv,2015,0.0,1.0
5112,In Bloom,97236,56092,41144,2013_boxofficemojo_rankings.csv,2013,0.5768645357686454,0.4231354642313546
5113,Difret,97205,49667,47538,2015_boxofficemojo_rankings.csv,2015,0.5109510827632323,0.48904891723676763
5114,Prassthanam,97204,19984,77220,2019_boxofficemojo_rankings.csv,2019,0.20558824739722645,0.7944117526027735
5115,A Field in England,97195,32846,64349,2013_boxofficemojo_rankings.csv,2013,0.3379391944030043,0.6620608055969958
5116,Little Monsters,97111,0,97111,2019_boxofficemojo_rankings.csv,2019,0.0,1.0
5117,Kisses 2010 Re-release,96933,81680,15253,2010_boxofficemojo_rankings.csv,2010,0.8426438880463826,0.15735611195361746
5118,A Little Help,96868,96868,0,2011_boxofficemojo_rankings.csv,2011,1.0,0.0
5119,Leviathan,96778,76202,20576,2013_boxofficemojo_rankings.csv,2013,0.7873896960052904,0.21261030399470954
5120,Singin' in the Rain 2013 Re-release,96763,96763,0,2013_boxofficemojo_rankings.csv,2013,1.0,0.0
5121,Hardflip,96734,96734,0,2012_boxofficemojo_rankings.csv,2012,1.0,0.0
5122,Sunshine Superman,96715,88097,8618,2015_boxofficemojo_rankings.csv,2015,0.9108928294473453,0.08910717055265471
5123,Godspeed: The Race Across America,96690,96690,0,2018_boxofficemojo_rankings.csv,2018,1.0,0.0
5124,A Poem Is a Naked Person,96592,96592,0,2015_boxofficemojo_rankings.csv,2015,1.0,0.0
5125,Dina,96524,90503,6021,2017_boxofficemojo_rankings.csv,2017,0.9376217313828685,0.06237826861713149
5126,Hiroshima Mon Amour 2014 Re-release,96439,96439,0,2014_boxofficemojo_rankings.csv,2014,1.0,0.0
5127,My Reincarnation,96115,92822,3293,2011_boxofficemojo_rankings.csv,2011,0.9657389585392498,0.034261041460750145
5128,A Bigger Splash 2019 Re-release,95826,95826,0,2019_boxofficemojo_rankings.csv,2019,1.0,0.0
5129,Saand Ki Aankh,95724,0,95724,2019_boxofficemojo_rankings.csv,2019,0.0,1.0
5130,Ardor,95549,18565,76984,2014_boxofficemojo_rankings.csv,2014,0.19429821348208773,0.8057017865179122
5131,The Lovers & the Despot,95521,55511,40010,2016_boxofficemojo_rankings.csv,2016,0.5811392259293768,0.4188607740706232
5132,The Final Wish,95215,25183,70032,2019_boxofficemojo_rankings.csv,2019,0.26448563776715855,0.7355143622328415
5133,The Night Eats the World,95208,0,95208,2018_boxofficemojo_rankings.csv,2018,0.0,1.0
5134,Queen of Earth,95183,91218,3965,2015_boxofficemojo_rankings.csv,2015,0.958343401657859,0.04165659834214093
5135,Saala Khadoos,94787,76931,17856,2016_boxofficemojo_rankings.csv,2016,0.8116197368837499,0.1883802631162501
5136,The Fight Within,94326,94326,0,2016_boxofficemojo_rankings.csv,2016,1.0,0.0
5137,Keep Watching,94178,94178,0,2017_boxofficemojo_rankings.csv,2017,1.0,0.0
5138,Blue Caprice,93995,93995,0,2013_boxofficemojo_rankings.csv,2013,1.0,0.0
5139,Let the Corpses Tan,93409,93409,0,2018_boxofficemojo_rankings.csv,2018,1.0,0.0
5140,First Lady,93298,93298,0,2020_boxofficemojo_rankings.csv,2020,1.0,0.0
5141,Will You Still Love Me Tomorrow?,93046,6694,86352,2013_boxofficemojo_rankings.csv,2013,0.07194290995851514,0.9280570900414848
5142,Vamps,92748,3361,89387,2012_boxofficemojo_rankings.csv,2012,0.03623797817742701,0.963762021822573
5143,The First Time,92654,22836,69818,2012_boxofficemojo_rankings.csv,2012,0.24646534418373733,0.7535346558162627
5144,American: The Bill Hicks Story,92234,92234,0,2011_boxofficemojo_rankings.csv,2011,1.0,0.0
5145,Into the Forest,92166,9995,82171,2016_boxofficemojo_rankings.csv,2016,0.10844563070980621,0.8915543692901938
5146,Nancy,92000,80115,11885,2018_boxofficemojo_rankings.csv,2018,0.8708152173913043,0.12918478260869565
5147,Generation War,91595,91595,0,2014_boxofficemojo_rankings.csv,2014,1.0,0.0
5148,Legends from the Sky,91462,91462,0,2015_boxofficemojo_rankings.csv,2015,1.0,0.0
5149,Other People,91441,91441,0,2016_boxofficemojo_rankings.csv,2016,1.0,0.0
5150,Evil Bong 3: The Wrath of Bong,91260,91260,0,2011_boxofficemojo_rankings.csv,2011,1.0,0.0
5151,Morris from America,91151,91151,0,2016_boxofficemojo_rankings.csv,2016,1.0,0.0
5152,A Kind of Murder,91149,2915,88234,2016_boxofficemojo_rankings.csv,2016,0.03198060318818638,0.9680193968118136
5153,Mapplethorpe,91002,91002,0,2019_boxofficemojo_rankings.csv,2019,1.0,0.0
5154,BANDSTAND: The Broadway Musical on Screen 2018 Re-release,91000,91000,0,2018_boxofficemojo_rankings.csv,2018,1.0,0.0
5155,Because of Grácia,90878,90878,0,2017_boxofficemojo_rankings.csv,2017,1.0,0.0
5156,Porto,90849,15126,75723,2017_boxofficemojo_rankings.csv,2017,0.16649605389162236,0.8335039461083776
5157,Heroic Antics,90785,63649,27136,2014_boxofficemojo_rankings.csv,2014,0.7010959960345872,0.2989040039654128
5158,Beasts of No Nation,90777,90777,0,2015_boxofficemojo_rankings.csv,2015,1.0,0.0
5159,Yuri!!! On Ice,90751,81878,8873,2018_boxofficemojo_rankings.csv,2018,0.902226972705535,0.09777302729446508
5160,Loopers: The Caddie's Long Walk,90679,90679,0,2019_boxofficemojo_rankings.csv,2019,1.0,0.0
5161,Moonwalkers,90646,0,90646,2016_boxofficemojo_rankings.csv,2016,0.0,1.0
5162,The Good Neighbor,90573,0,90573,2016_boxofficemojo_rankings.csv,2016,0.0,1.0
5163,Fireworks Wednesday 2016 Re-release,90519,90519,0,2016_boxofficemojo_rankings.csv,2016,1.0,0.0
5164,Minding the Gap,90328,11998,78330,2018_boxofficemojo_rankings.csv,2018,0.1328270303781773,0.8671729696218227
5165,Dark Horse,90136,90136,0,2015_boxofficemojo_rankings.csv,2015,1.0,0.0
5166,King's Faith,90106,90106,0,2013_boxofficemojo_rankings.csv,2013,1.0,0.0
5167,Running for Grace,89988,89988,0,2018_boxofficemojo_rankings.csv,2018,1.0,0.0
5168,Pump,89787,89787,0,2014_boxofficemojo_rankings.csv,2014,1.0,0.0
5169,The Principle,89543,89543,0,2014_boxofficemojo_rankings.csv,2014,1.0,0.0
5170,Oy Vey! My Son Is Gay!!,89507,89507,0,2010_boxofficemojo_rankings.csv,2010,1.0,0.0
5171,Somebody Up There Likes Me,89435,89435,0,2013_boxofficemojo_rankings.csv,2013,1.0,0.0
5172,Cat on a Hot Tin Roof,89332,89332,0,2018_boxofficemojo_rankings.csv,2018,1.0,0.0
5173,Salvation Boulevard,89182,28468,60714,2011_boxofficemojo_rankings.csv,2011,0.31921239712049515,0.6807876028795048
5174,Night of the Living Dead,89029,89029,0,2017_boxofficemojo_rankings.csv,2017,1.0,0.0
5175,This Is Not a Film,88758,77016,11742,2012_boxofficemojo_rankings.csv,2012,0.8677076995876428,0.1322923004123572
5176,The Lumber Baron,88336,88336,0,2019_boxofficemojo_rankings.csv,2019,1.0,0.0
5177,Crazy on the Outside,88335,88335,0,2010_boxofficemojo_rankings.csv,2010,1.0,0.0
5178,Jewtopia,88327,46437,41890,2013_boxofficemojo_rankings.csv,2013,0.5257395813284726,0.4742604186715274
5179,Money for Nothing: Inside the Federal Reserve,88045,88045,0,2013_boxofficemojo_rankings.csv,2013,1.0,0.0
5180,Jim Allison: Breakthrough,87984,87984,0,2019_boxofficemojo_rankings.csv,2019,1.0,0.0
5181,Hyena Road,87768,1430,86338,2015_boxofficemojo_rankings.csv,2015,0.01629295415185489,0.9837070458481451
5182,The Cartel,87763,87763,0,2010_boxofficemojo_rankings.csv,2010,1.0,0.0
5183,Ocean Waves,87738,87738,0,2016_boxofficemojo_rankings.csv,2016,1.0,0.0
5184,Glory,87728,18415,69313,2017_boxofficemojo_rankings.csv,2017,0.2099101769104505,0.7900898230895496
5185,Exporting Raymond,87727,87727,0,2011_boxofficemojo_rankings.csv,2011,1.0,0.0
5186,Author: The JT LeRoy Story,87686,85999,1687,2016_boxofficemojo_rankings.csv,2016,0.9807608968364391,0.019239103163560888
5187,Goldstone 2018 Re-release,87639,87639,0,2018_boxofficemojo_rankings.csv,2018,1.0,0.0
5188,ECCO,86858,86858,0,2019_boxofficemojo_rankings.csv,2019,1.0,0.0
5189,Singularity,86822,4176,82646,2017_boxofficemojo_rankings.csv,2017,0.04809840823754348,0.9519015917624565
5190,Vault,86741,29491,57250,2019_boxofficemojo_rankings.csv,2019,0.3399891631408446,0.6600108368591554
5191,Gueros,86736,60114,26622,2015_boxofficemojo_rankings.csv,2015,0.6930686220254566,0.30693137797454345
5192,School Life,86616,37381,49235,2017_boxofficemojo_rankings.csv,2017,0.4315715341276439,0.5684284658723562
5193,Beuys,86451,65410,21041,2018_boxofficemojo_rankings.csv,2018,0.7566135730066743,0.2433864269933257
5194,"My Love, Don't Cross That River 2016 Re-release",86446,86446,0,2016_boxofficemojo_rankings.csv,2016,1.0,0.0
5195,National Theater Live: Cyrano de Bergerac,86300,86300,0,2019_boxofficemojo_rankings.csv,2019,1.0,0.0
5196,Crazy Wisdom: The Life & Times of Chogyam Trungpa Rinpoche,86202,86202,0,2011_boxofficemojo_rankings.csv,2011,1.0,0.0
5197,Rapt 2011 Re-release,86028,45759,40269,2011_boxofficemojo_rankings.csv,2011,0.5319082159296973,0.4680917840703027
5198,Mudbound,85955,0,85955,2017_boxofficemojo_rankings.csv,2017,0.0,1.0
5199,Tab Hunter Confidential,85812,85812,0,2015_boxofficemojo_rankings.csv,2015,1.0,0.0
5200,Jackals,85410,0,85410,2017_boxofficemojo_rankings.csv,2017,0.0,1.0
5201,Skid Row Marathon,84997,84997,0,2019_boxofficemojo_rankings.csv,2019,1.0,0.0
5202,Waking Sleeping Beauty,84918,80741,4177,2010_boxofficemojo_rankings.csv,2010,0.9508113709696413,0.0491886290303587
5203,Ran 2016 Re-release,84789,66097,18692,2016_boxofficemojo_rankings.csv,2016,0.779546875184281,0.22045312481571902
5204,Wretches & Jabberers,84610,84610,0,2011_boxofficemojo_rankings.csv,2011,1.0,0.0
5205,Visitors,84577,84577,0,2014_boxofficemojo_rankings.csv,2014,1.0,0.0
5206,Woodstock,84440,84440,0,2019_boxofficemojo_rankings.csv,2019,1.0,0.0
5207,Heaven Knows What,84417,80734,3683,2015_boxofficemojo_rankings.csv,2015,0.9563713470035656,0.04362865299643437
5208,The Diabolical,84259,0,84259,2015_boxofficemojo_rankings.csv,2015,0.0,1.0
5209,Chapter & Verse,84147,84147,0,2017_boxofficemojo_rankings.csv,2017,1.0,0.0
5210,Los Sures,83992,83992,0,2016_boxofficemojo_rankings.csv,2016,1.0,0.0
5211,The Disappearance of My Mother,83930,24951,58979,2019_boxofficemojo_rankings.csv,2019,0.29728345049445964,0.7027165495055403
5212,"Nico, 1988",83558,73304,10254,2018_boxofficemojo_rankings.csv,2018,0.8772828454486704,0.12271715455132962
5213,Young Ahmed Domestic,83470,21291,62179,2020_boxofficemojo_rankings.csv,2020,0.25507367916616747,0.7449263208338325
5214,The Look,83137,19988,63149,2011_boxofficemojo_rankings.csv,2011,0.2404224352574666,0.7595775647425335
5215,The Kindness of Strangers,83042,2705,80337,2019_boxofficemojo_rankings.csv,2019,0.032573878278461504,0.9674261217215385
5216,Hateship Loveship,83008,54030,28978,2014_boxofficemojo_rankings.csv,2014,0.6509011179645335,0.34909888203546646
5217,Alien Abduction,82725,12897,69828,2014_boxofficemojo_rankings.csv,2014,0.15590208522212148,0.8440979147778785
5218,Doctor Who: The Woman Who Fell to Earth,82698,82698,0,2018_boxofficemojo_rankings.csv,2018,1.0,0.0
5219,12 O'Clock Boys,82614,82614,0,2014_boxofficemojo_rankings.csv,2014,1.0,0.0
5220,V/H/S Viral,82409,2756,79653,2014_boxofficemojo_rankings.csv,2014,0.033442949192442575,0.9665570508075574
5221,The Treasure,82392,50203,32189,2016_boxofficemojo_rankings.csv,2016,0.6093188659093116,0.39068113409068844
5222,Water & Power,82312,82312,0,2014_boxofficemojo_rankings.csv,2014,1.0,0.0
5223,Prey,82258,0,82258,2019_boxofficemojo_rankings.csv,2019,0.0,1.0
5224,Careful What You Wish For,82230,0,82230,2015_boxofficemojo_rankings.csv,2015,0.0,1.0
5225,On the Basis of Sex 2020 Re-release,82150,82150,0,2020_boxofficemojo_rankings.csv,2020,1.0,0.0
5226,The Whale,81881,81881,0,2011_boxofficemojo_rankings.csv,2011,1.0,0.0
5227,King Cobra,81757,81757,0,2016_boxofficemojo_rankings.csv,2016,1.0,0.0
5228,Inkubus,81600,81600,0,2011_boxofficemojo_rankings.csv,2011,1.0,0.0
5229,Hating Breitbart,81432,81432,0,2012_boxofficemojo_rankings.csv,2012,1.0,0.0
5230,The Girl in the Book,81379,8245,73134,2015_boxofficemojo_rankings.csv,2015,0.10131606434092333,0.8986839356590767
5231,Yomeddine,81030,11308,69722,2018_boxofficemojo_rankings.csv,2018,0.139553251882019,0.8604467481179809
5232,The Island President,80996,76398,4598,2012_boxofficemojo_rankings.csv,2012,0.9432317645315818,0.05676823546841819
5233,Burning Bush,80943,16731,64212,2013_boxofficemojo_rankings.csv,2013,0.2067010118231348,0.7932989881768652
5234,Woman Walks Ahead,80912,57528,23384,2018_boxofficemojo_rankings.csv,2018,0.7109946608661262,0.28900533913387383
5235,Taur Mittran Di,80879,69510,11369,2012_boxofficemojo_rankings.csv,2012,0.8594319909988996,0.14056800900110042
5236,Kind Hearts and Coronets 2019 Re-release,80795,35948,44847,2019_boxofficemojo_rankings.csv,2019,0.444928522804629,0.555071477195371
5237,Nasty Baby,80772,79800,972,2015_boxofficemojo_rankings.csv,2015,0.98796612687565,0.012033873124350022
5238,Trace Amounts,80735,80735,0,2015_boxofficemojo_rankings.csv,2015,1.0,0.0
5239,Batman Returns 2019 Re-release,80699,70642,10057,2019_boxofficemojo_rankings.csv,2019,0.8753763987162171,0.12462360128378294
5240,Ms. Purple,80657,80657,0,2019_boxofficemojo_rankings.csv,2019,1.0,0.0
5241,Enemies of the People,80654,73171,7483,2010_boxofficemojo_rankings.csv,2010,0.9072209685818434,0.09277903141815658
5242,Winnie Mandela,80634,80634,0,2013_boxofficemojo_rankings.csv,2013,1.0,0.0
5243,Always Kabhi Kabhi,80546,21381,59165,2011_boxofficemojo_rankings.csv,2011,0.26545079830159163,0.7345492016984083
5244,Armstrong,80169,19740,60429,2019_boxofficemojo_rankings.csv,2019,0.24622983946413202,0.753770160535868
5245,For the Love of Spock,80141,80141,0,2016_boxofficemojo_rankings.csv,2016,1.0,0.0
5246,Inhale,80112,4115,75997,2010_boxofficemojo_rankings.csv,2010,0.051365588176552825,0.9486344118234472
5247,Ramaiya Vastavaiya,80108,80108,0,2013_boxofficemojo_rankings.csv,2013,1.0,0.0
5248,En el séptimo día,79887,79887,0,2018_boxofficemojo_rankings.csv,2018,1.0,0.0
5249,Aurangzeb,79665,0,79665,2013_boxofficemojo_rankings.csv,2013,0.0,1.0
5250,Harvest of Empire,79627,79627,0,2012_boxofficemojo_rankings.csv,2012,1.0,0.0
5251,Camp X-Ray,79624,13302,66322,2014_boxofficemojo_rankings.csv,2014,0.16706018285943935,0.8329398171405606
5252,End of the Century,79607,66309,13298,2019_boxofficemojo_rankings.csv,2019,0.832954388433178,0.16704561156682202
5253,Jayne Mansfield's Car,79178,14836,64342,2013_boxofficemojo_rankings.csv,2013,0.18737528101240244,0.8126247189875976
5254,Concussion,78957,42606,36351,2013_boxofficemojo_rankings.csv,2013,0.5396101675595577,0.4603898324404423
5255,Fort McCoy,78948,78948,0,2014_boxofficemojo_rankings.csv,2014,1.0,0.0
5256,Christ Stopped at Eboli,78736,78736,0,2019_boxofficemojo_rankings.csv,2019,1.0,0.0
5257,The Boxcar Children - Surprise Island,78676,78676,0,2018_boxofficemojo_rankings.csv,2018,1.0,0.0
5258,Blackbird,78400,78400,0,2015_boxofficemojo_rankings.csv,2015,1.0,0.0
5259,Harold and Lillian: A Hollywood Love Story,78301,78301,0,2017_boxofficemojo_rankings.csv,2017,1.0,0.0
5260,Colliding Dreams,78288,78288,0,2016_boxofficemojo_rankings.csv,2016,1.0,0.0
5261,Anesthesia,78270,32163,46107,2016_boxofficemojo_rankings.csv,2016,0.41092372556535073,0.5890762744346493
5262,Un traductor,78075,13509,64566,2018_boxofficemojo_rankings.csv,2018,0.17302593659942364,0.8269740634005763
5263,Jodi Breakers,78024,52618,25406,2012_boxofficemojo_rankings.csv,2012,0.6743822413616323,0.32561775863836767
5264,Table No. 21,77621,46720,30901,2013_boxofficemojo_rankings.csv,2013,0.6018989706393888,0.39810102936061115
5265,Chevalier,77590,25696,51894,2015_boxofficemojo_rankings.csv,2015,0.3311766980280964,0.6688233019719036
5266,Circo,77466,77466,0,2011_boxofficemojo_rankings.csv,2011,1.0,0.0
5267,The Art of the Steal,77450,64065,13385,2014_boxofficemojo_rankings.csv,2014,0.8271788250484183,0.17282117495158167
5268,Breaking Upwards,77389,77389,0,2010_boxofficemojo_rankings.csv,2010,1.0,0.0
5269,To Catch a Dollar: Muhammad Yunus Banks on America,77142,77142,0,2011_boxofficemojo_rankings.csv,2011,1.0,0.0
5270,Parchi,77110,69431,7679,2018_boxofficemojo_rankings.csv,2018,0.9004149915704838,0.09958500842951627
5271,The Missing Picture,76933,52164,24769,2014_boxofficemojo_rankings.csv,2014,0.6780445322553391,0.32195546774466094
5272,Fast Color,76916,76916,0,2019_boxofficemojo_rankings.csv,2019,1.0,0.0
5273,Eisenstein in Guanajuato 2015 Re-release,76713,34282,42431,2015_boxofficemojo_rankings.csv,2015,0.4468864468864469,0.5531135531135531
5274,Mademoiselle C,76621,48668,27953,2013_boxofficemojo_rankings.csv,2013,0.6351783453622375,0.3648216546377625
5275,The New Rijksmuseum - The Film,76460,40578,35882,2015_boxofficemojo_rankings.csv,2015,0.5307088673816375,0.4692911326183625
5276,Night Catches Us,76185,76185,0,2010_boxofficemojo_rankings.csv,2010,1.0,0.0
5277,Don't Blink,76134,76134,0,2016_boxofficemojo_rankings.csv,2016,1.0,0.0
5278,93Queen,76056,76056,0,2018_boxofficemojo_rankings.csv,2018,1.0,0.0
5279,Greener Grass,76045,51456,24589,2019_boxofficemojo_rankings.csv,2019,0.6766519823788546,0.3233480176211454
5280,Whitey: United States of America v. James J. Bulger,75881,75881,0,2014_boxofficemojo_rankings.csv,2014,1.0,0.0
5281,Wish You Were Here 2013 Re-release,75870,46347,29523,2013_boxofficemojo_rankings.csv,2013,0.6108738631870304,0.38912613681296954
5282,Into the White 2013 Re-release,75747,704,75043,2013_boxofficemojo_rankings.csv,2013,0.009294097456004858,0.9907059025439952
5283,Touch Me Not,75507,13782,61725,2018_boxofficemojo_rankings.csv,2018,0.18252612340577695,0.8174738765942231
5284,The Riot Act,75506,75506,0,2018_boxofficemojo_rankings.csv,2018,1.0,0.0
5285,Swim Little Fish Swim,75504,3877,71627,2014_boxofficemojo_rankings.csv,2014,0.05134827293918203,0.948651727060818
5286,Bill Nye: Science Guy,74909,74909,0,2017_boxofficemojo_rankings.csv,2017,1.0,0.0
5287,Where Is Kyra?,74821,59717,15104,2018_boxofficemojo_rankings.csv,2018,0.7981315406102565,0.20186845938974352
5288,The Ornithologist,74714,50511,24203,2016_boxofficemojo_rankings.csv,2016,0.6760580346387558,0.3239419653612442
5289,Above and Beyond: NASA's Journey to Tomorrow,74711,74711,0,2018_boxofficemojo_rankings.csv,2018,1.0,0.0
5290,Batkid Begins: The Wish Heard Around the World,74709,74709,0,2015_boxofficemojo_rankings.csv,2015,1.0,0.0
5291,The Monster,74700,12544,62156,2016_boxofficemojo_rankings.csv,2016,0.16792503346720214,0.8320749665327979
5292,We Come as Friends,74633,50921,23712,2014_boxofficemojo_rankings.csv,2014,0.6822853161470127,0.3177146838529873
5293,Hadewijch,74586,5006,69580,2010_boxofficemojo_rankings.csv,2010,0.0671171533531762,0.9328828466468237
5294,Stations of the Cross,74509,1505,73004,2014_boxofficemojo_rankings.csv,2014,0.02019890214604947,0.9798010978539505
5295,Made in Bangladesh,74432,5322,69110,2019_boxofficemojo_rankings.csv,2019,0.07150150472914875,0.9284984952708513
5296,Reset,74341,5454,68887,2016_boxofficemojo_rankings.csv,2016,0.07336463055379938,0.9266353694462006
5297,The Boy Downstairs,73988,13638,60350,2018_boxofficemojo_rankings.csv,2018,0.1843271881926799,0.8156728118073201
5298,The Keeping Room,73922,27166,46756,2015_boxofficemojo_rankings.csv,2015,0.3674954681962068,0.6325045318037932
5299,After Auschwitz,73885,73885,0,2018_boxofficemojo_rankings.csv,2018,1.0,0.0
5300,War Pigs,73701,0,73701,2015_boxofficemojo_rankings.csv,2015,0.0,1.0
5301,Wait for Your Laugh,73585,73585,0,2017_boxofficemojo_rankings.csv,2017,1.0,0.0
5302,Prodigal Sons,73544,73544,0,2010_boxofficemojo_rankings.csv,2010,1.0,0.0
5303,On the Ice,73492,73492,0,2012_boxofficemojo_rankings.csv,2012,1.0,0.0
5304,Primal Rage: The Legend of Konga,73383,21497,51886,2018_boxofficemojo_rankings.csv,2018,0.2929425071201777,0.7070574928798223
5305,Vengeance: A Love Story,73270,4526,68744,2017_boxofficemojo_rankings.csv,2017,0.06177152995769073,0.9382284700423092
5306,Te Ata,73236,73236,0,2017_boxofficemojo_rankings.csv,2017,1.0,0.0
5307,Antonio Lopez 1970: Sex Fashion & Disco,73122,43169,29953,2018_boxofficemojo_rankings.csv,2018,0.5903695194332759,0.40963048056672413
5308,Buster's Mal Heart,73121,73121,0,2017_boxofficemojo_rankings.csv,2017,1.0,0.0
5309,Headshot,73010,0,73010,2017_boxofficemojo_rankings.csv,2017,0.0,1.0
5310,5B,72968,72968,0,2019_boxofficemojo_rankings.csv,2019,1.0,0.0
5311,Do Not Resist,72791,72791,0,2016_boxofficemojo_rankings.csv,2016,1.0,0.0
5312,The Green Wave,72152,0,72152,2011_boxofficemojo_rankings.csv,2011,0.0,1.0
5313,Partisan,72151,0,72151,2015_boxofficemojo_rankings.csv,2015,0.0,1.0
5314,After Tiller,72125,72125,0,2013_boxofficemojo_rankings.csv,2013,1.0,0.0
5315,Veil of Tears,72078,72078,0,2014_boxofficemojo_rankings.csv,2014,1.0,0.0
5316,The Invisible War,71968,71968,0,2012_boxofficemojo_rankings.csv,2012,1.0,0.0
5317,The Chambermaid Lynn,71918,315,71603,2015_boxofficemojo_rankings.csv,2015,0.004379988320031147,0.9956200116799688
5318,Raiders!: The Story of the Greatest Fan Film Ever Made,71916,71916,0,2016_boxofficemojo_rankings.csv,2016,1.0,0.0
5319,Come and See 2020 Re-release,71909,71909,0,2020_boxofficemojo_rankings.csv,2020,1.0,0.0
5320,An Oversimplification of Her Beauty,71906,71906,0,2013_boxofficemojo_rankings.csv,2013,1.0,0.0
5321,As I Lay Dying,71759,16697,55062,2013_boxofficemojo_rankings.csv,2013,0.23268161484970526,0.7673183851502947
5322,Runaway Slave,71737,71737,0,2012_boxofficemojo_rankings.csv,2012,1.0,0.0
5323,Flamenco Flamenco 2014 Re-release,71732,71732,0,2014_boxofficemojo_rankings.csv,2014,1.0,0.0
5324,"Je t'aime, je t'aime 2014 Re-release",71717,71717,0,2014_boxofficemojo_rankings.csv,2014,1.0,0.0
5325,The Congressman,71451,71451,0,2016_boxofficemojo_rankings.csv,2016,1.0,0.0
5326,The Sicilian Girl 2010 Re-release,71239,71239,0,2010_boxofficemojo_rankings.csv,2010,1.0,0.0
5327,My Journey Through French Cinema,71174,52214,18960,2016_boxofficemojo_rankings.csv,2016,0.7336105881361171,0.2663894118638829
5328,Free Trip to Egypt 2019 Re-release,71087,71087,0,2019_boxofficemojo_rankings.csv,2019,1.0,0.0
5329,Rosencrantz and Guildenstern Are Undead,71007,71007,0,2010_boxofficemojo_rankings.csv,2010,1.0,0.0
5330,Freaks of Nature,70958,70958,0,2015_boxofficemojo_rankings.csv,2015,1.0,0.0
5331,Norman Lear: Just Another Version of You,70950,70950,0,2016_boxofficemojo_rankings.csv,2016,1.0,0.0
5332,The Better Angels,70918,70918,0,2014_boxofficemojo_rankings.csv,2014,1.0,0.0
5333,4:44 Last Day on Earth,70851,17801,53050,2012_boxofficemojo_rankings.csv,2012,0.2512455716927072,0.7487544283072928
5334,Miss Lovely,70845,0,70845,2014_boxofficemojo_rankings.csv,2014,0.0,1.0
5335,How to Build a Girl,70632,70632,0,2020_boxofficemojo_rankings.csv,2020,1.0,0.0
5336,Seasons of Gray,70605,70605,0,2013_boxofficemojo_rankings.csv,2013,1.0,0.0
5337,Fireflies in the Garden 2011 Re-release,70600,70600,0,2011_boxofficemojo_rankings.csv,2011,1.0,0.0
5338,Go for Sisters,70495,70495,0,2013_boxofficemojo_rankings.csv,2013,1.0,0.0
5339,The Fog 2018 Re-release,70421,70421,0,2018_boxofficemojo_rankings.csv,2018,1.0,0.0
5340,Over Your Cities Grass Will Grow,70256,51301,18955,2010_boxofficemojo_rankings.csv,2010,0.7302009792757914,0.2697990207242086
5341,Wastelander,70045,70045,0,2018_boxofficemojo_rankings.csv,2018,1.0,0.0
5342,Nick Mason's Saucerful of Secrets: Live at the Roundhouse,69967,32444,37523,2020_boxofficemojo_rankings.csv,2020,0.4637043177497963,0.5362956822502036
5343,Turn It Around: The Story of East Bay Punk,69787,69787,0,2017_boxofficemojo_rankings.csv,2017,1.0,0.0
5344,Assassination of a High School President,69564,0,69564,2010_boxofficemojo_rankings.csv,2010,0.0,1.0
5345,Chef Flynn,69542,68407,1135,2018_boxofficemojo_rankings.csv,2018,0.9836789278421674,0.016321072157832676
5346,Back to the Jurassic,69423,4351,65072,2015_boxofficemojo_rankings.csv,2015,0.0626737536551287,0.9373262463448713
5347,An Inconsistent Truth,69394,69394,0,2012_boxofficemojo_rankings.csv,2012,1.0,0.0
5348,Siddharth,69310,60537,8773,2014_boxofficemojo_rankings.csv,2014,0.8734237483768575,0.1265762516231424
5349,Rocky Handsome,69289,0,69289,2016_boxofficemojo_rankings.csv,2016,0.0,1.0
5350,Bajatey Raho,69085,55397,13688,2013_boxofficemojo_rankings.csv,2013,0.8018672649634508,0.19813273503654918
5351,The White Sheik 2019 re-release,68940,50850,18090,2019_boxofficemojo_rankings.csv,2019,0.737597911227154,0.26240208877284593
5352,My Entire High School Sinking Into the Sea,68883,68883,0,2017_boxofficemojo_rankings.csv,2017,1.0,0.0
5353,Klown 2012 Re-release,68795,68795,0,2012_boxofficemojo_rankings.csv,2012,1.0,0.0
5354,Strange Powers: Stephin Merritt and the Magnetic Fields,68719,68719,0,2010_boxofficemojo_rankings.csv,2010,1.0,0.0
5355,Noma: My Perfect Storm,68622,21130,47492,2015_boxofficemojo_rankings.csv,2015,0.30791874326017893,0.692081256739821
5356,Take Me to the River,68598,68598,0,2014_boxofficemojo_rankings.csv,2014,1.0,0.0
5357,Mastizaade,68583,43403,25180,2016_boxofficemojo_rankings.csv,2016,0.6328536226178499,0.3671463773821501
5358,Wildflower,68577,18062,50515,2016_boxofficemojo_rankings.csv,2016,0.2633827668168628,0.7366172331831372
5359,Outside In,68492,68492,0,2018_boxofficemojo_rankings.csv,2018,1.0,0.0
5360,Alive and Kicking,68485,68485,0,2017_boxofficemojo_rankings.csv,2017,1.0,0.0
5361,Last Year at Marienbad 2019 Re-release,68402,63425,4977,2019_boxofficemojo_rankings.csv,2019,0.9272389696207713,0.07276103037922868
5362,Budrus,68353,68353,0,2010_boxofficemojo_rankings.csv,2010,1.0,0.0
5363,2012: Time for Change,68339,68339,0,2010_boxofficemojo_rankings.csv,2010,1.0,0.0
5364,The Eyes of Orson Welles,68328,10253,58075,2018_boxofficemojo_rankings.csv,2018,0.15005561409670998,0.84994438590329
5365,10x10,68260,2263,65997,2018_boxofficemojo_rankings.csv,2018,0.033152651626135364,0.9668473483738647
5366,Maidentrip,68243,68243,0,2013_boxofficemojo_rankings.csv,2013,1.0,0.0
5367,Le Amiche,68167,68167,0,2010_boxofficemojo_rankings.csv,2010,1.0,0.0
5368,¡He matado a mi marido!,68017,45777,22240,2019_boxofficemojo_rankings.csv,2019,0.6730229207404032,0.32697707925959685
5369,I Am Big Bird: The Caroll Spinney Story,67845,67845,0,2015_boxofficemojo_rankings.csv,2015,1.0,0.0
5370,The Messenger,67816,67816,0,2015_boxofficemojo_rankings.csv,2015,1.0,0.0
5371,Summer in the Forest,67743,45542,22201,2017_boxofficemojo_rankings.csv,2017,0.6722761023279158,0.3277238976720842
5372,Sanam Teri Kasam,67736,22121,45615,2016_boxofficemojo_rankings.csv,2016,0.32657670957836304,0.673423290421637
5373,The Greasy Strangler,67427,45878,21549,2016_boxofficemojo_rankings.csv,2016,0.6804099248075697,0.3195900751924303
5374,For No Good Reason,67421,67421,0,2014_boxofficemojo_rankings.csv,2014,1.0,0.0
5375,Making the Five Heartbeats,67415,67415,0,2018_boxofficemojo_rankings.csv,2018,1.0,0.0
5376,Being Frank,67343,67343,0,2019_boxofficemojo_rankings.csv,2019,1.0,0.0
5377,The Doctor from India,67136,67136,0,2018_boxofficemojo_rankings.csv,2018,1.0,0.0
5378,The Sun Behind the Clouds: Tibet's Struggle for Freedom,67095,67095,0,2010_boxofficemojo_rankings.csv,2010,1.0,0.0
5379,The Autobiography of Nicolae Ceausescu,67093,34023,33070,2010_boxofficemojo_rankings.csv,2010,0.5071020821844305,0.4928979178155694
5380,Turbo Kid,67069,67069,0,2015_boxofficemojo_rankings.csv,2015,1.0,0.0
5381,Side by Side,67054,58825,8229,2012_boxofficemojo_rankings.csv,2012,0.8772780147343932,0.12272198526560682
5382,"3100, Run and Become",66789,65524,1265,2018_boxofficemojo_rankings.csv,2018,0.9810597553489347,0.018940244651065294
5383,Pandora's Promise,66680,66680,0,2013_boxofficemojo_rankings.csv,2013,1.0,0.0
5384,Max Rose,66680,66680,0,2016_boxofficemojo_rankings.csv,2016,1.0,0.0
5385,King Georges,66175,66175,0,2016_boxofficemojo_rankings.csv,2016,1.0,0.0
5386,Dancing Across Borders,66166,66166,0,2010_boxofficemojo_rankings.csv,2010,1.0,0.0
5387,Out in the Dark,66017,26966,39051,2013_boxofficemojo_rankings.csv,2013,0.4084705454655619,0.5915294545344381
5388,D-Day,65536,0,65536,2013_boxofficemojo_rankings.csv,2013,0.0,1.0
5389,Architects of Denial,65424,65424,0,2017_boxofficemojo_rankings.csv,2017,1.0,0.0
5390,Sing Your Song,65310,47718,17592,2012_boxofficemojo_rankings.csv,2012,0.730638493339458,0.26936150666054204
5391,You've Been Trumped,65220,29273,35947,2012_boxofficemojo_rankings.csv,2012,0.44883471327813557,0.5511652867218645
5392,Through a Lens Darkly: Black Photographers and the Emergence of a People,65169,65169,0,2014_boxofficemojo_rankings.csv,2014,1.0,0.0
5393,The Lesson,65142,9045,56097,2015_boxofficemojo_rankings.csv,2015,0.13885051119093672,0.8611494888090633
5394,Racing Dreams,65082,65082,0,2010_boxofficemojo_rankings.csv,2010,1.0,0.0
5395,Toys in the Attic 2012 Re-release,64918,64918,0,2012_boxofficemojo_rankings.csv,2012,1.0,0.0
5396,Manolo: the Boy Who Made Shoes for Lizards,64889,60056,4833,2017_boxofficemojo_rankings.csv,2017,0.9255189631524604,0.07448103684753965
5397,Searching for Ingmar Bergman,64742,36686,28056,2018_boxofficemojo_rankings.csv,2018,0.5666491612863366,0.4333508387136635
5398,The Jesus Rolls,64648,18169,46479,2019_boxofficemojo_rankings.csv,2019,0.2810450439302067,0.7189549560697933
5399,"Monrovia, Indiana",64596,63944,652,2018_boxofficemojo_rankings.csv,2018,0.9899064957582513,0.010093504241748714
5400,Battle of the Brides,64572,64572,0,2011_boxofficemojo_rankings.csv,2011,1.0,0.0
5401,Let the Fire Burn,64489,64489,0,2013_boxofficemojo_rankings.csv,2013,1.0,0.0
5402,Badmaa$h Company,64398,0,64398,2010_boxofficemojo_rankings.csv,2010,0.0,1.0
5403,Paulette 2015 Re-release,64125,29494,34631,2015_boxofficemojo_rankings.csv,2015,0.4599454191033138,0.5400545808966861
5404,Girl Asleep,64056,60289,3767,2016_boxofficemojo_rankings.csv,2016,0.9411920819283127,0.058807918071687275
5405,Making Waves: The Art of Cinematic Sound,63998,53144,10854,2019_boxofficemojo_rankings.csv,2019,0.8304009500296884,0.16959904997031158
5406,Jealousy,63946,63946,0,2014_boxofficemojo_rankings.csv,2014,1.0,0.0
5407,The Details,63595,63595,0,2012_boxofficemojo_rankings.csv,2012,1.0,0.0
5408,A Liar's Autobiography: The Untrue Story of Monty Python's Graham Chapman,63469,5102,58367,2012_boxofficemojo_rankings.csv,2012,0.08038570010556334,0.9196142998944367
5409,I Smile Back,63373,58738,4635,2015_boxofficemojo_rankings.csv,2015,0.9268615972101684,0.07313840278983164
5410,Trapped,63241,63241,0,2016_boxofficemojo_rankings.csv,2016,1.0,0.0
5411,The Last of the Unjust,63136,40563,22573,2013_boxofficemojo_rankings.csv,2013,0.6424702230106437,0.3575297769893563
5412,No Tears for the Dead,63063,63063,0,2014_boxofficemojo_rankings.csv,2014,1.0,0.0
5413,Creative Control,63014,63014,0,2016_boxofficemojo_rankings.csv,2016,1.0,0.0
5414,"Love, Antosha",62900,50168,12732,2019_boxofficemojo_rankings.csv,2019,0.7975834658187599,0.20241653418124006
5415,The Gardener,62734,62734,0,2018_boxofficemojo_rankings.csv,2018,1.0,0.0
5416,The Swan,62716,2367,60349,2018_boxofficemojo_rankings.csv,2018,0.0377415651508387,0.9622584348491613
5417,Cool It,62713,62713,0,2010_boxofficemojo_rankings.csv,2010,1.0,0.0
5418,Drunk Stoned Brilliant Dead,62660,62660,0,2015_boxofficemojo_rankings.csv,2015,1.0,0.0
5419,The Tiger Hunter,62398,62398,0,2017_boxofficemojo_rankings.csv,2017,1.0,0.0
5420,Mifune: The Last Samurai,62279,62279,0,2016_boxofficemojo_rankings.csv,2016,1.0,0.0
5421,Public Speaking,62173,62173,0,2011_boxofficemojo_rankings.csv,2011,1.0,0.0
5422,Trigun: Badlands Rumble 2011 Re-release,62027,62027,0,2011_boxofficemojo_rankings.csv,2011,1.0,0.0
5423,Kites The Remix,61997,41783,20214,2010_boxofficemojo_rankings.csv,2010,0.6739519654176815,0.3260480345823185
5424,"I, Me aur Main",61863,0,61863,2013_boxofficemojo_rankings.csv,2013,0.0,1.0
5425,Dark Star: HR Gigers Welt,61845,61845,0,2015_boxofficemojo_rankings.csv,2015,1.0,0.0
5426,In a Valley of Violence,61797,61797,0,2016_boxofficemojo_rankings.csv,2016,1.0,0.0
5427,If a Tree Falls: A Story of the Earth Liberation Front,61794,61794,0,2011_boxofficemojo_rankings.csv,2011,1.0,0.0
5428,River Runs Red,61789,9893,51896,2018_boxofficemojo_rankings.csv,2018,0.1601094045865769,0.8398905954134231
5429,Amour Fou,61693,13702,47991,2014_boxofficemojo_rankings.csv,2014,0.22209975199779552,0.7779002480022045
5430,Quill: The Life of a Guide Dog 2012 Re-release,61674,15674,46000,2012_boxofficemojo_rankings.csv,2012,0.2541427505918215,0.7458572494081784
5431,Backwards,61465,61465,0,2012_boxofficemojo_rankings.csv,2012,1.0,0.0
5432,Donald Cried,61406,61406,0,2017_boxofficemojo_rankings.csv,2017,1.0,0.0
5433,Here and Now,61271,13892,47379,2018_boxofficemojo_rankings.csv,2018,0.22673042711886537,0.7732695728811346
5434,Never Goin' Back,61271,61271,0,2018_boxofficemojo_rankings.csv,2018,1.0,0.0
5435,The Seasons In Quincy: Four Portraits of John Berger,61267,28456,32811,2016_boxofficemojo_rankings.csv,2016,0.46445884407592997,0.53554115592407
5436,The Outcasts,61250,1455,59795,2017_boxofficemojo_rankings.csv,2017,0.023755102040816326,0.9762448979591837
5437,The Untamed,61249,27593,33656,2017_boxofficemojo_rankings.csv,2017,0.45050531437247954,0.5494946856275205
5438,The Mountain,61035,61035,0,2019_boxofficemojo_rankings.csv,2019,1.0,0.0
5439,The Bodyguard 2012 Re-release,61020,61020,0,2012_boxofficemojo_rankings.csv,2012,1.0,0.0
5440,The Sacrifice 2017 Re-release,61018,61018,0,2017_boxofficemojo_rankings.csv,2017,1.0,0.0
5441,Independent Lens: Don't Stop Believin': Everyman's Journey,61018,61018,0,2013_boxofficemojo_rankings.csv,2013,1.0,0.0
5442,Love U... Mr. Kalakaar!,60956,48557,12399,2011_boxofficemojo_rankings.csv,2011,0.7965909836603452,0.20340901633965483
5443,The Wicker Man 2013 Re-release,60891,60891,0,2013_boxofficemojo_rankings.csv,2013,1.0,0.0
5444,It's a Disaster,60818,60818,0,2013_boxofficemojo_rankings.csv,2013,1.0,0.0
5445,A Kid Like Jake,60784,58403,2381,2018_boxofficemojo_rankings.csv,2018,0.9608285075019742,0.039171492498025796
5446,Apprentice,60752,2578,58174,2016_boxofficemojo_rankings.csv,2016,0.042434816960758494,0.9575651830392415
5447,How to Live Forever,60630,60630,0,2011_boxofficemojo_rankings.csv,2011,1.0,0.0
5448,Viper Club,60607,60607,0,2018_boxofficemojo_rankings.csv,2018,1.0,0.0
5449,Too Late,60438,60438,0,2016_boxofficemojo_rankings.csv,2016,1.0,0.0
5450,Limelight,60335,60335,0,2011_boxofficemojo_rankings.csv,2011,1.0,0.0
5451,Crime After Crime,60291,60291,0,2011_boxofficemojo_rankings.csv,2011,1.0,0.0
5452,Wetlands 2014 Re-release,60230,59478,752,2014_boxofficemojo_rankings.csv,2014,0.9875145276440312,0.012485472355968787
5453,Presenting Princess Shaw,60197,60197,0,2016_boxofficemojo_rankings.csv,2016,1.0,0.0
5454,Just One Drop,60078,60078,0,2017_boxofficemojo_rankings.csv,2017,1.0,0.0
5455,Heaven,60065,60065,0,2020_boxofficemojo_rankings.csv,2020,1.0,0.0
5456,Gregory Crewdson: Brief Encounters,60064,60064,0,2012_boxofficemojo_rankings.csv,2012,1.0,0.0
5457,Decoding Annie Parker,60048,48390,11658,2014_boxofficemojo_rankings.csv,2014,0.8058553157474021,0.19414468425259793
5458,The Force,59912,59912,0,2017_boxofficemojo_rankings.csv,2017,1.0,0.0
5459,John Fogerty: 50 Year Trip - Live at Red Rocks,59795,59795,0,2019_boxofficemojo_rankings.csv,2019,1.0,0.0
5460,Frontera,59696,59696,0,2014_boxofficemojo_rankings.csv,2014,1.0,0.0
5461,Cheap Thrills,59424,59424,0,2014_boxofficemojo_rankings.csv,2014,1.0,0.0
5462,The Extraordinary Voyage,59424,52986,6438,2012_boxofficemojo_rankings.csv,2012,0.8916599353796446,0.1083400646203554
5463,Sweet Dreams,59403,59403,0,2013_boxofficemojo_rankings.csv,2013,1.0,0.0
5464,Bomb City,59329,59329,0,2018_boxofficemojo_rankings.csv,2018,1.0,0.0
5465,Bang! The Bert Berns Story,59299,59299,0,2017_boxofficemojo_rankings.csv,2017,1.0,0.0
5466,Saint Frances,59257,44330,14927,2020_boxofficemojo_rankings.csv,2020,0.7480972712084648,0.2519027287915352
5467,Digimon Adventure tri. Part 4: Loss,59114,59114,0,2018_boxofficemojo_rankings.csv,2018,1.0,0.0
5468,The Trials of Muhammad Ali,59081,59081,0,2013_boxofficemojo_rankings.csv,2013,1.0,0.0
5469,My Brothers' Crossing,58963,58963,0,2020_boxofficemojo_rankings.csv,2020,1.0,0.0
5470,The One I Wrote for You,58872,58872,0,2014_boxofficemojo_rankings.csv,2014,1.0,0.0
5471,Sagrada: The Mystery of Creation 2014 Re-release,58755,58755,0,2014_boxofficemojo_rankings.csv,2014,1.0,0.0
5472,The Conformist 2014 Re-release,58657,58657,0,2014_boxofficemojo_rankings.csv,2014,1.0,0.0
5473,Horn from the Heart: The Paul Butterfield Story,58597,58597,0,2018_boxofficemojo_rankings.csv,2018,1.0,0.0
5474,Putty Hill,58585,49918,8667,2011_boxofficemojo_rankings.csv,2011,0.852061107792097,0.14793889220790304
5475,Orlando 2010 Re-release,58198,58198,0,2010_boxofficemojo_rankings.csv,2010,1.0,0.0
5476,Cynthia,58177,58177,0,2018_boxofficemojo_rankings.csv,2018,1.0,0.0
5477,Faust,58132,58132,0,2013_boxofficemojo_rankings.csv,2013,1.0,0.0
5478,In Search of Greatness,58090,58090,0,2018_boxofficemojo_rankings.csv,2018,1.0,0.0
5479,The Boom,57962,57962,0,2017_boxofficemojo_rankings.csv,2017,1.0,0.0
5480,Rififi 2015 Re-release,57749,57749,0,2015_boxofficemojo_rankings.csv,2015,1.0,0.0
5481,Command and Control,57635,57635,0,2016_boxofficemojo_rankings.csv,2016,1.0,0.0
5482,Battleship Potemkin,57620,51198,6422,2011_boxofficemojo_rankings.csv,2011,0.888545643873655,0.11145435612634502
5483,Playback,57587,264,57323,2012_boxofficemojo_rankings.csv,2012,0.00458436799972216,0.9954156320002778
5484,Sold,57527,57527,0,2016_boxofficemojo_rankings.csv,2016,1.0,0.0
5485,Court,57416,22898,34518,2015_boxofficemojo_rankings.csv,2015,0.39880869444057404,0.6011913055594259
5486,Ramen Heads,57345,57345,0,2018_boxofficemojo_rankings.csv,2018,1.0,0.0
5487,Run & Jump,57189,20061,37128,2014_boxofficemojo_rankings.csv,2014,0.3507842417248072,0.6492157582751927
5488,Mickey and the Bear,57188,57188,0,2019_boxofficemojo_rankings.csv,2019,1.0,0.0
5489,My Joy,56857,6298,50559,2011_boxofficemojo_rankings.csv,2011,0.11076912253548375,0.8892308774645162
5490,The Battle of Algiers 2016 Re-release,56853,56853,0,2016_boxofficemojo_rankings.csv,2016,1.0,0.0
5491,Farmageddon,56573,56573,0,2011_boxofficemojo_rankings.csv,2011,1.0,0.0
5492,Muran,56493,30116,26377,2011_boxofficemojo_rankings.csv,2011,0.5330925955428106,0.46690740445718937
5493,Beyond the Black Rainbow,56491,56491,0,2012_boxofficemojo_rankings.csv,2012,1.0,0.0
5494,Big Men,56286,56286,0,2014_boxofficemojo_rankings.csv,2014,1.0,0.0
5495,Saving Brinton,56218,56218,0,2017_boxofficemojo_rankings.csv,2017,1.0,0.0
5496,Wedding Doll,56196,56196,0,2016_boxofficemojo_rankings.csv,2016,1.0,0.0
5497,Notebook,56166,0,56166,2019_boxofficemojo_rankings.csv,2019,0.0,1.0
5498,False Confessions,56165,29245,26920,2017_boxofficemojo_rankings.csv,2017,0.5206979435591561,0.47930205644084395
5499,Évolution,55985,24770,31215,2016_boxofficemojo_rankings.csv,2016,0.4424399392694472,0.5575600607305529
5500,Vitalina Varela,55862,14941,40921,2019_boxofficemojo_rankings.csv,2019,0.2674626758798468,0.7325373241201533
5501,Terms and Conditions May Apply,55824,55824,0,2013_boxofficemojo_rankings.csv,2013,1.0,0.0
5502,Hellion,55708,55708,0,2014_boxofficemojo_rankings.csv,2014,1.0,0.0
5503,XX,55668,30911,24757,2017_boxofficemojo_rankings.csv,2017,0.5552741251706546,0.4447258748293454
5504,Recorder: The Marion Stokes Project,55632,55632,0,2019_boxofficemojo_rankings.csv,2019,1.0,0.0
5505,Holidays,55621,0,55621,2016_boxofficemojo_rankings.csv,2016,0.0,1.0
5506,As Good as Dead,55618,1981,53637,2010_boxofficemojo_rankings.csv,2010,0.03561796540688266,0.9643820345931173
5507,Finding Joe,55518,55518,0,2011_boxofficemojo_rankings.csv,2011,1.0,0.0
5508,Entertainment,55506,55506,0,2015_boxofficemojo_rankings.csv,2015,1.0,0.0
5509,Naam Shabana,55429,0,55429,2017_boxofficemojo_rankings.csv,2017,0.0,1.0
5510,Into Eternity,55366,55366,0,2011_boxofficemojo_rankings.csv,2011,1.0,0.0
5511,C.O.G.,55301,55301,0,2013_boxofficemojo_rankings.csv,2013,1.0,0.0
5512,Natural Selection,55282,55282,0,2012_boxofficemojo_rankings.csv,2012,1.0,0.0
5513,Mamma Mia! 2018 Re-release,55168,39601,15567,2018_boxofficemojo_rankings.csv,2018,0.7178255510440835,0.2821744489559165
5514,American Dream: Detroit,55092,55092,0,2018_boxofficemojo_rankings.csv,2018,1.0,0.0
5515,The Lovely Month of May,55038,55038,0,2013_boxofficemojo_rankings.csv,2013,1.0,0.0
5516,Twenty Two 2017 Re-release,55001,46796,8205,2017_boxofficemojo_rankings.csv,2017,0.8508208941655606,0.14917910583443938
5517,Zombeavers,54985,14947,40038,2014_boxofficemojo_rankings.csv,2014,0.27183777393834685,0.7281622260616532
5518,DAZN Boxing: Canelo Alvarez vs. Rocky Fielding,54916,54916,0,2018_boxofficemojo_rankings.csv,2018,1.0,0.0
5519,Snowmen,54805,54805,0,2011_boxofficemojo_rankings.csv,2011,1.0,0.0
5520,The Nature of Existence,54645,54645,0,2010_boxofficemojo_rankings.csv,2010,1.0,0.0
5521,What Our Fathers Did: A Nazi Legacy,54603,40119,14484,2015_boxofficemojo_rankings.csv,2015,0.734739849458821,0.2652601505411791
5522,The Lottery,54543,54543,0,2010_boxofficemojo_rankings.csv,2010,1.0,0.0
5523,The Harimaya Bridge,54473,54473,0,2010_boxofficemojo_rankings.csv,2010,1.0,0.0
5524,A Simple Wedding,54415,54415,0,2020_boxofficemojo_rankings.csv,2020,1.0,0.0
5525,Digimon Adventure tri. Part 6: Future,54324,54324,0,2018_boxofficemojo_rankings.csv,2018,1.0,0.0
5526,Harlan: In the Shadow of Jew Suess,54305,54305,0,2010_boxofficemojo_rankings.csv,2010,1.0,0.0
5527,The Search for General Tso,54275,54275,0,2015_boxofficemojo_rankings.csv,2015,1.0,0.0
5528,Wagner & Me 2012 Re-release,54215,37745,16470,2012_boxofficemojo_rankings.csv,2012,0.6962095361062437,0.30379046389375636
5529,Line of Duty,54204,54204,0,2013_boxofficemojo_rankings.csv,2013,1.0,0.0
5530,Last Passenger,54110,14806,39304,2014_boxofficemojo_rankings.csv,2014,0.2736277952319349,0.7263722047680651
5531,Low Down,54051,54051,0,2014_boxofficemojo_rankings.csv,2014,1.0,0.0
5532,A Beautiful Soul,54008,54008,0,2012_boxofficemojo_rankings.csv,2012,1.0,0.0
5533,Surviving Progress,53953,53953,0,2012_boxofficemojo_rankings.csv,2012,1.0,0.0
5534,The Assassin's Code,53940,11218,42722,2018_boxofficemojo_rankings.csv,2018,0.20797182054134222,0.7920281794586578
5535,The Last Man on the Moon,53881,52482,1399,2016_boxofficemojo_rankings.csv,2016,0.9740353742506634,0.0259646257493365
5536,The Summer of Sangaile,53843,4480,49363,2015_boxofficemojo_rankings.csv,2015,0.0832048734283008,0.9167951265716991
5537,At Middleton,53837,53837,0,2014_boxofficemojo_rankings.csv,2014,1.0,0.0
5538,Rising from Ashes,53804,38602,15202,2013_boxofficemojo_rankings.csv,2013,0.7174559512303917,0.2825440487696082
5539,The Heir Apparent: Largo Winch 2011 Re-release,53793,10352,43441,2011_boxofficemojo_rankings.csv,2011,0.1924413957206328,0.8075586042793672
5540,Down by Love,53780,675,53105,2016_boxofficemojo_rankings.csv,2016,0.012551134250650799,0.9874488657493492
5541,The Legend of Hallowaiian,53738,451,53287,2018_boxofficemojo_rankings.csv,2018,0.00839257136476981,0.9916074286352302
5542,The Other F Word,53714,53714,0,2011_boxofficemojo_rankings.csv,2011,1.0,0.0
5543,Leonie 2013 Re-release,53692,53692,0,2013_boxofficemojo_rankings.csv,2013,1.0,0.0
5544,Grass,53503,8084,45419,2018_boxofficemojo_rankings.csv,2018,0.15109433115900042,0.8489056688409996
5545,God of Vampires,53345,53345,0,2010_boxofficemojo_rankings.csv,2010,1.0,0.0
5546,The Great Silence,53074,53074,0,2018_boxofficemojo_rankings.csv,2018,1.0,0.0
5547,Love Thy Nature,52947,41149,11798,2015_boxofficemojo_rankings.csv,2015,0.7771733998149093,0.22282660018509076
5548,Ping Pong Summer,52909,52909,0,2014_boxofficemojo_rankings.csv,2014,1.0,0.0
5549,Mia and the Migoo 2010 Re-release,52873,17000,35873,2010_boxofficemojo_rankings.csv,2010,0.3215251640723999,0.6784748359276
5550,To Be Takei,52823,52823,0,2014_boxofficemojo_rankings.csv,2014,1.0,0.0
5551,Occupy Unmasked,52768,52768,0,2012_boxofficemojo_rankings.csv,2012,1.0,0.0
5552,!Women Art Revolution,52681,52681,0,2011_boxofficemojo_rankings.csv,2011,1.0,0.0
5553,Salvation Army,52511,3929,48582,2014_boxofficemojo_rankings.csv,2014,0.07482241816000457,0.9251775818399954
5554,Cropsey,52476,52476,0,2010_boxofficemojo_rankings.csv,2010,1.0,0.0
5555,Going Attractions: The Definitive Story of the American Drive-in Movie,52458,52458,0,2013_boxofficemojo_rankings.csv,2013,1.0,0.0
5556,A Tale of Winter,52431,23268,29163,2014_boxofficemojo_rankings.csv,2014,0.4437832579962236,0.5562167420037764
5557,Breath Made Visible: Anna Halprin,52387,52387,0,2010_boxofficemojo_rankings.csv,2010,1.0,0.0
5558,Birdboy: The Forgotten Children,52366,38786,13580,2017_boxofficemojo_rankings.csv,2017,0.7406714280258183,0.25932857197418174
5559,Here and There,52307,27156,25151,2010_boxofficemojo_rankings.csv,2010,0.5191656948400788,0.48083430515992126
5560,The Human Experience,52296,52296,0,2010_boxofficemojo_rankings.csv,2010,1.0,0.0
5561,Henri-Georges Clouzot's Inferno,52003,25489,26514,2010_boxofficemojo_rankings.csv,2010,0.4901447993384997,0.5098552006615003
5562,American Dharma,51891,51891,0,2019_boxofficemojo_rankings.csv,2019,1.0,0.0
5563,Quay,51858,51858,0,2015_boxofficemojo_rankings.csv,2015,1.0,0.0
5564,The Snowman Trek,51743,51743,0,2018_boxofficemojo_rankings.csv,2018,1.0,0.0
5565,Wanda 2018 Re-release,51713,51713,0,2018_boxofficemojo_rankings.csv,2018,1.0,0.0
5566,Midnight Family,51712,42310,9402,2019_boxofficemojo_rankings.csv,2019,0.8181853341584159,0.18181466584158415
5567,Tickling Giants,51499,51499,0,2017_boxofficemojo_rankings.csv,2017,1.0,0.0
5568,The Yes Men Are Revolting,51331,50190,1141,2015_boxofficemojo_rankings.csv,2015,0.9777717168962226,0.022228283103777443
5569,Venus and Serena,51271,51271,0,2013_boxofficemojo_rankings.csv,2013,1.0,0.0
5570,God Loves Uganda,51229,51229,0,2013_boxofficemojo_rankings.csv,2013,1.0,0.0
5571,Miss Fisher & the Crypt of Tears Special Screenings,51158,51032,126,2020_boxofficemojo_rankings.csv,2020,0.9975370421048516,0.002462957895148364
5572,An Invisible Sign,51138,1279,49859,2011_boxofficemojo_rankings.csv,2011,0.02501075521138879,0.9749892447886112
5573,The Unknowns,51035,51035,0,2016_boxofficemojo_rankings.csv,2016,1.0,0.0
5574,The Good Doctor,51017,5206,45811,2012_boxofficemojo_rankings.csv,2012,0.10204441656702667,0.8979555834329733
5575,As I Open My Eyes,50721,30989,19732,2016_boxofficemojo_rankings.csv,2016,0.6109698152638946,0.38903018473610534
5576,House of Cardin,50659,0,50659,2020_boxofficemojo_rankings.csv,2020,0.0,1.0
5577,Keep Quiet,50451,50451,0,2017_boxofficemojo_rankings.csv,2017,1.0,0.0
5578,Clinton Road,50400,50400,0,2019_boxofficemojo_rankings.csv,2019,1.0,0.0
5579,Wake in Fright 2012 Re-release,50394,50394,0,2012_boxofficemojo_rankings.csv,2012,1.0,0.0
5580,Midnight Traveler,50336,41265,9071,2019_boxofficemojo_rankings.csv,2019,0.8197910044500953,0.18020899554990463
5581,The Fitzgerald Family Christmas,50292,50292,0,2012_boxofficemojo_rankings.csv,2012,1.0,0.0
5582,The Royal Wedding: Prince Harry and Meghan Markle,50264,50264,0,2018_boxofficemojo_rankings.csv,2018,1.0,0.0
5583,The Retrieval,50257,50257,0,2014_boxofficemojo_rankings.csv,2014,1.0,0.0
5584,In Order of Disappearance 2016 Re-release,50251,50251,0,2016_boxofficemojo_rankings.csv,2016,1.0,0.0
5585,Quest,50022,47807,2215,2017_boxofficemojo_rankings.csv,2017,0.955719483427292,0.04428051657270801
5586,The Discoverers,50020,50020,0,2014_boxofficemojo_rankings.csv,2014,1.0,0.0
5587,Bigger,49997,46382,3615,2018_boxofficemojo_rankings.csv,2018,0.9276956617397044,0.07230433826029561
5588,Spring,49970,49970,0,2015_boxofficemojo_rankings.csv,2015,1.0,0.0
5589,Free Trip to Egypt,49693,49693,0,2019_boxofficemojo_rankings.csv,2019,1.0,0.0
5590,NOW: In the Wings on a World Stage,49591,49591,0,2014_boxofficemojo_rankings.csv,2014,1.0,0.0
5591,A Call to Spy,49586,49586,0,2020_boxofficemojo_rankings.csv,2020,1.0,0.0
5592,Red Herring,49480,49480,0,2015_boxofficemojo_rankings.csv,2015,1.0,0.0
5593,GasLand,49428,30846,18582,2010_boxofficemojo_rankings.csv,2010,0.6240592376790484,0.3759407623209517
5594,Jumanji/Jumanji: Welcome to the Jungle 2018 NCM Fathom Event,49381,49381,0,2018_boxofficemojo_rankings.csv,2018,1.0,0.0
5595,Shirin in Love,49254,49254,0,2014_boxofficemojo_rankings.csv,2014,1.0,0.0
5596,Bonsai,49128,21267,27861,2012_boxofficemojo_rankings.csv,2012,0.4328895945285784,0.5671104054714216
5597,Hal,49045,48698,347,2018_boxofficemojo_rankings.csv,2018,0.9929248649199715,0.007075135080028545
5598,The Way I See It,49030,49030,0,2020_boxofficemojo_rankings.csv,2020,1.0,0.0
5599,Orgasm Inc.,49001,49001,0,2011_boxofficemojo_rankings.csv,2011,1.0,0.0
5600,Lucky Them,48995,48995,0,2014_boxofficemojo_rankings.csv,2014,1.0,0.0
5601,The Internet's Own Boy: The Story of Aaron Swartz,48911,48911,0,2014_boxofficemojo_rankings.csv,2014,1.0,0.0
5602,The Seven Five,48869,48869,0,2015_boxofficemojo_rankings.csv,2015,1.0,0.0
5603,The Bounty Killer,48815,48815,0,2019_boxofficemojo_rankings.csv,2019,1.0,0.0
5604,The Citizen,48767,24296,24471,2013_boxofficemojo_rankings.csv,2013,0.49820575389095084,0.5017942461090491
5605,A Birder's Guide to Everything,48713,48713,0,2014_boxofficemojo_rankings.csv,2014,1.0,0.0
5606,American Mustang,48700,48700,0,2014_boxofficemojo_rankings.csv,2014,1.0,0.0
5607,Tales from Earthsea 2010 Re-release,48658,48658,0,2010_boxofficemojo_rankings.csv,2010,1.0,0.0
5608,The China Hustle,48650,48650,0,2018_boxofficemojo_rankings.csv,2018,1.0,0.0
5609,Person to Person,48499,48499,0,2017_boxofficemojo_rankings.csv,2017,1.0,0.0
5610,Alleluia,48426,6334,42092,2014_boxofficemojo_rankings.csv,2014,0.13079750547226696,0.869202494527733
5611,Boogie Woogie,48411,2618,45793,2010_boxofficemojo_rankings.csv,2010,0.05407861849579641,0.9459213815042036
5612,"Lebanon, Pa.",48381,48381,0,2011_boxofficemojo_rankings.csv,2011,1.0,0.0
5613,Ceremony,48174,22270,25904,2011_boxofficemojo_rankings.csv,2011,0.4622825590567526,0.5377174409432474
5614,The Forbidden Room,48082,34404,13678,2015_boxofficemojo_rankings.csv,2015,0.7155276402811863,0.2844723597188137
5615,Life Happens,48041,30905,17136,2012_boxofficemojo_rankings.csv,2012,0.6433046772548449,0.3566953227451552
5616,A Cop,48040,48040,0,2013_boxofficemojo_rankings.csv,2013,1.0,0.0
5617,Saving Banksy,47965,47965,0,2017_boxofficemojo_rankings.csv,2017,1.0,0.0
5618,The Queen,47818,47818,0,2019_boxofficemojo_rankings.csv,2019,1.0,0.0
5619,Alphaville,47696,47696,0,2014_boxofficemojo_rankings.csv,2014,1.0,0.0
5620,So B. It,47627,47627,0,2017_boxofficemojo_rankings.csv,2017,1.0,0.0
5621,GMO OMG,47558,47558,0,2013_boxofficemojo_rankings.csv,2013,1.0,0.0
5622,350 Days - Legends. Champions. Survivors,47526,47526,0,2018_boxofficemojo_rankings.csv,2018,1.0,0.0
5623,Entre les Bras,47439,47439,0,2012_boxofficemojo_rankings.csv,2012,1.0,0.0
5624,Alabama Moon,47305,47305,0,2011_boxofficemojo_rankings.csv,2011,1.0,0.0
5625,Daughters of the Dust 2016 Re-release,47287,40986,6301,2016_boxofficemojo_rankings.csv,2016,0.8667498466809059,0.13325015331909404
5626,The Raft,47269,39678,7591,2019_boxofficemojo_rankings.csv,2019,0.8394084918233937,0.16059150817660622
5627,Every Man for Himself,47262,47262,0,2010_boxofficemojo_rankings.csv,2010,1.0,0.0
5628,Went the Day Well?,47214,47214,0,2011_boxofficemojo_rankings.csv,2011,1.0,0.0
5629,VHYes,47037,47037,0,2020_boxofficemojo_rankings.csv,2020,1.0,0.0
5630,Diary of a Country Priest,47000,47000,0,2011_boxofficemojo_rankings.csv,2011,1.0,0.0
5631,A Master Builder,46874,46874,0,2014_boxofficemojo_rankings.csv,2014,1.0,0.0
5632,Enter the Fat Dragon,46855,46855,0,2020_boxofficemojo_rankings.csv,2020,1.0,0.0
5633,78/52: Hitchcock's Shower Scene,46838,37664,9174,2017_boxofficemojo_rankings.csv,2017,0.8041333959605449,0.19586660403945513
5634,"Connected: An Autoblogography About Love, Death & Technology",46782,46782,0,2011_boxofficemojo_rankings.csv,2011,1.0,0.0
5635,The Woodmans,46623,46623,0,2011_boxofficemojo_rankings.csv,2011,1.0,0.0
5636,Ca$h,46488,46488,0,2010_boxofficemojo_rankings.csv,2010,1.0,0.0
5637,Shanghai 2015 Re-release,46425,46425,0,2015_boxofficemojo_rankings.csv,2015,1.0,0.0
5638,Patience,46410,15941,30469,2012_boxofficemojo_rankings.csv,2012,0.34348200818789054,0.6565179918121095
5639,Mediterranea,46392,22076,24316,2015_boxofficemojo_rankings.csv,2015,0.4758579065356096,0.5241420934643904
5640,William S. Burroughs: A Man Within,46380,46380,0,2010_boxofficemojo_rankings.csv,2010,1.0,0.0
5641,Greedy Lying Bastards,46121,45000,1121,2012_boxofficemojo_rankings.csv,2012,0.9756943691593851,0.024305630840614906
5642,Ballplayer: Pelotero,46109,46109,0,2012_boxofficemojo_rankings.csv,2012,1.0,0.0
5643,Panique,46041,46041,0,2017_boxofficemojo_rankings.csv,2017,1.0,0.0
5644,Every Day,46029,46029,0,2011_boxofficemojo_rankings.csv,2011,1.0,0.0
5645,Monk with a Camera,45938,45938,0,2014_boxofficemojo_rankings.csv,2014,1.0,0.0
5646,Maurice 2017 Re-release,45926,45926,0,2017_boxofficemojo_rankings.csv,2017,1.0,0.0
5647,High on the Hog,45696,45696,0,2019_boxofficemojo_rankings.csv,2019,1.0,0.0
5648,Eddie: The Sleepwalking Cannibal,45604,1632,43972,2012_boxofficemojo_rankings.csv,2012,0.035786334532058595,0.9642136654679414
5649,Our Time,45579,14777,30802,2019_boxofficemojo_rankings.csv,2019,0.3242063230873867,0.6757936769126133
5650,3 Weeks in Yerevan,45536,45536,0,2016_boxofficemojo_rankings.csv,2016,1.0,0.0
5651,An Eye for Beauty,45513,9395,36118,2015_boxofficemojo_rankings.csv,2015,0.20642453804407532,0.7935754619559247
5652,Mercury,45429,0,45429,2018_boxofficemojo_rankings.csv,2018,0.0,1.0
5653,Return to the Hiding Place,45405,45405,0,2014_boxofficemojo_rankings.csv,2014,1.0,0.0
5654,Ai Weiwei: The Fake Case,45255,45255,0,2014_boxofficemojo_rankings.csv,2014,1.0,0.0
5655,There's No Place Like Utopia,45254,45254,0,2014_boxofficemojo_rankings.csv,2014,1.0,0.0
5656,CornerStore,45176,45176,0,2011_boxofficemojo_rankings.csv,2011,1.0,0.0
5657,American Made Movie,45175,45175,0,2013_boxofficemojo_rankings.csv,2013,1.0,0.0
5658,The Proposal,45149,45149,0,2019_boxofficemojo_rankings.csv,2019,1.0,0.0
5659,The Farthest,44921,14773,30148,2017_boxofficemojo_rankings.csv,2017,0.32886623182921126,0.6711337681707887
5660,Celebration,44898,22557,22341,2019_boxofficemojo_rankings.csv,2019,0.5024054523586797,0.49759454764132033
5661,The Pruitt-Igoe Myth,44883,44883,0,2012_boxofficemojo_rankings.csv,2012,1.0,0.0
5662,River of Fundament,44840,44840,0,2015_boxofficemojo_rankings.csv,2015,1.0,0.0
5663,Union Square,44830,44830,0,2012_boxofficemojo_rankings.csv,2012,1.0,0.0
5664,That Summer,44659,34556,10103,2018_boxofficemojo_rankings.csv,2018,0.7737746031035178,0.22622539689648224
5665,The Dog,44581,44581,0,2014_boxofficemojo_rankings.csv,2014,1.0,0.0
5666,The Bride Wore Black,44566,44566,0,2011_boxofficemojo_rankings.csv,2011,1.0,0.0
5667,What Is Democracy?,44536,44536,0,2019_boxofficemojo_rankings.csv,2019,1.0,0.0
5668,"Léon Morin, Priest 2017 Re-release",44511,44511,0,2017_boxofficemojo_rankings.csv,2017,1.0,0.0
5669,Defendor,44462,44462,0,2010_boxofficemojo_rankings.csv,2010,1.0,0.0
5670,Maze 2019 Re-release,44381,44381,0,2019_boxofficemojo_rankings.csv,2019,1.0,0.0
5671,What You Gonna Do When the World's on Fire?,44290,4672,39618,2019_boxofficemojo_rankings.csv,2019,0.10548656581621134,0.8945134341837887
5672,Carmine Street Guitars,44253,44253,0,2019_boxofficemojo_rankings.csv,2019,1.0,0.0
5673,Slut in a Good Way,44240,40513,3727,2019_boxofficemojo_rankings.csv,2019,0.915754972875226,0.08424502712477396
5674,Nuts!,44230,44230,0,2016_boxofficemojo_rankings.csv,2016,1.0,0.0
5675,Danny Says,44213,44213,0,2016_boxofficemojo_rankings.csv,2016,1.0,0.0
5676,Life of a King,44161,6547,37614,2014_boxofficemojo_rankings.csv,2014,0.14825298340164397,0.851747016598356
5677,Hermia & Helena,44156,43152,1004,2017_boxofficemojo_rankings.csv,2017,0.9772624331914123,0.022737566808587736
5678,Submission,44069,39985,4084,2018_boxofficemojo_rankings.csv,2018,0.9073271460663959,0.09267285393360412
5679,Liyana,44045,44045,0,2018_boxofficemojo_rankings.csv,2018,1.0,0.0
5680,Garry Winogrand: All Things are Photographable,44002,44002,0,2018_boxofficemojo_rankings.csv,2018,1.0,0.0
5681,Granito,43942,43942,0,2011_boxofficemojo_rankings.csv,2011,1.0,0.0
5682,Summer 2011 Re-release,43839,43839,0,2011_boxofficemojo_rankings.csv,2011,1.0,0.0
5683,Hitler's Hollywood,43766,43766,0,2018_boxofficemojo_rankings.csv,2018,1.0,0.0
5684,Contempt 2013 Re-release,43763,43763,0,2013_boxofficemojo_rankings.csv,2013,1.0,0.0
5685,Bad Blood 2013 Re-release,43758,35176,8582,2013_boxofficemojo_rankings.csv,2013,0.8038758626993922,0.19612413730060788
5686,The Land,43756,43756,0,2016_boxofficemojo_rankings.csv,2016,1.0,0.0
5687,Bereavement,43712,43712,0,2011_boxofficemojo_rankings.csv,2011,1.0,0.0
5688,Woodshock,43682,42603,1079,2017_boxofficemojo_rankings.csv,2017,0.9752987500572318,0.024701249942768188
5689,Love Etc.,43593,43593,0,2011_boxofficemojo_rankings.csv,2011,1.0,0.0
5690,"OC87: The Obsessive Compulsive, Major Depression, Bipolar, Asperger's Movie",43583,43583,0,2012_boxofficemojo_rankings.csv,2012,1.0,0.0
5691,The Graduate 45th Anniversary Reunion,43466,43466,0,2012_boxofficemojo_rankings.csv,2012,1.0,0.0
5692,If You Build It,43393,43393,0,2014_boxofficemojo_rankings.csv,2014,1.0,0.0
5693,The Empire of Corpses,43320,0,43320,2016_boxofficemojo_rankings.csv,2016,0.0,1.0
5694,Next Goal Wins,43089,43089,0,2014_boxofficemojo_rankings.csv,2014,1.0,0.0
5695,3 Backyards,43073,43073,0,2011_boxofficemojo_rankings.csv,2011,1.0,0.0
5696,Spree,43062,28771,14291,2020_boxofficemojo_rankings.csv,2020,0.6681296734940319,0.33187032650596815
5697,Jenny's Wedding,42927,4704,38223,2015_boxofficemojo_rankings.csv,2015,0.10958138234677475,0.8904186176532253
5698,Andre Gregory: Before and After Dinner,42892,42892,0,2013_boxofficemojo_rankings.csv,2013,1.0,0.0
5699,First We Take Brooklyn,42812,42812,0,2018_boxofficemojo_rankings.csv,2018,1.0,0.0
5700,Interior. Leather Bar.,42534,42534,0,2014_boxofficemojo_rankings.csv,2014,1.0,0.0
5701,Last Call at the Oasis,42423,42423,0,2012_boxofficemojo_rankings.csv,2012,1.0,0.0
5702,Fixing the Future,42393,42393,0,2012_boxofficemojo_rankings.csv,2012,1.0,0.0
5703,Closet Monster,42360,42166,194,2016_boxofficemojo_rankings.csv,2016,0.9954202077431539,0.004579792256846081
5704,The Oath,42273,42273,0,2010_boxofficemojo_rankings.csv,2010,1.0,0.0
5705,Down for Life,41914,41914,0,2011_boxofficemojo_rankings.csv,2011,1.0,0.0
5706,In Pursuit of Silence,41913,29834,12079,2016_boxofficemojo_rankings.csv,2016,0.7118077923317347,0.2881922076682652
5707,Golden Exits,41888,41888,0,2018_boxofficemojo_rankings.csv,2018,1.0,0.0
5708,The Nightmare,41853,28281,13572,2015_boxofficemojo_rankings.csv,2015,0.675722170453731,0.3242778295462691
5709,On the Bowery,41802,41802,0,2010_boxofficemojo_rankings.csv,2010,1.0,0.0
5710,The Road Within,41760,0,41760,2015_boxofficemojo_rankings.csv,2015,0.0,1.0
5711,Union,41656,41656,0,2019_boxofficemojo_rankings.csv,2019,1.0,0.0
5712,Kalakalappu,41624,30949,10675,2012_boxofficemojo_rankings.csv,2012,0.7435373822794542,0.25646261772054585
5713,Death of a Superhero,41575,607,40968,2012_boxofficemojo_rankings.csv,2012,0.014600120264582081,0.9853998797354179
5714,The Settlers,41562,41562,0,2017_boxofficemojo_rankings.csv,2017,1.0,0.0
5715,Jonathan,41558,0,41558,2018_boxofficemojo_rankings.csv,2018,0.0,1.0
5716,Holla II,41537,41537,0,2013_boxofficemojo_rankings.csv,2013,1.0,0.0
5717,Censored Voices,41260,41260,0,2015_boxofficemojo_rankings.csv,2015,1.0,0.0
5718,Steve McQueen: The Man & Le Mans,41203,6843,34360,2015_boxofficemojo_rankings.csv,2015,0.16608013979564595,0.833919860204354
5719,The Comedy,41113,41113,0,2012_boxofficemojo_rankings.csv,2012,1.0,0.0
5720,Karl Marx City,41072,41072,0,2017_boxofficemojo_rankings.csv,2017,1.0,0.0
5721,Blue Iguana,41050,0,41050,2018_boxofficemojo_rankings.csv,2018,0.0,1.0
5722,The Myth of the American Sleepover,41045,41045,0,2011_boxofficemojo_rankings.csv,2011,1.0,0.0
5723,Fat Kid Rules the World,41000,41000,0,2012_boxofficemojo_rankings.csv,2012,1.0,0.0
5724,Why Don't You Just Die!,40995,0,40995,2019_boxofficemojo_rankings.csv,2019,0.0,1.0
5725,Hell and Back Again,40949,40634,315,2011_boxofficemojo_rankings.csv,2011,0.9923075044567633,0.007692495543236709
5726,Found Memories,40729,10575,30154,2012_boxofficemojo_rankings.csv,2012,0.25964300621179015,0.7403569937882098
5727,Language of a Broken Heart,40645,40645,0,2013_boxofficemojo_rankings.csv,2013,1.0,0.0
5728,Mercedes Sosa: The Voice of Latin America,40643,2648,37995,2013_boxofficemojo_rankings.csv,2013,0.06515267081662279,0.9348473291833772
5729,Life and Nothing More,40581,24358,16223,2017_boxofficemojo_rankings.csv,2017,0.6002316354944432,0.3997683645055568
5730,The FP,40557,40557,0,2012_boxofficemojo_rankings.csv,2012,1.0,0.0
5731,CBGB,40400,40400,0,2013_boxofficemojo_rankings.csv,2013,1.0,0.0
5732,Terkel in Trouble 2010 Re-release,40385,40385,0,2010_boxofficemojo_rankings.csv,2010,1.0,0.0
5733,Belle de Jour 2017 Re-release,40382,26331,14051,2017_boxofficemojo_rankings.csv,2017,0.6520479421524441,0.34795205784755584
5734,Of Mind and Music,40322,15073,25249,2016_boxofficemojo_rankings.csv,2016,0.37381578294727447,0.6261842170527255
5735,Paan Singh Tomar,40311,40311,0,2012_boxofficemojo_rankings.csv,2012,1.0,0.0
5736,The Red Baron 2010 Re-release,40239,37189,3050,2010_boxofficemojo_rankings.csv,2010,0.9242028877457193,0.07579711225428068
5737,Teenage,40169,40169,0,2014_boxofficemojo_rankings.csv,2014,1.0,0.0
5738,On Her Shoulders,40145,28288,11857,2018_boxofficemojo_rankings.csv,2018,0.7046456594843692,0.29535434051563086
5739,Aniara,40124,40124,0,2019_boxofficemojo_rankings.csv,2019,1.0,0.0
5740,Addiction Incorporated,40106,40106,0,2011_boxofficemojo_rankings.csv,2011,1.0,0.0
5741,Humor Me,40099,40099,0,2018_boxofficemojo_rankings.csv,2018,1.0,0.0
5742,Unrest,40081,40081,0,2017_boxofficemojo_rankings.csv,2017,1.0,0.0
5743,Louder Than a Bomb,40000,40000,0,2011_boxofficemojo_rankings.csv,2011,1.0,0.0
5744,Is That a Gun in Your Pocket?,39928,39928,0,2016_boxofficemojo_rankings.csv,2016,1.0,0.0
5745,The Short Game,39819,39819,0,2013_boxofficemojo_rankings.csv,2013,1.0,0.0
5746,Plot for Peace,39811,7051,32760,2013_boxofficemojo_rankings.csv,2013,0.17711185350782446,0.8228881464921756
5747,Port of Shadows,39623,27389,12234,2012_boxofficemojo_rankings.csv,2012,0.6912399364005755,0.3087600635994246
5748,An Elephant Sitting Still,39599,32556,7043,2018_boxofficemojo_rankings.csv,2018,0.8221419732821535,0.17785802671784642
5749,Loro,39520,35613,3907,2019_boxofficemojo_rankings.csv,2019,0.9011386639676113,0.09886133603238867
5750,The Homeless Billionaire,39493,39493,0,2016_boxofficemojo_rankings.csv,2016,1.0,0.0
5751,Juvenile Delinquents,39455,34292,5163,2020_boxofficemojo_rankings.csv,2020,0.869142060575339,0.130857939424661
5752,Prophet's Prey,39347,39347,0,2015_boxofficemojo_rankings.csv,2015,1.0,0.0
5753,Child of God,39324,39324,0,2014_boxofficemojo_rankings.csv,2014,1.0,0.0
5754,"3 1/2 Minutes, 10 Bullets",39263,30407,8856,2015_boxofficemojo_rankings.csv,2015,0.7744441331533505,0.22555586684664952
5755,La Notte,39236,39236,0,2016_boxofficemojo_rankings.csv,2016,1.0,0.0
5756,Where Soldiers Come From,39201,39201,0,2011_boxofficemojo_rankings.csv,2011,1.0,0.0
5757,How to Make Money Selling Drugs,39192,39192,0,2013_boxofficemojo_rankings.csv,2013,1.0,0.0
5758,I Do Not Care If We Go Down in History as Barbarians,39171,11307,27864,2018_boxofficemojo_rankings.csv,2018,0.2886574251359424,0.7113425748640576
5759,The Expedition to the End of the World,39115,39115,0,2014_boxofficemojo_rankings.csv,2014,1.0,0.0
5760,Zilla and Zoe,39003,39003,0,2019_boxofficemojo_rankings.csv,2019,1.0,0.0
5761,The Bra,38992,0,38992,2019_boxofficemojo_rankings.csv,2019,0.0,1.0
5762,I Used to Be Darker,38974,22214,16760,2013_boxofficemojo_rankings.csv,2013,0.5699697234053471,0.43003027659465287
5763,Herb & Dorothy 50X50,38933,38933,0,2013_boxofficemojo_rankings.csv,2013,1.0,0.0
5764,Shed of the Dead,38901,38901,0,2019_boxofficemojo_rankings.csv,2019,1.0,0.0
5765,The Son of Joseph,38774,30588,8186,2016_boxofficemojo_rankings.csv,2016,0.7888791458193635,0.2111208541806365
5766,Restored Me,38745,38745,0,2016_boxofficemojo_rankings.csv,2016,1.0,0.0
5767,Bluebeard,38696,33490,5206,2010_boxofficemojo_rankings.csv,2010,0.8654641306594997,0.1345358693405003
5768,Paul Williams Still Alive,38691,38691,0,2012_boxofficemojo_rankings.csv,2012,1.0,0.0
5769,Catching the Sun,38613,38613,0,2016_boxofficemojo_rankings.csv,2016,1.0,0.0
5770,Spa Night,38578,38578,0,2016_boxofficemojo_rankings.csv,2016,1.0,0.0
5771,Troublemakers: The Story of Land Art,38571,29462,9109,2016_boxofficemojo_rankings.csv,2016,0.7638381167198154,0.2361618832801846
5772,Divide and Conquer,38510,38510,0,2018_boxofficemojo_rankings.csv,2018,1.0,0.0
5773,Death by China,38492,38492,0,2012_boxofficemojo_rankings.csv,2012,1.0,0.0
5774,Multiple Maniacs,38403,33036,5367,2016_boxofficemojo_rankings.csv,2016,0.860245293336458,0.13975470666354192
5775,Araby,38399,38399,0,2018_boxofficemojo_rankings.csv,2018,1.0,0.0
5776,Batman Forever 2019 Re-release,38387,38014,373,2019_boxofficemojo_rankings.csv,2019,0.9902831687810978,0.009716831218902232
5777,Nine Nation Animation,38382,38382,0,2010_boxofficemojo_rankings.csv,2010,1.0,0.0
5778,The Blackcoat's Daughter,38348,20435,17913,2017_boxofficemojo_rankings.csv,2017,0.5328830708250756,0.46711692917492437
5779,Policeman,38263,11263,27000,2013_boxofficemojo_rankings.csv,2013,0.29435747327705614,0.7056425267229438
5780,No Intenso Agora,38223,24955,13268,2018_boxofficemojo_rankings.csv,2018,0.6528791565287916,0.3471208434712084
5781,Germans & Jews,38100,38100,0,2016_boxofficemojo_rankings.csv,2016,1.0,0.0
5782,The Legend of Pale Male,38083,38083,0,2010_boxofficemojo_rankings.csv,2010,1.0,0.0
5783,Gray Matter,38034,38034,0,2018_boxofficemojo_rankings.csv,2018,1.0,0.0
5784,Band of Outsiders 2016 Re-release,38004,38004,0,2016_boxofficemojo_rankings.csv,2016,1.0,0.0
5785,Moscow Never Sleeps,38004,25306,12698,2016_boxofficemojo_rankings.csv,2016,0.6658772760762025,0.3341227239237975
5786,The Crime of Monsieur Lange,38002,36438,1564,2017_boxofficemojo_rankings.csv,2017,0.9588442713541393,0.04115572864586074
5787,Russian Ark 2013 Re-release,37984,37984,0,2013_boxofficemojo_rankings.csv,2013,1.0,0.0
5788,Adult World,37887,25368,12519,2014_boxofficemojo_rankings.csv,2014,0.6695700372159316,0.3304299627840684
5789,I Am the Blues,37849,37849,0,2017_boxofficemojo_rankings.csv,2017,1.0,0.0
5790,The Heart of Nuba,37788,37788,0,2018_boxofficemojo_rankings.csv,2018,1.0,0.0
5791,Out 1,37743,31539,6204,2015_boxofficemojo_rankings.csv,2015,0.835625149034258,0.164374850965742
5792,Mumia: Long Distance Revolutionary,37731,37731,0,2013_boxofficemojo_rankings.csv,2013,1.0,0.0
5793,Krystal,37516,37516,0,2018_boxofficemojo_rankings.csv,2018,1.0,0.0
5794,News from Planet Mars,37507,310,37197,2016_boxofficemojo_rankings.csv,2016,0.008265123843549204,0.9917348761564508
5795,Big Sur,37466,37466,0,2013_boxofficemojo_rankings.csv,2013,1.0,0.0
5796,Match 2015 Re-release,37285,37285,0,2015_boxofficemojo_rankings.csv,2015,1.0,0.0
5797,Memory: The Origins of Alien,37272,31378,5894,2019_boxofficemojo_rankings.csv,2019,0.8418652071259927,0.1581347928740073
5798,Savannah,37240,37240,0,2013_boxofficemojo_rankings.csv,2013,1.0,0.0
5799,Small Group,37058,37058,0,2018_boxofficemojo_rankings.csv,2018,1.0,0.0
5800,24 Frames,37045,34482,2563,2018_boxofficemojo_rankings.csv,2018,0.9308138750168714,0.06918612498312862
5801,The Quiet One,37010,37010,0,2019_boxofficemojo_rankings.csv,2019,1.0,0.0
5802,Children of Paradise 2012 Re-release,36986,36986,0,2012_boxofficemojo_rankings.csv,2012,1.0,0.0
5803,Grey Gardens,36923,36923,0,2015_boxofficemojo_rankings.csv,2015,1.0,0.0
5804,Trust Fund,36885,36885,0,2016_boxofficemojo_rankings.csv,2016,1.0,0.0
5805,The Death of Dick Long,36856,36856,0,2019_boxofficemojo_rankings.csv,2019,1.0,0.0
5806,Three Christs,36723,36723,0,2020_boxofficemojo_rankings.csv,2020,1.0,0.0
5807,Sister Code,36676,36676,0,2015_boxofficemojo_rankings.csv,2015,1.0,0.0
5808,Mind Game,36613,36613,0,2018_boxofficemojo_rankings.csv,2018,1.0,0.0
5809,Bending the Arc,36586,21907,14679,2017_boxofficemojo_rankings.csv,2017,0.5987809544634559,0.40121904553654403
5810,Yoga Hosers,36585,0,36585,2016_boxofficemojo_rankings.csv,2016,0.0,1.0
5811,Hit So Hard,36576,34025,2551,2012_boxofficemojo_rankings.csv,2012,0.9302548118985127,0.06974518810148732
5812,Tread,36527,36527,0,2020_boxofficemojo_rankings.csv,2020,1.0,0.0
5813,For Those Who Don't Read Me,36506,36506,0,2018_boxofficemojo_rankings.csv,2018,1.0,0.0
5814,Cherry,36465,11362,25103,2010_boxofficemojo_rankings.csv,2010,0.31158645276292335,0.6884135472370766
5815,The Servant,36463,36463,0,2013_boxofficemojo_rankings.csv,2013,1.0,0.0
5816,Waiting for Anya,36404,0,36404,2020_boxofficemojo_rankings.csv,2020,0.0,1.0
5817,Unexpected,36402,23986,12416,2015_boxofficemojo_rankings.csv,2015,0.6589198395692545,0.34108016043074557
5818,How to Let Go of the World: and Love All the Things Climate Can't Change,36386,36386,0,2016_boxofficemojo_rankings.csv,2016,1.0,0.0
5819,Welcome to Leith,36380,36010,370,2015_boxofficemojo_rankings.csv,2015,0.9898295766904893,0.01017042330951072
5820,Mansome,36280,36280,0,2012_boxofficemojo_rankings.csv,2012,1.0,0.0
5821,Loosies,36145,3519,32626,2012_boxofficemojo_rankings.csv,2012,0.09735786415825148,0.9026421358417485
5822,Touchy Feely,36128,36128,0,2013_boxofficemojo_rankings.csv,2013,1.0,0.0
5823,Le Corbeau,36089,36089,0,2018_boxofficemojo_rankings.csv,2018,1.0,0.0
5824,Brimstone & Glory,36036,32059,3977,2017_boxofficemojo_rankings.csv,2017,0.8896381396381396,0.11036186036186037
5825,"Kill Me, Deadly",36027,36027,0,2016_boxofficemojo_rankings.csv,2016,1.0,0.0
5826,Not Cool,36026,36026,0,2014_boxofficemojo_rankings.csv,2014,1.0,0.0
5827,Almost Friends,35842,1481,34361,2017_boxofficemojo_rankings.csv,2017,0.04132023882595837,0.9586797611740416
5828,The House of Tomorrow,35821,35821,0,2018_boxofficemojo_rankings.csv,2018,1.0,0.0
5829,Bangkok Revenge,35784,35784,0,2012_boxofficemojo_rankings.csv,2012,1.0,0.0
5830,The Road Movie,35757,35757,0,2018_boxofficemojo_rankings.csv,2018,1.0,0.0
5831,Good Manners,35714,31177,4537,2018_boxofficemojo_rankings.csv,2018,0.8729629837038696,0.12703701629613037
5832,Paul Goodman Changed My Life,35671,35671,0,2011_boxofficemojo_rankings.csv,2011,1.0,0.0
5833,Far Out Isn't Far Enough: The Tomi Ungerer Story,35647,35647,0,2013_boxofficemojo_rankings.csv,2013,1.0,0.0
5834,M 2013 Re-release,35566,35566,0,2013_boxofficemojo_rankings.csv,2013,1.0,0.0
5835,Guy and Madeline on a Park Bench,35556,35556,0,2010_boxofficemojo_rankings.csv,2010,1.0,0.0
5836,Finders Keepers,35555,35555,0,2015_boxofficemojo_rankings.csv,2015,1.0,0.0
5837,PGS: Intuition Is Your Personal Guidance System,35423,35423,0,2018_boxofficemojo_rankings.csv,2018,1.0,0.0
5838,Kinyarwanda,35412,35412,0,2011_boxofficemojo_rankings.csv,2011,1.0,0.0
5839,Max and the Junkmen,35387,35387,0,2012_boxofficemojo_rankings.csv,2012,1.0,0.0
5840,Le Jour Se Leve,35321,35321,0,2014_boxofficemojo_rankings.csv,2014,1.0,0.0
5841,Growing Up Smith,35312,35312,0,2017_boxofficemojo_rankings.csv,2017,1.0,0.0
5842,The Decent One,35282,21327,13955,2014_boxofficemojo_rankings.csv,2014,0.6044725355705459,0.39552746442945413
5843,Underdogs,35271,35271,0,2013_boxofficemojo_rankings.csv,2013,1.0,0.0
5844,Rat Film,35195,35195,0,2017_boxofficemojo_rankings.csv,2017,1.0,0.0
5845,Ága,35178,35178,0,2019_boxofficemojo_rankings.csv,2019,1.0,0.0
5846,That Man from Rio,35144,35144,0,2014_boxofficemojo_rankings.csv,2014,1.0,0.0
5847,When Harry Tries to Marry,35100,35100,0,2011_boxofficemojo_rankings.csv,2011,1.0,0.0
5848,The Girl,35048,35048,0,2013_boxofficemojo_rankings.csv,2013,1.0,0.0
5849,Beneath the Harvest Sky,34768,34768,0,2014_boxofficemojo_rankings.csv,2014,1.0,0.0
5850,This Ain't No Mouse Music,34754,34754,0,2014_boxofficemojo_rankings.csv,2014,1.0,0.0
5851,Comic-Con Episode IV: A Fan's Hope,34665,34665,0,2012_boxofficemojo_rankings.csv,2012,1.0,0.0
5852,The Old Dark House,34649,25678,8971,2017_boxofficemojo_rankings.csv,2017,0.7410892089237785,0.25891079107622156
5853,Sophie and the Rising Sun,34630,34630,0,2017_boxofficemojo_rankings.csv,2017,1.0,0.0
5854,Le Trou,34588,34588,0,2017_boxofficemojo_rankings.csv,2017,1.0,0.0
5855,Orchestra of Exiles,34577,34577,0,2012_boxofficemojo_rankings.csv,2012,1.0,0.0
5856,Rakuen Tsuiho: Expelled from Paradise,34510,34510,0,2014_boxofficemojo_rankings.csv,2014,1.0,0.0
5857,Cosmos,34393,25856,8537,2015_boxofficemojo_rankings.csv,2015,0.7517808856453349,0.2482191143546652
5858,Pierrot le Fou 2015 Re-release,34371,34371,0,2015_boxofficemojo_rankings.csv,2015,1.0,0.0
5859,Holy Hell,34366,34366,0,2018_boxofficemojo_rankings.csv,2018,1.0,0.0
5860,Off the Rails,34249,34249,0,2016_boxofficemojo_rankings.csv,2016,1.0,0.0
5861,Rocks in My Pockets,34236,34236,0,2014_boxofficemojo_rankings.csv,2014,1.0,0.0
5862,Just Like a Woman,34206,11403,22803,2013_boxofficemojo_rankings.csv,2013,0.3333625679705315,0.6666374320294686
5863,Dave Made a Maze,34117,34117,0,2017_boxofficemojo_rankings.csv,2017,1.0,0.0
5864,Beautiful Darling,34096,34096,0,2011_boxofficemojo_rankings.csv,2011,1.0,0.0
5865,Kilo Two Bravo,34017,7891,26126,2015_boxofficemojo_rankings.csv,2015,0.23197224916953288,0.7680277508304671
5866,Bert Stern: Original Madman,34005,34005,0,2013_boxofficemojo_rankings.csv,2013,1.0,0.0
5867,RBG 2020 Re-release,34000,34000,0,2020_boxofficemojo_rankings.csv,2020,1.0,0.0
5868,Maui,33953,33953,0,2018_boxofficemojo_rankings.csv,2018,1.0,0.0
5869,Killer Unicorn,33901,33901,0,2019_boxofficemojo_rankings.csv,2019,1.0,0.0
5870,Moonlight Sonata: Deafness in Three Movements,33823,33823,0,2019_boxofficemojo_rankings.csv,2019,1.0,0.0
5871,It Felt Like Love,33817,33817,0,2014_boxofficemojo_rankings.csv,2014,1.0,0.0
5872,Closed Curtain,33735,28098,5637,2014_boxofficemojo_rankings.csv,2014,0.8329035126722988,0.1670964873277012
5873,Below Her Mouth,33673,0,33673,2017_boxofficemojo_rankings.csv,2017,0.0,1.0
5874,Making the Boys,33443,33443,0,2011_boxofficemojo_rankings.csv,2011,1.0,0.0
5875,The Winding Stream,33420,33420,0,2015_boxofficemojo_rankings.csv,2015,1.0,0.0
5876,Final Girl,33411,0,33411,2015_boxofficemojo_rankings.csv,2015,0.0,1.0
5877,"Distant Voices, Still Lives 2018 Re-release",33301,5234,28067,2018_boxofficemojo_rankings.csv,2018,0.15717245728356505,0.8428275427164349
5878,Running from Crazy,33300,33300,0,2013_boxofficemojo_rankings.csv,2013,1.0,0.0
5879,Daddy Longlegs,33217,21766,11451,2010_boxofficemojo_rankings.csv,2010,0.6552668814161423,0.3447331185838577
5880,Wasted! The Story of Food Waste,33211,33211,0,2017_boxofficemojo_rankings.csv,2017,1.0,0.0
5881,Redoubt,33155,33155,0,2019_boxofficemojo_rankings.csv,2019,1.0,0.0
5882,Love & Taxes,33150,33150,0,2017_boxofficemojo_rankings.csv,2017,1.0,0.0
5883,American Teacher,33144,33144,0,2011_boxofficemojo_rankings.csv,2011,1.0,0.0
5884,Super Dark Times,33109,33109,0,2017_boxofficemojo_rankings.csv,2017,1.0,0.0
5885,Dislecksia: The Movie,33066,33066,0,2013_boxofficemojo_rankings.csv,2013,1.0,0.0
5886,Meet Monica Velour,33042,33042,0,2011_boxofficemojo_rankings.csv,2011,1.0,0.0
5887,Ahead of Time: The Extraordinary Journey of Ruth Gruber,33024,33024,0,2010_boxofficemojo_rankings.csv,2010,1.0,0.0
5888,Albatross,32992,0,32992,2011_boxofficemojo_rankings.csv,2011,0.0,1.0
5889,Being Charlie,32964,30400,2564,2016_boxofficemojo_rankings.csv,2016,0.9222181774056547,0.07778182259434535
5890,Spoken Word,32961,32961,0,2010_boxofficemojo_rankings.csv,2010,1.0,0.0
5891,The Intervention,32919,32919,0,2016_boxofficemojo_rankings.csv,2016,1.0,0.0
5892,Shooting the Mafia,32792,10881,21911,2019_boxofficemojo_rankings.csv,2019,0.33181873627714076,0.6681812637228592
5893,No Home Movie,32757,32757,0,2016_boxofficemojo_rankings.csv,2016,1.0,0.0
5894,The Nun,32659,30245,2414,2018_boxofficemojo_rankings.csv,2018,0.9260846933463976,0.07391530665360238
5895,Sollers Point,32608,32608,0,2018_boxofficemojo_rankings.csv,2018,1.0,0.0
5896,The Day I Saw Your Heart 2012 Re-release,32567,3546,29021,2012_boxofficemojo_rankings.csv,2012,0.10888322535081524,0.8911167746491847
5897,Spettacolo,32494,32494,0,2017_boxofficemojo_rankings.csv,2017,1.0,0.0
5898,Boxing Gym,32476,32476,0,2010_boxofficemojo_rankings.csv,2010,1.0,0.0
5899,Rurouni Kenshin Part I: Origins 2016 Re-release,32445,32445,0,2016_boxofficemojo_rankings.csv,2016,1.0,0.0
5900,An Acceptable Loss,32427,32427,0,2019_boxofficemojo_rankings.csv,2019,1.0,0.0
5901,Brotherhood,32416,19722,12694,2010_boxofficemojo_rankings.csv,2010,0.6084032576505429,0.39159674234945707
5902,10E,32413,32413,0,2019_boxofficemojo_rankings.csv,2019,1.0,0.0
5903,Beetle Queen Conquers Tokyo,32308,32308,0,2010_boxofficemojo_rankings.csv,2010,1.0,0.0
5904,Living in Emergency,32208,32208,0,2010_boxofficemojo_rankings.csv,2010,1.0,0.0
5905,The Hero of Color City,32188,32188,0,2014_boxofficemojo_rankings.csv,2014,1.0,0.0
5906,Goodland,32140,32140,0,2018_boxofficemojo_rankings.csv,2018,1.0,0.0
5907,Desolation Center,32016,32016,0,2019_boxofficemojo_rankings.csv,2019,1.0,0.0
5908,"Rio, I Love You 2016 Re-release",31982,31982,0,2016_boxofficemojo_rankings.csv,2016,1.0,0.0
5909,Moynihan,31970,31970,0,2018_boxofficemojo_rankings.csv,2018,1.0,0.0
5910,District of Corruption,31954,31954,0,2012_boxofficemojo_rankings.csv,2012,1.0,0.0
5911,Amira & Sam,31849,31849,0,2015_boxofficemojo_rankings.csv,2015,1.0,0.0
5912,Paths of the Soul,31747,31747,0,2016_boxofficemojo_rankings.csv,2016,1.0,0.0
5913,180° South,31745,31745,0,2010_boxofficemojo_rankings.csv,2010,1.0,0.0
5914,At Berkeley,31736,31736,0,2013_boxofficemojo_rankings.csv,2013,1.0,0.0
5915,Aurora,31720,5677,26043,2011_boxofficemojo_rankings.csv,2011,0.1789722572509458,0.8210277427490542
5916,Gift,31588,31588,0,2019_boxofficemojo_rankings.csv,2019,1.0,0.0
5917,Signature Move,31551,31551,0,2017_boxofficemojo_rankings.csv,2017,1.0,0.0
5918,The Cat Rescuers,31540,31540,0,2019_boxofficemojo_rankings.csv,2019,1.0,0.0
5919,The Passionate Thief,31539,31539,0,2014_boxofficemojo_rankings.csv,2014,1.0,0.0
5920,Musical Chairs,31478,31478,0,2012_boxofficemojo_rankings.csv,2012,1.0,0.0
5921,Celine and Julie Go Boating,31452,31452,0,2012_boxofficemojo_rankings.csv,2012,1.0,0.0
5922,Beyond the Farthest Star,31433,31433,0,2013_boxofficemojo_rankings.csv,2013,1.0,0.0
5923,Here,31428,26743,4685,2012_boxofficemojo_rankings.csv,2012,0.8509291078019601,0.14907089219803996
5924,Sidemen: Long Road to Glory,31399,31399,0,2017_boxofficemojo_rankings.csv,2017,1.0,0.0
5925,Don Verdean,31309,31309,0,2015_boxofficemojo_rankings.csv,2015,1.0,0.0
5926,Max Winslow and the House of Secrets,31250,31250,0,2020_boxofficemojo_rankings.csv,2020,1.0,0.0
5927,Buddy,31203,31203,0,2019_boxofficemojo_rankings.csv,2019,1.0,0.0
5928,"Hey, Boo: Harper Lee and 'To Kill a Mockingbird'",31135,31135,0,2011_boxofficemojo_rankings.csv,2011,1.0,0.0
5929,Small Town Murder Songs,31133,31133,0,2011_boxofficemojo_rankings.csv,2011,1.0,0.0
5930,7 Witches,31100,31100,0,2017_boxofficemojo_rankings.csv,2017,1.0,0.0
5931,White Irish Drinkers,31056,31056,0,2011_boxofficemojo_rankings.csv,2011,1.0,0.0
5932,Poor Boy,31031,31031,0,2018_boxofficemojo_rankings.csv,2018,1.0,0.0
5933,"2 Autumns, 3 Winters",30985,5819,25166,2014_boxofficemojo_rankings.csv,2014,0.18780054865257384,0.8121994513474262
5934,The Seventh Fire,30977,30112,865,2016_boxofficemojo_rankings.csv,2016,0.9720760564289634,0.027923943571036575
5935,Who Is Harry Nilsson (And Why Is Everybody Talkin' About Him?),30975,30975,0,2010_boxofficemojo_rankings.csv,2010,1.0,0.0
5936,Rent-A-Pal,30901,30901,0,2020_boxofficemojo_rankings.csv,2020,1.0,0.0
5937,Lamb,30844,14547,16297,2016_boxofficemojo_rankings.csv,2016,0.47163143561146414,0.5283685643885359
5938,Meet the Fokkens,30810,30810,0,2012_boxofficemojo_rankings.csv,2012,1.0,0.0
5939,Pasolini 2019 Re-release,30757,30757,0,2019_boxofficemojo_rankings.csv,2019,1.0,0.0
5940,Documented,30662,30662,0,2014_boxofficemojo_rankings.csv,2014,1.0,0.0
5941,Hide Away,30655,30655,0,2012_boxofficemojo_rankings.csv,2012,1.0,0.0
5942,The Chaperone,30514,0,30514,2011_boxofficemojo_rankings.csv,2011,0.0,1.0
5943,After Parkland,30444,30444,0,2020_boxofficemojo_rankings.csv,2020,1.0,0.0
5944,Los Reyes,30418,30418,0,2019_boxofficemojo_rankings.csv,2019,1.0,0.0
5945,Dealt,30414,30414,0,2017_boxofficemojo_rankings.csv,2017,1.0,0.0
5946,These Birds Walk,30408,30408,0,2013_boxofficemojo_rankings.csv,2013,1.0,0.0
5947,"Hare Krishna! The Mantra, the Movement and the Swami Who Started It 2017 Re-release",30380,19278,11102,2017_boxofficemojo_rankings.csv,2017,0.6345622119815668,0.3654377880184332
5948,Shanghai Red 2010 Re-release,30353,30353,0,2010_boxofficemojo_rankings.csv,2010,1.0,0.0
5949,Heavy Trip,30351,10153,20198,2018_boxofficemojo_rankings.csv,2018,0.33451945570162434,0.6654805442983757
5950,Happy Christmas,30312,30312,0,2014_boxofficemojo_rankings.csv,2014,1.0,0.0
5951,No Greater Love,30247,30247,0,2017_boxofficemojo_rankings.csv,2017,1.0,0.0
5952,Cold Water,30209,30209,0,2018_boxofficemojo_rankings.csv,2018,1.0,0.0
5953,Army of Shadows 2015 Re-release,30190,30190,0,2015_boxofficemojo_rankings.csv,2015,1.0,0.0
5954,Runoff,30186,30186,0,2015_boxofficemojo_rankings.csv,2015,1.0,0.0
5955,Paul Taylor: Creative Domain,30168,30168,0,2015_boxofficemojo_rankings.csv,2015,1.0,0.0
5956,Southern Baptist Sissies,30160,30160,0,2014_boxofficemojo_rankings.csv,2014,1.0,0.0
5957,In My Sleep,30158,30158,0,2010_boxofficemojo_rankings.csv,2010,1.0,0.0
5958,Lionel Richie at Glastonbury,30123,30123,0,2019_boxofficemojo_rankings.csv,2019,1.0,0.0
5959,Therapy for a Vampire 2016 Re-release,30115,30115,0,2016_boxofficemojo_rankings.csv,2016,1.0,0.0
5960,A Long Way Off,30104,30104,0,2014_boxofficemojo_rankings.csv,2014,1.0,0.0
5961,Manakamana,30029,30029,0,2014_boxofficemojo_rankings.csv,2014,1.0,0.0
5962,Cat Run,30000,30000,0,2011_boxofficemojo_rankings.csv,2011,1.0,0.0
5963,Evidence of a Haunting,29904,29904,0,2011_boxofficemojo_rankings.csv,2011,1.0,0.0
5964,Saint Misbehavin': The Wavy Gravy Movie,29893,29893,0,2010_boxofficemojo_rankings.csv,2010,1.0,0.0
5965,Lbs.,29866,29866,0,2010_boxofficemojo_rankings.csv,2010,1.0,0.0
5966,Brother 2012 Re-release,29864,29864,0,2012_boxofficemojo_rankings.csv,2012,1.0,0.0
5967,Long Shot: The Kevin Laue Story 2013 Re-release,29863,29863,0,2013_boxofficemojo_rankings.csv,2013,1.0,0.0
5968,A Fierce Green Fire: The Battle for A Living Planet,29817,29817,0,2013_boxofficemojo_rankings.csv,2013,1.0,0.0
5969,Uncertain,29736,29736,0,2017_boxofficemojo_rankings.csv,2017,1.0,0.0
5970,Multiple Sarcasms,29731,29731,0,2010_boxofficemojo_rankings.csv,2010,1.0,0.0
5971,Yellow Day,29656,29656,0,2014_boxofficemojo_rankings.csv,2014,1.0,0.0
5972,Memories of Underdevelopment 2018 Re-release,29647,29647,0,2018_boxofficemojo_rankings.csv,2018,1.0,0.0
5973,The Perfect Race,29644,29644,0,2019_boxofficemojo_rankings.csv,2019,1.0,0.0
5974,Dead Man's Burden,29634,29634,0,2013_boxofficemojo_rankings.csv,2013,1.0,0.0
5975,The Eyes of My Mother,29539,27099,2440,2016_boxofficemojo_rankings.csv,2016,0.9173973391110057,0.0826026608889942
5976,Little Fugitive 2013 Re-release,29505,29505,0,2013_boxofficemojo_rankings.csv,2013,1.0,0.0
5977,The Best Democracy Money Can Buy,29500,29500,0,2016_boxofficemojo_rankings.csv,2016,1.0,0.0
5978,The Dog Wedding,29495,29495,0,2016_boxofficemojo_rankings.csv,2016,1.0,0.0
5979,Olympic Dreams,29450,29450,0,2020_boxofficemojo_rankings.csv,2020,1.0,0.0
5980,Redemption Road,29384,29384,0,2011_boxofficemojo_rankings.csv,2011,1.0,0.0
5981,Cousin Jules,29337,29337,0,2013_boxofficemojo_rankings.csv,2013,1.0,0.0
5982,Charm City,29335,29335,0,2018_boxofficemojo_rankings.csv,2018,1.0,0.0
5983,The Topp Twins: Untouchable Girls 2011 Re-release,29316,29316,0,2011_boxofficemojo_rankings.csv,2011,1.0,0.0
5984,Xenia 2015 Re-release,29274,3181,26093,2015_boxofficemojo_rankings.csv,2015,0.10866297738607639,0.8913370226139237
5985,Lemon,29258,29258,0,2017_boxofficemojo_rankings.csv,2017,1.0,0.0
5986,The Ground Beneath My Feet,29251,29251,0,2019_boxofficemojo_rankings.csv,2019,1.0,0.0
5987,Time to Choose,29233,29233,0,2016_boxofficemojo_rankings.csv,2016,1.0,0.0
5988,Buffaloed,29118,29118,0,2020_boxofficemojo_rankings.csv,2020,1.0,0.0
5989,Fire in the Blood,28994,28994,0,2013_boxofficemojo_rankings.csv,2013,1.0,0.0
5990,Othello,28980,28980,0,2014_boxofficemojo_rankings.csv,2014,1.0,0.0
5991,Plush,28864,3080,25784,2013_boxofficemojo_rankings.csv,2013,0.10670731707317073,0.8932926829268293
5992,Two in the Wave,28808,28808,0,2010_boxofficemojo_rankings.csv,2010,1.0,0.0
5993,Batman & Robin 2019 Re-release,28793,28597,196,2019_boxofficemojo_rankings.csv,2019,0.9931927899142152,0.00680721008578474
5994,Rebels of the Neon God,28791,28791,0,2015_boxofficemojo_rankings.csv,2015,1.0,0.0
5995,Americons,28782,28782,0,2015_boxofficemojo_rankings.csv,2015,1.0,0.0
5996,Nénette,28699,18009,10690,2010_boxofficemojo_rankings.csv,2010,0.627513153768424,0.372486846231576
5997,Hitler's Children,28663,28663,0,2012_boxofficemojo_rankings.csv,2012,1.0,0.0
5998,Abe,28657,0,28657,2020_boxofficemojo_rankings.csv,2020,0.0,1.0
5999,The Transfiguration,28631,22091,6540,2017_boxofficemojo_rankings.csv,2017,0.771576263490622,0.22842373650937794
6000,Garbo: El espía 2011 Re-release,28563,28563,0,2011_boxofficemojo_rankings.csv,2011,1.0,0.0
6001,Restoring Tomorrow,28556,28556,0,2018_boxofficemojo_rankings.csv,2018,1.0,0.0
6002,Stations of the Elevated,28516,28516,0,2014_boxofficemojo_rankings.csv,2014,1.0,0.0
6003,Carrie Pilby,28430,18957,9473,2017_boxofficemojo_rankings.csv,2017,0.6667956384101301,0.3332043615898699
6004,"Rabin, the Last Day",28411,28411,0,2016_boxofficemojo_rankings.csv,2016,1.0,0.0
6005,The Load,28410,28410,0,2019_boxofficemojo_rankings.csv,2019,1.0,0.0
6006,Struck by Lightning,28378,28378,0,2013_boxofficemojo_rankings.csv,2013,1.0,0.0
6007,The Strange Ones,28374,0,28374,2017_boxofficemojo_rankings.csv,2017,0.0,1.0
6008,North Sea Texas 2012 Re-release,28307,28307,0,2012_boxofficemojo_rankings.csv,2012,1.0,0.0
6009,"Arabian Nights - Volume 1, The Restless One",28245,12260,15985,2015_boxofficemojo_rankings.csv,2015,0.43405912550893966,0.5659408744910603
6010,"Like Sunday, Like Rain",28208,28208,0,2015_boxofficemojo_rankings.csv,2015,1.0,0.0
6011,7 Chinese Brothers,28180,28180,0,2015_boxofficemojo_rankings.csv,2015,1.0,0.0
6012,The Ambassador,28102,28102,0,2012_boxofficemojo_rankings.csv,2012,1.0,0.0
6013,Bikes vs Cars,28072,28072,0,2015_boxofficemojo_rankings.csv,2015,1.0,0.0
6014,Sembene!,28059,28059,0,2015_boxofficemojo_rankings.csv,2015,1.0,0.0
6015,Take Me to the River,28041,28041,0,2016_boxofficemojo_rankings.csv,2016,1.0,0.0
6016,Least Among Saints,28026,28026,0,2012_boxofficemojo_rankings.csv,2012,1.0,0.0
6017,Quai des Orfèvres 2018 Re-release,28013,28013,0,2018_boxofficemojo_rankings.csv,2018,1.0,0.0
6018,The Amendment,27961,27961,0,2018_boxofficemojo_rankings.csv,2018,1.0,0.0
6019,Ribbons,27959,27959,0,2017_boxofficemojo_rankings.csv,2017,1.0,0.0
6020,El Norte 2019 Re-release,27920,27920,0,2019_boxofficemojo_rankings.csv,2019,1.0,0.0
6021,Radio Dreams,27836,27836,0,2017_boxofficemojo_rankings.csv,2017,1.0,0.0
6022,Bauhaus Spirit: 100 Years of Bauhaus,27768,17122,10646,2019_boxofficemojo_rankings.csv,2019,0.6166090463843272,0.3833909536156727
6023,Simon Killer,27740,27740,0,2013_boxofficemojo_rankings.csv,2013,1.0,0.0
6024,30 Years of Garbage: The Garbage Pail Kids Story,27739,27739,0,2017_boxofficemojo_rankings.csv,2017,1.0,0.0
6025,Senso,27723,27723,0,2018_boxofficemojo_rankings.csv,2018,1.0,0.0
6026,Broadway Idiot,27595,27595,0,2013_boxofficemojo_rankings.csv,2013,1.0,0.0
6027,The King and the Mockingbird 2014 Re-release,27513,27513,0,2014_boxofficemojo_rankings.csv,2014,1.0,0.0
6028,Kate Plays Christine,27364,25564,1800,2016_boxofficemojo_rankings.csv,2016,0.9342201432539102,0.06577985674608976
6029,Cane River 2020 Re-release,27317,27317,0,2020_boxofficemojo_rankings.csv,2020,1.0,0.0
6030,Unlocking the Cage,27284,27284,0,2016_boxofficemojo_rankings.csv,2016,1.0,0.0
6031,Tiger Eyes,27160,27160,0,2013_boxofficemojo_rankings.csv,2013,1.0,0.0
6032,Bronx Gothic,27151,27151,0,2017_boxofficemojo_rankings.csv,2017,1.0,0.0
6033,"Leaving Home, Coming Home: A Portrait of Robert Frank",27073,27073,0,2019_boxofficemojo_rankings.csv,2019,1.0,0.0
6034,Last Weekend,27053,27053,0,2014_boxofficemojo_rankings.csv,2014,1.0,0.0
6035,Clash,27052,27052,0,2011_boxofficemojo_rankings.csv,2011,1.0,0.0
6036,The Last Ride,27000,27000,0,2011_boxofficemojo_rankings.csv,2011,1.0,0.0
6037,Level Five,27000,27000,0,2014_boxofficemojo_rankings.csv,2014,1.0,0.0
6038,Mali Blues,26950,26950,0,2017_boxofficemojo_rankings.csv,2017,1.0,0.0
6039,A Monster with a Thousand Heads,26865,24852,2013,2016_boxofficemojo_rankings.csv,2016,0.925069793411502,0.07493020658849804
6040,"The Devil, Probably",26816,26816,0,2012_boxofficemojo_rankings.csv,2012,1.0,0.0
6041,Tap World,26747,26747,0,2015_boxofficemojo_rankings.csv,2015,1.0,0.0
6042,Peace Officer,26632,26632,0,2015_boxofficemojo_rankings.csv,2015,1.0,0.0
6043,"Pink Ribbons, Inc.",26608,26608,0,2012_boxofficemojo_rankings.csv,2012,1.0,0.0
6044,Wrestle,26597,26597,0,2019_boxofficemojo_rankings.csv,2019,1.0,0.0
6045,Milford Graves Full Mantis,26566,26566,0,2018_boxofficemojo_rankings.csv,2018,1.0,0.0
6046,José,26563,26563,0,2020_boxofficemojo_rankings.csv,2020,1.0,0.0
6047,Front Cover,26409,26409,0,2016_boxofficemojo_rankings.csv,2016,1.0,0.0
6048,At First Light,26338,3292,23046,2018_boxofficemojo_rankings.csv,2018,0.12499050801123851,0.8750094919887614
6049,Marlina the Murderer in Four Acts,26331,17788,8543,2018_boxofficemojo_rankings.csv,2018,0.6755535300596255,0.32444646994037446
6050,Donnybrook,26284,26284,0,2019_boxofficemojo_rankings.csv,2019,1.0,0.0
6051,October Country,26185,26185,0,2010_boxofficemojo_rankings.csv,2010,1.0,0.0
6052,The Misandrists,26123,26123,0,2018_boxofficemojo_rankings.csv,2018,1.0,0.0
6053,They Call us Monsters,26080,26080,0,2017_boxofficemojo_rankings.csv,2017,1.0,0.0
6054,Ridge Runners,26019,26019,0,2018_boxofficemojo_rankings.csv,2018,1.0,0.0
6055,Main Street,26011,2560,23451,2011_boxofficemojo_rankings.csv,2011,0.09841989927338433,0.9015801007266157
6056,Jet Trash 2018 Re-release,26002,26002,0,2018_boxofficemojo_rankings.csv,2018,1.0,0.0
6057,Black Mother,25919,18762,7157,2018_boxofficemojo_rankings.csv,2018,0.7238705196959759,0.27612948030402407
6058,Django,25916,25916,0,2012_boxofficemojo_rankings.csv,2012,1.0,0.0
6059,Women Like Us,25859,25859,0,2017_boxofficemojo_rankings.csv,2017,1.0,0.0
6060,Caesar and Otto's Summer Camp Massacre,25844,25844,0,2011_boxofficemojo_rankings.csv,2011,1.0,0.0
6061,Elena,25788,25788,0,2014_boxofficemojo_rankings.csv,2014,1.0,0.0
6062,Gurukulam,25651,25651,0,2016_boxofficemojo_rankings.csv,2016,1.0,0.0
6063,Passion Play,25603,3669,21934,2011_boxofficemojo_rankings.csv,2011,0.14330351911885325,0.8566964808811467
6064,The Exploding Girl,25572,25572,0,2010_boxofficemojo_rankings.csv,2010,1.0,0.0
6065,Banjo,25531,25531,0,2016_boxofficemojo_rankings.csv,2016,1.0,0.0
6066,Waiting for Forever,25517,25517,0,2011_boxofficemojo_rankings.csv,2011,1.0,0.0
6067,Unsubscribe,25488,25488,0,2020_boxofficemojo_rankings.csv,2020,1.0,0.0
6068,Christian Mingle,25480,25480,0,2014_boxofficemojo_rankings.csv,2014,1.0,0.0
6069,Kill Command,25427,0,25427,2016_boxofficemojo_rankings.csv,2016,0.0,1.0
6070,Nobody Walks,25342,25342,0,2012_boxofficemojo_rankings.csv,2012,1.0,0.0
6071,Rediscover Sautet,25314,25314,0,2015_boxofficemojo_rankings.csv,2015,1.0,0.0
6072,Disturbing the Peace,25287,25287,0,2016_boxofficemojo_rankings.csv,2016,1.0,0.0
6073,In Search of Fellini,25269,12772,12497,2017_boxofficemojo_rankings.csv,2017,0.5054414499980213,0.49455855000197874
6074,Death of the Virgin,25247,25247,0,2012_boxofficemojo_rankings.csv,2012,1.0,0.0
6075,The Worst Movie Ever!,25206,25206,0,2011_boxofficemojo_rankings.csv,2011,1.0,0.0
6076,Fresh,25115,25115,0,2010_boxofficemojo_rankings.csv,2010,1.0,0.0
6077,Vazante,25091,23884,1207,2018_boxofficemojo_rankings.csv,2018,0.9518951018293412,0.0481048981706588
6078,Disappearance at Clifton Hill,25084,25084,0,2020_boxofficemojo_rankings.csv,2020,1.0,0.0
6079,Bonnie & Clyde vs. Dracula,25027,25027,0,2011_boxofficemojo_rankings.csv,2011,1.0,0.0
6080,The Lucky Man,25015,25015,0,2017_boxofficemojo_rankings.csv,2017,1.0,0.0
6081,The Power of Few,25000,25000,0,2013_boxofficemojo_rankings.csv,2013,1.0,0.0
6082,Ugetsu,24959,11197,13762,2017_boxofficemojo_rankings.csv,2017,0.44861572979686687,0.5513842702031332
6083,R100,24956,24956,0,2015_boxofficemojo_rankings.csv,2015,1.0,0.0
6084,Naples '44,24863,24620,243,2017_boxofficemojo_rankings.csv,2017,0.9902264408961107,0.009773559103889313
6085,An Elephant's Journey,24844,24844,0,2018_boxofficemojo_rankings.csv,2018,1.0,0.0
6086,Madaari,24822,0,24822,2016_boxofficemojo_rankings.csv,2016,0.0,1.0
6087,Light from Light,24808,24808,0,2019_boxofficemojo_rankings.csv,2019,1.0,0.0
6088,Marius/Fanny/César,24787,24787,0,2017_boxofficemojo_rankings.csv,2017,1.0,0.0
6089,Paradise 2017 Re-release,24749,24749,0,2017_boxofficemojo_rankings.csv,2017,1.0,0.0
6090,Strike,24743,15758,8985,2019_boxofficemojo_rankings.csv,2019,0.6368669926847997,0.36313300731520026
6091,Stage Mother,24736,0,24736,2020_boxofficemojo_rankings.csv,2020,0.0,1.0
6092,Cold Comes the Night,24732,16971,7761,2013_boxofficemojo_rankings.csv,2013,0.6861960213488598,0.31380397865114024
6093,The Day,24686,20984,3702,2012_boxofficemojo_rankings.csv,2012,0.8500364579113667,0.14996354208863324
6094,Hyenas,24672,24672,0,2019_boxofficemojo_rankings.csv,2019,1.0,0.0
6095,The Departure,24662,24662,0,2017_boxofficemojo_rankings.csv,2017,1.0,0.0
6096,Harvest,24657,24657,0,2011_boxofficemojo_rankings.csv,2011,1.0,0.0
6097,Knuckle,24655,2647,22008,2011_boxofficemojo_rankings.csv,2011,0.1073615899411884,0.8926384100588116
6098,Olvidados 2015 Re-release,24638,24638,0,2015_boxofficemojo_rankings.csv,2015,1.0,0.0
6099,Born to Fly: Elizabeth Streb vs. Gravity,24630,24630,0,2014_boxofficemojo_rankings.csv,2014,1.0,0.0
6100,Immigration Tango,24554,24554,0,2011_boxofficemojo_rankings.csv,2011,1.0,0.0
6101,The Aspern Papers,24554,9277,15277,2019_boxofficemojo_rankings.csv,2019,0.3778203144090576,0.6221796855909424
6102,After,24544,24544,0,2011_boxofficemojo_rankings.csv,2011,1.0,0.0
6103,Graceland,24529,24529,0,2013_boxofficemojo_rankings.csv,2013,1.0,0.0
6104,Too Late to Die Young,24487,16591,7896,2018_boxofficemojo_rankings.csv,2018,0.6775431861804223,0.32245681381957775
6105,Sudden Fear,24476,24476,0,2016_boxofficemojo_rankings.csv,2016,1.0,0.0
6106,Otter 501,24449,24449,0,2012_boxofficemojo_rankings.csv,2012,1.0,0.0
6107,Last Days in the Desert,24352,0,24352,2016_boxofficemojo_rankings.csv,2016,0.0,1.0
6108,Honeymoon,24343,9318,15025,2014_boxofficemojo_rankings.csv,2014,0.3827794437826069,0.6172205562173931
6109,Le Petit Soldat,24296,24296,0,2013_boxofficemojo_rankings.csv,2013,1.0,0.0
6110,Jasmine,24248,24248,0,2017_boxofficemojo_rankings.csv,2017,1.0,0.0
6111,Heart of Africa,24139,24139,0,2020_boxofficemojo_rankings.csv,2020,1.0,0.0
6112,Radio Unnameable,24090,24090,0,2012_boxofficemojo_rankings.csv,2012,1.0,0.0
6113,Level Up,24083,1469,22614,2016_boxofficemojo_rankings.csv,2016,0.06099738404683802,0.939002615953162
6114,Chasing Einstein,24057,24057,0,2019_boxofficemojo_rankings.csv,2019,1.0,0.0
6115,Ranchero,24036,24036,0,2011_boxofficemojo_rankings.csv,2011,1.0,0.0
6116,Steven Universe: The Movie,24012,0,24012,2019_boxofficemojo_rankings.csv,2019,0.0,1.0
6117,Beneath the Darkness,23998,0,23998,2012_boxofficemojo_rankings.csv,2012,0.0,1.0
6118,The Fiancé,23986,23986,0,2016_boxofficemojo_rankings.csv,2016,1.0,0.0
6119,Harry Dean Stanton: Partly Fiction,23959,23959,0,2013_boxofficemojo_rankings.csv,2013,1.0,0.0
6120,Almost Holy,23957,21142,2815,2016_boxofficemojo_rankings.csv,2016,0.8824978085736945,0.11750219142630547
6121,Simple Creature,23918,23918,0,2017_boxofficemojo_rankings.csv,2017,1.0,0.0
6122,Shut Up Little Man! An Audio Misadventure,23901,23901,0,2011_boxofficemojo_rankings.csv,2011,1.0,0.0
6123,Dear Mr. Watterson,23899,23899,0,2013_boxofficemojo_rankings.csv,2013,1.0,0.0
6124,Under The Wire,23897,3429,20468,2018_boxofficemojo_rankings.csv,2018,0.14349081474662093,0.856509185253379
6125,Vincent N Roxxy,23896,0,23896,2017_boxofficemojo_rankings.csv,2017,0.0,1.0
6126,Behind the Burly Q,23889,23889,0,2010_boxofficemojo_rankings.csv,2010,1.0,0.0
6127,Emoticon ;),23881,23881,0,2014_boxofficemojo_rankings.csv,2014,1.0,0.0
6128,Happy Valley,23868,23868,0,2014_boxofficemojo_rankings.csv,2014,1.0,0.0
6129,Argentina,23864,14869,8995,2015_boxofficemojo_rankings.csv,2015,0.623072410325176,0.376927589674824
6130,Death House,23833,23833,0,2018_boxofficemojo_rankings.csv,2018,1.0,0.0
6131,Greenwich Village: Music That Defined a Generation,23701,23701,0,2013_boxofficemojo_rankings.csv,2013,1.0,0.0
6132,Raw Faith,23667,23667,0,2011_boxofficemojo_rankings.csv,2011,1.0,0.0
6133,Southbound,23665,23665,0,2016_boxofficemojo_rankings.csv,2016,1.0,0.0
6134,Good Kids,23627,0,23627,2016_boxofficemojo_rankings.csv,2016,0.0,1.0
6135,"Phoenix, Oregon",23613,23613,0,2020_boxofficemojo_rankings.csv,2020,1.0,0.0
6136,Lost Bohemia,23584,23584,0,2011_boxofficemojo_rankings.csv,2011,1.0,0.0
6137,"A Woman, a Part",23562,23562,0,2017_boxofficemojo_rankings.csv,2017,1.0,0.0
6138,An Evening with Beverly Luff Linn,23515,6701,16814,2018_boxofficemojo_rankings.csv,2018,0.28496704231341696,0.715032957686583
6139,The Hill Chris Climbed: The Gridiron Heroes Story,23487,23487,0,2016_boxofficemojo_rankings.csv,2016,1.0,0.0
6140,Letter from Masanjia,23481,23481,0,2018_boxofficemojo_rankings.csv,2018,1.0,0.0
6141,Robert the Bruce,23425,0,23425,2019_boxofficemojo_rankings.csv,2019,0.0,1.0
6142,Believe Me,23419,23419,0,2014_boxofficemojo_rankings.csv,2014,1.0,0.0
6143,Can't Stand Losing You: Surviving the Police,23262,23262,0,2015_boxofficemojo_rankings.csv,2015,1.0,0.0
6144,For Ahkeem,23136,23136,0,2017_boxofficemojo_rankings.csv,2017,1.0,0.0
6145,Never Too Late,23135,0,23135,2020_boxofficemojo_rankings.csv,2020,0.0,1.0
6146,The Judge,23127,22257,870,2018_boxofficemojo_rankings.csv,2018,0.9623816318588663,0.03761836814113374
6147,Finding Oscar,23116,23116,0,2017_boxofficemojo_rankings.csv,2017,1.0,0.0
6148,The Iran Job,23115,23115,0,2012_boxofficemojo_rankings.csv,2012,1.0,0.0
6149,The Grace of Jake,23078,23078,0,2017_boxofficemojo_rankings.csv,2017,1.0,0.0
6150,Premature,23071,23071,0,2020_boxofficemojo_rankings.csv,2020,1.0,0.0
6151,Three Peaks,23069,16216,6853,2018_boxofficemojo_rankings.csv,2018,0.7029346742381551,0.2970653257618449
6152,History of Jazz: Oxygen for the Ears,23048,23048,0,2014_boxofficemojo_rankings.csv,2014,1.0,0.0
6153,Video Games: The Movie,23043,23043,0,2014_boxofficemojo_rankings.csv,2014,1.0,0.0
6154,Goat,23020,23020,0,2016_boxofficemojo_rankings.csv,2016,1.0,0.0
6155,Hellbound?,22887,22887,0,2012_boxofficemojo_rankings.csv,2012,1.0,0.0
6156,Mirza's Lady,22886,0,22886,2016_boxofficemojo_rankings.csv,2016,0.0,1.0
6157,Keyhole,22826,22826,0,2012_boxofficemojo_rankings.csv,2012,1.0,0.0
6158,The Long Day Closes,22765,22765,0,2012_boxofficemojo_rankings.csv,2012,1.0,0.0
6159,Carol Channing: Larger Than Life,22740,22740,0,2012_boxofficemojo_rankings.csv,2012,1.0,0.0
6160,The Revisionaries,22664,22664,0,2012_boxofficemojo_rankings.csv,2012,1.0,0.0
6161,Ode to Joy,22594,17303,5291,2019_boxofficemojo_rankings.csv,2019,0.7658227848101266,0.23417721518987342
6162,Trophy,22553,21439,1114,2017_boxofficemojo_rankings.csv,2017,0.9506052409878952,0.04939475901210482
6163,L'Innocente,22549,22549,0,2020_boxofficemojo_rankings.csv,2020,1.0,0.0
6164,The Other City,22539,22539,0,2010_boxofficemojo_rankings.csv,2010,1.0,0.0
6165,Anything,22537,19037,3500,2018_boxofficemojo_rankings.csv,2018,0.8446998269512358,0.15530017304876426
6166,The Black Dove,22517,22517,0,2016_boxofficemojo_rankings.csv,2016,1.0,0.0
6167,Casting By,22497,18164,4333,2013_boxofficemojo_rankings.csv,2013,0.8073965417611237,0.19260345823887629
6168,Middleground,22490,0,22490,2017_boxofficemojo_rankings.csv,2017,0.0,1.0
6169,Happy Tears,22464,22464,0,2010_boxofficemojo_rankings.csv,2010,1.0,0.0
6170,Incendiary,22457,22457,0,2011_boxofficemojo_rankings.csv,2011,1.0,0.0
6171,Realms,22443,147,22296,2017_boxofficemojo_rankings.csv,2017,0.006549926480417056,0.9934500735195829
6172,Kamikaze 89,22440,22440,0,2016_boxofficemojo_rankings.csv,2016,1.0,0.0
6173,Be Here Now,22424,22424,0,2016_boxofficemojo_rankings.csv,2016,1.0,0.0
6174,Paradise Club,22381,22381,0,2017_boxofficemojo_rankings.csv,2017,1.0,0.0
6175,Girl Model,22369,21154,1215,2012_boxofficemojo_rankings.csv,2012,0.9456837587733024,0.05431624122669766
6176,Picture Me,22369,12008,10361,2010_boxofficemojo_rankings.csv,2010,0.5368143412758729,0.46318565872412715
6177,The Painting,22313,21008,1305,2012_boxofficemojo_rankings.csv,2012,0.9415139156545511,0.058486084345448844
6178,The Atomic Cafe,22293,22293,0,2018_boxofficemojo_rankings.csv,2018,1.0,0.0
6179,Metropolitan 2015 Re-release,22284,22284,0,2015_boxofficemojo_rankings.csv,2015,1.0,0.0
6180,Slow Learners,22272,22272,0,2015_boxofficemojo_rankings.csv,2015,1.0,0.0
6181,Generation Startup,22271,22271,0,2016_boxofficemojo_rankings.csv,2016,1.0,0.0
6182,Reparation,22267,22267,0,2016_boxofficemojo_rankings.csv,2016,1.0,0.0
6183,Winning Formula,22189,22189,0,2018_boxofficemojo_rankings.csv,2018,1.0,0.0
6184,All's Faire in Love,22180,22180,0,2011_boxofficemojo_rankings.csv,2011,1.0,0.0
6185,Princess Cut,22167,22167,0,2015_boxofficemojo_rankings.csv,2015,1.0,0.0
6186,Murder Eleven,22107,22107,0,2013_boxofficemojo_rankings.csv,2013,1.0,0.0
6187,The Garden of Eden,22083,22083,0,2010_boxofficemojo_rankings.csv,2010,1.0,0.0
6188,Losing Control,22081,22081,0,2012_boxofficemojo_rankings.csv,2012,1.0,0.0
6189,And Everything Is Going Fine,22080,22080,0,2010_boxofficemojo_rankings.csv,2010,1.0,0.0
6190,Four Adventures of Reinette and Mirabelle,22039,22039,0,2011_boxofficemojo_rankings.csv,2011,1.0,0.0
6191,Answers to Nothing,22029,22029,0,2011_boxofficemojo_rankings.csv,2011,1.0,0.0
6192,Pet,22003,8004,13999,2016_boxofficemojo_rankings.csv,2016,0.3637685770122256,0.6362314229877744
6193,The Sound of Silence,21994,20013,1981,2019_boxofficemojo_rankings.csv,2019,0.9099299809038829,0.09007001909611713
6194,The Passion of Joan of Arc,21877,21877,0,2017_boxofficemojo_rankings.csv,2017,1.0,0.0
6195,Deep Gold 3D,21868,12000,9868,2011_boxofficemojo_rankings.csv,2011,0.5487470276202671,0.45125297237973294
6196,The ABCs of Death,21832,21832,0,2013_boxofficemojo_rankings.csv,2013,1.0,0.0
6197,Animals 2015 Re-release,21821,21821,0,2015_boxofficemojo_rankings.csv,2015,1.0,0.0
6198,Viola,21818,21818,0,2013_boxofficemojo_rankings.csv,2013,1.0,0.0
6199,The Female Brain,21786,21786,0,2018_boxofficemojo_rankings.csv,2018,1.0,0.0
6200,Better Than Something: Jay Reatard,21697,21697,0,2012_boxofficemojo_rankings.csv,2012,1.0,0.0
6201,Dead Awake,21675,11528,10147,2017_boxofficemojo_rankings.csv,2017,0.5318569780853518,0.46814302191464824
6202,Évocateur: The Morton Downey Jr. Movie,21652,21652,0,2013_boxofficemojo_rankings.csv,2013,1.0,0.0
6203,Toe to Toe,21648,21648,0,2010_boxofficemojo_rankings.csv,2010,1.0,0.0
6204,Sedona,21638,21638,0,2012_boxofficemojo_rankings.csv,2012,1.0,0.0
6205,Blue Jay,21626,21626,0,2016_boxofficemojo_rankings.csv,2016,1.0,0.0
6206,Wicked Witches,21600,21600,0,2019_boxofficemojo_rankings.csv,2019,1.0,0.0
6207,Half the Picture,21589,21589,0,2018_boxofficemojo_rankings.csv,2018,1.0,0.0
6208,Waiting for Lightning,21577,21577,0,2012_boxofficemojo_rankings.csv,2012,1.0,0.0
6209,10 timer til Paradis,21561,16000,5561,2012_boxofficemojo_rankings.csv,2012,0.742080608506099,0.25791939149390103
6210,Monogamy,21527,21527,0,2011_boxofficemojo_rankings.csv,2011,1.0,0.0
6211,Thank You for Your Service,21497,21497,0,2016_boxofficemojo_rankings.csv,2016,1.0,0.0
6212,Hagazussa,21487,13253,8234,2018_boxofficemojo_rankings.csv,2018,0.616791548378089,0.3832084516219109
6213,Tyrel,21456,21456,0,2018_boxofficemojo_rankings.csv,2018,1.0,0.0
6214,Song Of Granite,21349,16182,5167,2017_boxofficemojo_rankings.csv,2017,0.7579746123940231,0.24202538760597686
6215,Tio Papi,21316,21316,0,2013_boxofficemojo_rankings.csv,2013,1.0,0.0
6216,Memphis,21286,21286,0,2014_boxofficemojo_rankings.csv,2014,1.0,0.0
6217,Resurrect Dead: The Mystery of the Toynbee Tiles,21242,21242,0,2011_boxofficemojo_rankings.csv,2011,1.0,0.0
6218,Already Tomorrow in Hong Kong,21206,21206,0,2016_boxofficemojo_rankings.csv,2016,1.0,0.0
6219,Ganja & Hess,21197,21197,0,2018_boxofficemojo_rankings.csv,2018,1.0,0.0
6220,NightLights,21147,21147,0,2014_boxofficemojo_rankings.csv,2014,1.0,0.0
6221,God Knows Where I Am,21135,21135,0,2017_boxofficemojo_rankings.csv,2017,1.0,0.0
6222,The Happys,21108,21108,0,2018_boxofficemojo_rankings.csv,2018,1.0,0.0
6223,Massacre on Aisle 12,21106,21106,0,2017_boxofficemojo_rankings.csv,2017,1.0,0.0
6224,A Beginner's Guide to Snuff,21031,21031,0,2017_boxofficemojo_rankings.csv,2017,1.0,0.0
6225,The Sacrifice 2014 Re-release,20945,20945,0,2014_boxofficemojo_rankings.csv,2014,1.0,0.0
6226,Round of Your Life,20941,20941,0,2019_boxofficemojo_rankings.csv,2019,1.0,0.0
6227,Ava,20940,20940,0,2018_boxofficemojo_rankings.csv,2018,1.0,0.0
6228,Man Underground,20907,20907,0,2017_boxofficemojo_rankings.csv,2017,1.0,0.0
6229,Lekar Hum Deewana Dil,20874,20874,0,2014_boxofficemojo_rankings.csv,2014,1.0,0.0
6230,Cameraman: The Life and Work of Jack Cardiff,20840,20840,0,2011_boxofficemojo_rankings.csv,2011,1.0,0.0
6231,Time Changer 2016 Re-release,20797,20797,0,2016_boxofficemojo_rankings.csv,2016,1.0,0.0
6232,Did You Wonder Who Fired the Gun?,20765,20765,0,2018_boxofficemojo_rankings.csv,2018,1.0,0.0
6233,All These Sleepless Nights,20762,20762,0,2017_boxofficemojo_rankings.csv,2017,1.0,0.0
6234,For Ellen,20746,12396,8350,2012_boxofficemojo_rankings.csv,2012,0.5975127735467078,0.4024872264532922
6235,The Ghosts in Our Machine,20709,20709,0,2013_boxofficemojo_rankings.csv,2013,1.0,0.0
6236,The Great Flood,20694,20694,0,2014_boxofficemojo_rankings.csv,2014,1.0,0.0
6237,Freak Show,20657,19696,961,2018_boxofficemojo_rankings.csv,2018,0.9534782398218522,0.046521760178147846
6238,Douchebag,20615,20615,0,2010_boxofficemojo_rankings.csv,2010,1.0,0.0
6239,Our Nixon,20584,20584,0,2013_boxofficemojo_rankings.csv,2013,1.0,0.0
6240,Fidelio: Alice's Odyssey,20571,3580,16991,2015_boxofficemojo_rankings.csv,2015,0.17403140343201595,0.825968596567984
6241,Coming Up Roses 2014 Re-release,20567,20567,0,2014_boxofficemojo_rankings.csv,2014,1.0,0.0
6242,Band of Robbers,20555,20555,0,2016_boxofficemojo_rankings.csv,2016,1.0,0.0
6243,The Work,20554,5853,14701,2017_boxofficemojo_rankings.csv,2017,0.28476209010411596,0.715237909895884
6244,Ice Dragon: Legend of the Blue Daisies,20549,20549,0,2018_boxofficemojo_rankings.csv,2018,1.0,0.0
6245,This Last Lonely Place,20507,20507,0,2016_boxofficemojo_rankings.csv,2016,1.0,0.0
6246,Consumed,20476,20476,0,2015_boxofficemojo_rankings.csv,2015,1.0,0.0
6247,The Devil and Father Amorth,20449,20449,0,2018_boxofficemojo_rankings.csv,2018,1.0,0.0
6248,Boy Meets Girl,20441,20441,0,2015_boxofficemojo_rankings.csv,2015,1.0,0.0
6249,Burden,20437,18440,1997,2017_boxofficemojo_rankings.csv,2017,0.9022850711944023,0.09771492880559769
6250,Never,20431,20431,0,2016_boxofficemojo_rankings.csv,2016,1.0,0.0
6251,The Highest Pass,20386,20386,0,2012_boxofficemojo_rankings.csv,2012,1.0,0.0
6252,The All Americans,20324,20324,0,2019_boxofficemojo_rankings.csv,2019,1.0,0.0
6253,Koroshiya 1 2017 Re-release,20285,20285,0,2017_boxofficemojo_rankings.csv,2017,1.0,0.0
6254,The Korean,20279,20279,0,2010_boxofficemojo_rankings.csv,2010,1.0,0.0
6255,Double Take,20218,20218,0,2010_boxofficemojo_rankings.csv,2010,1.0,0.0
6256,Izzy Gets the F*ck Across Town,20208,20208,0,2018_boxofficemojo_rankings.csv,2018,1.0,0.0
6257,New World Order,20205,20205,0,2016_boxofficemojo_rankings.csv,2016,1.0,0.0
6258,Jesus Henry Christ,20183,20183,0,2012_boxofficemojo_rankings.csv,2012,1.0,0.0
6259,Shoah,20175,20175,0,2010_boxofficemojo_rankings.csv,2010,1.0,0.0
6260,Friends and Romans,20136,20136,0,2015_boxofficemojo_rankings.csv,2015,1.0,0.0
6261,How to Grow a Band,20135,20135,0,2012_boxofficemojo_rankings.csv,2012,1.0,0.0
6262,The Man from Outer Space,20102,20102,0,2017_boxofficemojo_rankings.csv,2017,1.0,0.0
6263,Love Me True,20100,20100,0,2016_boxofficemojo_rankings.csv,2016,1.0,0.0
6264,The Past is a Grotesque Animal,20056,20056,0,2014_boxofficemojo_rankings.csv,2014,1.0,0.0
6265,Apocalypsis,20052,20052,0,2018_boxofficemojo_rankings.csv,2018,1.0,0.0
6266,General Magic,20046,20046,0,2019_boxofficemojo_rankings.csv,2019,1.0,0.0
6267,The Gospel of Eureka,20039,20039,0,2019_boxofficemojo_rankings.csv,2019,1.0,0.0
6268,"No Pay, Nudity",20017,20017,0,2016_boxofficemojo_rankings.csv,2016,1.0,0.0
6269,Lore,20006,20006,0,2020_boxofficemojo_rankings.csv,2020,1.0,0.0
6270,Eight Hours Don't Make a Day,19987,19987,0,2018_boxofficemojo_rankings.csv,2018,1.0,0.0
6271,"One Sings, the Other Doesn't",19919,19919,0,2018_boxofficemojo_rankings.csv,2018,1.0,0.0
6272,Wedding Palace,19908,19908,0,2013_boxofficemojo_rankings.csv,2013,1.0,0.0
6273,Forbidden Games,19889,19889,0,2015_boxofficemojo_rankings.csv,2015,1.0,0.0
6274,Foster Boy,19873,19873,0,2020_boxofficemojo_rankings.csv,2020,1.0,0.0
6275,Active Measures,19862,19862,0,2018_boxofficemojo_rankings.csv,2018,1.0,0.0
6276,Heat and Dust 2017 Re-release,19856,19856,0,2017_boxofficemojo_rankings.csv,2017,1.0,0.0
6277,Wild Canaries,19777,19777,0,2015_boxofficemojo_rankings.csv,2015,1.0,0.0
6278,The Trial,19753,19753,0,2010_boxofficemojo_rankings.csv,2010,1.0,0.0
6279,The Romans,19705,19705,0,2016_boxofficemojo_rankings.csv,2016,1.0,0.0
6280,Trafficked,19698,19698,0,2017_boxofficemojo_rankings.csv,2017,1.0,0.0
6281,Kills On Wheels 2016 Re-release,19680,15898,3782,2016_boxofficemojo_rankings.csv,2016,0.8078252032520326,0.19217479674796747
6282,Misery Loves Comedy,19634,19634,0,2015_boxofficemojo_rankings.csv,2015,1.0,0.0
6283,Bad Milo,19613,19613,0,2013_boxofficemojo_rankings.csv,2013,1.0,0.0
6284,Art Bastard,19600,19600,0,2016_boxofficemojo_rankings.csv,2016,1.0,0.0
6285,Uzumasa Limelight,19597,19597,0,2014_boxofficemojo_rankings.csv,2014,1.0,0.0
6286,Zoology,19572,0,19572,2016_boxofficemojo_rankings.csv,2016,0.0,1.0
6287,Damascus Cover,19532,0,19532,2018_boxofficemojo_rankings.csv,2018,0.0,1.0
6288,Comet,19530,8623,10907,2014_boxofficemojo_rankings.csv,2014,0.4415258576548899,0.5584741423451101
6289,Hannah: Buddhism's Untold Journey,19526,396,19130,2016_boxofficemojo_rankings.csv,2016,0.02028065143910683,0.9797193485608932
6290,BOSTON: An American Running Story 2017 Re-release,19499,19499,0,2017_boxofficemojo_rankings.csv,2017,1.0,0.0
6291,Grassroots,19492,12356,7136,2012_boxofficemojo_rankings.csv,2012,0.6339010876256926,0.3660989123743074
6292,In Over My Head,19482,19482,0,2012_boxofficemojo_rankings.csv,2012,1.0,0.0
6293,A Picture of You,19480,19480,0,2014_boxofficemojo_rankings.csv,2014,1.0,0.0
6294,Guardian Angel,19480,19480,0,2014_boxofficemojo_rankings.csv,2014,1.0,0.0
6295,Whensday,19463,19463,0,2013_boxofficemojo_rankings.csv,2013,1.0,0.0
6296,Hunter Gatherer,19462,19462,0,2016_boxofficemojo_rankings.csv,2016,1.0,0.0
6297,Skateland,19411,19411,0,2011_boxofficemojo_rankings.csv,2011,1.0,0.0
6298,Mansfield 66/67,19390,17930,1460,2017_boxofficemojo_rankings.csv,2017,0.9247034553893759,0.07529654461062403
6299,Tchoupitoulas,19375,19375,0,2012_boxofficemojo_rankings.csv,2012,1.0,0.0
6300,Actress,19365,19365,0,2014_boxofficemojo_rankings.csv,2014,1.0,0.0
6301,Peter Brook: The Tightrope,19365,19365,0,2014_boxofficemojo_rankings.csv,2014,1.0,0.0
6302,Watchers of the Sky,19339,19339,0,2014_boxofficemojo_rankings.csv,2014,1.0,0.0
6303,Gabo: The Creation of Gabriel Garcia Marquez,19337,19337,0,2015_boxofficemojo_rankings.csv,2015,1.0,0.0
6304,Jackie & Ryan,19305,0,19305,2015_boxofficemojo_rankings.csv,2015,0.0,1.0
6305,Reuniting the Rubins,19288,13569,5719,2011_boxofficemojo_rankings.csv,2011,0.703494400663625,0.29650559933637494
6306,Romeos,19248,1081,18167,2011_boxofficemojo_rankings.csv,2011,0.056161679135494594,0.9438383208645054
6307,Neshoba,19245,19245,0,2010_boxofficemojo_rankings.csv,2010,1.0,0.0
6308,The People I've Slept With,19137,19137,0,2010_boxofficemojo_rankings.csv,2010,1.0,0.0
6309,Who We Are Now,19128,19128,0,2018_boxofficemojo_rankings.csv,2018,1.0,0.0
6310,L'important c'est d'aimer,19120,19120,0,2017_boxofficemojo_rankings.csv,2017,1.0,0.0
6311,Revelation: Dawn of Global Government,19107,19107,0,2016_boxofficemojo_rankings.csv,2016,1.0,0.0
6312,Make Believe,19085,19085,0,2011_boxofficemojo_rankings.csv,2011,1.0,0.0
6313,November,19084,19084,0,2018_boxofficemojo_rankings.csv,2018,1.0,0.0
6314,Search Engines,19033,19033,0,2016_boxofficemojo_rankings.csv,2016,1.0,0.0
6315,The Challenger,19003,19003,0,2015_boxofficemojo_rankings.csv,2015,1.0,0.0
6316,The Color Wheel,19001,19001,0,2012_boxofficemojo_rankings.csv,2012,1.0,0.0
6317,The Kill Team,18983,18983,0,2014_boxofficemojo_rankings.csv,2014,1.0,0.0
6318,Sophomore,18945,18945,0,2012_boxofficemojo_rankings.csv,2012,1.0,0.0
6319,Smash & Grab: The Story of the Pink Panthers,18938,18938,0,2013_boxofficemojo_rankings.csv,2013,1.0,0.0
6320,Ktown Cowboys,18863,18863,0,2016_boxofficemojo_rankings.csv,2016,1.0,0.0
6321,Nostalgia,18846,18846,0,2013_boxofficemojo_rankings.csv,2013,1.0,0.0
6322,Frank and Ava,18829,18829,0,2018_boxofficemojo_rankings.csv,2018,1.0,0.0
6323,Test,18823,18823,0,2014_boxofficemojo_rankings.csv,2014,1.0,0.0
6324,Scandalous: The True Story of the National Enquirer,18759,18759,0,2019_boxofficemojo_rankings.csv,2019,1.0,0.0
6325,The Sorcerer and the White Snake 2013 Re-release,18759,18759,0,2013_boxofficemojo_rankings.csv,2013,1.0,0.0
6326,Before Stonewall,18724,18724,0,2019_boxofficemojo_rankings.csv,2019,1.0,0.0
6327,Seoul Searching,18654,18654,0,2016_boxofficemojo_rankings.csv,2016,1.0,0.0
6328,Crime + Punishment,18644,18644,0,2018_boxofficemojo_rankings.csv,2018,1.0,0.0
6329,A Single Shot,18642,18642,0,2013_boxofficemojo_rankings.csv,2013,1.0,0.0
6330,Wish Me Away,18618,18618,0,2012_boxofficemojo_rankings.csv,2012,1.0,0.0
6331,The Return of Martin Guerre 2019 Re-release,18603,18603,0,2019_boxofficemojo_rankings.csv,2019,1.0,0.0
6332,The Pagan King: The Battle of Death,18598,0,18598,2018_boxofficemojo_rankings.csv,2018,0.0,1.0
6333,Bobbi Jene,18579,18579,0,2017_boxofficemojo_rankings.csv,2017,1.0,0.0
6334,La Camioneta: The Journey of One American School Bus,18558,18558,0,2013_boxofficemojo_rankings.csv,2013,1.0,0.0
6335,Let My People Go!,18529,18529,0,2013_boxofficemojo_rankings.csv,2013,1.0,0.0
6336,Allegiance to Broadway,18527,18527,0,2018_boxofficemojo_rankings.csv,2018,1.0,0.0
6337,Desolation,18490,18490,0,2018_boxofficemojo_rankings.csv,2018,1.0,0.0
6338,All the Rage,18489,18489,0,2017_boxofficemojo_rankings.csv,2017,1.0,0.0
6339,The Ghoul,18459,2032,16427,2017_boxofficemojo_rankings.csv,2017,0.11008180291456741,0.8899181970854326
6340,306 Hollywood,18399,18399,0,2018_boxofficemojo_rankings.csv,2018,1.0,0.0
6341,Oka!,18364,18364,0,2011_boxofficemojo_rankings.csv,2011,1.0,0.0
6342,"Phoenix, Oregon",18356,18356,0,2019_boxofficemojo_rankings.csv,2019,1.0,0.0
6343,"Intent to Destroy: Death, Denial & Depiction 2017 Re-release",18340,18340,0,2017_boxofficemojo_rankings.csv,2017,1.0,0.0
6344,The Channel,18319,18319,0,2016_boxofficemojo_rankings.csv,2016,1.0,0.0
6345,Four Bags Full,18297,18297,0,2013_boxofficemojo_rankings.csv,2013,1.0,0.0
6346,SHOT! The Psycho-Spiritual Mantra of Rock,18295,15157,3138,2017_boxofficemojo_rankings.csv,2017,0.8284777261546871,0.17152227384531293
6347,Off and Running,18262,18262,0,2010_boxofficemojo_rankings.csv,2010,1.0,0.0
6348,Tosca's Kiss,18236,18236,0,2014_boxofficemojo_rankings.csv,2014,1.0,0.0
6349,Torn,18202,18202,0,2013_boxofficemojo_rankings.csv,2013,1.0,0.0
6350,Marcelino Pan y Vino 2012 Re-release,18193,18193,0,2012_boxofficemojo_rankings.csv,2012,1.0,0.0
6351,Who is Dayani Cristal?,18190,18190,0,2014_boxofficemojo_rankings.csv,2014,1.0,0.0
6352,The Lion in Winter 2016 Re-release,18177,18177,0,2016_boxofficemojo_rankings.csv,2016,1.0,0.0
6353,Coming Through the Rye,18137,18137,0,2016_boxofficemojo_rankings.csv,2016,1.0,0.0
6354,King of Hearts,18130,17646,484,2018_boxofficemojo_rankings.csv,2018,0.973303916161059,0.02669608383894098
6355,Peter and the Farm,18123,18123,0,2016_boxofficemojo_rankings.csv,2016,1.0,0.0
6356,Harry Benson: Shoot First,18092,18092,0,2016_boxofficemojo_rankings.csv,2016,1.0,0.0
6357,A Bit of Bad Luck,18089,18089,0,2016_boxofficemojo_rankings.csv,2016,1.0,0.0
6358,Total Recall 2012 Re-release,18081,18081,0,2012_boxofficemojo_rankings.csv,2012,1.0,0.0
6359,Holy Hell,18051,18051,0,2016_boxofficemojo_rankings.csv,2016,1.0,0.0
6360,On Tour with Pina Bausch,18016,18016,0,2014_boxofficemojo_rankings.csv,2014,1.0,0.0
6361,I Knew Her Well,18010,18010,0,2016_boxofficemojo_rankings.csv,2016,1.0,0.0
6362,Men Go to Battle,18006,18006,0,2016_boxofficemojo_rankings.csv,2016,1.0,0.0
6363,Battle for Brooklyn,18000,18000,0,2011_boxofficemojo_rankings.csv,2011,1.0,0.0
6364,Jamel Shabazz Street Photographer,17992,17992,0,2013_boxofficemojo_rankings.csv,2013,1.0,0.0
6365,Payback,17979,17979,0,2012_boxofficemojo_rankings.csv,2012,1.0,0.0
6366,Cook County,17977,17977,0,2011_boxofficemojo_rankings.csv,2011,1.0,0.0
6367,The Cranes Are Flying,17923,17923,0,2019_boxofficemojo_rankings.csv,2019,1.0,0.0
6368,Great Directors,17921,17921,0,2010_boxofficemojo_rankings.csv,2010,1.0,0.0
6369,Dealin' with Idiots,17909,17909,0,2013_boxofficemojo_rankings.csv,2013,1.0,0.0
6370,Li'l Quinquin,17868,7192,10676,2015_boxofficemojo_rankings.csv,2015,0.4025072755764495,0.5974927244235505
6371,The Thorn in the Heart,17849,7376,10473,2010_boxofficemojo_rankings.csv,2010,0.41324443946439576,0.5867555605356042
6372,The Last Shaman,17844,17844,0,2017_boxofficemojo_rankings.csv,2017,1.0,0.0
6373,Made in Hong Kong,17843,17843,0,2020_boxofficemojo_rankings.csv,2020,1.0,0.0
6374,David,17828,0,17828,2013_boxofficemojo_rankings.csv,2013,0.0,1.0
6375,Batman: Mask of the Phantasm 2018 Re-release,17813,17813,0,2018_boxofficemojo_rankings.csv,2018,1.0,0.0
6376,Escapes,17778,17778,0,2017_boxofficemojo_rankings.csv,2017,1.0,0.0
6377,Sacred,17740,17740,0,2017_boxofficemojo_rankings.csv,2017,1.0,0.0
6378,Little Birds,17739,17739,0,2012_boxofficemojo_rankings.csv,2012,1.0,0.0
6379,The Other One,17727,17727,0,2015_boxofficemojo_rankings.csv,2015,1.0,0.0
6380,Kelly & Cal,17702,17702,0,2014_boxofficemojo_rankings.csv,2014,1.0,0.0
6381,Bad Grandmas,17688,17688,0,2017_boxofficemojo_rankings.csv,2017,1.0,0.0
6382,The History of Future Folk,17646,17646,0,2013_boxofficemojo_rankings.csv,2013,1.0,0.0
6383,How He Fell in Love,17575,17575,0,2016_boxofficemojo_rankings.csv,2016,1.0,0.0
6384,The Chronicle of Anna Magdalena Bach,17527,17527,0,2018_boxofficemojo_rankings.csv,2018,1.0,0.0
6385,Streit's: Matzo and the American Dream,17506,17506,0,2016_boxofficemojo_rankings.csv,2016,1.0,0.0
6386,Butterfly Girl,17503,17503,0,2015_boxofficemojo_rankings.csv,2015,1.0,0.0
6387,Chained for Life,17431,17431,0,2019_boxofficemojo_rankings.csv,2019,1.0,0.0
6388,Pandora and the Flying Dutchman 2020 Re-release,17401,17401,0,2020_boxofficemojo_rankings.csv,2020,1.0,0.0
6389,The Law,17351,17351,0,2010_boxofficemojo_rankings.csv,2010,1.0,0.0
6390,"A Bread Factory, Part One/A Bread Factory, Part Two",17325,17325,0,2018_boxofficemojo_rankings.csv,2018,1.0,0.0
6391,Littlerock,17309,17309,0,2011_boxofficemojo_rankings.csv,2011,1.0,0.0
6392,The Homestretch,17306,17306,0,2014_boxofficemojo_rankings.csv,2014,1.0,0.0
6393,Stand Clear of the Closing Doors,17282,17282,0,2014_boxofficemojo_rankings.csv,2014,1.0,0.0
6394,Archie's Final Project,17282,17282,0,2011_boxofficemojo_rankings.csv,2011,1.0,0.0
6395,Revival,17252,17252,0,2018_boxofficemojo_rankings.csv,2018,1.0,0.0
6396,Landfill Harmonic,17205,17205,0,2016_boxofficemojo_rankings.csv,2016,1.0,0.0
6397,Food Evolution,17181,17181,0,2017_boxofficemojo_rankings.csv,2017,1.0,0.0
6398,Accident 2014 Re-release,17161,17161,0,2014_boxofficemojo_rankings.csv,2014,1.0,0.0
6399,Le Pont du Nord,17110,17110,0,2013_boxofficemojo_rankings.csv,2013,1.0,0.0
6400,Always Shine,17102,17102,0,2016_boxofficemojo_rankings.csv,2016,1.0,0.0
6401,On the Map,17099,17099,0,2016_boxofficemojo_rankings.csv,2016,1.0,0.0
6402,Grandmaster,17077,17077,0,2012_boxofficemojo_rankings.csv,2012,1.0,0.0
6403,The Understudy,17036,17036,0,2012_boxofficemojo_rankings.csv,2012,1.0,0.0
6404,Goodbye to All That,16986,16986,0,2014_boxofficemojo_rankings.csv,2014,1.0,0.0
6405,The Prophet's Son,16983,16983,0,2012_boxofficemojo_rankings.csv,2012,1.0,0.0
6406,Joseph Pulitzer: Voice of the People,16970,16970,0,2019_boxofficemojo_rankings.csv,2019,1.0,0.0
6407,Advocate,16942,16942,0,2020_boxofficemojo_rankings.csv,2020,1.0,0.0
6408,Carbon Nation,16901,16901,0,2010_boxofficemojo_rankings.csv,2010,1.0,0.0
6409,Return,16886,16124,762,2012_boxofficemojo_rankings.csv,2012,0.9548738600023688,0.045126139997631175
6410,Hank and Asha,16878,16878,0,2014_boxofficemojo_rankings.csv,2014,1.0,0.0
6411,Swim Team,16783,16783,0,2017_boxofficemojo_rankings.csv,2017,1.0,0.0
6412,Night Across the Street,16778,16778,0,2013_boxofficemojo_rankings.csv,2013,1.0,0.0
6413,Eva 2015 Re-release,16738,16738,0,2015_boxofficemojo_rankings.csv,2015,1.0,0.0
6414,Inventing Our Life: The Kibbutz Experiment,16734,16734,0,2012_boxofficemojo_rankings.csv,2012,1.0,0.0
6415,This Changes Everything,16692,16692,0,2015_boxofficemojo_rankings.csv,2015,1.0,0.0
6416,The World of Kanako 2015 Re-release,16627,16627,0,2015_boxofficemojo_rankings.csv,2015,1.0,0.0
6417,The Freebie,16613,16613,0,2010_boxofficemojo_rankings.csv,2010,1.0,0.0
6418,The Freedom to Marry,16611,16611,0,2017_boxofficemojo_rankings.csv,2017,1.0,0.0
6419,Who Took Johnny,16595,16595,0,2015_boxofficemojo_rankings.csv,2015,1.0,0.0
6420,Haikara-San: Here Comes Miss Modern,16572,16572,0,2018_boxofficemojo_rankings.csv,2018,1.0,0.0
6421,Life in a Walk,16557,16557,0,2015_boxofficemojo_rankings.csv,2015,1.0,0.0
6422,Brave New Jersey,16544,16544,0,2017_boxofficemojo_rankings.csv,2017,1.0,0.0
6423,33 & Beyond: The Royal Art of Freemasonry,16533,16533,0,2017_boxofficemojo_rankings.csv,2017,1.0,0.0
6424,Mission Control: The Unsung Heroes of Apollo,16405,16405,0,2017_boxofficemojo_rankings.csv,2017,1.0,0.0
6425,Magician: The Astonishing Life and Work of Orson Welles,16400,16400,0,2014_boxofficemojo_rankings.csv,2014,1.0,0.0
6426,Dying to Know: Ram Dass & Timothy Leary,16397,16397,0,2017_boxofficemojo_rankings.csv,2017,1.0,0.0
6427,Design Is One: The Vignellis,16386,16386,0,2013_boxofficemojo_rankings.csv,2013,1.0,0.0
6428,Pray: The Story of Patrick Peyton,16270,16270,0,2020_boxofficemojo_rankings.csv,2020,1.0,0.0
6429,Centigrade,16263,16263,0,2020_boxofficemojo_rankings.csv,2020,1.0,0.0
6430,I Melt with You,16232,6361,9871,2011_boxofficemojo_rankings.csv,2011,0.3918802365697388,0.6081197634302612
6431,The Human Centipede III (Final Sequence),16184,16184,0,2015_boxofficemojo_rankings.csv,2015,1.0,0.0
6432,This is Our Land,16182,11567,4615,2017_boxofficemojo_rankings.csv,2017,0.7148065752070202,0.2851934247929799
6433,All the Queen's Horses,16172,16172,0,2017_boxofficemojo_rankings.csv,2017,1.0,0.0
6434,Detour,16172,16172,0,2018_boxofficemojo_rankings.csv,2018,1.0,0.0
6435,Virginia Minnesota,16118,16118,0,2019_boxofficemojo_rankings.csv,2019,1.0,0.0
6436,Levitated Mass,16086,16086,0,2014_boxofficemojo_rankings.csv,2014,1.0,0.0
6437,Straight Up,16080,16080,0,2020_boxofficemojo_rankings.csv,2020,1.0,0.0
6438,1920 London,16077,0,16077,2016_boxofficemojo_rankings.csv,2016,0.0,1.0
6439,Out of the Clear Blue Sky,16050,16050,0,2013_boxofficemojo_rankings.csv,2013,1.0,0.0
6440,Long Shot: The Kevin Laue Story,16011,16011,0,2012_boxofficemojo_rankings.csv,2012,1.0,0.0
6441,Planet of Snail,16002,13957,2045,2012_boxofficemojo_rankings.csv,2012,0.8722034745656793,0.1277965254343207
6442,Supercapitalist,16000,16000,0,2012_boxofficemojo_rankings.csv,2012,1.0,0.0
6443,Charged: The Eduardo Garcia Story,15920,15920,0,2017_boxofficemojo_rankings.csv,2017,1.0,0.0
6444,Can You Dig This,15909,15909,0,2015_boxofficemojo_rankings.csv,2015,1.0,0.0
6445,The Bay of Silence,15889,1941,13948,2020_boxofficemojo_rankings.csv,2020,0.12215998489521052,0.8778400151047895
6446,This Binary Universe,15875,15875,0,2012_boxofficemojo_rankings.csv,2012,1.0,0.0
6447,Starfish,15849,15849,0,2019_boxofficemojo_rankings.csv,2019,1.0,0.0
6448,A Reason,15792,15792,0,2015_boxofficemojo_rankings.csv,2015,1.0,0.0
6449,Defining Hope,15788,15788,0,2017_boxofficemojo_rankings.csv,2017,1.0,0.0
6450,Take Me Home,15760,15760,0,2012_boxofficemojo_rankings.csv,2012,1.0,0.0
6451,Full Moon in Paris,15726,15726,0,2015_boxofficemojo_rankings.csv,2015,1.0,0.0
6452,Trinity Seven The Movie 2: Heavens Library & Crimson Lord,15712,15712,0,2019_boxofficemojo_rankings.csv,2019,1.0,0.0
6453,Breakdance Academy,15628,15628,0,2010_boxofficemojo_rankings.csv,2010,1.0,0.0
6454,Dreams Rewired,15626,11843,3783,2015_boxofficemojo_rankings.csv,2015,0.7579034941763727,0.2420965058236273
6455,Out on Stage,15623,15623,0,2018_boxofficemojo_rankings.csv,2018,1.0,0.0
6456,The Competition 2019 Re-release,15622,15622,0,2019_boxofficemojo_rankings.csv,2019,1.0,0.0
6457,Basmati Blues,15605,0,15605,2017_boxofficemojo_rankings.csv,2017,0.0,1.0
6458,Five Nights in Maine,15587,15587,0,2016_boxofficemojo_rankings.csv,2016,1.0,0.0
6459,Bob le Flambeur,15586,15586,0,2018_boxofficemojo_rankings.csv,2018,1.0,0.0
6460,When You Read This Letter,15552,15552,0,2018_boxofficemojo_rankings.csv,2018,1.0,0.0
6461,Postcards from London,15548,5312,10236,2018_boxofficemojo_rankings.csv,2018,0.3416516593774119,0.6583483406225881
6462,Stuffed,15532,15532,0,2019_boxofficemojo_rankings.csv,2019,1.0,0.0
6463,Dreamkiller,15514,15514,0,2010_boxofficemojo_rankings.csv,2010,1.0,0.0
6464,Tom of Finland 2018 Re-release,15483,3314,12169,2018_boxofficemojo_rankings.csv,2018,0.21404120648453143,0.7859587935154686
6465,They Will Have to Kill Us First: Malian Music In Exile,15453,7516,7937,2015_boxofficemojo_rankings.csv,2015,0.48637804956966285,0.5136219504303372
6466,California Solo,15433,15433,0,2012_boxofficemojo_rankings.csv,2012,1.0,0.0
6467,Be Somebody,15395,15395,0,2016_boxofficemojo_rankings.csv,2016,1.0,0.0
6468,Between the Lines,15383,15383,0,2019_boxofficemojo_rankings.csv,2019,1.0,0.0
6469,Dumbstruck,15379,15379,0,2011_boxofficemojo_rankings.csv,2011,1.0,0.0
6470,The Adderall Diaries,15364,13191,2173,2016_boxofficemojo_rankings.csv,2016,0.8585654777401718,0.14143452225982817
6471,The President,15338,7578,7760,2016_boxofficemojo_rankings.csv,2016,0.4940670230799322,0.5059329769200678
6472,Narcissister Organ Player,15334,15334,0,2018_boxofficemojo_rankings.csv,2018,1.0,0.0
6473,Only the Young,15312,15312,0,2012_boxofficemojo_rankings.csv,2012,1.0,0.0
6474,Contemporary Color,15305,15305,0,2017_boxofficemojo_rankings.csv,2017,1.0,0.0
6475,American Deep State,15269,15269,0,2020_boxofficemojo_rankings.csv,2020,1.0,0.0
6476,Starcrossed,15263,15263,0,2016_boxofficemojo_rankings.csv,2016,1.0,0.0
6477,"Arabian Nights - Volume 2, The Desolate One",15245,6398,8847,2015_boxofficemojo_rankings.csv,2015,0.4196785831420138,0.5803214168579862
6478,People's Republic of Desire,15241,15241,0,2018_boxofficemojo_rankings.csv,2018,1.0,0.0
6479,The Samaritan,15220,2521,12699,2012_boxofficemojo_rankings.csv,2012,0.16563731931668857,0.8343626806833114
6480,Funan,15152,15152,0,2019_boxofficemojo_rankings.csv,2019,1.0,0.0
6481,The Olivia Experiment,15122,15122,0,2014_boxofficemojo_rankings.csv,2014,1.0,0.0
6482,Kung Fu Joe,15120,15120,0,2012_boxofficemojo_rankings.csv,2012,1.0,0.0
6483,Trade of Innocents,15091,15091,0,2012_boxofficemojo_rankings.csv,2012,1.0,0.0
6484,Rebels on Pointe,15088,15088,0,2017_boxofficemojo_rankings.csv,2017,1.0,0.0
6485,Cheatin',15077,15077,0,2015_boxofficemojo_rankings.csv,2015,1.0,0.0
6486,Barefoot,15071,15071,0,2014_boxofficemojo_rankings.csv,2014,1.0,0.0
6487,Caught in the Web,15033,1067,13966,2012_boxofficemojo_rankings.csv,2012,0.07097718352956828,0.9290228164704317
6488,I'm Not Jesus Mommy,15005,15005,0,2011_boxofficemojo_rankings.csv,2011,1.0,0.0
6489,The Tenant,15003,15003,0,2011_boxofficemojo_rankings.csv,2011,1.0,0.0
6490,Wrinkles the Clown,14938,14938,0,2019_boxofficemojo_rankings.csv,2019,1.0,0.0
6491,I Declare War,14928,14928,0,2013_boxofficemojo_rankings.csv,2013,1.0,0.0
6492,La Maison de la radio,14905,8095,6810,2013_boxofficemojo_rankings.csv,2013,0.5431063401543106,0.45689365984568936
6493,Trust Machine: The Story of Blockchain,14905,14905,0,2018_boxofficemojo_rankings.csv,2018,1.0,0.0
6494,ZZ Top: That Little Ol' Band from Texas,14879,14879,0,2019_boxofficemojo_rankings.csv,2019,1.0,0.0
6495,Horses of God 2014 Re-release,14817,14817,0,2014_boxofficemojo_rankings.csv,2014,1.0,0.0
6496,Vince Giordano: There's a Future in the Past,14807,14807,0,2017_boxofficemojo_rankings.csv,2017,1.0,0.0
6497,Kiss of the Damned,14752,14752,0,2013_boxofficemojo_rankings.csv,2013,1.0,0.0
6498,The Prey 2012 Re-release,14738,13959,779,2012_boxofficemojo_rankings.csv,2012,0.9471434387298141,0.05285656127018591
6499,Sweet Virginia,14725,11753,2972,2017_boxofficemojo_rankings.csv,2017,0.7981663837011884,0.20183361629881155
6500,Gloria,14701,14701,0,2015_boxofficemojo_rankings.csv,2015,1.0,0.0
6501,30 Beats,14693,14693,0,2012_boxofficemojo_rankings.csv,2012,1.0,0.0
6502,Last Men in Aleppo,14637,14637,0,2017_boxofficemojo_rankings.csv,2017,1.0,0.0
6503,10 Days in a Madhouse,14616,14616,0,2015_boxofficemojo_rankings.csv,2015,1.0,0.0
6504,Unraveled,14615,14615,0,2012_boxofficemojo_rankings.csv,2012,1.0,0.0
6505,Buzzard,14591,14591,0,2015_boxofficemojo_rankings.csv,2015,1.0,0.0
6506,Tristana,14586,14586,0,2012_boxofficemojo_rankings.csv,2012,1.0,0.0
6507,Ferrante Fever,14518,11137,3381,2018_boxofficemojo_rankings.csv,2018,0.7671166827386693,0.23288331726133077
6508,The Wanderers 2016 Re-release,14492,14492,0,2016_boxofficemojo_rankings.csv,2016,1.0,0.0
6509,Antarctica: Ice and Sky 2017 Re-release,14475,14475,0,2017_boxofficemojo_rankings.csv,2017,1.0,0.0
6510,The Public Image is Rotten,14464,11293,3171,2018_boxofficemojo_rankings.csv,2018,0.7807660398230089,0.21923396017699115
6511,The Two Escobars,14457,14457,0,2010_boxofficemojo_rankings.csv,2010,1.0,0.0
6512,My Son 2019 Re-release,14450,14450,0,2019_boxofficemojo_rankings.csv,2019,1.0,0.0
6513,The Last Movie Star,14410,14410,0,2018_boxofficemojo_rankings.csv,2018,1.0,0.0
6514,The Unbelievers,14400,14400,0,2013_boxofficemojo_rankings.csv,2013,1.0,0.0
6515,The Uncondemned,14393,14393,0,2016_boxofficemojo_rankings.csv,2016,1.0,0.0
6516,Exhibition,14378,14344,34,2014_boxofficemojo_rankings.csv,2014,0.9976352761162888,0.0023647238837112253
6517,Justice Is Mind,14360,14360,0,2013_boxofficemojo_rankings.csv,2013,1.0,0.0
6518,Gone Doggy Gone,14354,14354,0,2015_boxofficemojo_rankings.csv,2015,1.0,0.0
6519,Peep World,14351,14351,0,2011_boxofficemojo_rankings.csv,2011,1.0,0.0
6520,Machines,14331,9710,4621,2017_boxofficemojo_rankings.csv,2017,0.6775521596538971,0.32244784034610285
6521,Never Stand Still,14272,14272,0,2012_boxofficemojo_rankings.csv,2012,1.0,0.0
6522,Combat Obscura,14242,14242,0,2019_boxofficemojo_rankings.csv,2019,1.0,0.0
6523,Saheb Biwi Aur Gangster,14231,14231,0,2011_boxofficemojo_rankings.csv,2011,1.0,0.0
6524,Brother Nature,14218,14218,0,2016_boxofficemojo_rankings.csv,2016,1.0,0.0
6525,A Perfect Man,14147,7117,7030,2013_boxofficemojo_rankings.csv,2013,0.5030748568601117,0.49692514313988834
6526,Newtown,14109,14109,0,2016_boxofficemojo_rankings.csv,2016,1.0,0.0
6527,We Won't Grow Old Together,14104,14104,0,2012_boxofficemojo_rankings.csv,2012,1.0,0.0
6528,"I Was at Home, But...",14078,14078,0,2020_boxofficemojo_rankings.csv,2020,1.0,0.0
6529,Shangri-La Suite,14073,14073,0,2016_boxofficemojo_rankings.csv,2016,1.0,0.0
6530,Gayby,14062,14062,0,2012_boxofficemojo_rankings.csv,2012,1.0,0.0
6531,6 Month Rule,14057,14057,0,2012_boxofficemojo_rankings.csv,2012,1.0,0.0
6532,Head Games,14056,14056,0,2012_boxofficemojo_rankings.csv,2012,1.0,0.0
6533,Ghetto Physics,14034,14034,0,2010_boxofficemojo_rankings.csv,2010,1.0,0.0
6534,Chasing the Blues,14030,14030,0,2018_boxofficemojo_rankings.csv,2018,1.0,0.0
6535,Il Futuro,14001,14001,0,2013_boxofficemojo_rankings.csv,2013,1.0,0.0
6536,Screwball,13967,13967,0,2019_boxofficemojo_rankings.csv,2019,1.0,0.0
6537,Yosemite,13931,13931,0,2016_boxofficemojo_rankings.csv,2016,1.0,0.0
6538,Weed the People,13926,13926,0,2018_boxofficemojo_rankings.csv,2018,1.0,0.0
6539,This Is Martin Bonner,13888,13888,0,2013_boxofficemojo_rankings.csv,2013,1.0,0.0
6540,Falling Away,13869,13869,0,2012_boxofficemojo_rankings.csv,2012,1.0,0.0
6541,Genesis,13856,6784,7072,2019_boxofficemojo_rankings.csv,2019,0.4896073903002309,0.5103926096997691
6542,Blackfoot Trail,13848,13848,0,2015_boxofficemojo_rankings.csv,2015,1.0,0.0
6543,Sympathy for Delicious,13826,13826,0,2011_boxofficemojo_rankings.csv,2011,1.0,0.0
6544,Stavisky...,13793,13793,0,2018_boxofficemojo_rankings.csv,2018,1.0,0.0
6545,The Pretty One,13769,13769,0,2014_boxofficemojo_rankings.csv,2014,1.0,0.0
6546,A Space Program,13739,13739,0,2016_boxofficemojo_rankings.csv,2016,1.0,0.0
6547,Dorfman in Love,13737,13737,0,2013_boxofficemojo_rankings.csv,2013,1.0,0.0
6548,Don McKay,13722,13722,0,2010_boxofficemojo_rankings.csv,2010,1.0,0.0
6549,Time to Die,13707,13707,0,2017_boxofficemojo_rankings.csv,2017,1.0,0.0
6550,Daisies,13692,13692,0,2012_boxofficemojo_rankings.csv,2012,1.0,0.0
6551,This One's for the Ladies,13688,13688,0,2019_boxofficemojo_rankings.csv,2019,1.0,0.0
6552,The Law in These Parts,13683,13683,0,2012_boxofficemojo_rankings.csv,2012,1.0,0.0
6553,Tikkun,13671,13671,0,2016_boxofficemojo_rankings.csv,2016,1.0,0.0
6554,Red Trees,13666,13666,0,2017_boxofficemojo_rankings.csv,2017,1.0,0.0
6555,Fifi Howls from Happiness,13614,13614,0,2014_boxofficemojo_rankings.csv,2014,1.0,0.0
6556,When the Iron Bird Flies: Tibetan Buddhism Arrives in the West,13598,13598,0,2012_boxofficemojo_rankings.csv,2012,1.0,0.0
6557,Stray Dogs,13573,10433,3140,2014_boxofficemojo_rankings.csv,2014,0.7686583658734252,0.23134163412657482
6558,Eli,13547,13547,0,2015_boxofficemojo_rankings.csv,2015,1.0,0.0
6559,Dysfunctional Friends,13546,13546,0,2012_boxofficemojo_rankings.csv,2012,1.0,0.0
6560,Paper Man,13514,13514,0,2010_boxofficemojo_rankings.csv,2010,1.0,0.0
6561,Handsome Harry,13500,13500,0,2010_boxofficemojo_rankings.csv,2010,1.0,0.0
6562,Shadowman,13498,13498,0,2017_boxofficemojo_rankings.csv,2017,1.0,0.0
6563,Spices of Liberty,13463,13463,0,2016_boxofficemojo_rankings.csv,2016,1.0,0.0
6564,War of the Worlds: Goliath,13385,13385,0,2014_boxofficemojo_rankings.csv,2014,1.0,0.0
6565,Solaris 2017 Re-release,13352,0,13352,2017_boxofficemojo_rankings.csv,2017,0.0,1.0
6566,Violet Tendencies,13304,13304,0,2010_boxofficemojo_rankings.csv,2010,1.0,0.0
6567,Rapid Response,13294,13294,0,2019_boxofficemojo_rankings.csv,2019,1.0,0.0
6568,Late Spring,13254,13254,0,2016_boxofficemojo_rankings.csv,2016,1.0,0.0
6569,Days and Nights,13243,13243,0,2014_boxofficemojo_rankings.csv,2014,1.0,0.0
6570,Our Blood is Wine,13210,13210,0,2018_boxofficemojo_rankings.csv,2018,1.0,0.0
6571,"Intent to Destroy: Death, Denial & Depiction",13194,13194,0,2017_boxofficemojo_rankings.csv,2017,1.0,0.0
6572,Sol LeWitt,13146,13146,0,2014_boxofficemojo_rankings.csv,2014,1.0,0.0
6573,The Pleasures of Being Out of Step,13137,13137,0,2014_boxofficemojo_rankings.csv,2014,1.0,0.0
6574,The Trouble with Bliss,13093,13093,0,2012_boxofficemojo_rankings.csv,2012,1.0,0.0
6575,Under the Boardwalk: The Monopoly Story,13080,13080,0,2011_boxofficemojo_rankings.csv,2011,1.0,0.0
6576,Nothing But a Man,13063,13063,0,2012_boxofficemojo_rankings.csv,2012,1.0,0.0
6577,"How Much Does Your Building Weigh, Mr Foster? 2012 Re-release",13013,13013,0,2012_boxofficemojo_rankings.csv,2012,1.0,0.0
6578,Jim,13000,13000,0,2010_boxofficemojo_rankings.csv,2010,1.0,0.0
6579,Bloodworth,12971,12971,0,2011_boxofficemojo_rankings.csv,2011,1.0,0.0
6580,Like Me,12965,12965,0,2018_boxofficemojo_rankings.csv,2018,1.0,0.0
6581,Duet for Cannibals 2019 re-release,12962,12962,0,2019_boxofficemojo_rankings.csv,2019,1.0,0.0
6582,K2: Siren of the Himalayas,12959,12959,0,2014_boxofficemojo_rankings.csv,2014,1.0,0.0
6583,The Last Rampage,12944,6294,6650,2017_boxofficemojo_rankings.csv,2017,0.48624845488257107,0.5137515451174289
6584,A Green Story,12901,12901,0,2013_boxofficemojo_rankings.csv,2013,1.0,0.0
6585,Taipei Story,12897,12897,0,2017_boxofficemojo_rankings.csv,2017,1.0,0.0
6586,Permanent,12847,12847,0,2017_boxofficemojo_rankings.csv,2017,1.0,0.0
6587,The Taqwacores,12839,11445,1394,2010_boxofficemojo_rankings.csv,2010,0.8914245657761508,0.10857543422384922
6588,Junction 48,12795,12795,0,2017_boxofficemojo_rankings.csv,2017,1.0,0.0
6589,Yakuza Apocalypse,12756,12756,0,2015_boxofficemojo_rankings.csv,2015,1.0,0.0
6590,Virginia,12728,12728,0,2012_boxofficemojo_rankings.csv,2012,1.0,0.0
6591,Breakdance Academy 2013 Re-release,12708,12708,0,2013_boxofficemojo_rankings.csv,2013,1.0,0.0
6592,Concerning Violence,12680,12680,0,2014_boxofficemojo_rankings.csv,2014,1.0,0.0
6593,Heal,12668,12668,0,2017_boxofficemojo_rankings.csv,2017,1.0,0.0
6594,Bhopal: A Prayer for Rain,12628,12628,0,2014_boxofficemojo_rankings.csv,2014,1.0,0.0
6595,Kangaroo,12626,4547,8079,2018_boxofficemojo_rankings.csv,2018,0.3601298907017266,0.6398701092982734
6596,American Socialist: The Life and Times of Eugene Victor Debs,12609,12609,0,2018_boxofficemojo_rankings.csv,2018,1.0,0.0
6597,Boy Meets Girl,12589,12589,0,2014_boxofficemojo_rankings.csv,2014,1.0,0.0
6598,Husbands in Goa,12588,10135,2453,2012_boxofficemojo_rankings.csv,2012,0.8051318716237686,0.19486812837623133
6599,Of Fathers and Sons,12579,12579,0,2018_boxofficemojo_rankings.csv,2018,1.0,0.0
6600,Around June,12578,12578,0,2012_boxofficemojo_rankings.csv,2012,1.0,0.0
6601,My Art,12554,12554,0,2018_boxofficemojo_rankings.csv,2018,1.0,0.0
6602,Off Season,12544,12544,0,2019_boxofficemojo_rankings.csv,2019,1.0,0.0
6603,City of Women,12516,12516,0,2016_boxofficemojo_rankings.csv,2016,1.0,0.0
6604,Seven Beauties,12408,12408,0,2017_boxofficemojo_rankings.csv,2017,1.0,0.0
6605,Killer Raccoons! 2! Dark Christmas in the Dark!,12382,12382,0,2020_boxofficemojo_rankings.csv,2020,1.0,0.0
6606,The Pale Door,12374,0,12374,2020_boxofficemojo_rankings.csv,2020,0.0,1.0
6607,American Chaos,12368,12368,0,2018_boxofficemojo_rankings.csv,2018,1.0,0.0
6608,America the Beautiful 2: The Thin Commandments,12366,12366,0,2011_boxofficemojo_rankings.csv,2011,1.0,0.0
6609,Rebirth,12358,12358,0,2011_boxofficemojo_rankings.csv,2011,1.0,0.0
6610,L'héritage de la chouette,12316,12316,0,2018_boxofficemojo_rankings.csv,2018,1.0,0.0
6611,4 Days in France,12273,12273,0,2017_boxofficemojo_rankings.csv,2017,1.0,0.0
6612,The Armor of Light,12267,12267,0,2015_boxofficemojo_rankings.csv,2015,1.0,0.0
6613,Wa-shoku Dream: Beyond Sushi,12240,12240,0,2015_boxofficemojo_rankings.csv,2015,1.0,0.0
6614,The Living Wake,12232,12232,0,2010_boxofficemojo_rankings.csv,2010,1.0,0.0
6615,Bricked,12201,12201,0,2019_boxofficemojo_rankings.csv,2019,1.0,0.0
6616,Elstree 1976,12173,12173,0,2016_boxofficemojo_rankings.csv,2016,1.0,0.0
6617,Touch the Wall,12156,12156,0,2014_boxofficemojo_rankings.csv,2014,1.0,0.0
6618,Destiny,12156,12156,0,2016_boxofficemojo_rankings.csv,2016,1.0,0.0
6619,Greetings from Tim Buckley,12155,11157,998,2013_boxofficemojo_rankings.csv,2013,0.9178938708350473,0.08210612916495269
6620,Back Door Channels: The Price of Peace,12139,12139,0,2011_boxofficemojo_rankings.csv,2011,1.0,0.0
6621,In No Great Hurry: 13 Lessons in Life with Saul Leiter,12133,12133,0,2014_boxofficemojo_rankings.csv,2014,1.0,0.0
6622,The Most Unknown,12119,12119,0,2018_boxofficemojo_rankings.csv,2018,1.0,0.0
6623,Call Me Kuchu,12110,9124,2986,2012_boxofficemojo_rankings.csv,2012,0.7534269199009084,0.24657308009909165
6624,Zen for Nothing,12107,12107,0,2019_boxofficemojo_rankings.csv,2019,1.0,0.0
6625,Hot Water,12101,12101,0,2016_boxofficemojo_rankings.csv,2016,1.0,0.0
6626,The Kids Grow Up,12095,12095,0,2010_boxofficemojo_rankings.csv,2010,1.0,0.0
6627,A Murder in the Park,12088,12088,0,2015_boxofficemojo_rankings.csv,2015,1.0,0.0
6628,When Two Worlds Collide,12080,12080,0,2016_boxofficemojo_rankings.csv,2016,1.0,0.0
6629,Little England 2015 Re-release,12077,12077,0,2015_boxofficemojo_rankings.csv,2015,1.0,0.0
6630,Imprisoned,12050,12050,0,2019_boxofficemojo_rankings.csv,2019,1.0,0.0
6631,Quartet,12042,12042,0,2019_boxofficemojo_rankings.csv,2019,1.0,0.0
6632,Lost Angels: Skid Row Is My Home,12025,12025,0,2012_boxofficemojo_rankings.csv,2012,1.0,0.0
6633,Queen Margot 2014 Re-release,12005,12005,0,2014_boxofficemojo_rankings.csv,2014,1.0,0.0
6634,Autumn Sonata 2017 Re-release,11959,0,11959,2017_boxofficemojo_rankings.csv,2017,0.0,1.0
6635,The Strange Little Cat,11956,5885,6071,2014_boxofficemojo_rankings.csv,2014,0.4922214787554366,0.5077785212445634
6636,The Last Race,11947,11947,0,2018_boxofficemojo_rankings.csv,2018,1.0,0.0
6637,Frank Serpico,11925,11925,0,2017_boxofficemojo_rankings.csv,2017,1.0,0.0
6638,"Cassandro, The Exotico!",11897,11897,0,2019_boxofficemojo_rankings.csv,2019,1.0,0.0
6639,Hollywould,11888,11888,0,2019_boxofficemojo_rankings.csv,2019,1.0,0.0
6640,Revenge of the Mekons,11861,11861,0,2014_boxofficemojo_rankings.csv,2014,1.0,0.0
6641,Les Parents Terribles,11818,11818,0,2018_boxofficemojo_rankings.csv,2018,1.0,0.0
6642,Emptying the Skies,11811,11811,0,2015_boxofficemojo_rankings.csv,2015,1.0,0.0
6643,The Dry Land,11777,11777,0,2010_boxofficemojo_rankings.csv,2010,1.0,0.0
6644,Summer '03,11746,11746,0,2018_boxofficemojo_rankings.csv,2018,1.0,0.0
6645,Rid of Me,11740,11740,0,2011_boxofficemojo_rankings.csv,2011,1.0,0.0
6646,Lucha Mexico,11722,11722,0,2016_boxofficemojo_rankings.csv,2016,1.0,0.0
6647,White Wedding 2010 Re-release,11710,11710,0,2010_boxofficemojo_rankings.csv,2010,1.0,0.0
6648,The Grizzlies,11650,11650,0,2020_boxofficemojo_rankings.csv,2020,1.0,0.0
6649,36 Saints,11640,11640,0,2013_boxofficemojo_rankings.csv,2013,1.0,0.0
6650,The Tribes of Palos Verdes,11603,11603,0,2017_boxofficemojo_rankings.csv,2017,1.0,0.0
6651,11 Flowers,11599,9213,2386,2012_boxofficemojo_rankings.csv,2012,0.79429261143202,0.20570738856798
6652,Around India with a Movie Camera,11568,10389,1179,2018_boxofficemojo_rankings.csv,2018,0.8980809128630706,0.10191908713692946
6653,The Preppie Connection,11558,11558,0,2016_boxofficemojo_rankings.csv,2016,1.0,0.0
6654,River of Grass,11553,11553,0,2016_boxofficemojo_rankings.csv,2016,1.0,0.0
6655,The Ruins of Lifta,11548,11548,0,2016_boxofficemojo_rankings.csv,2016,1.0,0.0
6656,Ultrasuede: In Search of Halston,11539,11539,0,2012_boxofficemojo_rankings.csv,2012,1.0,0.0
6657,After the Cup: Sons of Sakhnin United,11538,11538,0,2010_boxofficemojo_rankings.csv,2010,1.0,0.0
6658,Elektra Luxx,11514,11514,0,2011_boxofficemojo_rankings.csv,2011,1.0,0.0
6659,The Final Member,11428,11428,0,2014_boxofficemojo_rankings.csv,2014,1.0,0.0
6660,The Great Invisible,11428,11428,0,2014_boxofficemojo_rankings.csv,2014,1.0,0.0
6661,Beside Bowie: The Mick Ronson Story,11400,11400,0,2017_boxofficemojo_rankings.csv,2017,1.0,0.0
6662,Rendezvous in July,11321,11321,0,2018_boxofficemojo_rankings.csv,2018,1.0,0.0
6663,Powerbomb,11319,11319,0,2020_boxofficemojo_rankings.csv,2020,1.0,0.0
6664,Saigon Bodyguards,11314,11314,0,2017_boxofficemojo_rankings.csv,2017,1.0,0.0
6665,Viktoria,11314,11314,0,2016_boxofficemojo_rankings.csv,2016,1.0,0.0
6666,Lost in America,11301,11301,0,2020_boxofficemojo_rankings.csv,2020,1.0,0.0
6667,Dishkiyaoon,11288,11288,0,2014_boxofficemojo_rankings.csv,2014,1.0,0.0
6668,Theo Who Lived,11271,11271,0,2016_boxofficemojo_rankings.csv,2016,1.0,0.0
6669,Bullitt County,11257,11257,0,2018_boxofficemojo_rankings.csv,2018,1.0,0.0
6670,Daylight's End,11257,0,11257,2016_boxofficemojo_rankings.csv,2016,0.0,1.0
6671,In Like Flynn,11255,11255,0,2019_boxofficemojo_rankings.csv,2019,1.0,0.0
6672,Hacker,11239,11239,0,2016_boxofficemojo_rankings.csv,2016,1.0,0.0
6673,The Pathological Optimist,11222,11222,0,2017_boxofficemojo_rankings.csv,2017,1.0,0.0
6674,Children of Invention,11183,11183,0,2010_boxofficemojo_rankings.csv,2010,1.0,0.0
6675,Made Me Do It,11151,11151,0,2019_boxofficemojo_rankings.csv,2019,1.0,0.0
6676,"Now, Forager",11146,11146,0,2012_boxofficemojo_rankings.csv,2012,1.0,0.0
6677,InSight,11100,11100,0,2011_boxofficemojo_rankings.csv,2011,1.0,0.0
6678,Edward II 2018 Re-release,11055,4826,6229,2018_boxofficemojo_rankings.csv,2018,0.4365445499773858,0.5634554500226142
6679,The Challenge,11043,11043,0,2017_boxofficemojo_rankings.csv,2017,1.0,0.0
6680,The Woman with the 5 Elephants 2011 Re-release,11026,11026,0,2011_boxofficemojo_rankings.csv,2011,1.0,0.0
6681,Draupadi Unleashed,11025,11025,0,2020_boxofficemojo_rankings.csv,2020,1.0,0.0
6682,PAY 2 PLAY: Democracy's High Stakes,11021,11021,0,2014_boxofficemojo_rankings.csv,2014,1.0,0.0
6683,Midget Zombie Takeover,11006,11006,0,2013_boxofficemojo_rankings.csv,2013,1.0,0.0
6684,Christina,11000,11000,0,2010_boxofficemojo_rankings.csv,2010,1.0,0.0
6685,Suburban Birds,10997,10997,0,2019_boxofficemojo_rankings.csv,2019,1.0,0.0
6686,16 Bars,10985,10985,0,2019_boxofficemojo_rankings.csv,2019,1.0,0.0
6687,Just Before I Go,10970,10970,0,2015_boxofficemojo_rankings.csv,2015,1.0,0.0
6688,Digging Up the Marrow,10969,10969,0,2015_boxofficemojo_rankings.csv,2015,1.0,0.0
6689,Very Good Girls,10963,6940,4023,2014_boxofficemojo_rankings.csv,2014,0.6330384018972909,0.3669615981027091
6690,Wallander: Hämnden 2012 Re-release,10960,10960,0,2012_boxofficemojo_rankings.csv,2012,1.0,0.0
6691,Sarah Palin: You Betcha!,10935,10935,0,2011_boxofficemojo_rankings.csv,2011,1.0,0.0
6692,If the Dancer Dances,10912,10912,0,2019_boxofficemojo_rankings.csv,2019,1.0,0.0
6693,As It Is in Heaven,10850,10850,0,2014_boxofficemojo_rankings.csv,2014,1.0,0.0
6694,What Happened Last Night,10844,10844,0,2016_boxofficemojo_rankings.csv,2016,1.0,0.0
6695,The Forecaster,10824,10172,652,2015_boxofficemojo_rankings.csv,2015,0.9397634885439764,0.06023651145602365
6696,Bleeding Heart,10815,0,10815,2015_boxofficemojo_rankings.csv,2015,0.0,1.0
6697,Terkel in Trouble 2010 Re-release,10783,10783,0,2010_boxofficemojo_rankings.csv,2010,1.0,0.0
6698,The Man Who Shook the Hand of Vicente Fernandez,10782,10782,0,2012_boxofficemojo_rankings.csv,2012,1.0,0.0
6699,Vision Portraits,10771,10771,0,2019_boxofficemojo_rankings.csv,2019,1.0,0.0
6700,Mala Mala,10761,10761,0,2015_boxofficemojo_rankings.csv,2015,1.0,0.0
6701,A Resurrection,10730,10730,0,2013_boxofficemojo_rankings.csv,2013,1.0,0.0
6702,Hollow in the Land,10688,0,10688,2017_boxofficemojo_rankings.csv,2017,0.0,1.0
6703,You Go to My Head,10682,10682,0,2020_boxofficemojo_rankings.csv,2020,1.0,0.0
6704,Made in Cleveland,10681,10681,0,2013_boxofficemojo_rankings.csv,2013,1.0,0.0
6705,Frankie & Alice,10670,10670,0,2010_boxofficemojo_rankings.csv,2010,1.0,0.0
6706,National Bird,10656,10656,0,2016_boxofficemojo_rankings.csv,2016,1.0,0.0
6707,American Meat,10650,10650,0,2013_boxofficemojo_rankings.csv,2013,1.0,0.0
6708,Caucus,10645,10645,0,2013_boxofficemojo_rankings.csv,2013,1.0,0.0
6709,Lovesong,10626,10626,0,2017_boxofficemojo_rankings.csv,2017,1.0,0.0
6710,Intuitions,10606,10606,0,2019_boxofficemojo_rankings.csv,2019,1.0,0.0
6711,Marriage Italian Style 2011 Re-release,10600,10600,0,2011_boxofficemojo_rankings.csv,2011,1.0,0.0
6712,Inside the Mind of Leonardo,10600,10600,0,2014_boxofficemojo_rankings.csv,2014,1.0,0.0
6713,China Heavyweight,10550,10550,0,2012_boxofficemojo_rankings.csv,2012,1.0,0.0
6714,I'll Take Your Dead,10523,10523,0,2019_boxofficemojo_rankings.csv,2019,1.0,0.0
6715,Waiting for Armageddon,10501,10501,0,2010_boxofficemojo_rankings.csv,2010,1.0,0.0
6716,Clarence,10495,10495,0,2017_boxofficemojo_rankings.csv,2017,1.0,0.0
6717,Santa Mesa,10490,10490,0,2012_boxofficemojo_rankings.csv,2012,1.0,0.0
6718,Neon Flesh 2012 Re-release,10483,0,10483,2012_boxofficemojo_rankings.csv,2012,0.0,1.0
6719,"Norte, the End of History",10457,10457,0,2014_boxofficemojo_rankings.csv,2014,1.0,0.0
6720,Evil Intent,10454,10454,0,2013_boxofficemojo_rankings.csv,2013,1.0,0.0
6721,Class Rank,10452,10452,0,2018_boxofficemojo_rankings.csv,2018,1.0,0.0
6722,Mama Africa 2018 Re-release,10430,10430,0,2018_boxofficemojo_rankings.csv,2018,1.0,0.0
6723,The Advocates,10402,10402,0,2018_boxofficemojo_rankings.csv,2018,1.0,0.0
6724,Shanghai Calling,10400,10400,0,2013_boxofficemojo_rankings.csv,2013,1.0,0.0
6725,Elemental,10358,10358,0,2013_boxofficemojo_rankings.csv,2013,1.0,0.0
6726,Zero Bridge,10357,10357,0,2011_boxofficemojo_rankings.csv,2011,1.0,0.0
6727,SK1 2016 Re-release,10330,10330,0,2016_boxofficemojo_rankings.csv,2016,1.0,0.0
6728,Painted Woman,10298,10298,0,2017_boxofficemojo_rankings.csv,2017,1.0,0.0
6729,Shepard & Dark,10278,10278,0,2013_boxofficemojo_rankings.csv,2013,1.0,0.0
6730,Moebius,10254,2340,7914,2014_boxofficemojo_rankings.csv,2014,0.22820362785254536,0.7717963721474547
6731,Amelia 2.0,10233,10233,0,2017_boxofficemojo_rankings.csv,2017,1.0,0.0
6732,The Endless Summer,10233,10233,0,2014_boxofficemojo_rankings.csv,2014,1.0,0.0
6733,Approaching the Unknown,10232,10232,0,2016_boxofficemojo_rankings.csv,2016,1.0,0.0
6734,Tip Top,10201,6050,4151,2013_boxofficemojo_rankings.csv,2013,0.5930791098911872,0.4069208901088129
6735,When Lambs Become Lions,10197,9337,860,2019_boxofficemojo_rankings.csv,2019,0.9156614690595273,0.0843385309404727
6736,Prince of the Himalayas,10190,10190,0,2011_boxofficemojo_rankings.csv,2011,1.0,0.0
6737,Miss Minoes 2011 Re-release,10189,10189,0,2011_boxofficemojo_rankings.csv,2011,1.0,0.0
6738,A Bird of the Air,10152,10152,0,2011_boxofficemojo_rankings.csv,2011,1.0,0.0
6739,Beta Test,10104,10104,0,2016_boxofficemojo_rankings.csv,2016,1.0,0.0
6740,Putin's Kiss,10082,10082,0,2012_boxofficemojo_rankings.csv,2012,1.0,0.0
6741,Pawn Shop Chronicles,10080,8088,1992,2013_boxofficemojo_rankings.csv,2013,0.8023809523809524,0.1976190476190476
6742,Before I Disappear,10078,10078,0,2014_boxofficemojo_rankings.csv,2014,1.0,0.0
6743,Little Accidents,10071,10071,0,2015_boxofficemojo_rankings.csv,2015,1.0,0.0
6744,Informant,10068,10068,0,2013_boxofficemojo_rankings.csv,2013,1.0,0.0
6745,The Sunshine Makers,10042,10042,0,2017_boxofficemojo_rankings.csv,2017,1.0,0.0
6746,Circle,10024,10024,0,2010_boxofficemojo_rankings.csv,2010,1.0,0.0
6747,The Life and Mind of Mark DeFriest,10021,10021,0,2015_boxofficemojo_rankings.csv,2015,1.0,0.0
6748,Arjun: The Warrior Prince,10017,10017,0,2012_boxofficemojo_rankings.csv,2012,1.0,0.0
6749,Guest Artist,10017,10017,0,2020_boxofficemojo_rankings.csv,2020,1.0,0.0
6750,"Hugh Hefner: Playboy, Activist and Rebel",10000,10000,0,2010_boxofficemojo_rankings.csv,2010,1.0,0.0
6751,The Do-Deca-Pentathlon,10000,10000,0,2012_boxofficemojo_rankings.csv,2012,1.0,0.0
6752,Tere Bin Laden: Dead Or Alive,9995,0,9995,2016_boxofficemojo_rankings.csv,2016,0.0,1.0
6753,Foosballers,9966,9966,0,2020_boxofficemojo_rankings.csv,2020,1.0,0.0
6754,Made in France,9956,9956,0,2016_boxofficemojo_rankings.csv,2016,1.0,0.0
6755,Olivia,9934,9934,0,2019_boxofficemojo_rankings.csv,2019,1.0,0.0
6756,Streetwise,9904,9904,0,2019_boxofficemojo_rankings.csv,2019,1.0,0.0
6757,52 Tuesdays,9844,0,9844,2015_boxofficemojo_rankings.csv,2015,0.0,1.0
6758,Kabbalah Me,9816,9816,0,2014_boxofficemojo_rankings.csv,2014,1.0,0.0
6759,Down Terrace,9812,9812,0,2010_boxofficemojo_rankings.csv,2010,1.0,0.0
6760,Birth of the Living Dead,9802,9802,0,2013_boxofficemojo_rankings.csv,2013,1.0,0.0
6761,Pelle the Conqueror 2017 Re-release,9757,9757,0,2017_boxofficemojo_rankings.csv,2017,1.0,0.0
6762,"If You Don't, I Will",9719,9719,0,2014_boxofficemojo_rankings.csv,2014,1.0,0.0
6763,Antoine and Antoinette,9704,9704,0,2013_boxofficemojo_rankings.csv,2013,1.0,0.0
6764,Brutal Beauty: Tales of the Rose City Rollers,9677,9677,0,2010_boxofficemojo_rankings.csv,2010,1.0,0.0
6765,The Quest of Alain Ducasse,9627,9627,0,2018_boxofficemojo_rankings.csv,2018,1.0,0.0
6766,The Spanish Prisoner 2019 Re-release,9589,9589,0,2019_boxofficemojo_rankings.csv,2019,1.0,0.0
6767,Vito Bonafacci,9570,9570,0,2011_boxofficemojo_rankings.csv,2011,1.0,0.0
6768,Chosen,9536,9283,253,2016_boxofficemojo_rankings.csv,2016,0.9734689597315436,0.026531040268456377
6769,The Lost Arcade,9522,9522,0,2016_boxofficemojo_rankings.csv,2016,1.0,0.0
6770,Strangers on the Earth,9518,9518,0,2018_boxofficemojo_rankings.csv,2018,1.0,0.0
6771,Living Proof,9512,9512,0,2017_boxofficemojo_rankings.csv,2017,1.0,0.0
6772,In the House of Flies,9480,9480,0,2014_boxofficemojo_rankings.csv,2014,1.0,0.0
6773,Northern Lights,9453,9453,0,2013_boxofficemojo_rankings.csv,2013,1.0,0.0
6774,If I Were You,9432,9432,0,2013_boxofficemojo_rankings.csv,2013,1.0,0.0
6775,Zero Charisma,9417,9417,0,2013_boxofficemojo_rankings.csv,2013,1.0,0.0
6776,"One Cut, One Life",9406,9406,0,2015_boxofficemojo_rankings.csv,2015,1.0,0.0
6777,Miss Kiet's Children 2017 Re-release,9384,9384,0,2017_boxofficemojo_rankings.csv,2017,1.0,0.0
6778,The Tree of Wooden Clogs,9367,0,9367,2016_boxofficemojo_rankings.csv,2016,0.0,1.0
6779,Radio Free Albemuth,9365,9365,0,2014_boxofficemojo_rankings.csv,2014,1.0,0.0
6780,Fritz Lang's Indian Epic 2019 re-release,9345,9345,0,2019_boxofficemojo_rankings.csv,2019,1.0,0.0
6781,The End of Love,9342,9342,0,2013_boxofficemojo_rankings.csv,2013,1.0,0.0
6782,Looking for Maria Sanchez,9338,9338,0,2013_boxofficemojo_rankings.csv,2013,1.0,0.0
6783,The Immortalists,9331,9331,0,2014_boxofficemojo_rankings.csv,2014,1.0,0.0
6784,Better Mus' Come,9318,9318,0,2013_boxofficemojo_rankings.csv,2013,1.0,0.0
6785,Wonderful World,9309,9309,0,2010_boxofficemojo_rankings.csv,2010,1.0,0.0
6786,The City Dark,9269,9269,0,2012_boxofficemojo_rankings.csv,2012,1.0,0.0
6787,Hooligan Sparrow,9263,9263,0,2016_boxofficemojo_rankings.csv,2016,1.0,0.0
6788,The Sacrament,9221,9221,0,2014_boxofficemojo_rankings.csv,2014,1.0,0.0
6789,A Dark Place,9212,0,9212,2019_boxofficemojo_rankings.csv,2019,0.0,1.0
6790,Cracked Up,9197,9197,0,2019_boxofficemojo_rankings.csv,2019,1.0,0.0
6791,Ghost Team One,9195,9195,0,2013_boxofficemojo_rankings.csv,2013,1.0,0.0
6792,Trouble Every Day 2013 Re-release,9189,9189,0,2013_boxofficemojo_rankings.csv,2013,1.0,0.0
6793,Frank & Lola,9188,9188,0,2016_boxofficemojo_rankings.csv,2016,1.0,0.0
6794,The Hottest August,9163,9163,0,2019_boxofficemojo_rankings.csv,2019,1.0,0.0
6795,The Hollow Point,9149,0,9149,2016_boxofficemojo_rankings.csv,2016,0.0,1.0
6796,Just One More Kiss,9130,9130,0,2020_boxofficemojo_rankings.csv,2020,1.0,0.0
6797,Cupcakes,9129,9129,0,2015_boxofficemojo_rankings.csv,2015,1.0,0.0
6798,Thirst Street,9129,9129,0,2017_boxofficemojo_rankings.csv,2017,1.0,0.0
6799,The Ardennes 2016 Re-release,9116,5638,3478,2016_boxofficemojo_rankings.csv,2016,0.6184730144800351,0.3815269855199649
6800,Faith Connections,9111,9111,0,2014_boxofficemojo_rankings.csv,2014,1.0,0.0
6801,Lycan,9110,9110,0,2017_boxofficemojo_rankings.csv,2017,1.0,0.0
6802,The Eyes,9104,9104,0,2017_boxofficemojo_rankings.csv,2017,1.0,0.0
6803,Julian Schnabel: A Private Portrait,9103,9103,0,2017_boxofficemojo_rankings.csv,2017,1.0,0.0
6804,Decoding Deepak,9100,9100,0,2012_boxofficemojo_rankings.csv,2012,1.0,0.0
6805,Gerontophilia 2015 Re-release,9074,4916,4158,2015_boxofficemojo_rankings.csv,2015,0.541767687899493,0.45823231210050697
6806,El Mar La Mar,9065,9065,0,2018_boxofficemojo_rankings.csv,2018,1.0,0.0
6807,Frantz Fanon: Black Skin White Mask,9025,9025,0,2019_boxofficemojo_rankings.csv,2019,1.0,0.0
6808,Step Up: High Water,9005,9005,0,2018_boxofficemojo_rankings.csv,2018,1.0,0.0
6809,Money Fight,9004,9004,0,2012_boxofficemojo_rankings.csv,2012,1.0,0.0
6810,Station to Station,9000,9000,0,2015_boxofficemojo_rankings.csv,2015,1.0,0.0
6811,Mosquita y Mari,9000,9000,0,2012_boxofficemojo_rankings.csv,2012,1.0,0.0
6812,Zoo Wars,8998,8998,0,2018_boxofficemojo_rankings.csv,2018,1.0,0.0
6813,Revolt,8986,0,8986,2017_boxofficemojo_rankings.csv,2017,0.0,1.0
6814,Survivors Guide To Prison,8982,8982,0,2018_boxofficemojo_rankings.csv,2018,1.0,0.0
6815,Colossal Youth,8968,8331,637,2018_boxofficemojo_rankings.csv,2018,0.9289696699375558,0.07103033006244425
6816,Big Words,8965,8965,0,2013_boxofficemojo_rankings.csv,2013,1.0,0.0
6817,Three Stars,8942,8942,0,2012_boxofficemojo_rankings.csv,2012,1.0,0.0
6818,Summer of '67,8941,8941,0,2018_boxofficemojo_rankings.csv,2018,1.0,0.0
6819,This is Congo,8905,7051,1854,2018_boxofficemojo_rankings.csv,2018,0.7918023582257159,0.2081976417742841
6820,B-Side,8870,8870,0,2015_boxofficemojo_rankings.csv,2015,1.0,0.0
6821,The Meanest Man in Texas,8850,8850,0,2019_boxofficemojo_rankings.csv,2019,1.0,0.0
6822,The Pardon,8845,8845,0,2015_boxofficemojo_rankings.csv,2015,1.0,0.0
6823,Providence,8840,8840,0,2016_boxofficemojo_rankings.csv,2016,1.0,0.0
6824,Home Run Showdown,8824,8824,0,2012_boxofficemojo_rankings.csv,2012,1.0,0.0
6825,That Part Feeling - the Universe of Arvo Part,8812,8812,0,2019_boxofficemojo_rankings.csv,2019,1.0,0.0
6826,The Cabinet of Dr. Caligari 2014 Re-release,8811,8811,0,2014_boxofficemojo_rankings.csv,2014,1.0,0.0
6827,Dawn of the Crescent Moon,8799,8799,0,2015_boxofficemojo_rankings.csv,2015,1.0,0.0
6828,Hell Baby,8785,8785,0,2013_boxofficemojo_rankings.csv,2013,1.0,0.0
6829,Only When I Dance,8738,8738,0,2010_boxofficemojo_rankings.csv,2010,1.0,0.0
6830,The Man in the White Suit,8718,8718,0,2012_boxofficemojo_rankings.csv,2012,1.0,0.0
6831,Blood Feast,8708,8708,0,2018_boxofficemojo_rankings.csv,2018,1.0,0.0
6832,Amnesia,8700,8700,0,2017_boxofficemojo_rankings.csv,2017,1.0,0.0
6833,Man on a Mission: Richard Garriott's Road to the Stars,8688,8688,0,2012_boxofficemojo_rankings.csv,2012,1.0,0.0
6834,Dosed,8643,0,8643,2019_boxofficemojo_rankings.csv,2019,0.0,1.0
6835,"Small, Beautifully Moving Parts",8631,8631,0,2012_boxofficemojo_rankings.csv,2012,1.0,0.0
6836,Meet Me in Montenegro,8612,8612,0,2015_boxofficemojo_rankings.csv,2015,1.0,0.0
6837,Almost Human,8608,8447,161,2014_boxofficemojo_rankings.csv,2014,0.981296468401487,0.018703531598513012
6838,Mojave,8602,8253,349,2016_boxofficemojo_rankings.csv,2016,0.9594280399906998,0.04057196000930016
6839,Farewell to Hollywood,8601,8601,0,2015_boxofficemojo_rankings.csv,2015,1.0,0.0
6840,General Education,8601,8601,0,2012_boxofficemojo_rankings.csv,2012,1.0,0.0
6841,Lucky,8564,8564,0,2011_boxofficemojo_rankings.csv,2011,1.0,0.0
6842,From the East,8540,8540,0,2016_boxofficemojo_rankings.csv,2016,1.0,0.0
6843,Inspector Maigret,8528,8528,0,2017_boxofficemojo_rankings.csv,2017,1.0,0.0
6844,The Quitter,8512,8512,0,2014_boxofficemojo_rankings.csv,2014,1.0,0.0
6845,The Empty Hours,8478,8244,234,2014_boxofficemojo_rankings.csv,2014,0.9723991507430998,0.027600849256900213
6846,Furlough,8472,8472,0,2018_boxofficemojo_rankings.csv,2018,1.0,0.0
6847,Canopy,8462,8462,0,2014_boxofficemojo_rankings.csv,2014,1.0,0.0
6848,The Institute,8445,8445,0,2013_boxofficemojo_rankings.csv,2013,1.0,0.0
6849,We Are the Flesh,8438,8438,0,2017_boxofficemojo_rankings.csv,2017,1.0,0.0
6850,Hello Herman,8437,8437,0,2013_boxofficemojo_rankings.csv,2013,1.0,0.0
6851,Red Hollywood,8426,8426,0,2014_boxofficemojo_rankings.csv,2014,1.0,0.0
6852,The Happy Sad,8395,8395,0,2013_boxofficemojo_rankings.csv,2013,1.0,0.0
6853,Downloaded,8377,8377,0,2013_boxofficemojo_rankings.csv,2013,1.0,0.0
6854,Counting,8374,8374,0,2015_boxofficemojo_rankings.csv,2015,1.0,0.0
6855,Gilbert,8362,8362,0,2017_boxofficemojo_rankings.csv,2017,1.0,0.0
6856,Eternity: The Movie,8350,8350,0,2014_boxofficemojo_rankings.csv,2014,1.0,0.0
6857,Gringo Trails,8349,8349,0,2014_boxofficemojo_rankings.csv,2014,1.0,0.0
6858,A Teacher,8348,8348,0,2013_boxofficemojo_rankings.csv,2013,1.0,0.0
6859,Natasha,8325,8325,0,2017_boxofficemojo_rankings.csv,2017,1.0,0.0
6860,The Dead Center,8320,8320,0,2019_boxofficemojo_rankings.csv,2019,1.0,0.0
6861,About Cherry,8315,3003,5312,2012_boxofficemojo_rankings.csv,2012,0.36115453998797353,0.6388454600120265
6862,Mr. Chibbs,8302,8302,0,2017_boxofficemojo_rankings.csv,2017,1.0,0.0
6863,Served Like a Girl,8290,8290,0,2017_boxofficemojo_rankings.csv,2017,1.0,0.0
6864,We Are Twisted Fucking Sister!,8277,8277,0,2016_boxofficemojo_rankings.csv,2016,1.0,0.0
6865,Life Partners,8265,8265,0,2014_boxofficemojo_rankings.csv,2014,1.0,0.0
6866,Aliyah,8253,8253,0,2013_boxofficemojo_rankings.csv,2013,1.0,0.0
6867,Silicon Cowboys,8239,8239,0,2016_boxofficemojo_rankings.csv,2016,1.0,0.0
6868,The Etruscan Smile 2019 release,8213,8213,0,2019_boxofficemojo_rankings.csv,2019,1.0,0.0
6869,Brooklyn Brothers Beat the Best,8210,7466,744,2012_boxofficemojo_rankings.csv,2012,0.9093788063337394,0.09062119366626066
6870,Spiral,8190,8190,0,2018_boxofficemojo_rankings.csv,2018,1.0,0.0
6871,Jellyfish Eyes,8176,8176,0,2015_boxofficemojo_rankings.csv,2015,1.0,0.0
6872,Anatahan,8171,8171,0,2017_boxofficemojo_rankings.csv,2017,1.0,0.0
6873,The Other Side,8168,8074,94,2016_boxofficemojo_rankings.csv,2016,0.9884916748285995,0.011508325171400588
6874,Inside the Rain,8140,8140,0,2020_boxofficemojo_rankings.csv,2020,1.0,0.0
6875,Far from Vietnam,8132,8132,0,2013_boxofficemojo_rankings.csv,2013,1.0,0.0
6876,From Nowhere,8109,8109,0,2017_boxofficemojo_rankings.csv,2017,1.0,0.0
6877,The Wave,8101,8101,0,2020_boxofficemojo_rankings.csv,2020,1.0,0.0
6878,Restless City,8100,8100,0,2012_boxofficemojo_rankings.csv,2012,1.0,0.0
6879,Next Year Jerusalem,8093,8093,0,2014_boxofficemojo_rankings.csv,2014,1.0,0.0
6880,Golden Kingdom,8077,8077,0,2016_boxofficemojo_rankings.csv,2016,1.0,0.0
6881,Steak (R)evolution,8038,8025,13,2015_boxofficemojo_rankings.csv,2015,0.9983826822592685,0.0016173177407315252
6882,Straight Outta Tompkins,8022,8022,0,2015_boxofficemojo_rankings.csv,2015,1.0,0.0
6883,Talent Has Hunger,7998,7998,0,2016_boxofficemojo_rankings.csv,2016,1.0,0.0
6884,All About Evil,7995,7995,0,2010_boxofficemojo_rankings.csv,2010,1.0,0.0
6885,One Small Hitch 2015 Re-release,7965,7965,0,2015_boxofficemojo_rankings.csv,2015,1.0,0.0
6886,Roseanne for President!,7960,7960,0,2016_boxofficemojo_rankings.csv,2016,1.0,0.0
6887,Stolen,7943,7943,0,2010_boxofficemojo_rankings.csv,2010,1.0,0.0
6888,Mugabe and the White African,7924,7924,0,2010_boxofficemojo_rankings.csv,2010,1.0,0.0
6889,Angels Are Made Of Light,7919,7919,0,2019_boxofficemojo_rankings.csv,2019,1.0,0.0
6890,Portrait of a Garden,7914,7914,0,2016_boxofficemojo_rankings.csv,2016,1.0,0.0
6891,This Magnificent Cake!,7888,7888,0,2019_boxofficemojo_rankings.csv,2019,1.0,0.0
6892,Bleak Street,7888,0,7888,2015_boxofficemojo_rankings.csv,2015,0.0,1.0
6893,I AM PATRICK,7880,0,7880,2020_boxofficemojo_rankings.csv,2020,0.0,1.0
6894,Swept Away,7876,7876,0,2017_boxofficemojo_rankings.csv,2017,1.0,0.0
6895,Zenith,7862,7862,0,2010_boxofficemojo_rankings.csv,2010,1.0,0.0
6896,The Ballad of Lefty Brown,7856,7856,0,2017_boxofficemojo_rankings.csv,2017,1.0,0.0
6897,Ghost Fleet,7850,7850,0,2019_boxofficemojo_rankings.csv,2019,1.0,0.0
6898,Roadie,7825,7825,0,2012_boxofficemojo_rankings.csv,2012,1.0,0.0
6899,Photographic Memory,7822,7822,0,2012_boxofficemojo_rankings.csv,2012,1.0,0.0
6900,The Great Man,7814,7814,0,2015_boxofficemojo_rankings.csv,2015,1.0,0.0
6901,Archipelago 2014 Re-release,7791,7791,0,2014_boxofficemojo_rankings.csv,2014,1.0,0.0
6902,Old Stone,7768,7476,292,2016_boxofficemojo_rankings.csv,2016,0.962409886714727,0.03759011328527292
6903,The Plagiarists,7768,7768,0,2019_boxofficemojo_rankings.csv,2019,1.0,0.0
6904,And While We Were Here,7750,7750,0,2013_boxofficemojo_rankings.csv,2013,1.0,0.0
6905,Come Back to Me,7744,7744,0,2014_boxofficemojo_rankings.csv,2014,1.0,0.0
6906,Young Ones,7740,0,7740,2014_boxofficemojo_rankings.csv,2014,0.0,1.0
6907,Gregory's Girl,7710,7710,0,2019_boxofficemojo_rankings.csv,2019,1.0,0.0
6908,Maurizio Cattelan: Be Right Back,7706,7706,0,2017_boxofficemojo_rankings.csv,2017,1.0,0.0
6909,I Don't Belong Anywhere: The Cinema of Chantal Akerman,7703,7703,0,2016_boxofficemojo_rankings.csv,2016,1.0,0.0
6910,Running Shaadi,7674,0,7674,2017_boxofficemojo_rankings.csv,2017,0.0,1.0
6911,Valley Girl,7671,0,7671,2020_boxofficemojo_rankings.csv,2020,0.0,1.0
6912,Last Days Here,7643,7643,0,2012_boxofficemojo_rankings.csv,2012,1.0,0.0
6913,Legend of the Mountain,7640,7640,0,2018_boxofficemojo_rankings.csv,2018,1.0,0.0
6914,Psycho Raman,7612,0,7612,2016_boxofficemojo_rankings.csv,2016,0.0,1.0
6915,Area 51,7556,7556,0,2015_boxofficemojo_rankings.csv,2015,1.0,0.0
6916,The Wrong Light,7553,7553,0,2017_boxofficemojo_rankings.csv,2017,1.0,0.0
6917,Tales from the Script,7535,7535,0,2010_boxofficemojo_rankings.csv,2010,1.0,0.0
6918,Girls Against Boys,7529,7529,0,2013_boxofficemojo_rankings.csv,2013,1.0,0.0
6919,Birthright: A War Story,7519,7519,0,2017_boxofficemojo_rankings.csv,2017,1.0,0.0
6920,Udaan,7461,7461,0,2010_boxofficemojo_rankings.csv,2010,1.0,0.0
6921,The Little Bedroom 2014 Re-release,7440,7440,0,2014_boxofficemojo_rankings.csv,2014,1.0,0.0
6922,Raze,7429,7429,0,2014_boxofficemojo_rankings.csv,2014,1.0,0.0
6923,Bel Borba Aqui,7426,7426,0,2012_boxofficemojo_rankings.csv,2012,1.0,0.0
6924,Rubble Kings,7416,7416,0,2015_boxofficemojo_rankings.csv,2015,1.0,0.0
6925,Price Check,7413,7413,0,2012_boxofficemojo_rankings.csv,2012,1.0,0.0
6926,The Giant Mechanical Man,7396,7396,0,2012_boxofficemojo_rankings.csv,2012,1.0,0.0
6927,Desperate Acts of Magic,7373,7373,0,2013_boxofficemojo_rankings.csv,2013,1.0,0.0
6928,Big Time,7347,7347,0,2017_boxofficemojo_rankings.csv,2017,1.0,0.0
6929,Shoah: Four Sisters,7323,7323,0,2018_boxofficemojo_rankings.csv,2018,1.0,0.0
6930,Beloved Beast,7301,7301,0,2019_boxofficemojo_rankings.csv,2019,1.0,0.0
6931,Gangster's Paradise: Jerusalema 2010 Re-release,7294,7294,0,2010_boxofficemojo_rankings.csv,2010,1.0,0.0
6932,Another WolfCop,7285,7285,0,2017_boxofficemojo_rankings.csv,2017,1.0,0.0
6933,Indian Point,7251,7251,0,2016_boxofficemojo_rankings.csv,2016,1.0,0.0
6934,Outside Satan,7226,0,7226,2013_boxofficemojo_rankings.csv,2013,0.0,1.0
6935,Tall: The American Skyscraper and Louis Sullivan,7216,7216,0,2018_boxofficemojo_rankings.csv,2018,1.0,0.0
6936,I Am Ali,7205,7205,0,2014_boxofficemojo_rankings.csv,2014,1.0,0.0
6937,London River 2011 Re-release,7200,7200,0,2011_boxofficemojo_rankings.csv,2011,1.0,0.0
6938,Happiness Runs,7199,7199,0,2010_boxofficemojo_rankings.csv,2010,1.0,0.0
6939,Antarctic Edge: 70° South,7193,7193,0,2015_boxofficemojo_rankings.csv,2015,1.0,0.0
6940,The Strange Color of Your Body's Tears,7182,7182,0,2014_boxofficemojo_rankings.csv,2014,1.0,0.0
6941,ABCs of Death 2,7171,7171,0,2014_boxofficemojo_rankings.csv,2014,1.0,0.0
6942,It Had to Be You,7162,7162,0,2016_boxofficemojo_rankings.csv,2016,1.0,0.0
6943,"Brutti, sporchi e cattivi",7144,7144,0,2016_boxofficemojo_rankings.csv,2016,1.0,0.0
6944,Logan,7137,7137,0,2010_boxofficemojo_rankings.csv,2010,1.0,0.0
6945,The Reagan Show,7109,5500,1609,2017_boxofficemojo_rankings.csv,2017,0.7736671824447883,0.2263328175552117
6946,Domain 2012 Re-release,7105,7105,0,2012_boxofficemojo_rankings.csv,2012,1.0,0.0
6947,The Jazz Funeral,7103,7103,0,2017_boxofficemojo_rankings.csv,2017,1.0,0.0
6948,The Dark Below,7095,7095,0,2017_boxofficemojo_rankings.csv,2017,1.0,0.0
6949,Painless,7082,7082,0,2018_boxofficemojo_rankings.csv,2018,1.0,0.0
6950,Stage Fright,7078,7078,0,2014_boxofficemojo_rankings.csv,2014,1.0,0.0
6951,In Echo Park,7072,7072,0,2018_boxofficemojo_rankings.csv,2018,1.0,0.0
6952,Good Neighbours,7072,7072,0,2011_boxofficemojo_rankings.csv,2011,1.0,0.0
6953,The Brainwashing of My Dad,7028,7028,0,2016_boxofficemojo_rankings.csv,2016,1.0,0.0
6954,In the Land of Pomegranates,7014,7014,0,2018_boxofficemojo_rankings.csv,2018,1.0,0.0
6955,Corman's World: Exploits of a Hollywood Rebel,7000,7000,0,2011_boxofficemojo_rankings.csv,2011,1.0,0.0
6956,The Brass Teapot,6997,6997,0,2013_boxofficemojo_rankings.csv,2013,1.0,0.0
6957,What We Found,6976,6976,0,2020_boxofficemojo_rankings.csv,2020,1.0,0.0
6958,Gabriel,6959,6959,0,2015_boxofficemojo_rankings.csv,2015,1.0,0.0
6959,"Love, Marilyn",6950,6950,0,2012_boxofficemojo_rankings.csv,2012,1.0,0.0
6960,A Kind of Loving,6912,6912,0,2017_boxofficemojo_rankings.csv,2017,1.0,0.0
6961,Assaulted: Civil Rights Under Fire,6905,6905,0,2013_boxofficemojo_rankings.csv,2013,1.0,0.0
6962,Boom Bust Boom,6896,6896,0,2016_boxofficemojo_rankings.csv,2016,1.0,0.0
6963,Misconceptions,6892,6892,0,2010_boxofficemojo_rankings.csv,2010,1.0,0.0
6964,Sal,6883,6883,0,2013_boxofficemojo_rankings.csv,2013,1.0,0.0
6965,The Human Scale,6878,6878,0,2013_boxofficemojo_rankings.csv,2013,1.0,0.0
6966,Duck Butter,6877,6877,0,2018_boxofficemojo_rankings.csv,2018,1.0,0.0
6967,The Sisterhood of Night,6870,6870,0,2015_boxofficemojo_rankings.csv,2015,1.0,0.0
6968,Last Ride 2012 Re-release,6853,6853,0,2012_boxofficemojo_rankings.csv,2012,1.0,0.0
6969,Janie Jones,6840,6840,0,2011_boxofficemojo_rankings.csv,2011,1.0,0.0
6970,Mad Tiger,6823,6823,0,2016_boxofficemojo_rankings.csv,2016,1.0,0.0
6971,"No God, No Master",6796,6796,0,2014_boxofficemojo_rankings.csv,2014,1.0,0.0
6972,Finding Bliss,6783,6783,0,2010_boxofficemojo_rankings.csv,2010,1.0,0.0
6973,Mercy,6780,6780,0,2010_boxofficemojo_rankings.csv,2010,1.0,0.0
6974,Going Attractions: The Definitive Story of the Movie Palace,6763,6763,0,2019_boxofficemojo_rankings.csv,2019,1.0,0.0
6975,The Other Lamb,6760,6024,736,2020_boxofficemojo_rankings.csv,2020,0.8911242603550296,0.10887573964497041
6976,Calling All Earthlings,6756,6756,0,2018_boxofficemojo_rankings.csv,2018,1.0,0.0
6977,Dying to Survive 2019 Re-release,6752,6752,0,2019_boxofficemojo_rankings.csv,2019,1.0,0.0
6978,A Whale of a Tale,6747,6747,0,2018_boxofficemojo_rankings.csv,2018,1.0,0.0
6979,Dreaming Grand Avenue,6726,6726,0,2020_boxofficemojo_rankings.csv,2020,1.0,0.0
6980,Iceman,6719,2138,4581,2018_boxofficemojo_rankings.csv,2018,0.3182021134097336,0.6817978865902664
6981,Before You Know It,6717,6717,0,2014_boxofficemojo_rankings.csv,2014,1.0,0.0
6982,Regina Spektor Live in London,6684,6684,0,2010_boxofficemojo_rankings.csv,2010,1.0,0.0
6983,"Arabian Nights - Volume 3, The Enchanted One",6681,4502,2179,2015_boxofficemojo_rankings.csv,2015,0.6738512198772639,0.3261487801227361
6984,Footnotes 2017 Re-release,6660,6660,0,2017_boxofficemojo_rankings.csv,2017,1.0,0.0
6985,Ghost Team,6639,6639,0,2016_boxofficemojo_rankings.csv,2016,1.0,0.0
6986,The Persian Connection,6634,6634,0,2017_boxofficemojo_rankings.csv,2017,1.0,0.0
6987,Breakfast with Curtis,6629,6629,0,2013_boxofficemojo_rankings.csv,2013,1.0,0.0
6988,The Dying of the Light,6627,6627,0,2016_boxofficemojo_rankings.csv,2016,1.0,0.0
6989,Brief Reunion,6601,6601,0,2013_boxofficemojo_rankings.csv,2013,1.0,0.0
6990,Aatsinki: The Story of Arctic Cowboys,6601,6601,0,2014_boxofficemojo_rankings.csv,2014,1.0,0.0
6991,Human Capital,6596,6596,0,2020_boxofficemojo_rankings.csv,2020,1.0,0.0
6992,Down the Shore,6558,6558,0,2013_boxofficemojo_rankings.csv,2013,1.0,0.0
6993,In Our Nature,6543,6543,0,2012_boxofficemojo_rankings.csv,2012,1.0,0.0
6994,Elizabeth Blue,6542,6542,0,2017_boxofficemojo_rankings.csv,2017,1.0,0.0
6995,Dream Boy,6534,6534,0,2010_boxofficemojo_rankings.csv,2010,1.0,0.0
6996,Spiral Farm,6517,6517,0,2019_boxofficemojo_rankings.csv,2019,1.0,0.0
6997,Horse Money,6508,6508,0,2015_boxofficemojo_rankings.csv,2015,1.0,0.0
6998,Jews of Egypt,6505,6505,0,2014_boxofficemojo_rankings.csv,2014,1.0,0.0
6999,Windfall,6504,6504,0,2012_boxofficemojo_rankings.csv,2012,1.0,0.0
7000,Ride,6489,0,6489,2015_boxofficemojo_rankings.csv,2015,0.0,1.0
7001,The Beat Hotel,6480,6480,0,2012_boxofficemojo_rankings.csv,2012,1.0,0.0
7002,Afterward,6477,6477,0,2020_boxofficemojo_rankings.csv,2020,1.0,0.0
7003,Scum,6461,6461,0,2017_boxofficemojo_rankings.csv,2017,1.0,0.0
7004,Tu Dors Nicole,6445,5662,783,2015_boxofficemojo_rankings.csv,2015,0.8785104732350659,0.12148952676493406
7005,The Suicide Theory,6434,6434,0,2015_boxofficemojo_rankings.csv,2015,1.0,0.0
7006,Some Velvet Morning,6420,6420,0,2013_boxofficemojo_rankings.csv,2013,1.0,0.0
7007,100 Bloody Acres,6388,6388,0,2013_boxofficemojo_rankings.csv,2013,1.0,0.0
7008,Inescapable,6334,6334,0,2013_boxofficemojo_rankings.csv,2013,1.0,0.0
7009,The Charnel House,6332,6332,0,2016_boxofficemojo_rankings.csv,2016,1.0,0.0
7010,Watercolors,6305,6305,0,2010_boxofficemojo_rankings.csv,2010,1.0,0.0
7011,Manuscripts Don't Burn,6295,6295,0,2014_boxofficemojo_rankings.csv,2014,1.0,0.0
7012,Under the Eiffel Tower,6291,6291,0,2019_boxofficemojo_rankings.csv,2019,1.0,0.0
7013,The Skyjacker's Tale,6253,6253,0,2017_boxofficemojo_rankings.csv,2017,1.0,0.0
7014,Tar,6241,6241,0,2020_boxofficemojo_rankings.csv,2020,1.0,0.0
7015,One Last Thing,6232,6232,0,2018_boxofficemojo_rankings.csv,2018,1.0,0.0
7016,In the Steps of Trisha Brown,6230,6230,0,2017_boxofficemojo_rankings.csv,2017,1.0,0.0
7017,The Bad Kids,6226,6226,0,2016_boxofficemojo_rankings.csv,2016,1.0,0.0
7018,A Man Vanishes 2012 Re-release,6201,6201,0,2012_boxofficemojo_rankings.csv,2012,1.0,0.0
7019,The Red Chapel,6196,6196,0,2010_boxofficemojo_rankings.csv,2010,1.0,0.0
7020,The Night of the Shooting Stars 2015 Re-release,6186,6186,0,2015_boxofficemojo_rankings.csv,2015,1.0,0.0
7021,To Be of Service,6173,6173,0,2019_boxofficemojo_rankings.csv,2019,1.0,0.0
7022,Sweetwater,6147,6147,0,2013_boxofficemojo_rankings.csv,2013,1.0,0.0
7023,Crazy Eyes,6141,6141,0,2012_boxofficemojo_rankings.csv,2012,1.0,0.0
7024,Relaxer,6133,6133,0,2019_boxofficemojo_rankings.csv,2019,1.0,0.0
7025,Guitar Innovators: John Fahey & Nels Cline,6132,6132,0,2013_boxofficemojo_rankings.csv,2013,1.0,0.0
7026,"El Sicario, Room 164",6123,6123,0,2011_boxofficemojo_rankings.csv,2011,1.0,0.0
7027,Welcome to Pine Hill,6115,6115,0,2013_boxofficemojo_rankings.csv,2013,1.0,0.0
7028,Arise from Darkness,6112,6112,0,2017_boxofficemojo_rankings.csv,2017,1.0,0.0
7029,Rangrezz,6108,6108,0,2013_boxofficemojo_rankings.csv,2013,1.0,0.0
7030,The Last Fall,6100,6100,0,2012_boxofficemojo_rankings.csv,2012,1.0,0.0
7031,The Last Time I Saw Macao,6095,6095,0,2013_boxofficemojo_rankings.csv,2013,1.0,0.0
7032,The Fuzz,6067,6067,0,2017_boxofficemojo_rankings.csv,2017,1.0,0.0
7033,The Miners' Hymns,6051,6051,0,2012_boxofficemojo_rankings.csv,2012,1.0,0.0
7034,The Marquise of O,6048,6048,0,2015_boxofficemojo_rankings.csv,2015,1.0,0.0
7035,Blood Widow,6047,6047,0,2019_boxofficemojo_rankings.csv,2019,1.0,0.0
7036,Love & Air Sex,6047,6047,0,2014_boxofficemojo_rankings.csv,2014,1.0,0.0
7037,The Family Tree,6035,6035,0,2011_boxofficemojo_rankings.csv,2011,1.0,0.0
7038,BearCity,6000,6000,0,2010_boxofficemojo_rankings.csv,2010,1.0,0.0
7039,On Wings of Eagles 2017 Re-release,5975,5975,0,2017_boxofficemojo_rankings.csv,2017,1.0,0.0
7040,"Sex, Death and Bowling",5972,5972,0,2015_boxofficemojo_rankings.csv,2015,1.0,0.0
7041,The Playroom,5964,5964,0,2013_boxofficemojo_rankings.csv,2013,1.0,0.0
7042,Cavemen,5948,5948,0,2014_boxofficemojo_rankings.csv,2014,1.0,0.0
7043,Starless Dreams,5937,5937,0,2017_boxofficemojo_rankings.csv,2017,1.0,0.0
7044,American Animal,5928,5928,0,2012_boxofficemojo_rankings.csv,2012,1.0,0.0
7045,Sweethearts of the Prison Rodeo,5922,5922,0,2010_boxofficemojo_rankings.csv,2010,1.0,0.0
7046,I Am MLK Jr.,5918,5918,0,2018_boxofficemojo_rankings.csv,2018,1.0,0.0
7047,Gang of Ghosts,5906,5906,0,2014_boxofficemojo_rankings.csv,2014,1.0,0.0
7048,Slash,5902,5902,0,2016_boxofficemojo_rankings.csv,2016,1.0,0.0
7049,Medeas,5895,5895,0,2015_boxofficemojo_rankings.csv,2015,1.0,0.0
7050,An Actor Prepares,5891,1743,4148,2018_boxofficemojo_rankings.csv,2018,0.2958750636564251,0.704124936343575
7051,Infliction,5875,5875,0,2014_boxofficemojo_rankings.csv,2014,1.0,0.0
7052,The Imperialists Are Still Alive!,5874,5874,0,2011_boxofficemojo_rankings.csv,2011,1.0,0.0
7053,Empire of Silver 2011 Re-release,5867,0,5867,2011_boxofficemojo_rankings.csv,2011,0.0,1.0
7054,BuzzKill,5860,5860,0,2012_boxofficemojo_rankings.csv,2012,1.0,0.0
7055,Top Spin,5858,5858,0,2015_boxofficemojo_rankings.csv,2015,1.0,0.0
7056,Bourek,5844,5844,0,2016_boxofficemojo_rankings.csv,2016,1.0,0.0
7057,Shout Gladi Gladi,5839,5839,0,2015_boxofficemojo_rankings.csv,2015,1.0,0.0
7058,Human Nature,5834,5487,347,2019_boxofficemojo_rankings.csv,2019,0.9405210833047651,0.05947891669523483
7059,Five Dances,5788,5788,0,2013_boxofficemojo_rankings.csv,2013,1.0,0.0
7060,Black November,5782,5782,0,2015_boxofficemojo_rankings.csv,2015,1.0,0.0
7061,Undrafted,5777,5777,0,2016_boxofficemojo_rankings.csv,2016,1.0,0.0
7062,In the Life of Music,5772,5772,0,2020_boxofficemojo_rankings.csv,2020,1.0,0.0
7063,Sushi: The Global Catch,5757,5757,0,2012_boxofficemojo_rankings.csv,2012,1.0,0.0
7064,A Dark Truth,5750,5750,0,2013_boxofficemojo_rankings.csv,2013,1.0,0.0
7065,Sex and the Future,5745,5745,0,2020_boxofficemojo_rankings.csv,2020,1.0,0.0
7066,Love Goes Public,5738,5738,0,2019_boxofficemojo_rankings.csv,2019,1.0,0.0
7067,Save the Date,5719,5719,0,2012_boxofficemojo_rankings.csv,2012,1.0,0.0
7068,The Wanted 18,5680,5680,0,2015_boxofficemojo_rankings.csv,2015,1.0,0.0
7069,People of a Feather,5677,5677,0,2013_boxofficemojo_rankings.csv,2013,1.0,0.0
7070,The Fall of Night,5673,5673,0,2010_boxofficemojo_rankings.csv,2010,1.0,0.0
7071,Knife Fight,5661,5661,0,2013_boxofficemojo_rankings.csv,2013,1.0,0.0
7072,Papirosen,5658,5658,0,2014_boxofficemojo_rankings.csv,2014,1.0,0.0
7073,This Isn't Funny,5654,5654,0,2015_boxofficemojo_rankings.csv,2015,1.0,0.0
7074,Série noire,5633,5633,0,2019_boxofficemojo_rankings.csv,2019,1.0,0.0
7075,La Chinoise 2017 Re-release,5631,5631,0,2017_boxofficemojo_rankings.csv,2017,1.0,0.0
7076,Elevate,5580,5580,0,2011_boxofficemojo_rankings.csv,2011,1.0,0.0
7077,Our Man in Tehran,5573,5573,0,2015_boxofficemojo_rankings.csv,2015,1.0,0.0
7078,Kid Cannabis,5565,5565,0,2014_boxofficemojo_rankings.csv,2014,1.0,0.0
7079,The Miracle of the Little Prince,5553,5553,0,2019_boxofficemojo_rankings.csv,2019,1.0,0.0
7080,Booker's Place: A Mississippi Story,5549,5549,0,2012_boxofficemojo_rankings.csv,2012,1.0,0.0
7081,American Grindhouse,5529,5529,0,2010_boxofficemojo_rankings.csv,2010,1.0,0.0
7082,Are We Not Cats,5518,5518,0,2018_boxofficemojo_rankings.csv,2018,1.0,0.0
7083,The Living,5514,5514,0,2015_boxofficemojo_rankings.csv,2015,1.0,0.0
7084,Icaros: A Vision,5510,5510,0,2017_boxofficemojo_rankings.csv,2017,1.0,0.0
7085,The Man from Earth: Holocene,5472,5472,0,2017_boxofficemojo_rankings.csv,2017,1.0,0.0
7086,Cuban Food Stories,5434,5434,0,2018_boxofficemojo_rankings.csv,2018,1.0,0.0
7087,Flex Is Kings,5418,5418,0,2014_boxofficemojo_rankings.csv,2014,1.0,0.0
7088,Whiz Kids,5386,5386,0,2010_boxofficemojo_rankings.csv,2010,1.0,0.0
7089,The Only Real Game,5384,5384,0,2014_boxofficemojo_rankings.csv,2014,1.0,0.0
7090,She's Lost Control,5319,5319,0,2015_boxofficemojo_rankings.csv,2015,1.0,0.0
7091,12 Hour Shift,5319,5319,0,2020_boxofficemojo_rankings.csv,2020,1.0,0.0
7092,The Time Being,5274,5274,0,2013_boxofficemojo_rankings.csv,2013,1.0,0.0
7093,It's Not Yet Dark,5269,1227,4042,2017_boxofficemojo_rankings.csv,2017,0.2328715126209907,0.7671284873790093
7094,Still Here,5268,5268,0,2020_boxofficemojo_rankings.csv,2020,1.0,0.0
7095,Killers,5248,0,5248,2014_boxofficemojo_rankings.csv,2014,0.0,1.0
7096,Sarajevo,5247,5247,0,2015_boxofficemojo_rankings.csv,2015,1.0,0.0
7097,Speed-Dating,5240,5240,0,2010_boxofficemojo_rankings.csv,2010,1.0,0.0
7098,The Princess of France,5212,5212,0,2015_boxofficemojo_rankings.csv,2015,1.0,0.0
7099,Death Valley,5211,5211,0,2015_boxofficemojo_rankings.csv,2015,1.0,0.0
7100,In Searching,5210,5210,0,2018_boxofficemojo_rankings.csv,2018,1.0,0.0
7101,Chokehold,5200,5200,0,2019_boxofficemojo_rankings.csv,2019,1.0,0.0
7102,The Gliksmans,5166,5166,0,2019_boxofficemojo_rankings.csv,2019,1.0,0.0
7103,And They're Off,5154,5154,0,2011_boxofficemojo_rankings.csv,2011,1.0,0.0
7104,100 Acres of Hell,5152,5152,0,2019_boxofficemojo_rankings.csv,2019,1.0,0.0
7105,To Die Is Hard,5129,5129,0,2010_boxofficemojo_rankings.csv,2010,1.0,0.0
7106,Body at Brighton Rock,5123,5123,0,2019_boxofficemojo_rankings.csv,2019,1.0,0.0
7107,Return to Nuke 'Em High Volume 1,5122,5122,0,2014_boxofficemojo_rankings.csv,2014,1.0,0.0
7108,Intersection,5116,5116,0,2018_boxofficemojo_rankings.csv,2018,1.0,0.0
7109,Bad Lucky Goat,5088,5088,0,2017_boxofficemojo_rankings.csv,2017,1.0,0.0
7110,On War 2015 Re-release,5086,5086,0,2015_boxofficemojo_rankings.csv,2015,1.0,0.0
7111,Welcome to Happiness,5083,5083,0,2016_boxofficemojo_rankings.csv,2016,1.0,0.0
7112,2307: Winter's Dream,5078,0,5078,2017_boxofficemojo_rankings.csv,2017,0.0,1.0
7113,Bidder 70,5074,5074,0,2013_boxofficemojo_rankings.csv,2013,1.0,0.0
7114,Tanner Hall,5073,5073,0,2011_boxofficemojo_rankings.csv,2011,1.0,0.0
7115,Notes on an Appearance,5065,5065,0,2018_boxofficemojo_rankings.csv,2018,1.0,0.0
7116,Chulas Fronteras,5021,5021,0,2019_boxofficemojo_rankings.csv,2019,1.0,0.0
7117,The Sleepwalker,5012,5012,0,2014_boxofficemojo_rankings.csv,2014,1.0,0.0
7118,Downtown Express,5010,5010,0,2012_boxofficemojo_rankings.csv,2012,1.0,0.0
7119,The Texture of Falling,5010,5010,0,2018_boxofficemojo_rankings.csv,2018,1.0,0.0
7120,Social Animals,5007,5007,0,2018_boxofficemojo_rankings.csv,2018,1.0,0.0
7121,The Garden,5006,5006,0,2019_boxofficemojo_rankings.csv,2019,1.0,0.0
7122,An L.A. Minute,5004,5004,0,2018_boxofficemojo_rankings.csv,2018,1.0,0.0
7123,Newlyweds,5000,5000,0,2012_boxofficemojo_rankings.csv,2012,1.0,0.0
7124,Weekend of a Champion,4976,4100,876,2013_boxofficemojo_rankings.csv,2013,0.8239549839228296,0.1760450160771704
7125,Bringing Up Bobby,4975,4975,0,2012_boxofficemojo_rankings.csv,2012,1.0,0.0
7126,sxtape,4961,0,4961,2014_boxofficemojo_rankings.csv,2014,0.0,1.0
7127,Futaba kara tooku hanarete,4960,4960,0,2013_boxofficemojo_rankings.csv,2013,1.0,0.0
7128,Herman's House,4956,4956,0,2013_boxofficemojo_rankings.csv,2013,1.0,0.0
7129,To Die Like a Man,4955,4029,926,2011_boxofficemojo_rankings.csv,2011,0.8131180625630676,0.1868819374369324
7130,SBK: The Movie,4950,4950,0,2015_boxofficemojo_rankings.csv,2015,1.0,0.0
7131,Tournament,4942,4942,0,2017_boxofficemojo_rankings.csv,2017,1.0,0.0
7132,Company Town,4934,4934,0,2017_boxofficemojo_rankings.csv,2017,1.0,0.0
7133,Supporting Characters,4917,4917,0,2013_boxofficemojo_rankings.csv,2013,1.0,0.0
7134,Guidance,4900,4900,0,2015_boxofficemojo_rankings.csv,2015,1.0,0.0
7135,Malek,4898,4898,0,2019_boxofficemojo_rankings.csv,2019,1.0,0.0
7136,Revelation Road 2: The Sea of Glass and Fire,4871,4871,0,2013_boxofficemojo_rankings.csv,2013,1.0,0.0
7137,Nothing Bad Can Happen,4870,4870,0,2014_boxofficemojo_rankings.csv,2014,1.0,0.0
7138,Crepitus,4846,4846,0,2019_boxofficemojo_rankings.csv,2019,1.0,0.0
7139,Call Her Applebroog,4842,4842,0,2016_boxofficemojo_rankings.csv,2016,1.0,0.0
7140,Ballet Blanc,4832,4832,0,2019_boxofficemojo_rankings.csv,2019,1.0,0.0
7141,Ferlinghetti: A Rebirth of Wonder,4816,4816,0,2013_boxofficemojo_rankings.csv,2013,1.0,0.0
7142,"Half The Road: The Passion, Pitfalls & Power of Women's Professional Cycling",4783,4783,0,2014_boxofficemojo_rankings.csv,2014,1.0,0.0
7143,Behind the White Glasses,4770,2223,2547,2016_boxofficemojo_rankings.csv,2016,0.4660377358490566,0.5339622641509434
7144,Miss Hill: Making Dance Matter,4706,4706,0,2015_boxofficemojo_rankings.csv,2015,1.0,0.0
7145,Shot,4701,4701,0,2017_boxofficemojo_rankings.csv,2017,1.0,0.0
7146,Marinoni: The Fire in the Frame,4696,4696,0,2016_boxofficemojo_rankings.csv,2016,1.0,0.0
7147,The Other Side of Everything,4685,4685,0,2018_boxofficemojo_rankings.csv,2018,1.0,0.0
7148,Death Metal Angola,4674,4674,0,2014_boxofficemojo_rankings.csv,2014,1.0,0.0
7149,The Long Dumb Road,4667,4667,0,2018_boxofficemojo_rankings.csv,2018,1.0,0.0
7150,Blood on the Mountain,4664,4664,0,2016_boxofficemojo_rankings.csv,2016,1.0,0.0
7151,Night School,4663,4663,0,2017_boxofficemojo_rankings.csv,2017,1.0,0.0
7152,I Love You Both,4661,4661,0,2017_boxofficemojo_rankings.csv,2017,1.0,0.0
7153,Shakespeare-Wallah,4650,4650,0,2017_boxofficemojo_rankings.csv,2017,1.0,0.0
7154,Against the Sun,4646,4646,0,2015_boxofficemojo_rankings.csv,2015,1.0,0.0
7155,Seeds of Time,4630,4630,0,2015_boxofficemojo_rankings.csv,2015,1.0,0.0
7156,Miss Stevens,4611,4611,0,2016_boxofficemojo_rankings.csv,2016,1.0,0.0
7157,The Automatic Hate,4603,4603,0,2016_boxofficemojo_rankings.csv,2016,1.0,0.0
7158,Protector 2010 Re-release,4576,2968,1608,2010_boxofficemojo_rankings.csv,2010,0.6486013986013986,0.3513986013986014
7159,Search Party 2016 Re-release,4571,4571,0,2016_boxofficemojo_rankings.csv,2016,1.0,0.0
7160,Smiling Through the Apocalypse,4560,4560,0,2014_boxofficemojo_rankings.csv,2014,1.0,0.0
7161,All Is Bright,4556,4556,0,2013_boxofficemojo_rankings.csv,2013,1.0,0.0
7162,A Boy Called Po,4550,4550,0,2017_boxofficemojo_rankings.csv,2017,1.0,0.0
7163,Promised Lands,4546,4546,0,2010_boxofficemojo_rankings.csv,2010,1.0,0.0
7164,Lie Exposed,4546,4546,0,2020_boxofficemojo_rankings.csv,2020,1.0,0.0
7165,Here Comes the Devil,4534,4534,0,2013_boxofficemojo_rankings.csv,2013,1.0,0.0
7166,Weightless,4530,4461,69,2018_boxofficemojo_rankings.csv,2018,0.9847682119205298,0.015231788079470199
7167,Unrelated 2014 Re-release,4529,4529,0,2014_boxofficemojo_rankings.csv,2014,1.0,0.0
7168,Synchronicity,4505,4505,0,2016_boxofficemojo_rankings.csv,2016,1.0,0.0
7169,The Pulitzer at 100,4489,4489,0,2017_boxofficemojo_rankings.csv,2017,1.0,0.0
7170,I'm Leaving Now,4488,4488,0,2019_boxofficemojo_rankings.csv,2019,1.0,0.0
7171,German Concentration Camps Factual Survey,4468,4468,0,2017_boxofficemojo_rankings.csv,2017,1.0,0.0
7172,"Farewell, Herr Schwarz",4445,4445,0,2015_boxofficemojo_rankings.csv,2015,1.0,0.0
7173,Generation Iron 2,4439,4439,0,2017_boxofficemojo_rankings.csv,2017,1.0,0.0
7174,SGT. Will Gardner,4405,4405,0,2019_boxofficemojo_rankings.csv,2019,1.0,0.0
7175,The Truth About Emanuel,4404,4404,0,2014_boxofficemojo_rankings.csv,2014,1.0,0.0
7176,The Peacemaker,4400,4400,0,2018_boxofficemojo_rankings.csv,2018,1.0,0.0
7177,30-LOVE,4392,4392,0,2017_boxofficemojo_rankings.csv,2017,1.0,0.0
7178,Between Us,4380,4380,0,2013_boxofficemojo_rankings.csv,2013,1.0,0.0
7179,The End of Time,4375,4375,0,2013_boxofficemojo_rankings.csv,2013,1.0,0.0
7180,The Woman Who Left,4373,3974,399,2017_boxofficemojo_rankings.csv,2017,0.9087582895037731,0.09124171049622684
7181,The Catechism Cataclysm,4373,4373,0,2011_boxofficemojo_rankings.csv,2011,1.0,0.0
7182,The Party's Just Beginning,4371,4145,226,2018_boxofficemojo_rankings.csv,2018,0.9482955845344315,0.05170441546556852
7183,The Flower of Kim Jong II,4362,4362,0,2010_boxofficemojo_rankings.csv,2010,1.0,0.0
7184,Tito and the Birds,4332,4332,0,2019_boxofficemojo_rankings.csv,2019,1.0,0.0
7185,On Meditation,4322,4322,0,2016_boxofficemojo_rankings.csv,2016,1.0,0.0
7186,Days of Grace 2015 Re-release,4308,4308,0,2015_boxofficemojo_rankings.csv,2015,1.0,0.0
7187,The Tower,4305,1117,3188,2014_boxofficemojo_rankings.csv,2014,0.259465737514518,0.740534262485482
7188,Auto Shop of Horrors,4300,4300,0,2016_boxofficemojo_rankings.csv,2016,1.0,0.0
7189,The Fate of Lee Khan,4295,4295,0,2019_boxofficemojo_rankings.csv,2019,1.0,0.0
7190,Art Is... The Permanent Revolution,4291,4291,0,2012_boxofficemojo_rankings.csv,2012,1.0,0.0
7191,State Like Sleep,4282,4282,0,2019_boxofficemojo_rankings.csv,2019,1.0,0.0
7192,Set Fire to the Stars,4280,4280,0,2015_boxofficemojo_rankings.csv,2015,1.0,0.0
7193,The Knife of Don Juan,4254,4254,0,2015_boxofficemojo_rankings.csv,2015,1.0,0.0
7194,My Father Die,4252,4252,0,2017_boxofficemojo_rankings.csv,2017,1.0,0.0
7195,Cocote,4224,3815,409,2018_boxofficemojo_rankings.csv,2018,0.9031723484848485,0.09682765151515152
7196,Maximum Ride,4218,4218,0,2016_boxofficemojo_rankings.csv,2016,1.0,0.0
7197,Stella's Last Weekend,4215,4215,0,2018_boxofficemojo_rankings.csv,2018,1.0,0.0
7198,Breaking a Monster,4212,4212,0,2016_boxofficemojo_rankings.csv,2016,1.0,0.0
7199,Free the Nipple,4198,4198,0,2014_boxofficemojo_rankings.csv,2014,1.0,0.0
7200,Helena from the Wedding,4190,4190,0,2010_boxofficemojo_rankings.csv,2010,1.0,0.0
7201,Among the Believers,4189,4189,0,2016_boxofficemojo_rankings.csv,2016,1.0,0.0
7202,3 Geezers!,4175,4175,0,2013_boxofficemojo_rankings.csv,2013,1.0,0.0
7203,Daylight,4171,4171,0,2011_boxofficemojo_rankings.csv,2011,1.0,0.0
7204,Badsville,4153,4153,0,2017_boxofficemojo_rankings.csv,2017,1.0,0.0
7205,Pawn,4141,4141,0,2013_boxofficemojo_rankings.csv,2013,1.0,0.0
7206,Chinese Portrait,4140,4140,0,2019_boxofficemojo_rankings.csv,2019,1.0,0.0
7207,Contracted,4105,4105,0,2013_boxofficemojo_rankings.csv,2013,1.0,0.0
7208,Jason Becker: Not Dead Yet,4080,1294,2786,2012_boxofficemojo_rankings.csv,2012,0.317156862745098,0.682843137254902
7209,Silver Circle,4080,4080,0,2013_boxofficemojo_rankings.csv,2013,1.0,0.0
7210,Three Night Stand,4076,4076,0,2015_boxofficemojo_rankings.csv,2015,1.0,0.0
7211,The Kitchen,4054,4054,0,2013_boxofficemojo_rankings.csv,2013,1.0,0.0
7212,La Flor,4032,4032,0,2019_boxofficemojo_rankings.csv,2019,1.0,0.0
7213,Morning,4029,4029,0,2013_boxofficemojo_rankings.csv,2013,1.0,0.0
7214,Approved for Adoption 2013 Re-release,4015,4015,0,2013_boxofficemojo_rankings.csv,2013,1.0,0.0
7215,Yangsi,4008,4008,0,2012_boxofficemojo_rankings.csv,2012,1.0,0.0
7216,Campus Radio,4000,4000,0,2011_boxofficemojo_rankings.csv,2011,1.0,0.0
7217,Building Hope,4000,4000,0,2011_boxofficemojo_rankings.csv,2011,1.0,0.0
7218,Pickin' & Grinnin',4000,4000,0,2012_boxofficemojo_rankings.csv,2012,1.0,0.0
7219,Emily,3982,3982,0,2017_boxofficemojo_rankings.csv,2017,1.0,0.0
7220,Dream Boat,3981,3981,0,2017_boxofficemojo_rankings.csv,2017,1.0,0.0
7221,Armed,3948,3948,0,2018_boxofficemojo_rankings.csv,2018,1.0,0.0
7222,Just Say Love,3944,3944,0,2010_boxofficemojo_rankings.csv,2010,1.0,0.0
7223,Mother of a Day,3919,3919,0,2019_boxofficemojo_rankings.csv,2019,1.0,0.0
7224,Maidan,3909,3909,0,2014_boxofficemojo_rankings.csv,2014,1.0,0.0
7225,Find Your Voice,3897,3897,0,2020_boxofficemojo_rankings.csv,2020,1.0,0.0
7226,American Dresser,3895,3895,0,2018_boxofficemojo_rankings.csv,2018,1.0,0.0
7227,The Iron Ministry,3885,3340,545,2015_boxofficemojo_rankings.csv,2015,0.8597168597168597,0.1402831402831403
7228,Crown Vic,3868,3868,0,2019_boxofficemojo_rankings.csv,2019,1.0,0.0
7229,Hollidaysburg,3861,3861,0,2014_boxofficemojo_rankings.csv,2014,1.0,0.0
7230,The Second Time Around,3837,3837,0,2018_boxofficemojo_rankings.csv,2018,1.0,0.0
7231,Aashayein,3836,0,3836,2010_boxofficemojo_rankings.csv,2010,0.0,1.0
7232,"High Tech, Low Life",3836,3836,0,2013_boxofficemojo_rankings.csv,2013,1.0,0.0
7233,King's Gambit,3816,3816,0,2020_boxofficemojo_rankings.csv,2020,1.0,0.0
7234,Free Radicals: A History of Experimental Film,3804,3804,0,2012_boxofficemojo_rankings.csv,2012,1.0,0.0
7235,Wallflower,3801,3801,0,2019_boxofficemojo_rankings.csv,2019,1.0,0.0
7236,Unfreedom,3778,3778,0,2015_boxofficemojo_rankings.csv,2015,1.0,0.0
7237,They Come to America,3775,3775,0,2012_boxofficemojo_rankings.csv,2012,1.0,0.0
7238,The Gender Card Flip,3774,3774,0,2017_boxofficemojo_rankings.csv,2017,1.0,0.0
7239,In/Significant Others,3763,3763,0,2010_boxofficemojo_rankings.csv,2010,1.0,0.0
7240,The Hollow,3755,3755,0,2016_boxofficemojo_rankings.csv,2016,1.0,0.0
7241,Nelly,3751,3751,0,2018_boxofficemojo_rankings.csv,2018,1.0,0.0
7242,Bugs,3742,3742,0,2017_boxofficemojo_rankings.csv,2017,1.0,0.0
7243,Bad Blood,3731,3731,0,2012_boxofficemojo_rankings.csv,2012,1.0,0.0
7244,The Free Speech Apocalypse,3726,3726,0,2015_boxofficemojo_rankings.csv,2015,1.0,0.0
7245,The Condemned,3718,3718,0,2013_boxofficemojo_rankings.csv,2013,1.0,0.0
7246,The Harvest/La Cosecha,3709,3709,0,2011_boxofficemojo_rankings.csv,2011,1.0,0.0
7247,Heartless,3697,3697,0,2010_boxofficemojo_rankings.csv,2010,1.0,0.0
7248,The Family,3696,3696,0,2018_boxofficemojo_rankings.csv,2018,1.0,0.0
7249,The Word,3648,3648,0,2014_boxofficemojo_rankings.csv,2014,1.0,0.0
7250,Smash His Camera,3644,3644,0,2010_boxofficemojo_rankings.csv,2010,1.0,0.0
7251,Stop The Pounding Heart,3642,3642,0,2014_boxofficemojo_rankings.csv,2014,1.0,0.0
7252,The Wandering Soap Opera,3624,3624,0,2019_boxofficemojo_rankings.csv,2019,1.0,0.0
7253,Mr. Nobody 2013 Re-release,3622,3622,0,2013_boxofficemojo_rankings.csv,2013,1.0,0.0
7254,Hyena,3586,3401,185,2015_boxofficemojo_rankings.csv,2015,0.9484104852203011,0.05158951477969883
7255,Hide Your Smiling Faces,3576,3576,0,2014_boxofficemojo_rankings.csv,2014,1.0,0.0
7256,Evolution of a Criminal,3568,3568,0,2014_boxofficemojo_rankings.csv,2014,1.0,0.0
7257,The Last Film Festival,3558,3558,0,2016_boxofficemojo_rankings.csv,2016,1.0,0.0
7258,Fourplay,3550,3550,0,2018_boxofficemojo_rankings.csv,2018,1.0,0.0
7259,The Beautiful Troublemaker 2017 Re-release,3540,3540,0,2017_boxofficemojo_rankings.csv,2017,1.0,0.0
7260,Tricked,3533,3533,0,2013_boxofficemojo_rankings.csv,2013,1.0,0.0
7261,The Loving Story 2016 Re-release,3518,3518,0,2016_boxofficemojo_rankings.csv,2016,1.0,0.0
7262,Who's Crazy?,3497,3497,0,2017_boxofficemojo_rankings.csv,2017,1.0,0.0
7263,Locker 13,3496,3496,0,2014_boxofficemojo_rankings.csv,2014,1.0,0.0
7264,The Citizen 2018 Re-release,3495,3495,0,2018_boxofficemojo_rankings.csv,2018,1.0,0.0
7265,Dead Awake,3484,0,3484,2010_boxofficemojo_rankings.csv,2010,0.0,1.0
7266,"Love, Sweat and Tears",3482,3482,0,2017_boxofficemojo_rankings.csv,2017,1.0,0.0
7267,Metal Messiah,3476,3476,0,2010_boxofficemojo_rankings.csv,2010,1.0,0.0
7268,The Hacker Wars,3470,3470,0,2014_boxofficemojo_rankings.csv,2014,1.0,0.0
7269,The Full Picture,3467,3467,0,2010_boxofficemojo_rankings.csv,2010,1.0,0.0
7270,Aftermath,3451,3451,0,2014_boxofficemojo_rankings.csv,2014,1.0,0.0
7271,Life's a Breeze 2014 Re-release,3450,3450,0,2014_boxofficemojo_rankings.csv,2014,1.0,0.0
7272,Scenic Route,3434,3434,0,2013_boxofficemojo_rankings.csv,2013,1.0,0.0
7273,Mahogany Sunrise,3432,3432,0,2014_boxofficemojo_rankings.csv,2014,1.0,0.0
7274,Restored Me 2016 Re-release,3428,3428,0,2016_boxofficemojo_rankings.csv,2016,1.0,0.0
7275,Speed Sisters,3423,3423,0,2017_boxofficemojo_rankings.csv,2017,1.0,0.0
7276,The Happy Poet,3400,3400,0,2013_boxofficemojo_rankings.csv,2013,1.0,0.0
7277,The Cage Fighter,3392,3392,0,2018_boxofficemojo_rankings.csv,2018,1.0,0.0
7278,Rottentail,3383,3383,0,2019_boxofficemojo_rankings.csv,2019,1.0,0.0
7279,Amanda & Jack Go Glamping,3352,3352,0,2017_boxofficemojo_rankings.csv,2017,1.0,0.0
7280,Bad Match,3351,3351,0,2017_boxofficemojo_rankings.csv,2017,1.0,0.0
7281,Followers,3350,3350,0,2018_boxofficemojo_rankings.csv,2018,1.0,0.0
7282,Fashion Victim,3346,3346,0,2010_boxofficemojo_rankings.csv,2010,1.0,0.0
7283,Swerve,3338,3338,0,2013_boxofficemojo_rankings.csv,2013,1.0,0.0
7284,Mi America,3330,3330,0,2015_boxofficemojo_rankings.csv,2015,1.0,0.0
7285,Know How,3323,3323,0,2015_boxofficemojo_rankings.csv,2015,1.0,0.0
7286,Drunk Wedding,3301,3301,0,2015_boxofficemojo_rankings.csv,2015,1.0,0.0
7287,Burning Bodhi,3289,3289,0,2016_boxofficemojo_rankings.csv,2016,1.0,0.0
7288,Axe Giant: The Wrath of Paul Bunyan,3287,3287,0,2013_boxofficemojo_rankings.csv,2013,1.0,0.0
7289,El Superstar: The Unlikely Rise of Juan Frances,3271,3271,0,2010_boxofficemojo_rankings.csv,2010,1.0,0.0
7290,Justice,3259,3259,0,2017_boxofficemojo_rankings.csv,2017,1.0,0.0
7291,Windsor Drive,3256,3256,0,2015_boxofficemojo_rankings.csv,2015,1.0,0.0
7292,Over the Limit,3243,3243,0,2018_boxofficemojo_rankings.csv,2018,1.0,0.0
7293,The Sons of Tennessee Williams,3242,3242,0,2011_boxofficemojo_rankings.csv,2011,1.0,0.0
7294,As Cool as I Am,3234,3234,0,2013_boxofficemojo_rankings.csv,2013,1.0,0.0
7295,Blackhats,3216,3216,0,2015_boxofficemojo_rankings.csv,2015,1.0,0.0
7296,After the Wizard,3184,3184,0,2012_boxofficemojo_rankings.csv,2012,1.0,0.0
7297,Apart,3161,3161,0,2012_boxofficemojo_rankings.csv,2012,1.0,0.0
7298,Game Changers,3142,3142,0,2018_boxofficemojo_rankings.csv,2018,1.0,0.0
7299,Balls to the Wall,3140,3140,0,2011_boxofficemojo_rankings.csv,2011,1.0,0.0
7300,Hot to Trot,3133,3133,0,2018_boxofficemojo_rankings.csv,2018,1.0,0.0
7301,The Girl on the Train,3124,3124,0,2014_boxofficemojo_rankings.csv,2014,1.0,0.0
7302,Showrunners: The Art of Running a TV Show,3100,3100,0,2014_boxofficemojo_rankings.csv,2014,1.0,0.0
7303,What Now? Remind Me,3089,3089,0,2014_boxofficemojo_rankings.csv,2014,1.0,0.0
7304,The Trial of the Chicago 7,3084,0,3084,2020_boxofficemojo_rankings.csv,2020,0.0,1.0
7305,Drew: The Man Behind the Poster,3078,3078,0,2013_boxofficemojo_rankings.csv,2013,1.0,0.0
7306,Chasing Portraits,3076,3076,0,2019_boxofficemojo_rankings.csv,2019,1.0,0.0
7307,The Weird World of Blowfly,3062,3062,0,2011_boxofficemojo_rankings.csv,2011,1.0,0.0
7308,The Afterlight,3059,3059,0,2010_boxofficemojo_rankings.csv,2010,1.0,0.0
7309,Ottolenghi and the Cakes of Versailles,3028,3028,0,2020_boxofficemojo_rankings.csv,2020,1.0,0.0
7310,A French Gigolo 2014 Re-release,3021,3021,0,2014_boxofficemojo_rankings.csv,2014,1.0,0.0
7311,A Girl and a Gun,3018,3018,0,2013_boxofficemojo_rankings.csv,2013,1.0,0.0
7312,Best and Most Beautiful Things,3016,3016,0,2016_boxofficemojo_rankings.csv,2016,1.0,0.0
7313,The Ghosts of Johnson Woods,3000,3000,0,2016_boxofficemojo_rankings.csv,2016,1.0,0.0
7314,The Lie,3000,3000,0,2011_boxofficemojo_rankings.csv,2011,1.0,0.0
7315,Zokkomon,3000,3000,0,2011_boxofficemojo_rankings.csv,2011,1.0,0.0
7316,Fatal Assistance,3000,3000,0,2014_boxofficemojo_rankings.csv,2014,1.0,0.0
7317,Moana,2993,2993,0,2015_boxofficemojo_rankings.csv,2015,1.0,0.0
7318,Kepler's Dream,2923,2923,0,2017_boxofficemojo_rankings.csv,2017,1.0,0.0
7319,Demons,2900,2900,0,2017_boxofficemojo_rankings.csv,2017,1.0,0.0
7320,The Professor: Tai Chi's Journey West,2852,2852,0,2016_boxofficemojo_rankings.csv,2016,1.0,0.0
7321,Approaching Midnight,2795,2795,0,2013_boxofficemojo_rankings.csv,2013,1.0,0.0
7322,Nana,2784,2784,0,2018_boxofficemojo_rankings.csv,2018,1.0,0.0
7323,White Lies 2016 Re-release,2760,2760,0,2016_boxofficemojo_rankings.csv,2016,1.0,0.0
7324,Blood Ties,2760,2760,0,2011_boxofficemojo_rankings.csv,2011,1.0,0.0
7325,I Dream in Another Language,2739,2739,0,2017_boxofficemojo_rankings.csv,2017,1.0,0.0
7326,Black Out 2014 Re-release,2734,2734,0,2014_boxofficemojo_rankings.csv,2014,1.0,0.0
7327,The Lesser Blessed,2732,2732,0,2013_boxofficemojo_rankings.csv,2013,1.0,0.0
7328,Julia,2710,2710,0,2015_boxofficemojo_rankings.csv,2015,1.0,0.0
7329,Chocolat 2015 Re-release,2710,2710,0,2015_boxofficemojo_rankings.csv,2015,1.0,0.0
7330,Adolf Eichmann,2706,2706,0,2010_boxofficemojo_rankings.csv,2010,1.0,0.0
7331,Back to the Fatherland,2697,2697,0,2019_boxofficemojo_rankings.csv,2019,1.0,0.0
7332,Santoalla,2684,2684,0,2017_boxofficemojo_rankings.csv,2017,1.0,0.0
7333,Straight Into a Storm,2684,2684,0,2018_boxofficemojo_rankings.csv,2018,1.0,0.0
7334,Division 19,2680,1699,981,2019_boxofficemojo_rankings.csv,2019,0.633955223880597,0.366044776119403
7335,Restitution,2664,2664,0,2011_boxofficemojo_rankings.csv,2011,1.0,0.0
7336,United Red Army 2011 Re-release,2659,2659,0,2011_boxofficemojo_rankings.csv,2011,1.0,0.0
7337,Daughter of the Nile,2640,2640,0,2017_boxofficemojo_rankings.csv,2017,1.0,0.0
7338,Body,2634,2634,0,2015_boxofficemojo_rankings.csv,2015,1.0,0.0
7339,Refuge,2631,2631,0,2014_boxofficemojo_rankings.csv,2014,1.0,0.0
7340,ACORN and the Firestorm,2621,2621,0,2018_boxofficemojo_rankings.csv,2018,1.0,0.0
7341,Indigo Children,2621,2621,0,2014_boxofficemojo_rankings.csv,2014,1.0,0.0
7342,Sparrows Dance,2602,2602,0,2013_boxofficemojo_rankings.csv,2013,1.0,0.0
7343,Last Flight of the Champion,2597,2597,0,2013_boxofficemojo_rankings.csv,2013,1.0,0.0
7344,Carl,2592,2592,0,2012_boxofficemojo_rankings.csv,2012,1.0,0.0
7345,Jake Squared,2592,2592,0,2014_boxofficemojo_rankings.csv,2014,1.0,0.0
7346,Hammer of the Gods,2590,641,1949,2013_boxofficemojo_rankings.csv,2013,0.24749034749034748,0.7525096525096525
7347,Take Me,2583,2583,0,2017_boxofficemojo_rankings.csv,2017,1.0,0.0
7348,McCanick,2572,2572,0,2014_boxofficemojo_rankings.csv,2014,1.0,0.0
7349,Hayride 2,2571,2571,0,2015_boxofficemojo_rankings.csv,2015,1.0,0.0
7350,Joan the Maid 1: The Battles,2562,2562,0,2019_boxofficemojo_rankings.csv,2019,1.0,0.0
7351,Cassadaga,2544,2544,0,2013_boxofficemojo_rankings.csv,2013,1.0,0.0
7352,Two-Bit Waltz,2540,2540,0,2014_boxofficemojo_rankings.csv,2014,1.0,0.0
7353,Miles,2537,2537,0,2017_boxofficemojo_rankings.csv,2017,1.0,0.0
7354,Almost in Love,2510,2510,0,2013_boxofficemojo_rankings.csv,2013,1.0,0.0
7355,Mekong Hotel,2502,2502,0,2016_boxofficemojo_rankings.csv,2016,1.0,0.0
7356,The Last Day of August,2492,2492,0,2013_boxofficemojo_rankings.csv,2013,1.0,0.0
7357,Homeland (Iraq Year Zero),2491,2491,0,2016_boxofficemojo_rankings.csv,2016,1.0,0.0
7358,Men at Lunch,2483,2483,0,2013_boxofficemojo_rankings.csv,2013,1.0,0.0
7359,The Wait,2480,2480,0,2014_boxofficemojo_rankings.csv,2014,1.0,0.0
7360,TINY: The Life of Erin Blackwell,2465,2465,0,2019_boxofficemojo_rankings.csv,2019,1.0,0.0
7361,The Ghastly Love of Johnny X,2436,2436,0,2012_boxofficemojo_rankings.csv,2012,1.0,0.0
7362,Why Stop Now?,2432,2432,0,2012_boxofficemojo_rankings.csv,2012,1.0,0.0
7363,The Reflektor Tapes,2424,0,2424,2015_boxofficemojo_rankings.csv,2015,0.0,1.0
7364,L.A. Slasher,2421,2421,0,2015_boxofficemojo_rankings.csv,2015,1.0,0.0
7365,Ek Hazarachi Note,2404,2404,0,2016_boxofficemojo_rankings.csv,2016,1.0,0.0
7366,Daniel and Ana,2372,2372,0,2010_boxofficemojo_rankings.csv,2010,1.0,0.0
7367,Moondance,2371,2371,0,2020_boxofficemojo_rankings.csv,2020,1.0,0.0
7368,Evergreen: The Road to Legalization,2363,2363,0,2014_boxofficemojo_rankings.csv,2014,1.0,0.0
7369,I Lost Albert 2019 Re-release,2354,2354,0,2019_boxofficemojo_rankings.csv,2019,1.0,0.0
7370,A German Youth,2343,2343,0,2019_boxofficemojo_rankings.csv,2019,1.0,0.0
7371,Detective Chinatown 3,2342,0,2342,2020_boxofficemojo_rankings.csv,2020,0.0,1.0
7372,Lotus Eaters,2325,2325,0,2013_boxofficemojo_rankings.csv,2013,1.0,0.0
7373,The Happy House,2311,2311,0,2013_boxofficemojo_rankings.csv,2013,1.0,0.0
7374,Goldie,2302,2302,0,2020_boxofficemojo_rankings.csv,2020,1.0,0.0
7375,Serendipity,2298,2298,0,2019_boxofficemojo_rankings.csv,2019,1.0,0.0
7376,The Girl 2010 Re-release,2273,2201,72,2010_boxofficemojo_rankings.csv,2010,0.9683238011438627,0.03167619885613726
7377,The Pool Boys,2269,2269,0,2011_boxofficemojo_rankings.csv,2011,1.0,0.0
7378,Red Christmas,2255,2255,0,2017_boxofficemojo_rankings.csv,2017,1.0,0.0
7379,Anita Ho,2250,2250,0,2015_boxofficemojo_rankings.csv,2015,1.0,0.0
7380,Memoria,2242,2242,0,2016_boxofficemojo_rankings.csv,2016,1.0,0.0
7381,You Wont Miss Me,2240,2240,0,2010_boxofficemojo_rankings.csv,2010,1.0,0.0
7382,The Night Watchman,2219,2219,0,2012_boxofficemojo_rankings.csv,2012,1.0,0.0
7383,7 from Etheria,2208,2208,0,2017_boxofficemojo_rankings.csv,2017,1.0,0.0
7384,InSpectres,2207,2207,0,2013_boxofficemojo_rankings.csv,2013,1.0,0.0
7385,Scorn,2206,2206,0,2012_boxofficemojo_rankings.csv,2012,1.0,0.0
7386,NoBody's Perfect 2010 Re-release,2122,2122,0,2010_boxofficemojo_rankings.csv,2010,1.0,0.0
7387,Missionary,2120,2120,0,2014_boxofficemojo_rankings.csv,2014,1.0,0.0
7388,Me You and Five Bucks,2105,2105,0,2015_boxofficemojo_rankings.csv,2015,1.0,0.0
7389,Jihadists,2104,2104,0,2019_boxofficemojo_rankings.csv,2019,1.0,0.0
7390,Dayveon,2077,2077,0,2017_boxofficemojo_rankings.csv,2017,1.0,0.0
7391,Red Flag,2075,2075,0,2013_boxofficemojo_rankings.csv,2013,1.0,0.0
7392,Rubberneck,2075,2075,0,2013_boxofficemojo_rankings.csv,2013,1.0,0.0
7393,Patagonia Rising,2064,2064,0,2012_boxofficemojo_rankings.csv,2012,1.0,0.0
7394,Gul Makai,2035,0,2035,2020_boxofficemojo_rankings.csv,2020,0.0,1.0
7395,Algorithms,2021,2021,0,2014_boxofficemojo_rankings.csv,2014,1.0,0.0
7396,Split: A Deeper Divide,2000,2000,0,2012_boxofficemojo_rankings.csv,2012,1.0,0.0
7397,The Watermelon Woman,1989,1989,0,2016_boxofficemojo_rankings.csv,2016,1.0,0.0
7398,Falling Awake,1978,1978,0,2010_boxofficemojo_rankings.csv,2010,1.0,0.0
7399,The Temptation of St. Tony,1963,1963,0,2010_boxofficemojo_rankings.csv,2010,1.0,0.0
7400,The Transcendents,1953,1953,0,2020_boxofficemojo_rankings.csv,2020,1.0,0.0
7401,"Accidental Courtesy: Daryl Davis, Race & America",1940,1940,0,2017_boxofficemojo_rankings.csv,2017,1.0,0.0
7402,Best Man Down,1938,1938,0,2013_boxofficemojo_rankings.csv,2013,1.0,0.0
7403,Saint Maud,1933,0,1933,2020_boxofficemojo_rankings.csv,2020,0.0,1.0
7404,West Of The Jordan River,1926,1926,0,2018_boxofficemojo_rankings.csv,2018,1.0,0.0
7405,A Mother's Courage: Talking Back to Autism 2010 Re-release,1916,1916,0,2010_boxofficemojo_rankings.csv,2010,1.0,0.0
7406,Sneakerheadz,1903,1903,0,2015_boxofficemojo_rankings.csv,2015,1.0,0.0
7407,We Were Here,1873,0,1873,2011_boxofficemojo_rankings.csv,2011,0.0,1.0
7408,Finding Happiness,1841,1841,0,2018_boxofficemojo_rankings.csv,2018,1.0,0.0
7409,Jimi Hendrix Electric Church,1818,0,1818,2019_boxofficemojo_rankings.csv,2019,0.0,1.0
7410,Now & Later,1808,1808,0,2011_boxofficemojo_rankings.csv,2011,1.0,0.0
7411,I Kissed a Vampire,1794,1794,0,2012_boxofficemojo_rankings.csv,2012,1.0,0.0
7412,Detour,1788,1788,0,2017_boxofficemojo_rankings.csv,2017,1.0,0.0
7413,The Lost Village,1780,1780,0,2018_boxofficemojo_rankings.csv,2018,1.0,0.0
7414,Detention of the Dead,1777,1777,0,2013_boxofficemojo_rankings.csv,2013,1.0,0.0
7415,The Other Man: F.W. de Klerk and the End of Apartheid,1747,1747,0,2015_boxofficemojo_rankings.csv,2015,1.0,0.0
7416,Dark Forest,1739,1739,0,2015_boxofficemojo_rankings.csv,2015,1.0,0.0
7417,You Don't Need Feet to Dance,1719,1719,0,2013_boxofficemojo_rankings.csv,2013,1.0,0.0
7418,A Beautiful Now,1714,1714,0,2016_boxofficemojo_rankings.csv,2016,1.0,0.0
7419,The Looking Glass,1711,1711,0,2015_boxofficemojo_rankings.csv,2015,1.0,0.0
7420,Dystopia: 2013,1708,1708,0,2012_boxofficemojo_rankings.csv,2012,1.0,0.0
7421,More Than the Rainbow,1677,1677,0,2014_boxofficemojo_rankings.csv,2014,1.0,0.0
7422,They're Out of the Business,1655,1655,0,2011_boxofficemojo_rankings.csv,2011,1.0,0.0
7423,Drown,1631,1631,0,2015_boxofficemojo_rankings.csv,2015,1.0,0.0
7424,Cut Snake,1625,1625,0,2015_boxofficemojo_rankings.csv,2015,1.0,0.0
7425,Game Day,1624,1624,0,2019_boxofficemojo_rankings.csv,2019,1.0,0.0
7426,Miss India America,1598,1598,0,2016_boxofficemojo_rankings.csv,2016,1.0,0.0
7427,Forever,1598,1598,0,2015_boxofficemojo_rankings.csv,2015,1.0,0.0
7428,American Playhouse: The Killing Floor,1583,1583,0,2019_boxofficemojo_rankings.csv,2019,1.0,0.0
7429,Manuela and Manuel,1582,1582,0,2010_boxofficemojo_rankings.csv,2010,1.0,0.0
7430,The Fox Hunter,1577,1577,0,2020_boxofficemojo_rankings.csv,2020,1.0,0.0
7431,The Tunnel,1532,1532,0,2011_boxofficemojo_rankings.csv,2011,1.0,0.0
7432,Rhymes for Young Ghouls,1529,1529,0,2014_boxofficemojo_rankings.csv,2014,1.0,0.0
7433,"Carmo, Hit the Road 2010 Re-release",1512,1512,0,2010_boxofficemojo_rankings.csv,2010,1.0,0.0
7434,Souldier,1500,1500,0,2014_boxofficemojo_rankings.csv,2014,1.0,0.0
7435,Where Are You Taking Me?,1492,1492,0,2012_boxofficemojo_rankings.csv,2012,1.0,0.0
7436,Making Rounds,1484,1484,0,2015_boxofficemojo_rankings.csv,2015,1.0,0.0
7437,The Package,1469,1469,0,2013_boxofficemojo_rankings.csv,2013,1.0,0.0
7438,Henchmen,1469,1469,0,2018_boxofficemojo_rankings.csv,2018,1.0,0.0
7439,That Way Madness Lies...,1447,1447,0,2018_boxofficemojo_rankings.csv,2018,1.0,0.0
7440,Bestiaire,1428,1428,0,2012_boxofficemojo_rankings.csv,2012,1.0,0.0
7441,The Silence of Mark Rothko,1422,1422,0,2016_boxofficemojo_rankings.csv,2016,1.0,0.0
7442,The Forest for the Trees,1410,1410,0,2017_boxofficemojo_rankings.csv,2017,1.0,0.0
7443,Drool,1403,1403,0,2010_boxofficemojo_rankings.csv,2010,1.0,0.0
7444,Beauty and the Beholder,1368,1368,0,2018_boxofficemojo_rankings.csv,2018,1.0,0.0
7445,Along the Roadside 2015 Re-release,1352,1352,0,2015_boxofficemojo_rankings.csv,2015,1.0,0.0
7446,3 Nights in the Desert,1297,1297,0,2015_boxofficemojo_rankings.csv,2015,1.0,0.0
7447,The Hours and Times,1273,1273,0,2019_boxofficemojo_rankings.csv,2019,1.0,0.0
7448,Altered Perception,1259,1259,0,2018_boxofficemojo_rankings.csv,2018,1.0,0.0
7449,The Wolf Hour,1255,0,1255,2019_boxofficemojo_rankings.csv,2019,0.0,1.0
7450,A Fish in the Bathtub 2019 re-release,1237,1237,0,2019_boxofficemojo_rankings.csv,2019,1.0,0.0
7451,Two Men Went to War 2018 Re-release,1227,1227,0,2018_boxofficemojo_rankings.csv,2018,1.0,0.0
7452,A Small Good Thing,1196,1196,0,2016_boxofficemojo_rankings.csv,2016,1.0,0.0
7453,Under the Turban,1190,1190,0,2018_boxofficemojo_rankings.csv,2018,1.0,0.0
7454,Snowman's Land,1190,1190,0,2012_boxofficemojo_rankings.csv,2012,1.0,0.0
7455,Above and Below,1189,0,1189,2016_boxofficemojo_rankings.csv,2016,0.0,1.0
7456,A Different American Dream,1172,1172,0,2017_boxofficemojo_rankings.csv,2017,1.0,0.0
7457,A Zombie Invasion,1170,1170,0,2013_boxofficemojo_rankings.csv,2013,1.0,0.0
7458,Fear Pharm,1157,1157,0,2020_boxofficemojo_rankings.csv,2020,1.0,0.0
7459,Jack & Diane,1142,1142,0,2012_boxofficemojo_rankings.csv,2012,1.0,0.0
7460,Veer!,1132,1132,0,2013_boxofficemojo_rankings.csv,2013,1.0,0.0
7461,Hai Tang Hong,1107,1107,0,2020_boxofficemojo_rankings.csv,2020,1.0,0.0
7462,Half Brothers,1100,1100,0,2018_boxofficemojo_rankings.csv,2018,1.0,0.0
7463,We Are the Giant,1088,1088,0,2014_boxofficemojo_rankings.csv,2014,1.0,0.0
7464,The Butterfly Room,1081,1081,0,2014_boxofficemojo_rankings.csv,2014,1.0,0.0
7465,Childless,1036,1036,0,2015_boxofficemojo_rankings.csv,2015,1.0,0.0
7466,Invisible Hands,1034,1034,0,2018_boxofficemojo_rankings.csv,2018,1.0,0.0
7467,Absence,1031,1031,0,2013_boxofficemojo_rankings.csv,2013,1.0,0.0
7468,Remnants,1022,1022,0,2013_boxofficemojo_rankings.csv,2013,1.0,0.0
7469,The Penguin Counters,976,976,0,2017_boxofficemojo_rankings.csv,2017,1.0,0.0
7470,Strangers Online,968,968,0,2011_boxofficemojo_rankings.csv,2011,1.0,0.0
7471,A People Uncounted,930,930,0,2014_boxofficemojo_rankings.csv,2014,1.0,0.0
7472,They Are We,900,900,0,2015_boxofficemojo_rankings.csv,2015,1.0,0.0
7473,Big Muddy,881,881,0,2015_boxofficemojo_rankings.csv,2015,1.0,0.0
7474,Extraordinary Ordinary People,880,880,0,2017_boxofficemojo_rankings.csv,2017,1.0,0.0
7475,45365,853,853,0,2010_boxofficemojo_rankings.csv,2010,1.0,0.0
7476,Officer Downe,850,850,0,2016_boxofficemojo_rankings.csv,2016,1.0,0.0
7477,Abandoned,832,832,0,2011_boxofficemojo_rankings.csv,2011,1.0,0.0
7478,TVTV: Video Revolutionaries,812,812,0,2018_boxofficemojo_rankings.csv,2018,1.0,0.0
7479,Jackpot 2014 Re-release,806,806,0,2014_boxofficemojo_rankings.csv,2014,1.0,0.0
7480,The Untold Story,790,790,0,2019_boxofficemojo_rankings.csv,2019,1.0,0.0
7481,It's All So Quiet 2015 Re-release,724,724,0,2015_boxofficemojo_rankings.csv,2015,1.0,0.0
7482,A Girl Like Grace,713,713,0,2016_boxofficemojo_rankings.csv,2016,1.0,0.0
7483,Redneck Carnage,706,706,0,2011_boxofficemojo_rankings.csv,2011,1.0,0.0
7484,The Loving Story,700,700,0,2012_boxofficemojo_rankings.csv,2012,1.0,0.0
7485,It's Hard Being Loved by Jerks 2015 Re-release,697,697,0,2015_boxofficemojo_rankings.csv,2015,1.0,0.0
7486,The Portal,685,0,685,2019_boxofficemojo_rankings.csv,2019,0.0,1.0
7487,Syrup,663,663,0,2013_boxofficemojo_rankings.csv,2013,1.0,0.0
7488,Nature Calls,646,646,0,2012_boxofficemojo_rankings.csv,2012,1.0,0.0
7489,Citizen Gangster,625,625,0,2012_boxofficemojo_rankings.csv,2012,1.0,0.0
7490,Gottfried Helnwein and the Dreaming Child,601,601,0,2012_boxofficemojo_rankings.csv,2012,1.0,0.0
7491,Shake Hands with the Devil,594,594,0,2010_boxofficemojo_rankings.csv,2010,1.0,0.0
7492,A Good Day to Die,573,573,0,2011_boxofficemojo_rankings.csv,2011,1.0,0.0
7493,The Pit,560,560,0,2016_boxofficemojo_rankings.csv,2016,1.0,0.0
7494,Higher Power,528,528,0,2018_boxofficemojo_rankings.csv,2018,1.0,0.0
7495,Greater 2020 Re-release,527,527,0,2020_boxofficemojo_rankings.csv,2020,1.0,0.0
7496,Meeting Evil,525,525,0,2012_boxofficemojo_rankings.csv,2012,1.0,0.0
7497,The 11th Hour,510,0,510,2015_boxofficemojo_rankings.csv,2015,0.0,1.0
7498,Triumph of the Wall,476,476,0,2013_boxofficemojo_rankings.csv,2013,1.0,0.0
7499,Green is Gold,455,455,0,2016_boxofficemojo_rankings.csv,2016,1.0,0.0
7500,The Magician 2010 Re-release,406,406,0,2010_boxofficemojo_rankings.csv,2010,1.0,0.0
7501,Skinless,400,400,0,2014_boxofficemojo_rankings.csv,2014,1.0,0.0
7502,Cinemanovels,398,398,0,2014_boxofficemojo_rankings.csv,2014,1.0,0.0
7503,Spaceship Earth,362,0,362,2020_boxofficemojo_rankings.csv,2020,0.0,1.0
7504,Antiporno,294,0,294,2017_boxofficemojo_rankings.csv,2017,0.0,1.0
7505,Wet Woman in the Wind,268,0,268,2017_boxofficemojo_rankings.csv,2017,0.0,1.0
7506,"Mummy, I'm A Zombie",120,120,0,2014_boxofficemojo_rankings.csv,2014,1.0,0.0
7507,Paranoid Girls,78,78,0,2015_boxofficemojo_rankings.csv,2015,1.0,0.0
7508,Confession of a Child of the Century 2015 Re-release,74,74,0,2015_boxofficemojo_rankings.csv,2015,1.0,0.0
